	(+)-trans-carveol dehydrogenase	(1->4)-alpha-D-glucan 1-alpha-D-glucosylmutase	(1->4)-alpha-D-glucan branching enzyme	(1->4)-alpha-D-glucan synthase (UDP-glucose)	(2-(2,4-dihydroxy-6-methylphenyl)-2-  oxoethyl)-4-hydroxy-2-pyrone synthase	(2Fe-2S) ferredoxin	(2Fe-2S)-binding domain protein	(2R)-3-sulfolactate dehydrogenase (NADP+)	(2R)-sulfolactate sulfo-lyase subunit alpha	(2R)-sulfolactate sulfo-lyase subunit beta	(2S)-methylsuccinyl-CoA dehydrogenase	(3S)-malyl-CoA thioesterase	(Glutamate--ammonia-ligase) adenylyltransferase	(R)-ethylmalonyl-CoA mutase	(R,R)-butanediol dehydrogenase / meso-butanediol  dehydrogenase / diacetyl reductase	(S)-2-hydroxy-acid oxidase	(S)-sulfolactate dehydrogenase	(S)-ureidoglycine aminohydrolase	(p)ppGpp synthetase I, SpoT/RelA	1,2-dihydroxy-3-keto-5-methylthiopentene  dioxygenase	1,2-phenylacetyl-CoA epoxidase, catalytic  subunit	1,3,6,8-tetrahydroxynaphthalene monooxygenase	1,4-Dihydroxy-2-naphthoyl-CoA synthase	1,4-alpha-glucan branching enzyme	1,4-dihydroxy-2-naphthoate octaprenyltransferase	1,4-dihydroxy-2-naphthoate prenyltransferase	1,5-anhydro-D-fructose reductase  (1,5-anhydro-D-mannitol-forming)	1-Cys peroxiredoxin	1-Cys peroxiredoxin (EC 1.11.1.15)	1-acyl-sn-glycerol-3-phosphate acyltransferase	1-acyl-sn-glycerol-3-phosphate acyltransferase  (EC 2.3.1.51)	1-acyl-sn-glycerol-3-phosphate acyltransferases	1-aminocyclopropane-1-carboxylate deaminase	1-deoxy-D-xylulose 5-phosphate reductoisomerase	1-deoxy-D-xylulose 5-phosphate reductoisomerase  (EC 1.1.1.267)	1-deoxy-D-xylulose-5-phosphate synthase	1-deoxy-D-xylulose-5-phosphate synthase (EC  2.2.1.7)	1-hydroxycarotenoid 3,4-desaturase	1-phosphofructokinase	1-pyrroline dehydrogenase	15-methylpalmitoyl-4-hydroxy-2-pyrone  4-O-methyltransferase	15-methylpalmitoyl-4-hydroxy-2-pyrone synthase	16S RNA G1207 methylase RsmC	16S rRNA  (adenine1518-N6/adenine1519-N6)-dimethyltransferase	16S rRNA (cytidine1402-2'-O)-methyltransferase	16S rRNA (cytosine1402-N4)-methyltransferase	16S rRNA (cytosine967-C5)-methyltransferase	16S rRNA (guanine(966)-N(2))-methyltransferase  RsmD	16S rRNA (guanine1207-N2)-methyltransferase	16S rRNA (guanine527-N7)-methyltransferase	16S rRNA (guanine966-N2)-methyltransferase	16S rRNA (uracil1498-N3)-methyltransferase	16S rRNA m(2)G 1207 methyltransferase	16S rRNA m(2)G 1207 methyltransferase (EC  2.1.1.52)/23S rRNA m(2)G-1835 methyltransferase (EC 2.1.1.52)	16S rRNA m(2)G 1207 methyltransferase /23S rRNA  m(2)G-1835 methyltransferase	16S rRNA m(3)U-1498 methyltransferase (EC  2.1.1.193)	16S rRNA m(7)G-527 methyltransferase	16S rRNA m(7)G-527 methyltransferase (EC  2.1.1.170)	16S rRNA processing protein RimM	16S rRNA pseudouridine516 synthase	17 kDa surface antigen	2',3'-cyclic-nucleotide 2'-phosphodiesterase /  3'-nucleotidase	2',3'-cyclic-nucleotide 2'-phosphodiesterase/5'-  or 3'-nucleotidase, 5'-nucleotidase family	2'-5' RNA ligase	2'-5' RNA ligase superfamily protein	2'-hydroxybiphenyl-2-sulfinate desulfinase (EC  3.13.1.3)	2,3,4,5-tetrahydropyridine-2,6-dicarboxylate  N-acetyltransferase	2,3,4,5-tetrahydropyridine-2,6-dicarboxylate  N-succinyltransferase	2,3,4,5-tetrahydropyridine-2,6-dicarboxylate  N-succinyltransferase (EC 2.3.1.117)	2,3,4,5-tetrahydropyridine-2-carboxylate  N-succinyltransferase	2,3-bisphosphoglycerate-dependent  phosphoglycerate mutase	2,3-bisphosphoglycerate-independent  phosphoglycerate mutase	2,3-dihydro-2,3-dihydroxybenzoate dehydrogenase	2,3-dihydroxybenzoate decarboxylase	2,3-dihydroxybenzoate-AMP ligase	2,3-dihydroxybiphenyl 1,2-dioxygenase	2,3-dihydroxyphenylpropionate 1,2-dioxygenase	2,3-diketo-5-methylthio-1-phosphopentane  phosphatase	2,3-diketo-5-methylthiopentyl-1-phosphate  enolase	2,3-dimethylmalate lyase	2,4-dichlorophenol 6-monooxygenase	2,4-dienoyl-CoA reductase	2,4-dienoyl-CoA reductase (EC 1.3.1.34)	2,4-dienoyl-CoA reductase (NADPH2)	2,4-dihydroxyhept-2-enedioate aldolase	2,4-dihydroxyhept-2-enedioate aldolase (EC  4.1.2.-)	2,4-diketo-3-deoxy-L-fuconate hydrolase	2,5-dihydroxypyridine 5,6-dioxygenase	2,5-diketo-D-gluconate reductase A	2,5-dioxopentanoate dehydrogenase (EC 1.2.1.26)	2,5-furandicarboxylate decarboxylase 1	2-(1,2-epoxy-1,2-dihydrophenyl)acetyl-CoA  isomerase	2-C-methyl-D-erythritol 2,4-cyclodiphosphate  synthase	2-C-methyl-D-erythritol 2,4-cyclodiphosphate  synthase (EC 4.6.1.12)	2-C-methyl-D-erythritol 4-phosphate  cytidylyltransferase	2-Methylisocitrate lyase, PEP mutase family	2-alkenal reductase	2-amino-3,7-dideoxy-D-threo-hept-6-ulosonate  synthase	2-amino-3-ketobutyrate coenzyme A ligase	2-amino-4-hydroxy-6-  hydroxymethyldihydropteridine pyrophosphokinase	2-aminoadipate aminotransferase apoenzyme	2-aminoadipate transaminase	2-aminobenzoate-CoA ligase	2-aminoethylphosphonate transport system  ATP-binding protein	2-aminoethylphosphonate transport system  permease protein	2-aminoethylphosphonate transport system  substrate-binding protein	2-aminoethylphosphonate--pyruvate transaminase	2-aminoethylphosphonate--pyruvate transaminase  (EC 2.6.1.37)	2-aminoethylphosphonate-pyruvate transaminase	2-dehydro-3-deoxygalactonokinase	2-dehydro-3-deoxygluconokinase	2-dehydro-3-deoxyphosphogalactonate aldolase	2-dehydro-3-deoxyphosphogluconate aldolase /  (4S)-4-hydroxy-2-oxoglutarate aldolase	2-dehydro-3-deoxyphosphooctonate aldolase	2-dehydro-3-deoxyphosphooctonate aldolase (KDO  8-P synthase)	2-dehydropantoate 2-reductase	2-deoxy-D-gluconate 3-dehydrogenase	2-desacetyl-2-hydroxyethyl  bacteriochlorophyllide A dehydrogenase	2-furoate---CoA ligase	2-furoyl-CoA dehydrogenase 2Fe-2S iron sulfur  subunit	2-furoyl-CoA dehydrogenase FAD binding subunit	2-furoyl-CoA dehydrogenase large subunit	2-haloacid dehalogenase	2-hydroxy-3-oxopropionate reductase	2-hydroxy-6-ketonona-2,4-dienedioate hydrolase  (EC 3.7.1.-)	2-hydroxy-6-oxonona-2,4-dienedioate hydrolase	2-hydroxychromene-2-carboxylate isomerase	2-hydroxycyclohexanecarboxyl-CoA dehydrogenase	2-hydroxymuconate semialdehyde hydrolase	2-hydroxymuconate-semialdehyde hydrolase	2-iminobutanoate/2-iminopropanoate deaminase	2-isopropylmalate synthase	2-isopropylmalate synthase (EC 2.3.3.13)	2-keto-3-deoxy-L-fuconate dehydrogenase	2-keto-3-deoxy-L-rhamnonate aldolase RhmA	2-keto-3-deoxy-phosphogalactonate aldolase	2-keto-3-deoxy-phosphogalactonate aldolase (EC  4.1.2.21)	2-keto-3-deoxy-phosphogluconate aldolase	2-keto-3-deoxy-phosphogluconate aldolase (EC  4.1.2.14)	2-keto-3-deoxygalactonate kinase (EC 2.7.1.58)	2-keto-3-deoxygluconate kinase	2-keto-3-deoxygluconate kinase (EC 2.7.1.45)	2-keto-3-deoxygluconate permease	2-keto-4-pentenoate  hydratase/2-oxohepta-3-ene-1,7-dioic acid hydratase (catechol pathway)	2-keto-4-pentenoate hydratase	2-keto-myo-inositol dehydratase	2-keto-myo-inositol isomerase	2-ketocyclohexanecarboxyl-CoA hydrolase	2-methylcitrate dehydratase	2-methylcitrate dehydratase (EC 4.2.1.79)	2-methylcitrate dehydratase PrpD	2-methylcitrate synthase	2-methylcitrate synthase (EC 2.3.3.5)	2-methylcitrate synthase/citrate synthase II	2-methylfumaryl-CoA hydratase	2-methylfumaryl-CoA isomerase	2-octaprenyl-3-methyl-6-methoxy-1,4-benzoquinol  hydroxylase (EC 1.14.13.-)	2-octaprenyl-6-methoxy-1,4-benzoquinone  methylase (EC 2.1.1.-)/demethylmenaquinone methyltransferase (EC 2.1.1.163)	2-octaprenyl-6-methoxyphenol hydroxylase	2-octaprenyl-6-methoxyphenol hydroxylase (EC  1.14.13.-)/2-octaprenyl-3-methyl-6-methoxy-1,4-benzoquinol hydroxylase (EC 1.14.13	2-octaprenylphenol hydroxylase	2-octaprenylphenol hydroxylase (EC 1.14.13.-)	2-oxo-3-hexenedioate decarboxylase	2-oxo-4-hydroxy-4-carboxy-5-ureidoimidazoline  decarboxylase	2-oxo-acid dehydrogenase E1 subunit, homodimeric  type	2-oxo-hept-3-ene-1,7-dioate hydratase	2-oxoglutarate decarboxylase	2-oxoglutarate dehydrogenase E1 component	2-oxoglutarate dehydrogenase E1 component (EC  1.2.4.2)	2-oxoglutarate dehydrogenase E2 component	2-oxoglutarate ferredoxin oxidoreductase subunit  alpha	2-oxoglutarate ferredoxin oxidoreductase subunit  beta	2-oxoglutarate ferredoxin oxidoreductase subunit  delta	2-oxoglutarate ferredoxin oxidoreductase subunit  gamma	2-oxoglutaroyl-CoA hydrolase	2-oxohept-3-enedioate hydratase	2-oxohept-3-enedioate hydratase (EC 4.2.1.-)	2-oxoisovalerate dehydrogenase E1 component	2-oxoisovalerate dehydrogenase E1 component  alpha subunit	2-oxoisovalerate dehydrogenase E1 component beta  subunit	2-oxoisovalerate dehydrogenase E2 component  (dihydrolipoyl transacylase)	2-oxopent-4-enoate/cis-2-oxohex-4-enoate  hydratase	2-phospho-L-lactate guanylyltransferase	2-phosphosulfolactate phosphatase	2-polyprenyl-6-hydroxyphenyl methylase /  3-demethylubiquinone-9 3-methyltransferase	2-polyprenyl-6-methoxyphenol hydroxylase	2-pyrone-4,6-dicarboxylate hydrolase (EC  3.1.1.57)	2-succinylbenzoyl-CoA synthetase	2-succinylbenzoyl-CoA synthetase (EC 6.2.1.26)	20S proteasome A and B subunits	23S rRNA  (pseudouridine1915-N3)-methyltransferase	23S rRNA (adenine1618-N6)-methyltransferase	23S rRNA (adenine2030-N6)-methyltransferase	23S rRNA (adenine2503-C2)-methyltransferase	23S rRNA (cytidine1920-2'-O)/16S rRNA  (cytidine1409-2'-O)-methyltransferase	23S rRNA (cytidine2498-2'-O)-methyltransferase	23S rRNA (cytosine1962-C5)-methyltransferase	23S rRNA (guanosine2251-2'-O)-methyltransferase	23S rRNA (uracil1939-C5)-methyltransferase	23S rRNA (uridine2552-2'-O)-methyltransferase	23S rRNA Gm-2251 2'-O-methyltransferase (EC  2.1.1.185)	23S rRNA Um-2552 2'-O-methyltransferase	23S rRNA Um-2552 2'-O-methyltransferase (EC  2.1.1.166)	23S rRNA m(1)G-748 methyltransferase	23S rRNA m(1)G-748 methyltransferase (EC  2.1.1.51)	23S rRNA m(2)A-2503 methyltransferase	23S rRNA m(2)A-2503 methyltransferase (EC  2.1.1.192)	23S rRNA m(5)U-1939 methyltransferase	23S rRNA m(5)U-1939 methyltransferase (EC  2.1.1.190)	23S rRNA m(6)A-1618 methyltransferase (EC  2.1.1.48)	23S rRNA pseudouridine1911/1915/1917 synthase	23S rRNA pseudouridine2457 synthase	23S rRNA pseudouridine2604 synthase	23S rRNA pseudouridine2605 synthase	23S rRNA pseudouridine955/2504/2580 synthase	2Fe-2S iron-sulfur cluster binding  domain-containing protein	2OG-Fe(II) oxygenase	2OG-Fe(II) oxygenase superfamily protein	2TM domain-containing protein	3' exoribonuclease	3'(2'), 5'-bisphosphate nucleotidase	3'(2'),5'-bisphosphate nucleotidase	3'(2'),5'-bisphosphate nucleotidase (EC 3.1.3.7)	3',5'-cyclic AMP phosphodiesterase CpdA	3'-5' exonuclease, PolB-like protein	3'-nucleotidase (EC 3.1.3.6)/5'-nucleotidase (EC  3.1.3.5)/exopolyphosphatase (EC 3.6.1.11)	3'-phosphoadenosine 5'-phosphosulfate  sulfotransferase (PAPS reductase)/FAD synthetase and related enzymes	3,4-dihydroxy 2-butanone 4-phosphate synthase	3,4-dihydroxy 2-butanone 4-phosphate synthase /  GTP cyclohydrolase II	3,4-dihydroxy-2-butanone 4-phosphate synthase	3,4-dihydroxy-2-butanone 4-phosphate synthase 	3-(3-hydroxy-phenyl)propionate hydroxylase	3-Cys thioredoxin peroxidase (EC 1.11.1.15)	3-amino-4-hydroxybenzoic acid synthase	3-carboxy-cis,cis-muconate cycloisomerase	3-carboxy-cis,cis-muconate cycloisomerase (EC  5.5.1.2)	3-dehydroquinate dehydratase	3-dehydroquinate dehydratase (EC 4.2.1.10)	3-dehydroquinate synthase	3-dehydroquinate synthase (EC 4.2.3.4)	3-dehydroquinate synthase /shikimate kinase	3-dehydrosphinganine reductase	3-demethylubiquinone-9 3-methyltransferase	3-demethylubiquinone-9 3-methyltransferase (EC  2.1.1.64)	3-deoxy-D-arabinoheptulosonate-7-phosphate  synthase	3-deoxy-D-arabinoheptulosonate-7-phosphate  synthase (EC 2.5.1.54)	3-deoxy-D-arabinoheptulosonate-7-phosphate  synthase /chorismate mutase	3-deoxy-D-manno-oct-2-ulosonic acid (Kdo)  hydroxylase	3-deoxy-D-manno-octulosonate  cytidylyltransferase	3-deoxy-D-manno-octulosonate 8-phosphate  phosphatase (KDO 8-P phosphatase)	3-deoxy-D-manno-octulosonate 8-phosphate  phosphatase, YrbI family	3-deoxy-D-manno-octulosonic-acid transferase	3-deoxy-manno-octulosonate cytidylyltransferase  (CMP-KDO synthetase)	3-hexulose-6-phosphate isomerase (EC 5.3.1.27)	3-hexulose-6-phosphate synthase	3-hexulose-6-phosphate synthase (EC 4.1.2.43)	3-hydroxy acid dehydrogenase / malonic  semialdehyde reductase	3-hydroxy-3-methylglutaryl CoA synthase	3-hydroxy-3-methylglutaryl-coenzyme A reductase	3-hydroxy-D-aspartate aldolase	3-hydroxyacyl-CoA dehydrogenase	3-hydroxyacyl-CoA dehydrogenase (EC 1.1.1.35)	3-hydroxyacyl-CoA dehydrogenase / enoyl-CoA  hydratase / 3-hydroxybutyryl-CoA epimerase	3-hydroxyacyl-[acyl-carrier-protein] dehydratase	3-hydroxyacyl-[acyl-carrier-protein] dehydratase  (EC 4.2.1.-)	3-hydroxyanthranilate 3,4-dioxygenase	3-hydroxybutyrate dehydrogenase	3-hydroxybutyryl-CoA dehydratase	3-hydroxybutyryl-CoA dehydrogenase	3-hydroxydecanoyl-[acyl-carrier-protein]  dehydratase	3-hydroxydecanoyl-[acyl-carrier-protein]  dehydratase (EC 4.2.1.60)	3-hydroxyethyl bacteriochlorophyllide a  dehydrogenase	3-hydroxyisobutyrate dehydrogenase	3-hydroxyisobutyryl-CoA hydrolase (EC 3.1.2.4)	3-hydroxymyristoyl/3-hydroxydecanoyl-(acyl  carrier protein) dehydratases	3-hydroxypropanoate dehydrogenase	3-hydroxypropionyl-CoA dehydratase	3-isopropylmalate dehydratase, large subunit	3-isopropylmalate dehydratase, large subunit (EC  4.2.1.33)	3-isopropylmalate dehydratase, small subunit	3-isopropylmalate dehydratase, small subunit (EC  4.2.1.33)	3-isopropylmalate dehydrogenase	3-isopropylmalate dehydrogenase (EC 1.1.1.85)	3-isopropylmalate/(R)-2-methylmalate dehydratase  large subunit	3-isopropylmalate/(R)-2-methylmalate dehydratase  small subunit	3-keto-5-aminohexanoate cleavage enzyme	3-ketoacyl-CoA thiolase (EC 2.3.1.16)	3-mercaptopyruvate sulfurtransferase SseA,  contains two rhodanese domains	3-methyl-2-oxobutanoate hydroxymethyltransferase	3-methyladenine DNA glycosylase AlkC	3-methyladenine DNA glycosylase AlkD	3-methyladenine DNA glycosylase/8-oxoguanine DNA  glycosylase	3-methylcrotonoyl-CoA carboxylase, alpha subunit  (EC 6.4.1.4)	3-methylcrotonyl-CoA carboxylase alpha subunit	3-methylcrotonyl-CoA carboxylase beta subunit	3-methylfumaryl-CoA hydratase	3-oxoacid CoA-transferase	3-oxoacid CoA-transferase subunit A	3-oxoacid CoA-transferase subunit B	3-oxoacid CoA-transferase, A subunit	3-oxoacyl-(acyl-carrier-protein) synthase 2	3-oxoacyl-[acyl-carrier protein] reductase	3-oxoacyl-[acyl-carrier-protein] reductase	3-oxoacyl-[acyl-carrier-protein] reductase 	3-oxoacyl-[acyl-carrier-protein] reductase (EC  1.1.1.100)	3-oxoacyl-[acyl-carrier-protein] synthase I	3-oxoacyl-[acyl-carrier-protein] synthase I (EC  2.3.1.41)	3-oxoacyl-[acyl-carrier-protein] synthase II	3-oxoacyl-[acyl-carrier-protein] synthase II (EC  2.3.1.41)	3-oxoacyl-[acyl-carrier-protein] synthase III	3-oxoacyl-[acyl-carrier-protein] synthase III  (EC 2.3.1.41)	3-oxoacyl-[acyl-carrier-protein] synthase NodE	3-oxoacyl-[acyl-carrier-protein] synthase-1	3-oxoacyl-[acyl-carrier-protein] synthase-3	3-oxoadipate CoA-transferase alpha subunit	3-oxoadipate CoA-transferase beta subunit	3-oxoadipate CoA-transferase, alpha subunit	3-oxoadipate CoA-transferase, beta subunit	3-oxoadipate enol-lactonase	3-oxoadipate enol-lactonase (EC 3.1.1.24)	3-oxoadipyl-CoA thiolase	3-oxoadipyl-CoA thiolase (EC 2.3.1.174)	3-phenylpropionate/cinnamic acid dioxygenase,  small subunit	3-phenylpropionate/trans-cinnamate dioxygenase  ferredoxin reductase subunit	3-phenylpropionate/trans-cinnamate dioxygenase  ferredoxin subunit	3-phosphoshikimate 1-carboxyvinyltransferase	3-phosphoshikimate 1-carboxyvinyltransferase (EC  2.5.1.19)	3-vinyl bacteriochlorophyllide hydratase	30S ribosomal protein S11	3D (Asp-Asp-Asp) domain-containing protein	3D-(3,5/4)-trihydroxycyclohexane-1,2-dione  acylhydrolase (decyclizing)	3D-(3,5/4)-trihydroxycyclohexane-1,2-dione  hydrolase	3D-(3,5/4)-trihydroxycyclohexane-1,2-dione  hydrolase (EC 3.7.1.-)	3alpha(or 20beta)-hydroxysteroid dehydrogenase	3beta-hydroxy-delta5-steroid dehydrogenase /  steroid delta-isomerase	4 TMS phage holin, superfamily IV	4'-phosphopantetheinyl transferase	4'-phosphopantetheinyl transferase EntD  (siderophore biosynthesis)	4,5-dihydroxyphthalate decarboxylase	4,5-epoxidase	4-(2-carboxyphenyl)-2-oxobut-3-enoate aldolase	4-alpha-L-fucosyltransferase glycosyl  transferase group 56	4-alpha-glucanotransferase	4-alpha-glucanotransferase (EC 2.4.1.25)	4-amino-4-deoxy-L-arabinose transferase	4-amino-4-deoxy-L-arabinose transferase and  related glycosyltransferases of PMT family	4-amino-4-deoxychorismate lyase	4-aminobutyrate aminotransferase	4-aminobutyrate aminotransferase /  (S)-3-amino-2-methylpropionate transaminase	4-aminobutyrate aminotransferase apoenzyme	4-aminobutyrate aminotransferase apoenzyme (EC  2.6.1.19)	4-aminobutyrate---pyruvate transaminase	4-azaleucine resistance probable transporter  AzlC	4-carboxy-4-hydroxy-2-oxoadipate aldolase (EC  4.1.3.-)	4-carboxymuconolactone decarboxylase	4-coumarate--CoA ligase	4-coumarate--CoA ligase, photoactive yellow  protein activation family	4-cresol dehydrogenase (hydroxylating) (EC  1.17.99.1)	4-deoxy-L-threo-5-hexosulose-uronate  ketol-isomerase	4-diphosphocytidyl-2-C-methyl-D-erythritol  kinase	4-diphosphocytidyl-2-C-methyl-D-erythritol  kinase (EC 2.7.1.148)	4-hydroxy 2-oxovalerate aldolase	4-hydroxy-2-oxoheptanedioate aldolase	4-hydroxy-2-oxovalerate aldolase (EC 4.1.3.39)	4-hydroxy-2-oxovalerate/4-hydroxy-2-oxohexanoate  aldolase	4-hydroxy-3-methylbut-2-en-1-yl diphosphate  synthase	4-hydroxy-3-methylbut-2-en-1-yl diphosphate  synthase (EC 1.17.4.3)	4-hydroxy-3-methylbut-2-enyl diphosphate  reductase	4-hydroxy-3-methylbut-2-enyl diphosphate  reductase (EC 1.17.1.2)	4-hydroxy-3-polyprenylbenzoate decarboxylase	4-hydroxy-4-methyl-2-oxoglutarate aldolase	4-hydroxy-tetrahydrodipicolinate synthase	4-hydroxybenzaldehyde dehydrogenase	4-hydroxybenzaldehyde dehydrogenase (EC  1.2.1.64)	4-hydroxybenzoate polyprenyltransferase	4-hydroxybenzoate polyprenyltransferase (EC  2.5.1.39)	4-hydroxybenzoyl-CoA thioesterase	4-hydroxymandelate oxidase	4-hydroxyphenylacetate 3-monooxygenase	4-hydroxyphenylpyruvate dioxygenase	4-hydroxyphenylpyruvate dioxygenase (EC  1.13.11.27)	4-hydroxyproline epimerase	4-hydroxythreonine-4-phosphate dehydrogenase	4-hydroxythreonine-4-phosphate dehydrogenase (EC  1.1.1.262)	4-methylaminobutanoate oxidase  (formaldehyde-forming)	4-nitrophenyl phosphatase	4-oxalocrotonate tautomerase	4-oxalomesaconate hydratase	4-oxalomesaconate hydratase (EC 4.2.1.83)	4-oxalomesaconate tautomerase	4-phosphoerythronate dehydrogenase  (FAD-dependent)	4-vinyl reductase, 4VR	40-residue YVTN family beta-propeller  repeat-containing protein	40-residue YVTN family beta-propeller repeat  protein	4Fe-4S binding domain-containing protein	4Fe-4S dicluster domain-containing protein	4Fe-4S ferredoxin iron-sulfur binding domain  protein	4Fe-4S single cluster domain-containing protein	4TM region of DNA translocase FtsK/SpoIIIE	4a-hydroxytetrahydrobiopterin dehydratase	5'-3' exonuclease	5'-methylthioadenosine phosphorylase	5'-methylthioribose kinase	5'-nucleotidase	5'-nucleotidase /3'-nucleotidase 	5'-nucleotidase, lipoprotein e(P4) family	5'-phosphate synthase pdxT subunit	5'-phosphoribosyl-monophospho-decaprenol  phosphatase	5,10-methenyltetrahydrofolate synthetase	5,10-methylenetetrahydrofolate dehydrogenase  (NADP+)	5,10-methylenetetrahydrofolate reductase	5,10-methylenetetrahydrofolate reductase  (NAD(P))	5,10-methylenetetrahydrofolate reductase  (NAD(P)) (EC 1.5.1.20)	5,6,7,8-tetrahydromethanopterin hydro-lyase	5,6-dimethylbenzimidazole synthase (EC  1.14.99.40)/cob(II)yrinic acid a,c-diamide reductase (EC 1.16.8.1)	5-(carboxyamino)imidazole ribonucleotide  synthase	5-(carboxyamino)imidazole ribonucleotide mutase	5-(hydroxymethyl)furfural/furfural oxidase	5-aminolevulinate synthase	5-aminolevulinate synthase (EC 2.3.1.37)	5-aminopentanamidase (EC 3.5.1.30)	5-bromo-4-chloroindolyl phosphate hydrolysis  protein	5-carboxymethyl-2-hydroxymuconic-semialdehyde  dehydrogenase	5-dehydro-2-deoxygluconokinase	5-dehydro-2-deoxygluconokinase (EC 2.7.1.92)	5-dehydro-4-deoxyglucarate dehydratase	5-deoxy-glucuronate isomerase	5-deoxyglucuronate isomerase	5-formyltetrahydrofolate cyclo-ligase	5-histidylcysteine sulfoxide synthase/putative  4-mercaptohistidine N1-methyltranferase	5-hydroxyisourate hydrolase	5-methylcytosine-specific restriction  endonuclease McrA	5-methylcytosine-specific restriction enzyme  subunit McrC	5-methylcytosine-specific restriction enzyme A	5-methylcytosine-specific restriction enzyme B	5-methyltetrahydrofolate--homocysteine  methyltransferase	5-methylthioadenosine/S-adenosylhomocysteine  deaminase	5-oxoprolinase (ATP-hydrolysing)	50S ribosomal protein L16 3-hydroxylase	50S ribosome-binding GTPase	6,7-dimethyl-8-ribityllumazine synthase	6,7-dimethyl-8-ribityllumazine synthase (EC  2.5.1.78)	6-hydroxynicotinate 3-monooxygenase	6-hydroxynicotinate reductase	6-phospho 3-hexuloisomerase	6-phospho-3-hexuloisomerase	6-phospho-beta-glucosidase	6-phosphofructokinase	6-phosphofructokinase (EC 2.7.1.11)	6-phosphofructokinase 1	6-phosphofructokinase 2	6-phosphogluconate dehydratase	6-phosphogluconate dehydratase (EC 4.2.1.12)	6-phosphogluconate dehydrogenase	6-phosphogluconate dehydrogenase  (decarboxylating)	6-phosphogluconate dehydrogenase  (decarboxylating) (EC 1.1.1.44)	6-phosphogluconolactonase	6-phosphogluconolactonase (EC 3.1.1.31)	6-phosphogluconolactonase, cycloisomerase 2  family	6-pyruvoyl tetrahydropterin synthase and  hypothetical protein	6-pyruvoyl-tetrahydropterin synthase	60S ribosomal protein L19	7-alpha-hydroxysteroid dehydrogenase	7-carboxy-7-deazaguanine synthase	7-carboxy-7-deazaguanine synthase, Cx14CxxC type	7-cyano-7-deazaguanine reductase	7-cyano-7-deazaguanine synthase	7-cyano-7-deazaguanine synthase (queuosine  biosynthesis)	7TM diverse intracellular signalling	7TM domain sensor diguanylate cyclase	8-amino-7-oxononanoate synthase	8-amino-7-oxononanoate synthase (EC 2.3.1.47)	8-oxo-dGTP diphosphatase	8-oxo-dGTP pyrophosphatase MutT, NUDIX family	8-oxoguanine deaminase	A-factor biosynthesis hotdog domain-containing  protein	A/G-specific DNA-adenine glycosylase	A/G-specific DNA-adenine glycosylase (EC  3.2.2.-)	AAA ATPase	AAA ATPase central domain protein	AAA ATPase domain-containing protein	AAA domain (dynein-related subfamily)	AAA domain-containing protein	AAA domain-containing protein, putative AbiEii  toxin, Type IV TA system	AAA+-type ATPase, SpoVK/Ycf46/Vps4 family	AAA-like domain-containing protein	ABC transporter	ABC transporter related	ABC transporter related protein	ABC transporter, permease protein, putative	ABC transporter, substrate binding protein,  PQQ-dependent alcohol dehydrogenase system	ABC-2 family transporter protein	ABC-2 type transport system ATP-binding protein	ABC-2 type transport system permease protein	ABC-2 type transporter	ABC-3 protein	ABC-type Fe3+ transport system,  substrate-binding protein	ABC-type Fe3+-hydroxamate transport system,  substrate-binding protein	ABC-type Mn2+/Zn2+ transport system, ATPase  component	ABC-type Zn uptake system ZnuABC, Zn-binding  component ZnuA	ABC-type Zn2+ transport system, periplasmic  component/surface adhesin	ABC-type amino acid transport substrate-binding  protein	ABC-type bacteriocin/lantibiotic exporter,  contains an N-terminal double-glycine peptidase domain	ABC-type branched-chain amino acid transport  system, ATPase component	ABC-type branched-chain amino acid transport  system, permease component	ABC-type branched-chain amino acid transport  system, substrate-binding protein	ABC-type branched-chain amino acid transport  systems, periplasmic component	ABC-type dipeptide/oligopeptide/nickel transport  system, ATPase component	ABC-type dipeptide/oligopeptide/nickel transport  system, permease component	ABC-type glycerol-3-phosphate transport system,  substrate-binding protein	ABC-type lipoprotein export system, ATPase  component	ABC-type metal ion transport system, periplasmic  component/surface adhesin	ABC-type molybdate transport system,  substrate-binding protein	ABC-type multidrug transport system, ATPase  component	ABC-type multidrug transport system, ATPase and  permease component	ABC-type multidrug transport system, permease  component	ABC-type nickel/cobalt efflux system, permease  component RcnA	ABC-type nitrate/sulfonate/bicarbonate transport  system, ATPase component	ABC-type nitrate/sulfonate/bicarbonate transport  system, permease component	ABC-type nitrate/sulfonate/bicarbonate transport  system, substrate-binding protein	ABC-type oligopeptide transport system,  substrate-binding protein	ABC-type phosphate/phosphonate transport system,  periplasmic component	ABC-type phosphate/phosphonate transport system,  substrate-binding protein	ABC-type polysaccharide/polyol phosphate  transport system, ATPase component	ABC-type polysaccharide/polyol phosphate export  permease	ABC-type proline/glycine betaine transport  system, permease component	ABC-type spermidine/putrescine transport system,  permease component II	ABC-type sugar transport system,  substrate-binding protein, contains N-terminal xre family HTH domain	ABC-type sugar transport systems, permease  components	ABC-type transport system involved in  multi-copper enzyme maturation, permease component	ABC-type transport system, substrate-binding  protein	ABC-type transporter Mla maintaining outer  membrane lipid asymmetry, component MlaD	ABC-type transporter Mla maintaining outer  membrane lipid asymmetry, lipoprotein component MlaA	ABC-type uncharacterized transport system	ABC-type uncharacterized transport system  involved in gliding motility, auxiliary component	ABC-type uncharacterized transport system,  permease and ATPase components	ABC-type uncharacterized transport system,  permease component	ABC-type uncharacterized transport system,  substrate-binding protein	ACP:hemolysin acyltransferase  (hemolysin-activating protein)	ADP-L-glycero-D-manno-heptose 6-epimerase	ADP-glyceromanno-heptose 6-epimerase precursor	ADP-glyceromanno-heptose 6-epimerase precursor  (EC 5.1.3.20)	ADP-heptose:LPS heptosyltransferase	ADP-ribose pyrophosphatase	ADP-ribose pyrophosphatase YjhB, NUDIX family	ADP-ribosyl-[dinitrogen reductase] hydrolase	ADP-ribosylation factor family	ADP-ribosylation/Crystallin J1	ADP-ribosylglycohydrolase	AGP19/ATAGP19 (arabinogalacta-protein 19)	AIG2-like family protein	AIPR protein	AMP nucleosidase	AMP-binding enzyme	AMP-binding enzyme C-terminal domain-containing  protein	AMP-dependent synthetase and ligase	ANTAR domain protein with unknown sensor	ANTAR domain-containing protein	AP2 domain-containing protein	AP2-like DNA-binding integrase domain-containing  protein	ASCH domain-containing protein	ATP dependent DNA ligase	ATP dependent helicase, Lhr family	ATP diphosphatase	ATP phosphoribosyltransferase	ATP phosphoribosyltransferase (homohexameric)	ATP phosphoribosyltransferase (homohexameric)  (EC 2.4.2.17)	ATP phosphoribosyltransferase catalytic subunit	ATP phosphoribosyltransferase regulatory subunit	ATP phosphoribosyltransferase regulatory subunit  (EC 2.4.2.17)	ATP synthase (C/AC39) subunit	ATP synthase F0 subcomplex A subunit	ATP synthase F0 subcomplex B subunit	ATP synthase F0 subcomplex C subunit	ATP synthase F0, A subunit	ATP synthase F0, B subunit	ATP synthase F0, C subunit	ATP synthase F1 subcomplex alpha subunit	ATP synthase F1 subcomplex beta subunit	ATP synthase F1 subcomplex delta subunit	ATP synthase F1 subcomplex epsilon subunit	ATP synthase F1 subcomplex gamma subunit	ATP synthase F1, beta subunit	ATP synthase I chain	ATP synthase protein I	ATP-, maltotriose- and DNA-dependent  transcriptional regulator MalT	ATP-NAD/AcoX kinase	ATP-binding cassette protein, ChvD family	ATP-binding cassette, subfamily B	ATP-binding cassette, subfamily B, HlyB/CyaB	ATP-binding cassette, subfamily B, IrtA	ATP-binding cassette, subfamily B, IrtB	ATP-binding cassette, subfamily B, MsbA	ATP-binding cassette, subfamily B, RaxB	ATP-binding cassette, subfamily B, multidrug  efflux pump	ATP-binding cassette, subfamily C	ATP-binding cassette, subfamily C, CydC	ATP-binding cassette, subfamily C, CydCD	ATP-binding cassette, subfamily C, CydD	ATP-binding cassette, subfamily C, EexD	ATP-binding cassette, subfamily C, LapB	ATP-binding cassette, subfamily C, PrsD	ATP-binding cassette, subfamily C, RsaD	ATP-binding cassette, subfamily C, exporter for  protease/lipase	ATP-binding cassette, subfamily F, member 3	ATP-binding cassette, subfamily F, uup	ATP-binding protein HasD (TC 3.A.1.110.9)	ATP-binding protein involved in chromosome  partitioning	ATP-binding region ATPase domain protein	ATP-cone domain protein	ATP-dependent Clp endopeptidase, proteolytic  subunit ClpP	ATP-dependent Clp protease ATP-binding subunit  ClpA	ATP-dependent Clp protease ATP-binding subunit  ClpA (EC 3.4.21.92)	ATP-dependent Clp protease ATP-binding subunit  ClpB	ATP-dependent Clp protease ATP-binding subunit  ClpC	ATP-dependent Clp protease ATP-binding subunit  ClpE	ATP-dependent Clp protease ATP-binding subunit  ClpX	ATP-dependent Clp protease ATP-binding subunit  ClpX (EC 3.4.21.92)	ATP-dependent Clp protease adaptor protein ClpS	ATP-dependent Clp protease proteolytic subunit  ClpP	ATP-dependent Clp protease proteolytic subunit  ClpP (EC 3.4.21.92)	ATP-dependent Clp protease, ATP-binding subunit  ClpX	ATP-dependent Clp protease, protease subunit	ATP-dependent DNA helicase DinG	ATP-dependent DNA helicase PcrA (EC 3.6.1.-)	ATP-dependent DNA helicase RecG	ATP-dependent DNA helicase RecG (EC 3.6.1.-)	ATP-dependent DNA helicase RecQ	ATP-dependent DNA helicase RecQ (EC 3.6.1.-)	ATP-dependent DNA helicase Rep	ATP-dependent DNA helicase Rep (EC 3.6.1.-)	ATP-dependent DNA helicase UvrD (EC 3.6.1.-)	ATP-dependent DNA helicase, RecQ-like	ATP-dependent DNA helicase, RecQ-like (EC  3.6.1.-)	ATP-dependent DNA helicase, Rep family	ATP-dependent DNA ligase	ATP-dependent DNA ligase LigD ligase  module/ATP-dependent DNA ligase LigD phosphoesterase module/ATP-dependent DNA ligase LigD 	ATP-dependent DNA ligase LigD ligase module 	ATP-dependent DNA ligase LigD phosphoesterase  module/ATP-dependent DNA ligase LigD polymerase module	ATP-dependent HslUV protease ATP-binding subunit  HslU	ATP-dependent HslUV protease, peptidase subunit  HslV	ATP-dependent Lon protease	ATP-dependent Lon protease, bacterial type	ATP-dependent RNA helicase CsdA	ATP-dependent RNA helicase CsdA (EC 5.99.1.-)	ATP-dependent RNA helicase DeaD	ATP-dependent RNA helicase HelY	ATP-dependent RNA helicase RhlE	ATP-dependent RNA helicase SUPV3L1/SUV3	ATP-dependent Zn proteases	ATP-dependent chaperone ClpB	ATP-dependent exoDNAse (exonuclease V) alpha  subunit - helicase superfamily I member-like protein	ATP-dependent exoDNAse (exonuclease V) beta  subunit (contains helicase and exonuclease domains)	ATP-dependent helicase HrpA	ATP-dependent helicase HrpB	ATP-dependent helicase IRC3	ATP-dependent helicase Lhr and Lhr-like helicase	ATP-dependent helicase/nuclease subunit A	ATP-dependent helicase/nuclease subunit B	ATP-dependent protease ClpP, protease subunit	ATP-dependent protease-like protein	ATP-dependent proteinase. Serine peptidase.  MEROPS family S16	ATP-dependent transcriptional regulator	ATP-dependent transcriptional regulator,  MalT-like, LuxR family	ATP-grasp domain	ATP-grasp domain-containing protein	ATP-independent RNA helicase DbpA	ATP:ADP antiporter, AAA family	ATP:cob(I)alamin adenosyltransferase	ATPase associated with various cellular  activities AAA_3	ATPase associated with various cellular  activities AAA_5	ATPase components of ABC transporters with  duplicated ATPase domains	ATPase components of various ABC-type transport  systems, contain duplicated ATPase	ATPase family associated with various cellular  activities (AAA)	ATPase involved in DNA replication initiation	ATPase related to the helicase subunit of the  Holliday junction resolvase	ATPase, FliI/YscN family	ATPase, P-type (transporting), HAD superfamily,  subfamily IC	ATPase, P-type (transporting), HAD superfamily,  subfamily IC/heavy metal translocating P-type ATPase	ATPase-like protein	ATPase-like, ParA/MinD	ATPase/GTPase, AAA15 family	ATPases of the AAA+ class	Abortive infection C-terminus	Abortive infection bacteriophage resistance  protein	AbrB family transcriptional regulator, stage V  sporulation protein T	Acetamidase/formamidase	Acetoacetate decarboxylase	Acetoacetate decarboxylase (ADC)	Acetoin utilization deacetylase AcuC	Acetolactate synthase large subunit	Acetyl esterase (deacetylase)	Acetyl esterase/lipase	Acetyl-CoA acetyltransferase	Acetyl-CoA carboxylase, carboxyltransferase  component	Acetyl-CoA hydrolase/transferase C-terminal  domain-containing protein	Acetyl/propionyl-CoA carboxylase, alpha subunit	Acetylornithine  deacetylase/Succinyl-diaminopimelate desuccinylase	Acetyltransferase (GNAT) domain	Acetyltransferase (GNAT) domain-containing  protein	Acetyltransferase (GNAT) family	Acetyltransferase (GNAT) family protein	Acetyltransferase (GNAT) family.	Acetyltransferase (isoleucine patch superfamily)	Acetyltransferase involved in cellulose  biosynthesis, CelD/BcsL family	Acetyltransferase, GNAT family	Acetyltransferases	Acetyltransferases, including N-acetylases of  ribosomal proteins	Acid stress-induced BolA-like protein IbaG/YrbA,  predicted regulator of iron metabolism	Activator of HSP90 ATPase	Activator of Hsp90 ATPase 1 family protein	Activator of Hsp90 ATPase homolog 1-like protein	Acyl CoA:acetate/3-ketoacid CoA transferase	Acyl carrier protein	Acyl dehydratase	Acyl transferase domain-containing protein	Acyl-ACP thioesterase	Acyl-CoA carboxylase epsilon subunit	Acyl-CoA dehydrogenase	Acyl-CoA dehydrogenase type 2 domain protein	Acyl-CoA dehydrogenases	Acyl-CoA hydrolase	Acyl-CoA reductase	Acyl-CoA synthetase (AMP-forming)/AMP-acid  ligase II	Acyl-CoA synthetase (NDP forming)	Acyl-CoA synthetases (AMP-forming)/AMP-acid  ligases II	Acyl-CoA thioesterase FadM	Acyl-coenzyme A oxidase	Acyl-coenzyme A synthetase/AMP-(fatty) acid  ligase	Acyl-coenzyme A thioesterase PaaI, contains HGG  motif	Acyltransferase	Acyltransferase family protein	Adenine deaminase	Adenine deaminase (EC 3.5.4.2)	Adenine-specific DNA methylase, N12 class	Adenine-specific DNA methylase, contains a  Zn-ribbon domain	Adenine/guanine phosphoribosyltransferase	Adenosylmethionine-8-amino-7-oxononanoate  aminotransferase	Adenylate and Guanylate cyclase catalytic  domain-containing protein	Adenylate cyclase, class 3	Adenylate cyclase, family 3 (some proteins  contain HAMP domain)	Adenylate kinase	Adenylate kinase (EC 2.7.4.3)	Adenylosuccinate lyase	Adenylosuccinate lyase (EC 4.3.2.2)	Adenylosuccinate synthetase	Adenylosuccinate synthetase (EC 6.3.4.4)	Aerobic-type carbon monoxide dehydrogenase,  small subunit CoxS/CutS homologs	Aerobic-type carbon monoxide dehydrogenase,  small subunit, CoxS/CutS family	AhpC/TSA family protein	Ala-tRNA(Pro) deacylase	Ala-tRNA(Pro) hydrolase (EC 3.1.1.-)	Alanine dehydrogenase	Alcohol dehydrogenase GroES domain protein	Alcohol dehydrogenase YqhD, Fe-dependent ADH  family	Alcohol dehydrogenase zinc-binding domain  protein	Alcohol dehydrogenase, class IV	Aldehyde Dehydrogenase	Aldehyde dehydrogenase (NAD(+))	Aldo/keto reductase	Aldo/keto reductases, related to diketogulonate  reductase	Aldose 1-epimerase	Alginate O-acetyl transferase AlgF	Alginate export	Alkaline phosphatase	Alkanesulfonate monooxygenase	Alkyl hydroperoxide reductase subunit AhpC  (peroxiredoxin)	Alkyl sulfatase BDS1, metallo-beta-lactamase  superfamily	Alkylated DNA nucleotide flippase Atl1,  participates in nucleotide excision repair, Ada-like DNA-binding domain	Alkylated DNA repair dioxygenase AlkB	Alkylhydroperoxidase family enzyme, contains  CxxC motif	Allophanate hydrolase subunit 1	Allophanate hydrolase subunit 2	Alpha-L-arabinofuranosidase B, catalytic	Alpha-N-acetylglucosamine transferase	Alpha-amylase/alpha-mannosidase, GH57 family	Alpha-glucosidase, glycosyl hydrolase family  GH31	Alpha-glucosidases, family 31 of glycosyl  hydrolases	Alpha-mannosidase	Alpha-tubulin suppressor	Alpha/beta hydrolase	Alpha/beta hydrolase family	Alpha/beta hydrolase family protein	Alpha/beta hydrolase fold-3 domain protein	Alpha/beta hydrolase of unknown function  (DUF900)	AmiS/UreI family transporter	Amidases related to nicotinamidase	Amidohydrolase 3	Amino acid kinase family	Amino acid kinase family protein	Amino acid synthesis	Amino acid transporter	Aminobutyraldehyde dehydrogenase	Aminoglycoside phosphotransferase family enzyme	Aminoglycoside-2''-adenylyltransferase	Aminopeptidase N	AmpD protein	AmpG-related permease	Anaerobic dehydrogenases, typically  selenocysteine-containing	Anaerobic selenocysteine-containing  dehydrogenase	Anaphase-promoting complex, cyclosome, subunit 3	Animal haem peroxidase	Animal haem peroxidase.	Anion-transporting ATPase, ArsA/GET3 family	Ankyrin	Ankyrin repeat	Ankyrin repeat-containing protein	Annexin	Anthranilate phosphoribosyltransferase	Anti-anti-sigma regulatory factor (antagonist of  anti-sigma factor)	Anti-sigma regulatory factor (Ser/Thr protein  kinase)	Anti-sigma-D factor RsdA to sigma factor binding  region	Anti-sigma-K factor RskA	Anti-sigma-K factor rskA	Antibiotic biosynthesis monooxygenase	Antibiotic biosynthesis monooxygenase.	Antimicrobial peptide resistance and lipid A  acylation PagP	Antirepressor regulating drug resistance,  predicted signal transduction N-terminal membrane component	Antirestriction protein	Antirestriction protein (ArdA)	Antirestriction protein ArdC	Antitoxin Phd_YefM, type II toxin-antitoxin  system	Antitoxin of toxin-antitoxin stability system	ApaG domain protein	ApaG protein	ApbE family lipoprotein	Apolipoprotein A1/A4/E domain-containing protein	Apolipoprotein N-acyltransferase	AraC family transcriptional regulator	AraC family transcriptional regulator,  ethanolamine operon transcriptional activator	AraC family transcriptional regulator,  regulatory protein of adaptative response / methylated-DNA-[protein]-cysteine methyltran	AraC family transcriptional regulator,  regulatory protein of adaptative response / methylphosphotriester-DNA alkyltransferase m	AraC family transcriptional regulator,  transcriptional activator of pobA	AraC family transcriptional regulator, carnitine  catabolism transcriptional activator	AraC-binding-like domain-containing protein	AraC-like ligand binding domain-containing  protein	AraC-type DNA-binding domain-containing proteins	AraC-type DNA-binding protein	Arabinose efflux permease	Arabinose-binding domain of AraC transcription  regulator, N-term	Arc-like DNA binding domain-containing protein	Archaeal enzymes of ATP-grasp superfamily	Archaeal/vacuolar-type H+-ATPase subunit I	Arginase family protein	Arginine exporter protein ArgO	Arginine utilization protein RocB	Arginine/lysine/ornithine decarboxylase	Arginyltransferase	Aromatic ring-opening dioxygenase, catalytic  subunit, LigB family	ArsR family transcriptional regulator	Arsenate reductase, glutaredoxin family	Arsenical pump membrane protein	Arsenical resistance operon trans-acting  repressor ArsD	Arsenite efflux pump ArsB, ACR3 family	Aryl carrier domain-containing protein	Aryl-phospho-beta-D-glucosidase BglC, GH1 family	Arylesterase	Arylsulfatase A	Arylsulfotransferase (ASST)	AsmA family protein	AsmA protein	AsmA-like C-terminal region	AsnC family protein	Asp-tRNAAsn/Glu-tRNAGln amidotransferase A  subunit	Asp-tRNAAsn/Glu-tRNAGln amidotransferase A  subunit and related amidases	Asp/Glu/hydantoin racemase	Asparagine synthase (glutamine-hydrolyzing)	Aspartate/glutamate racemase	Aspartate/methionine/tyrosine aminotransferase	Aspartyl aminopeptidase	Aspartyl protease	Aspartyl/Asparaginyl beta-hydroxylase	Autotransporter adhesin	Autotransporter beta-domain-containing protein	Autotransporter beta-domain.	Autotransporter translocation and assembly  factor TamB	BA14K-like protein	BFD domain protein (2Fe-2S)-binding domain  protein	BFD-like [2Fe-2S] binding domain-containing  protein	BLUF domain protein	BMC domain-containing protein	BMFP domain-containing protein YqiC	BNR repeat-containing family member	BNR repeat-containing protein	BNR/Asp-box repeat-containing protein	BNR/Asp-box repeat.	BON domain-containing protein	BT1 family protein	Bacterial SH3 domain.	Bacterial extracellular solute-binding proteins,  family 5 Middle.	Bacterial protein of unknown function (DUF883)	Bacterial protein of unknown function (DUF883).	Bacteriocin (Lactococcin_972)	Bacteriocin-protection, YdeI or OmpD-Associated	Bacterioferritin-associated ferredoxin	Bacteriophage HK97-gp10, putative tail-component	Bacteriophage head to tail connecting protein	Bacteriophage lambda head decoration protein D	Bacteriophage lambda tail assembly protein I	Bacteriophage related protein of unknown  function	Bacteriophage replication gene A protein (GPA)	Bacteriophage tail assembly protein	Bacteriophytochrome (light-regulated signal  transduction histidine kinase)	BadF-type ATPase	Barstar (barnase inhibitor)	Barstar, RNAse (barnase) inhibitor	Basic membrane lipoprotein Med,  substrate-binding protein (PBP1-ABC) superfamily	Benzoyl-CoA reductase/2-hydroxyglutaryl-CoA  dehydratase subunit, BcrC/BadD/HgdB	Bet v I allergen	Beta protein	Beta- N-acetylglucosaminidase	Beta-1,3-glucanase	Beta-1,4-xylanase	Beta-alanine--pyruvate transaminase	Beta-barrel assembly machine subunit BamA	Beta-barrel assembly machine subunit BamB	Beta-barrel assembly machine subunit BamC	Beta-barrel assembly machine subunit BamD	Beta-barrel assembly machine subunit BamE	Beta-barrel assembly machine subunit BamF	Beta-fructosidases (levanase/invertase)	Beta-galactosidase	Beta-galactosidase/beta-glucuronidase	Beta-glucanase, GH16 family	Beta-glucanase/Beta-glucan synthetase	Beta-ketoacyl synthase	Beta-ketoacyl synthase, N-terminal domain	Beta-ketoacyl-acyl-carrier-protein synthase III	Beta-lactamase	Beta-lactamase class A	Beta-lactamase superfamily domain-containing  protein	Beta-mannanase	Beta-phosphoglucomutase, HAD superfamily	Beta-propeller domains of methanol dehydrogenase  type	Beta-xylosidase	BhlA holin family protein	Bifunctional DNA primase/polymerase, N-terminal	Bifunctional DNA primase/polymerase, N-terminal.	Biopolymer transport protein ExbB/TolQ	Biopolymer transport protein ExbD/TolR	Biotin carboxyl carrier protein	Biotin-(acetyl-CoA carboxylase) ligase	Biotin-requiring enzyme	BirA family transcriptional regulator, biotin  operon repressor / biotin-[acetyl-CoA-carboxylase] ligase	Bis(5'nucleosyl)-tetraphosphatase, ApaH	BlaR1 peptidase M56	BolA family protein	BolA protein	Branched-chain amino acid  aminotransferase/4-amino-4-deoxychorismate lyase	Branched-chain amino acid ABC-type transport  system, permease components	Branched-chain amino acid transport protein	Branched-chain amino acid transport protein  (AzlD)	Branched-chain amino acid transport protein AzlD	BrnA antitoxin of type II toxin-antitoxin system	Broad specificity phosphatase PhoE	Butirosin biosynthesis protein H, N-terminal	C-5 cytosine-specific DNA methylase	C-methyltransferase C-terminal domain-containing  protein	C-terminal processing peptidase-3. Serine  peptidase. MEROPS family S41A	C-terminal, D2-small domain-containing protein,  of ClpB protein	C1q domain	C1q domain-containing protein	C4-dicarboxylate transporter, DctM subunit	C4-dicarboxylate transporter, DctQ subunit	C4-dicarboxylate transporter/malic acid  transport protein	C4-dicarboxylate-binding protein DctP	C50 carotenoid epsilon cyclase subunit CrtYe	C50 carotenoid epsilon cyclase subunit CrtYf	CAAX prenyl protease-related protein	CAAX protease self-immunity	CBS domain containing membrane protein	CBS domain containing protein	CBS domain-containing membrane protein	CBS domain-containing protein	CBS-domain-containing membrane protein	CDP-4-dehydro-6-deoxyglucose reductase	CDP-6-deoxy-D-xylo-4-hexulose-3-dehydrase	CDP-Glycerol:Poly(glycerophosphate)  glycerophosphotransferase	CDP-alcohol phosphatidyltransferase	CDP-diacylglycerol inositol  3-phosphatidyltransferase (EC 2.7.8.11)	CDP-diacylglycerol---serine  O-phosphatidyltransferase	CDP-diacylglycerol--glycerol-3-phosphate  3-phosphatidyltransferase	CDP-diacylglycerol--glycerol-3-phosphate  3-phosphatidyltransferase (EC 2.7.8.5)	CDP-diacylglycerol--inositol  3-phosphatidyltransferase	CDP-diacylglycerol--serine  O-phosphatidyltransferase (EC 2.7.8.8)	CDP-diacylglycerol-choline  O-phosphatidyltransferase (EC 2.7.8.24)	CDP-diacylglycerol-phosphatidylglycerol  phosphatidyltransferase (EC 2.7.8.-)	CDP-glucose 4,6-dehydratase	CDP-glycerol:poly(glycerophosphate)  glycerophosphotransferase	CDP-paratose synthetase	CGNR zinc finger domain-containing protein	CHAD domain-containing protein	CHAP domain-containing protein	CHAP domain.	CHAT domain-containing protein	CHC2 zinc finger	CMD domain protein, Avi_7170 family	CMP-N-acetylneuraminic acid synthetase-like  protein	CMP/dCMP deaminase zinc-binding	CNP1-like family protein	CO or xanthine dehydrogenase, FAD-binding  subunit	CO or xanthine dehydrogenase, Mo-binding subunit	CRISP-associated protein Cas1	CRISPR system Cascade subunit CasA	CRISPR system Cascade subunit CasB	CRISPR system Cascade subunit CasC	CRISPR system Cascade subunit CasD	CRISPR system Cascade subunit CasE	CRISPR-associated endonuclease Csn1	CRISPR-associated endonuclease/helicase Cas3	CRISPR-associated exonuclease Cas4	CRISPR-associated protein Cas2	CRISPR-associated protein Cas5d	CRISPR-associated protein Csd2	CRISPR-associated protein, Cas1 family	CRISPR-associated protein, Cas2 family	CRISPR-associated protein, Csd1 family	CRP/FNR family transcriptional regulator,  anaerobic regulatory protein	CRP/FNR family transcriptional regulator,  nitrogen fixation regulation protein	CRP/FNR family transcriptional regulator,  transcriptional activator FtrB	CRP/FNR family transcriptional regulator, cyclic  AMP receptor protein	CTP synthase	CTP synthase (EC 6.3.4.2)	CVNH domain-containing protein	CYTH domain-containing protein	Ca-activated chloride channel family protein	Ca-dependent carbohydrate-binding module  xylan-binding	Ca2+-binding protein, EF-hand superfamily	Ca2+-binding protein, RTX toxin-related	Ca2+-transporting ATPase	Ca2+:H+ antiporter	Cache domain-containing protein	Cadmium resistance protein CadD, predicted  permease	CagE TrbE VirB component of type IV transporter  system	CagE, TrbE, VirB family, component of type IV  transporter system	Calcineurin-like phosphoesterase	Calcineurin-like phosphoesterase superfamily  domain-containing protein	Calcineurin-like phosphoesterase superfamily  protein	Calcium-binding EF-hand-containing protein	Calpain family cysteine protease	Camelysin metallo-endopeptidase	Capsular polysaccharide biosynthesis protein	Capsule polysaccharide biosynthesis protein	Capsule polysaccharide biosynthesis protein.	Capsule polysaccharide export protein	Carbamoylphosphate synthase large subunit	Carbamoylphosphate synthase large subunit (split  gene in MJ)	Carbamoyltransferase	Carbohydrate binding domain-containing protein	Carbon dioxide concentrating  mechanism/carboxysome shell protein	Carbon monoxide dehydrogenase subunit G	Carbon-nitrogen hydrolase	Carbonate dehydratase	Carbonic anhydrase or acetyltransferase,  isoleucine patch superfamily	Carboxylesterase	Carboxymethylenebutenolidase	Carboxypeptidase C (cathepsin A)	Carboxypeptidase regulatory-like  domain-containing protein	Caspase domain-containing protein	Catalase	Catalase domain protein	Catalase related subgroup	Catalase.	Catechol 2,3-dioxygenase	Catechol-2,3-dioxygenase	Cation efflux family protein	Cation transport ATPase	Cation transport regulator ChaC	Cbb3-type cytochrome oxidase component	CcmE/CycJ protein	Cd2+/Zn2+-exporting ATPase	Cdc6-related protein, AAA superfamily ATPase	Cell Wall Hydrolase	Cell division and transport-associated protein  TolA	Cell division and transport-associated protein  TolA (TC 2.C.1.2.1)	Cell division and transport-associated protein  TolQ	Cell division and transport-associated protein  TolQ (TC 2.C.1.2.1)	Cell division and transport-associated protein  TolR	Cell division and transport-associated protein  TolR (TC 2.C.1.2.1)	Cell division protein	Cell division protein DedD (protein involved in  septation)	Cell division protein FtsB	Cell division protein FtsI/penicillin-binding  protein 2	Cell division protein FtsL	Cell division protein FtsN	Cell division septum initiation DivIVA,  interacts with FtsZ, MinD	Cell fate regulator YmcA, YheA/YmcA/DUF963  family (controls sporulation, competence, biofilm development)	Cell pole-organizing protein PopZ	Cell wall hydrolase CwlJ, involved in spore  germination	Cell wall-associated hydrolase, NlpC family	Cell wall-associated hydrolases  (invasion-associated proteins)	Cellobiohydrolase A (1,4-beta-cellobiosidase A)	Cellulase	Cellulase (glycosyl hydrolase family 5)	Cellulase family 5 (EC 3.2.1.4)	Cellulose biosynthesis protein BcsN	Cellulose biosynthesis protein BcsQ	Cellulose biosynthesis protein BcsS	Cephalosporin hydroxylase	Ceramidase	ChaB protein	Chalcone isomerase-like	Chaperone for flagella basal body P-ring  formation	Chaperone of endosialidase	Chaperone required for the assembly of the  F1-ATPase	Chaperonin Cpn10	CheA signal transduction histidine kinase	CheD, stimulates methylation of MCP protein	CheD, stimulates methylation of MCP proteins	CheW protein	CheW-like domain-containing protein	CheY chemotaxis protein or a CheY-like REC  (receiver) domain	Chemotaxis protein histidine kinase and related  kinases	Chemotaxis regulator CheZ, phosphatase of CheY~P	Chemotaxis signal transduction protein	Chitodextrinase	Chlorite dismutase.	Choline dehydrogenase	Choline kinase	Choline/ethanolamine kinase	Chorismate mutase	ChrR Cupin-like domain-containing protein	Chromosome partitioning ATPase, Mrp family,  contains Fe-S cluster	Chromosome segregation ATPase	Chromosome segregation and condensation protein  ScpB	Chromosome segregation protein Spo0J, contains  ParB-like nuclease domain	CinA domain protein	Citrate (pro-3S)-lyase	Citrate lyase beta subunit	Cl- channel voltage-gated family protein	Class I peptide chain release factor	Class II Aldolase and Adducin N-terminal  domain-containing protein	Class II flagellar assembly regulator	Clp amino terminal domain-containing protein,  pathogenicity island component	Clp protease	Co/Zn/Cd efflux system component	CoA-binding domain protein	CoA-substrate-specific enzyme activase, putative	CoA:oxalate CoA-transferase	CobQ/CobB/MinD/ParA nucleotide binding  domain-containing protein	Cobalamin biosynthesis protein CbiG	Cobalamin-independent synthase, Catalytic domain	Cobalt uptake substrate-specific transmembrane  region	Cobyrinic acid a,c-diamide synthase	Cobyrinic acid ac-diamide synthase	Coenzyme F420-dependent N5,N10-methylene  tetrahydromethanopterin reductase and related flavin-dependent oxidoreductases	Coenzyme F420-reducing hydrogenase, alpha  subunit	Coenzyme F420-reducing hydrogenase, beta subunit	Coenzyme F420-reducing hydrogenase, gamma  subunit	Coenzyme PQQ synthesis protein D (PqqD)	Cof subfamily of IIB subfamily of haloacid  dehalogenase superfamily/HAD-superfamily hydrolase, subfamily IIB	Cold shock protein, CspA family	Cold-inducible protein YdjO	Colicin D	Colicin V production protein	Collagen triple helix repeat (20 copies).	Collagen triple helix repeat protein	Collagen triple helix repeat-containing protein	Collagenase NC10 and Endostatin.	Collagenase-like protease, PrtC family	Competence protein	Competence protein CoiA-like family, contains a  predicted nuclease domain	Concanavalin A-like lectin/glucanases  superfamily protein	Condensation domain-containing protein	Conjugal transfer protein	Conjugal transfer protein TraD	Conjugal transfer protein TrbC	Conjugal transfer protein TrbG/VirB9/CagX	Conjugal transfer protein TrbH	Conjugative transposon protein TcpC	Conserved TM helix	Conserved TM helix repeat-containing protein	Conserved hypothetical phage protein (DUF2376)	Conserved membrane protein YqhR	Conserved protein containing a Zn-ribbon-like  motif, possibly RNA-binding	Conserved secreted protein	CopG family transcriptional regulator,  nickel-responsive regulator	Copper binding protein CusF	Copper chaperone CopZ	Copper transport outer membrane protein, MctB	Copper-binding protein CopC (methionine-rich)	Core-2/I-Branching enzyme	CrcB protein	CreA protein	Creatininase	Creatinine amidohydrolase/Fe(II)-dependent  formamide hydrolase involved in riboflavin and F420 biosynthesis	Cro/C1-type HTH DNA-binding domain-containing  protein	Crotonobetainyl-CoA:carnitine CoA-transferase  CaiB	CryBP1 protein	CryBP1 protein.	CsbD family protein	CsbD-like	Cu(I)-responsive transcriptional regulator	Cu(I)/Ag(I) efflux system membrane protein  CusA/SilA	Cu(I)/Ag(I) efflux system protein CusF	Cu+-exporting ATPase	Cu-processing system ATP-binding protein	Cu-processing system permease protein	Cu2+-containing amine oxidase	Cu2+-exporting ATPase	CubicO group peptidase, beta-lactamase class C  family	Cupin	Cupin 2 conserved barrel domain protein	Cupin 4 family protein	Cupin domain	Cupin domain protein	Cupin domain-containing protein	Cupin domain.	Cupin superfamily protein	Cupin-like domain-containing protein	Cupredoxin-like domain-containing protein	Curlin associated repeat.	CutA1 divalent ion tolerance protein	Cutinase	CxxC motif-containing protein, DUF1111 family	CyaY protein	Cyanate permease	Cyclic nucleotide-binding domain-containing  protein	Cyclopropane fatty acid synthase and related  methyltransferases	Cyclopropane-fatty-acyl-phospholipid synthase	Cys-tRNA(Pro) deacylase	Cys-tRNA(Pro) deacylase, prolyl-tRNA editing  enzyme YbaK/EbsC	Cys-tRNA(Pro)/Cys-tRNA(Cys) deacylase	Cys/Met metabolism pyridoxal-phosphate-dependent  protein	CysZ protein	Cystathionine beta-lyase family protein involved  in aluminum resistance	Cystathionine beta-lyase/cystathionine  gamma-synthase	Cystathionine beta-lyases/cystathionine  gamma-synthases	Cysteine desulfurase	Cysteine desulfuration protein SufE	Cysteine dioxygenase type I	Cysteine protease	Cysteine rich repeat	Cysteine rich repeat-containing protein	Cysteine-rich secretory protein family protein	Cytidylate kinase	Cytochrome C and Quinol oxidase polypeptide I	Cytochrome C oxidase subunit IV	Cytochrome C oxidase, cbb3-type, subunit III	Cytochrome C'	Cytochrome P450	Cytochrome P460	Cytochrome b	Cytochrome b/b6 domain protein	Cytochrome b561	Cytochrome c	Cytochrome c biogenesis protein CcdA	Cytochrome c oxidase assembly factor CtaG	Cytochrome c oxidase subunit IV	Cytochrome c peroxidase	Cytochrome c, mono- and diheme variants	Cytochrome c.	Cytochrome c1	Cytochrome c5	Cytochrome c553	Cytochrome c553-like protein	Cytochrome c554 and c-prime	Cytochrome c556	Cytochrome oxidase Cu insertion factor,  SCO1/SenC/PrrC family	Cytochrome oxidase assembly protein ShyY1	Cytochrome-c oxidase	Cytochrome-c peroxidase	Cytolysin, a secreted calcineurin-like  phosphatase	Cytosine/adenosine deaminase	Cytosine/adenosine deaminases	D-3-phosphoglycerate dehydrogenase	D-3-phosphoglycerate dehydrogenase (EC 1.1.1.95)	D-Ala-D-Ala carboxypeptidase A. Serine  peptidase. MEROPS family S11	D-Ala-D-Ala carboxypeptidase. Metallo peptidase.  MEROPS family M15B	D-alanine aminotransferase apoenzyme	D-alanine aminotransferase apoenzyme (EC  2.6.1.21)	D-alanine transaminase	D-alanine--D-alanine ligase (EC 6.3.2.4)	D-alanine-D-alanine ligase	D-alanyl-D-alanine  carboxypeptidase/D-alanyl-D-alanine-endopeptidase	D-alanyl-D-alanine carboxypeptidase	D-alanyl-D-alanine carboxypeptidase  (penicillin-binding protein 5/6)	D-alanyl-D-alanine carboxypeptidase /  D-alanyl-D-alanine-endopeptidase (penicillin-binding protein 4)	D-alanyl-D-alanine dipeptidase	D-alanyl-D-alanine endopeptidase  (penicillin-binding protein 7)	D-alanyl-D-alanine-carboxypeptidase /  D-alanyl-D-alanine-endopeptidase	D-alanyl-lipoteichoic acid acyltransferase DltB,  MBOAT superfamily	D-alpha,beta-D-heptose 1,7-bisphosphate  phosphatase (EC 3.1.3.-)	D-alpha,beta-D-heptose 7-phosphate 1-kinase (EC  2.7.1.167)/D-beta-D-heptose 1-phosphate adenylyltransferase (EC 2.7.7.70)	D-amino peptidase	D-amino-acid dehydrogenase	D-aminopeptidase	D-arabinose 1-dehydrogenase, Zn-dependent  alcohol dehydrogenase family	D-beta-D-heptose 7-phosphate kinase /  D-beta-D-heptose 1-phosphate adenosyltransferase	D-cysteine desulfhydrase	D-fructose 1,6-bisphosphatase	D-fructose 1,6-bisphosphatase (EC 3.1.3.11)	D-galactarolactone cycloisomerase	D-galactonate transporter	D-galactose 1-dehydrogenase	D-glycero-D-manno-heptose 1,7-bisphosphate  phosphatase	D-glycero-alpha-D-manno-heptose-7-phosphate  kinase	D-inositol-3-phosphate glycosyltransferase	D-isomer specific 2-hydroxyacid dehydrogenase  NAD-binding protein	D-lactate dehydrogenase	D-lactate dehydrogenase (cytochrome)	D-mannitol 1-phosphate 5-dehydrogenase	D-mannonate dehydratase	D-mannonate dehydratase (EC 4.2.1.8)	D-mannose binding lectin	D-methionine transport system ATP-binding  protein	D-methionine transport system permease protein	D-methionine transport system substrate-binding  protein	D-ribulokinase	D-sedoheptulose 7-phosphate isomerase	D-serine ammonia-lyase	D-serine deaminase, pyridoxal  phosphate-dependent	D-serine dehydratase	D-serine/D-alanine/glycine:proton symporter, AAT  family	D-serine/D-alanine/glycine:proton symporter, AAT  family (TC 2.A.3.1.7)	D-sorbitol dehydrogenase (acceptor)	D-threo-aldose 1-dehydrogenase	D-tyrosyl-tRNA(Tyr) deacylase	D-xylose transport system permease protein	D-xylose transport system substrate-binding  protein	D-xylulose reductase	DDE domain-containing protein	DEAD/DEAH box helicase domain protein	DEAD/DEAH box helicase domain-containing protein	DJ-1 family protein	DJ-1/PfpI family protein	DMSO reductase anchor subunit	DMSO/TMAO reductase YedYZ,  molybdopterin-dependent catalytic subunit	DNA (cytosine-5)-methyltransferase 1	DNA adenine methylase	DNA adenine methylase CcrM	DNA alkylation repair enzyme	DNA binding domain protein, excisionase family	DNA binding domain-containing protein,  excisionase family	DNA end-binding protein Ku	DNA excision repair protein ERCC-3	DNA gyrase subunit A	DNA gyrase subunit A (EC 5.99.1.3)	DNA gyrase subunit B	DNA gyrase subunit B (EC 5.99.1.3)	DNA helicase HerA, contains HAS-barrel and  ATPase domains	DNA helicase IV	DNA helicase-2 / ATP-dependent DNA helicase PcrA	DNA helicase/exodeoxyribonuclease V, alpha  subunit	DNA helicase/exodeoxyribonuclease V, beta  subunit	DNA helicase/exodeoxyribonuclease V, gamma  subunit	DNA helicase/exodeoxyribonuclease V, subunit A	DNA helicase/exodeoxyribonuclease V, subunit B	DNA internalization-related competence protein  ComEC/Rec2	DNA ligase (NAD+)	DNA ligase D	DNA ligase, NAD-dependent	DNA ligase-1	DNA methylase	DNA methylase N-4/N-6 domain protein	DNA mismatch repair enzyme (predicted ATPase)	DNA mismatch repair protein MutL	DNA mismatch repair protein MutS	DNA mismatch repair protein MutS2	DNA modification methylase	DNA or RNA helicases of superfamily II	DNA phosphorothioation-dependent restriction  protein DptG	DNA photolyase FAD-binding	DNA photolyase FAD-binding protein	DNA polymerase	DNA polymerase (family 10)	DNA polymerase I	DNA polymerase I (EC 2.7.7.7)	DNA polymerase III, alpha subunit	DNA polymerase III, alpha subunit (EC 2.7.7.7)	DNA polymerase III, alpha subunit /error-prone  DNA polymerase, DnaE-like	DNA polymerase III, beta subunit	DNA polymerase III, beta subunit (EC 2.7.7.7)	DNA polymerase III, chi subunit	DNA polymerase III, chi subunit (EC 2.7.7.7)	DNA polymerase III, delta prime subunit (EC  2.7.7.7)	DNA polymerase III, delta subunit	DNA polymerase III, delta subunit (EC 2.7.7.7)	DNA polymerase III, epsilon subunit	DNA polymerase III, epsilon subunit (EC 2.7.7.7)	DNA polymerase III, epsilon subunit and related  3'-5' exonucleases	DNA polymerase III, subunit gamma and tau	DNA polymerase III, subunits gamma and tau	DNA polymerase III, tau subunit (EC 2.7.7.7)	DNA polymerase V	DNA polymerase-1	DNA polymerase-3 subunit alpha	DNA polymerase-3 subunit beta	DNA polymerase-3 subunit delta'	DNA polymerase-3 subunit epsilon	DNA polymerase-3 subunit gamma/tau	DNA polymerase-4	DNA primase	DNA primase (EC 2.7.7.-)	DNA primase (bacterial type)	DNA processing protein	DNA protecting protein DprA	DNA recombination protein RmuC	DNA repair exonuclease	DNA repair exonuclease SbcCD ATPase subunit	DNA repair exonuclease SbcCD nuclease subunit	DNA repair photolyase	DNA repair protein RadA	DNA repair protein RadA/Sms	DNA repair protein RadC	DNA repair protein RecN	DNA repair protein RecN (Recombination protein  N)	DNA repair protein radc	DNA replication and repair protein RadA	DNA replication and repair protein RadC	DNA replication and repair protein RecF	DNA replication and repair protein RecN	DNA replication and repair protein RecO	DNA replication and repair protein RecR	DNA replication protein DnaC	DNA segregation ATPase FtsK/SpoIIIE and related  proteins	DNA segregation ATPase FtsK/SpoIIIE, S-DNA-T  family	DNA sulfur modification protein DndB	DNA sulfur modification protein DndC	DNA sulfur modification protein DndD	DNA sulfur modification protein DndE	DNA topoisomerase	DNA topoisomerase (ATP-hydrolyzing)	DNA topoisomerase I	DNA topoisomerase I (EC 5.99.1.2)	DNA topoisomerase IA	DNA topoisomerase IB	DNA topoisomerase IV subunit A	DNA topoisomerase IV subunit A (EC 5.99.1.3)	DNA topoisomerase IV subunit B	DNA topoisomerase IV subunit B (EC 5.99.1.3)	DNA topoisomerase-1	DNA topoisomerase-3	DNA transformation protein	DNA translocase FtsK	DNA transposition protein, AAA+ family ATPase	DNA-(apurinic or apyrimidinic site) lyase	DNA-(apurinic or apyrimidinic site) lyase 	DNA-(apurinic or apyrimidinic site) lyase (EC  4.2.99.18)/Formamidopyrimidine-DNA glycosylase (EC 3.2.2.23)	DNA-(apurinic or apyrimidinic site) lyase (EC  4.2.99.18)/endonuclease III (EC 3.2.2.-)	DNA-3-methyladenine glycosylase	DNA-3-methyladenine glycosylase I	DNA-3-methyladenine glycosylase I (EC 3.2.2.20)	DNA-3-methyladenine glycosylase II	DNA-N1-methyladenine dioxygenase	DNA-N1-methyladenine dioxygenase (EC 1.14.11.-)	DNA-O6-methylguanine--protein-cysteine  S-methyltransferase (EC 2.1.1.63)/Transcriptional regulator Ada	DNA-O6-methylguanine--protein-cysteine  S-methyltransferase /Transcriptional regulator Ada	DNA-binding beta-propeller fold protein YncE	DNA-binding ferritin-like protein (Dps family)	DNA-binding prophage protein	DNA-binding protein Fis	DNA-binding protein H-NS	DNA-binding protein HU-beta	DNA-binding regulatory protein, YebC/PmpR family	DNA-binding response regulator, NarL/FixJ  family, contains REC and HTH domains	DNA-binding response regulator, OmpR family,  contains REC and winged-helix (wHTH) domain	DNA-binding transcriptional activator of the  SARP family	DNA-binding transcriptional regulator GbsR, MarR  family	DNA-binding transcriptional regulator LsrR, DeoR  family	DNA-binding transcriptional regulator YdaS,  prophage-encoded, Cro superfamily	DNA-binding transcriptional regulator YhcF, GntR  family	DNA-binding transcriptional regulator of  glucitol operon	DNA-binding transcriptional regulator of sugar  metabolism, DeoR/GlpR family	DNA-binding transcriptional regulator,  XRE-family HTH domain	DNA-binding transcriptional regulator, ArsR  family	DNA-binding transcriptional regulator, CsgD  family	DNA-binding transcriptional regulator, FadR  family	DNA-binding transcriptional regulator, FrmR  family	DNA-binding transcriptional regulator, GntR  family	DNA-binding transcriptional regulator, IclR  family	DNA-binding transcriptional regulator, IscR  family	DNA-binding transcriptional regulator, LacI/PurR  family	DNA-binding transcriptional regulator, Lrp  family	DNA-binding transcriptional regulator, LysR  family	DNA-binding transcriptional regulator, MarR  family	DNA-binding transcriptional regulator, MerR  family	DNA-binding transcriptional regulator, MocR  family, contains an aminotransferase domain	DNA-binding transcriptional regulator, PadR  family	DNA-binding transcriptional regulator, PucR  family	DNA-binding transcriptional regulator, XRE  family	DNA-binding transcriptional response regulator,  NtrC family, contains REC, AAA-type ATPase, and a Fis-type DNA-binding domains	DNA-binding winged helix-turn-helix (wHTH)  domain-containing protein	DNA-binding winged-HTH domains	DNA-cytosine methyltransferase	DNA-damage-inducible protein J	DNA-directed DNA polymerase	DNA-directed RNA polymerase	DNA-directed RNA polymerase specialized sigma  subunit, sigma24 family	DNA-directed RNA polymerase specialized sigma  subunit, sigma24 homolog	DNA-directed RNA polymerase subunit alpha	DNA-directed RNA polymerase subunit alpha (EC  2.7.7.6)	DNA-directed RNA polymerase subunit beta	DNA-directed RNA polymerase subunit beta (EC  2.7.7.6)	DNA-directed RNA polymerase subunit beta'	DNA-directed RNA polymerase subunit beta' (EC  2.7.7.6)	DNA-directed RNA polymerase subunit delta	DNA-directed RNA polymerase subunit omega	DNA-directed RNA polymerase subunit omega (EC  2.7.7.6)	DNA-nicking endonuclease, Smr domain	DNA-packaging protein gp3	DNA-sulfur modification-associated	DNA/RNA endonuclease G, NUC1	DNA/RNA non-specific endonuclease	DNase/tRNase domain of colicin-like bacteriocin	DOPA 4,5-dioxygenase	DSBA oxidoreductase	DSF synthase	DUF218 domain-containing protein	DUF35 OB-fold domain-containing protein,  acyl-CoA-associated	DUF4097 and DUF4098 domain-containing protein  YvlB	DUF971 family protein	Dam-replacing family protein	DedD protein	DegT/DnrJ/EryC1/StrS aminotransferase	Dehydrogenase (flavoprotein)	Dehydrogenases with different specificities  (related to short-chain alcohol dehydrogenases)	Delta-9 acyl-phospholipid desaturase (EC  1.14.19.-)	Demethoxyubiquinone hydroxylase, CLK1/Coq7/Cat5  family	Deoxyadenosine/deoxycytidine kinase	Dephospho-CoA kinase	Di- and tricarboxylate transporter	Di- and tricarboxylate transporters	Diacylglycerol O-acyltransferase	Diacylglycerol O-acyltransferase (EC 2.3.1.20)	Diacylglycerol kinase family enzyme	Diadenosine tetraphosphate (Ap4A) hydrolase	Diadenosine tetraphosphate (Ap4A) hydrolase and  other HIT family hydrolases	Diaminopimelate decarboxylase	Dienelactone hydrolase	Dienelactone hydrolase and related enzymes	Diheme cytochrome c	Dihydrodipicolinate synthase/N-acetylneuraminate  lyase	Dihydrofolate reductase	Dihydrolipoyllysine-residue acetyltransferase	Dihydropteroate synthase (EC 2.5.1.15)	Dimeric dUTPase, all-alpha-NTP-PPase (MazG)  superfamily	Dimerisation domain-containing protein	Dimethlysulfonioproprionate lyase	Dimethyladenosine transferase (rRNA methylation)	DinB family protein	DinB superfamily protein	Dinucleotide-utilizing enzymes involved in  molybdopterin and thiamine biosynthesis family 1	Dinucleotide-utilizing enzymes involved in  molybdopterin and thiamine biosynthesis family 2	Dipeptide/tripeptide permease	Dipeptidyl aminopeptidase/acylaminoacyl  peptidase	Dissimilatory sulfite reductase  (desulfoviridin), alpha and beta subunits	Distinct helicase family with a unique  C-terminal domain including a metal-binding cysteine cluster	Disulfide bond formation protein DsbB	DivIVA domain-containing protein	Divalent metal cation (Fe/Co/Zn/Cd) transporter	Divergent AAA domain	DnaA family protein	DnaA regulatory inactivator Hda	DnaD and phage-associated domain-containing  protein	DnaJ domain	DnaJ domain-containing protein	DnaJ domain.	DnaJ like chaperone protein	DnaJ-class molecular chaperone with C-terminal  Zn finger domain	DnaK supressor	Do/DeqQ family serine protease	Dolichyl-phosphate-mannose--protein O-mannosyl  transferase	Dolichyl-phosphate-mannose-protein  mannosyltransferase	Domain amino terminal to FKBP-type  peptidyl-prolyl isomerase	Domain of Unknown Function (DUF1520).	Domain of unknown function (DU1801)	Domain of unknown function (DUF1127)	Domain of unknown function (DUF1127).	Domain of unknown function (DUF1833).	Domain of unknown function (DUF222)	Domain of unknown function (DUF3846)	Domain of unknown function (DUF4095)	Domain of unknown function (DUF4098)	Domain of unknown function (DUF4102)	Domain of unknown function (DUF4124)	Domain of unknown function (DUF4153)	Domain of unknown function (DUF4189)	Domain of unknown function (DUF4407)	Domain of unknown function (DUF4412)	Domain of unknown function (DUF4440)	Domain of unknown function (DUF955)	Domain of unknown function DUF1814	Domain of unknown function DUF1840	Domain of unknown function DUF1841	Domain of unknown function DUF1854	Domain of unknown function DUF1905	Domain of unknown function DUF1924	Domain of unknown function DUF1993	Double zinc ribbon	DoxX family protein	DoxX protein	DoxX-like family protein	DsrE/DsrF-like family protein	Dual specificity phosphatase, catalytic domain	Dynamin family protein	Dyp-type peroxidase family	EAL and modified HD-GYP domain-containing signal  transduction protein	EAL domain, c-di-GMP-specific phosphodiesterase  class I (or its enzymatically inactive variant)	EAL domain-containing protein	EDD domain protein, DegV family	EF hand	EF hand domain-containing protein	EF-Hand domain protein	EF-hand domain pair	EPS-associated transcriptional regulator, MarR  family	EPTP domain-containing protein	ERF superfamily protein	ETC complex I subunit conserved region	EVE domain-containing protein	EamA domain-containing membrane protein RarD	EamA-like transporter family	EamA-like transporter family protein	EamA-like transporter family.	Eco57I restriction-modification methylase	EcoEI R domain protein	EcoRII C terminal	EcsC protein family protein	Ectoine hydroxylase-related dioxygenase,  phytanoyl-CoA dioxygenase (PhyH) family	ElaA protein	Electron transfer DM13	Electron-transferring-flavoprotein dehydrogenase	Enamine deaminase RidA, house cleaning of  reactive enamine intermediates, YjgF/YER057c/UK114 family	Endo-beta-mannanase	Endoglucanase	Endonuclease IV	Endonuclease YncB, thermonuclease family	Endonuclease, Uma2 family (restriction  endonuclease fold)	Endonuclease/Exonuclease/phosphatase family  protein	Endonuclease/exonuclease/phosphatase	Endopolygalacturonase	Endoribonuclease L-PSP	Energy-coupling factor transporter ATP-binding  protein EcfA2	Enolase C-terminal domain-like	Enoyl-(Acyl carrier protein) reductase	Enoyl-CoA hydratase	Enoyl-CoA hydratase (EC 4.2.1.17)	Enoyl-CoA hydratase/carnithine racemase	Enoyl-CoA hydratase/isomerase	Enoyl-[acyl-carrier-protein] reductase [NADH]	Enoyl-[acyl-carrier-protein] reductase [NADH]  (EC 1.3.1.9)	Entericidin EcnAB	Enterochelin esterase	EpsG family protein	EpsI family protein	ErfK/YbiS/YcfS/YnhG family protein	Erythromycin esterase homolog	EspG family protein	Esterase-like activity of phytase	Esterase/lipase	Esterase/lipase superfamily enzyme	EthD domain-containing protein	EthD protein.	Ethanolamine ammonia-lyase heavy chain	Ethanolamine ammonia-lyase heavy chain (EC  4.3.1.7)	Ethanolamine ammonia-lyase light chain	Ethanolamine ammonia-lyase light chain 	Ethanolamine ammonia-lyase light chain (EC  4.3.1.7)	Ethanolamine utilisation protein EutQ	Ethanolamine utilization protein	Excalibur calcium-binding domain-containing  protein	Excinuclease ABC C subunit domain protein	Excinuclease ABC subunit A	Excinuclease ABC subunit B	Excinuclease ABC subunit C	Excinuclease UvrABC ATPase subunit	Excreted virulence factor EspC, type VII ESX  diderm	Exo-beta-1,3-glucanase, GH17 family	ExoV-like protein	Exodeoxyribonuclease I subunit C	Exodeoxyribonuclease I subunit D	Exodeoxyribonuclease III (EC 3.1.11.2)	Exodeoxyribonuclease V	Exodeoxyribonuclease VII large subunit	Exodeoxyribonuclease VII large subunit (EC  3.1.11.6)	Exodeoxyribonuclease VII small subunit	Exodeoxyribonuclease VII small subunit (EC  3.1.11.6)	Exonuclease III	Exonuclease RNase T and DNA polymerase III	Exopolysaccharide biosynthesis protein	Exopolysaccharide biosynthesis protein EpsI,  predicted pyruvyl transferase	Exopolysaccharide biosynthesis protein YbjH	Exopolysaccharide synthesis ExoD	Exoribonuclease R	Extended Signal Peptide of Type V secretion  system	Extensin-like protein C-terminus	Extradiol ring-cleavage dioxygenase class III  protein subunit B	F subunit of K+-transporting ATPase  (Potass_KdpF)	F-type H+-transporting ATPase subunit a	F-type H+-transporting ATPase subunit alpha	F-type H+-transporting ATPase subunit b	F-type H+-transporting ATPase subunit beta	F-type H+-transporting ATPase subunit c	F-type H+-transporting ATPase subunit delta	F-type H+-transporting ATPase subunit epsilon	F-type H+-transporting ATPase subunit gamma	F420-0:Gamma-glutamyl ligase	F420-dependent oxidoreductase, G6PDH family	FAD binding domain-containing protein	FAD dependent oxidoreductase	FAD dependent oxidoreductase TIGR03364	FAD linked oxidase domain protein	FAD synthase	FAD-NAD(P)-binding	FAD-dependent pyridine nucleotide-disulfide  oxidoreductase	FAD-dependent pyridine nucleotide-disulphide  oxidoreductase	FAD/FMN-containing dehydrogenase	FAD/FMN-containing dehydrogenases	FBP C-terminal treble-clef zinc-finger	FGGY-family pentulose kinase	FHA domain containing protein	FHA domain protein	FHA domain-containing protein	FHA modulated ABC efflux pump with fused ATPase  and integral membrane subunits	FIST C domain protein	FKBP-type peptidyl-prolyl cis-trans isomerase  FklB	FKBP-type peptidyl-prolyl cis-trans isomerase  FkpA	FKBP-type peptidyl-prolyl cis-trans isomerase  SlpA	FKBP-type peptidyl-prolyl cis-trans isomerase  SlyD	FMN adenylyltransferase (EC 2.7.7.2)/riboflavin  kinase (EC 2.7.1.26)	FMN phosphatase YigB, HAD superfamily	FMN reductase	FMN-binding domain protein	FMN-dependent NADH-azoreductase	FMN-dependent alpha-hydroxy acid dehydrogenase	FMN-dependent oxidoreductase, nitrilotriacetate  monooxygenase family	FMNH2-dependent dimethyl sulfone monooxygenase	FO synthase subunit 1 /FO synthase subunit 2	FOG: Ankyrin repeat	FOG: FHA domain	FOG: GGDEF domain	FOG: HPt domain	FOG: WD40 repeat	FRG domain-containing protein	FabA-like domain-containing protein	Fatty acid desaturase	Fatty acid hydroxylase superfamily protein	FdhD protein	FdhE protein	Fe(3+) dicitrate transport protein	Fe(II) trafficking protein YggX	Fe-S cluster assembly ATP-binding protein	Fe-S cluster assembly iron-binding protein IscA	Fe-S cluster assembly protein SufB	Fe-S cluster assembly protein SufD	Fe-S cluster assembly protein SufU	Fe-S cluster biogenesis protein NfuA,  4Fe-4S-binding domain	Fe-S cluster biosynthesis and repair protein  YggX	Fe-S oxidoreductase	Fe-S oxidoreductases	Fe-S protein assembly chaperone HscA	Fe-S-cluster-containing dehydrogenase component	Fe-S-cluster-containing hydrogenase component 2	Fe-S-cluster-containing hydrogenase components 1	Fe2+ transport system protein B	FeS assembly SUF system protein	FeS assembly protein IscX	FeS assembly scaffold apoprotein IscU	FeS cluster assembly scaffold IscU	FecR family protein	FemAB-related protein, PEP-CTERM  system-associated	FeoA family protein	Ferredoxin	Ferredoxin subunit of nitrite reductase or a  ring-hydroxylating dioxygenase	Ferredoxin--nitrite reductase	Ferredoxin-NADP reductase	Ferric iron reductase protein FhuF, involved in  iron transport	Ferric reductase domain protein protein  transmembrane component domain protein	Ferric reductase domain protein transmembrane  component domain	Ferric reductase like transmembrane component	Ferric reductase like transmembrane component.	Ferritin	Ferritin Dps family protein	Ferritin-like domain-containing protein	Ferritin-like metal-binding protein YciE	Fibronectin type III domain-containing protein	Fibronectin-attachment protein (FAP)	Fic family protein	FimB	FimV N-terminal domain protein	Fimbrial assembly family protein	Fimbrial assembly protein (PilN)	Fimbrial protein pilin	Fis family transcriptional regulator, factor for  inversion stimulation protein	FixH family protein	FlaG protein.	Flagella basal body rod protein	Flagellar assembly protein FliH/Type III  secretion system HrpE	Flagellar basal body P-ring biosynthesis protein	Flagellar biosynthesis protein, FliO	Flagellar biosynthesis/type III secretory  pathway protein FliH	Flagellar hook-associated protein	Flagellar hook-length control protein	Flagellar hook-length control protein FliK	Flagellar motility protein MotE, a chaperone for  MotC folding	Flagellar motor switch protein	Flagellin FlgL	Flagellin and related hook-associated proteins	Flavin-dependent oxidoreductase, luciferase  family (includes alkanesulfonate monooxygenase SsuD and methylene tetrahydromethano	Flavodoxin	Flavodoxins	Flavoprotein involved in thiazole biosynthesis	FlgN family protein	FlgN protein	Flp pilus assembly protein CpaB	Flp pilus assembly protein TadB	Flp pilus assembly protein TadC	Flp pilus assembly protein TadD, contains TPR  repeats	Flp pilus assembly protein TadG	Flp pilus assembly protein, pilin Flp	Flp pilus assembly protein, secretin CpaC	Flp/Fap pilin component	Fmu (Sun) domain protein	FoF1-type ATP synthase assembly protein I	FolC bifunctional protein	Folate-dependent phosphoribosylglycinamide  formyltransferase PurN	Forkhead associated (FHA) domain, binds pSer,  pThr, pTyr	Formamidase	Formate hydrogenlyase subunit 3/Multisubunit  Na+/H+ antiporter, MnhD subunit	Formate hydrogenlyase subunit 4	Formate hydrogenlyase subunit 6/NADH:ubiquinone  oxidoreductase 23 kD subunit (chain I)	Formate--tetrahydrofolate ligase	Formate-dependent nitrite reductase, membrane  component	Formate-dependent nitrite reductase, membrane  component NrfD	Formate-dependent phosphoribosylglycinamide  formyltransferase (GAR transformylase)	Formate-tetrahydrofolate ligase	Formate-tetrahydrofolate ligase (EC 6.3.4.3)	Formate/nitrite transporter FocA, FNT family	Formiminotetrahydrofolate cyclodeaminase	Formylglycine-generating enzyme, required for  sulfatase activity, contains SUMF1/FGE domain	Fructosamine-3-kinase	Fructose-2,6-bisphosphatase	Fructose-bisphosphate aldolase class Ia, DhnA  family	Fructoselysine-6-P-deglycase FrlB with  duplicated sugar isomerase (SIS) domain	FtsX-like permease family protein	Ftsk gamma domain-containing protein	Fucose 4-O-acetylase	Fucose permease	Fumarylacetoacetate (FAA) hydrolase family  protein	Fur family transcriptional regulator, ferric  uptake regulator	Fur family transcriptional regulator, iron  response regulator	Fur family transcriptional regulator, zinc  uptake regulator	Fur-regulated basic protein A	Fusaric acid resistance protein conserved region	Fusaric acid resistance protein-like	FxsA cytoplasmic membrane protein	G/U mismatch-specific uracil-DNA glycosylase	G/U mismatch-specific uracil-DNA glycosylase (EC  3.2.2.-)	GAD-like domain-containing protein	GAF domain-containing protein	GAF modulated sigma54 specific transcriptional  regulator, Fis family	GAF sensor signal transduction histidine kinase  (EC 2.7.13.3)	GCN5-related N-acetyltransferase	GDP-L-fucose synthase	GDP-mannose 4,6-dehydratase	GDP-mannose 6-dehydrogenase	GDPmannose 4,6-dehydratase	GDSL-like Lipase/Acylhydrolase family	GDSL-like Lipase/Acylhydrolase family protein	GGDEF domain-containing protein, diguanylate  cyclase (c-di-GMP synthetase) or its enzymatically inactive variants	GHMP kinase	GIY-YIG catalytic domain-containing protein	GLTT repeat-containing protein	GMC oxidoreductase	GMP synthase (glutamine-hydrolysing)	GMP synthase (glutamine-hydrolyzing)	GMP synthase (glutamine-hydrolyzing) (EC  6.3.5.2)	GMP synthase - Glutamine amidotransferase	GMP synthase, large subunit	GNAT-family acetyltransferase TIGR03103	GSCFA family protein	GST-like protein	GTP cyclohydrolase I	GTP cyclohydrolase I (EC 3.5.4.16)	GTP cyclohydrolase II	GTP cyclohydrolase II (EC  3.5.4.25)/3,4-dihydroxy-2-butanone 4-phosphate synthase (EC 4.1.99.12)	GTP cyclohydrolase II (EC 3.5.4.25)	GTP pyrophosphokinase	GTP-binding protein	GTP-binding protein EngB required for normal  cell division	GTP-binding protein Era	GTP-binding protein HSR1-related	GTP-binding protein HflX	GTP-binding protein HflX (EC 3.1.5.-)	GTP-binding protein LepA	GTP-binding protein Obg/CgtA	GTP-binding protein TypA	GTP-binding protein YchF	GTP-binding proten HflX	GTP-binding signal recognition particle SRP54 G-  domain protein	GTP:adenosylcobinamide-phosphate  guanylyltransferase	GTPase, G3E family	Galactose mutarotase	Galactose oxidase, central domain	Gamma-glutamyl phosphate reductase	Gas vesicle protein	GcrA cell cycle regulator	General stress protein 26	General substrate transporter	GerA spore germination protein	GlcNAc-PI de-N-acetylase	GlcNAc-PI de-N-acetylase.	Global cell cycle regulator GcrA	Glucoamylase (glucan-1,4-alpha-glucosidase),  GH15 family	Glucoamylase and related glycosyl hydrolases	Gluconate 2-dehydrogenase subunit 3	Gluconolactonase	Glucose / Sorbosone dehydrogenase	Glucose-1-phosphate thymidylyltransferase	Glucose-1-phosphate thymidylyltransferase (EC  2.7.7.24)	Glucose-6-phosphate 1-dehydrogenase	Glucose-6-phosphate isomerase	Glucose/arabinose dehydrogenase, beta-propeller  fold	Glutamate decarboxylase and related  PLP-dependent proteins	Glutamate dehydrogenase/leucine dehydrogenase	Glutamate or tyrosine decarboxylase	Glutamate synthase domain 2	Glutamate synthase domain-containing protein 1	Glutamate synthase domain-containing protein 2	Glutamate synthase domain-containing protein 3	Glutamate--tRNA ligase	Glutamate-1-semialdehyde aminotransferase	Glutamine amidotransferases class-II	Glutamine cyclotransferase	Glutamine--scyllo-inositol transaminase	Glutamyl-tRNA reductase	Glutaredoxin	Glutaredoxin and related proteins	Glutaredoxin, GrxC family	Glutaredoxin-family domain-containing protein	Glutaredoxin-like domain (DUF836)	Glutathione S-transferase	Glutathione S-transferase domain protein	Glutathione synthase/RimK-type ligase, ATP-grasp  superfamily	Glutathionylspermidine synthase	Glyceraldehyde-3-phosphate dehydrogenase  (phosphorylating)	Glycerol uptake facilitator (Major Intrinsic  Protein Family)	Glycerol uptake facilitator and related  permeases (Major Intrinsic Protein Family)	Glycerophosphoryl diester phosphodiesterase	Glycine cleavage system T protein  (aminomethyltransferase)	Glycine zipper	Glycine zipper 2TM domain	Glycine zipper 2TM domain-containing protein	Glycine-zipper containing OmpA-like membrane  domain-containing protein	Glycine/D-amino acid oxidase (deaminating)	Glycogen debranching enzyme	Glycogen debranching enzyme  (alpha-1,6-glucosidase)	Glycopeptide antibiotics resistance protein	Glycosidase	Glycoside hydrolase family 44	Glycoside-hydrolase family GH114	Glycosyl hydrolase family 1	Glycosyl hydrolase family 63 C-terminal  domain-containing protein	Glycosyl hydrolases family 18	Glycosyl hydrolases family 2, TIM barrel domain	Glycosyl hydrolases family 43	Glycosyl transferase 4-like domain-containing  protein	Glycosyl transferase family 1	Glycosyl transferase family 11	Glycosyl transferase family 2	Glycosyl transferase family 90	Glycosyl transferase family group 2	Glycosyl transferases group 1	Glycosyltransferase	Glycosyltransferase (GlcNAc)	Glycosyltransferase Family 4	Glycosyltransferase WbsX	Glycosyltransferase family 10  (fucosyltransferase) C-term	Glycosyltransferase family 29  (sialyltransferase)	Glycosyltransferase family 29  (sialyltransferase).	Glycosyltransferase family 92	Glycosyltransferase involved in LPS  biosynthesis, GR25 family	Glycosyltransferase involved in cell wall  bisynthesis	Glycosyltransferase sugar-binding region  containing DXD motif-containing protein	Glycosyltransferase, GT2 family	Glycosyltransferase, catalytic subunit of  cellulose synthase and poly-beta-1,6-N-acetylglucosamine synthase	Glycosyltransferases involved in cell wall  biogenesis	Glycosyltransferases, probably involved in cell  wall biogenesis	Glyoxalase superfamily enzyme, possibly  3-demethylubiquinone-9 3-methyltransferase	Glyoxalase-like domain	Glyoxalase-like domain-containing protein	Glyoxalase/Bleomycin resistance  protein/Dioxygenase superfamily protein	Glyoxalase/bleomycin resistance  protein/dioxygenase	Glyoxylase, beta-lactamase superfamily II	GntR family transcriptional regulator	GntR family transcriptional regulator / MocR  family aminotransferase	GntR family transcriptional regulator,  phosphonate transport system regulatory protein	GntR family transcriptional regulator,  transcriptional repressor for pyruvate dehydrogenase complex	GntR family transcriptional regulator, L-lactate  dehydrogenase operon regulator	GntR family transcriptional regulator, gluconate  operon transcriptional repressor	GntR family transcriptional regulator, histidine  utilization repressor	GntR family transcriptional regulator, regulator  for abcA and norABC	GntR family transcriptional regulator, trehalose  operon transcriptional repressor	Golgi phosphoprotein 3 (GPP34)	Gram-negative porin	GreA/GreB family elongation factor	Group 4 capsule polysaccharide lipoprotein gfcB,  YjbF	GrpB domain, predicted nucleotidyltransferase,  UPF0157 family	GrpE protein	GtrA family protein	GtrA-like protein	Guanosine polyphosphate  pyrophosphohydrolases/synthetases	Guanyl-specific ribonuclease Sa	GumN family protein	GxxExxY protein	H+ Antiporter protein	H+-ATPase subunit D/Vma8	H+-ATPase subunit F/Vma7	H+-transporting ATPase	H+/Cl- antiporter ClcA	H+/gluconate symporter	H-type lectin domain-containing protein	H4MPT-linked C1 transfer pathway protein	HAD-superfamily class IIA hydrolase, TIGR01459	HAD-superfamily hydrolase, subfamily IA, variant  1	HAD-superfamily hydrolase, subfamily IA, variant  3	HAD-superfamily subfamily IB hydrolase,  TIGR01490	HAD-superfamily subfamily IIA hydrolase like  protein	HAD-superfamily subfamily IIA hydrolase,  TIGR01457	HAD-superfamily subfamily IIA hydrolase,  TIGR01458	HAMP domain-containing protein	HB1, ASXL, restriction endonuclease HTH domain	HD domain-containing protein	HD-GYP domain	HD-GYP domain, c-di-GMP phosphodiesterase class  II (or its inactivated variant)	HD-like signal output (HDOD) domain, no  enzymatic activity	HDIG domain-containing protein	HDOD domain-containing protein	HEAT repeat	HEAT repeat-containing protein	HEAT repeat.	HEPN domain-containing protein	HEXXH motif-containing protein	HI0933 family protein	HIRAN domain	HIRAN domain-containing protein	HIT domain-containing protein	HKD family nuclease	HNH endonuclease	HNH endonuclease.	HPP family protein	HPr Serine kinase C-terminal domain-containing  protein	HPr kinase/phosphorylase	HPt (histidine-containing phosphotransfer)  domain-containing protein	HSP20 family protein	HTH DNA binding domain.	HTH domain.	HTH-like domain-containing protein	HTH-type transcriptional regulator / antitoxin  HigA	Haem-NO-binding	Haem-degrading	Haemagluttinin repeat-containing protein	Haloacid Dehalogenase Superfamily Class  (subfamily) IIA	Haloacid Dehalogenase superfamily, subfamily IB,  phosphoserine phosphatase-like/2,3-diketo-5-methylthio-1-phosphopentane phosph	Haloacid dehalogenase domain protein hydrolase	Haloacid dehalogenase superfamily, subfamily IA,  variant 2 with 3rd motif like haloacid dehalogenase/haloacid dehalogenase supe	Haloacid dehalogenase-like hydrolase	HdeA/HdeB family protein	Head domain of trimeric autotransporter adhesin	Heat induced stress protein YflT	Heat shock protein	Heat shock protein HslJ	Heat shock protein Hsp90-like protein	Heat shock protein. Metallo peptidase. MEROPS  family M48B	Heavy metal transport/detoxification protein	Heavy-metal resistance	Helicase	Helicase associated domain-containing protein	Helicase conserved C-terminal domain-containing  protein	Helicase subunit of the DNA excision repair  complex	Helix-hairpin-helix domain	Helix-hairpin-helix motif-containing protein	Helix-turn-helix	Helix-turn-helix domain	Helix-turn-helix domain of resolvase	Helix-turn-helix domain-containing protein	Helix-turn-helix of insertion element  transposase	Helix-turn-helix type 11 domain protein	HemK family putative methylases	HemX family protein	HemY domain protein	HemY protein	Heme oxygenase	Heme oxygenase-like protein	Heme-degrading monooxygenase HmoA	Hemerythrin HHE cation binding domain protein	Hemerythrin HHE cation binding domain-containing  protein	Hemin uptake protein HemP	Hemin uptake protein hemP	Hemin-degrading family protein	Hemoglobin-like flavoprotein	Hemolysin activation/secretion protein	Hemolysin, contains CBS domains	Hemolysin-type calcium binding domain protein	Hemolysin-type calcium-binding region	Hemolysin-type calcium-binding repeat-containing  protein	Hemolysins and related proteins containing CBS  domains	Heparinase II/III N-terminus	Heparinase II/III-like protein	Heptaprenyl diphosphate synthase (HEPPP  synthase) subunit 1	Heptaprenyl diphosphate synthase component I	Hexapeptide repeat of succinyl-transferase	High-affinity Fe2+/Pb2+ permease	HindVP restriction endonuclease	Hint domain-containing protein	HipA-like C-terminal domain-containing protein	HipA-like N-terminal domain.	His Kinase A (phospho-acceptor)  domain-containing protein	His-Xaa-Ser system protein HxsD	His-Xaa-Ser system radical SAM maturase HxsB	His-Xaa-Ser system radical SAM maturase HxsC	Histidine ammonia-lyase	Histidine kinase	Histidine kinase-, DNA gyrase B-, and HSP90-like  ATPase	Histidine phosphatase superfamily (branch 1)	Histidinol phosphatase and related hydrolases of  the PHP family	Histone deacetylase	HlyD family secretion protein	Holin of 3TMs, for gene-transfer release	Holliday junction DNA helicase subunit RuvA	Holliday junction DNA helicase subunit RuvB	Holliday junction endonuclease RuvC	Holliday junction endonuclease RuvC (EC  3.1.22.4)	Holliday junction resolvase	Holliday junction resolvase YqgF	Holliday junction resolvasome RuvABC  endonuclease subunit	Homeodomain-like domain-containing protein	Homoserine acetyltransferase	HpcH/HpaI aldolase	HpcH/HpaI aldolase/citrate lyase family protein	Hpr(Ser) kinase/phosphatase	Hpr(Ser) kinase/phosphatase (EC 2.7.1.-)	Hpt domain	Hpt domain-containing protein	Hpt protein	HsdM N-terminal domain-containing protein	HslV component of HslUV peptidase. Threonine  peptidase. MEROPS family T01B	Hsp33 protein	Htaa protein	HtrA2 peptidase	HupE / UreJ protein	HupE/UreJ protein	Hydantoinase/oxoprolinase	Hydrogenase 1 maturation peptidase HyaD.  Aspartic peptidase. MEROPS family A31	Hydrogenase maturation protein HypC	Hydrogenase maturation protein HypD	Hydrogenase maturation protein,  carbamoyltransferase HypF	Hydrogenase maturation protein, carbamoyl  dehydratase HypE	Hydrogenase nickel incorporation protein HypB	Hydrogenase-3 nickel incorporation protein HypA	Hydrogenase/urease accessory protein HupE	Hydroxyacylglutathione hydrolase	Hydroxylase for synthesis of  2-methylthio-cis-ribozeatin in tRNA	Hydroxymethylpyrimidine pyrophosphatase	Hydroxyneurosporene synthase (CrtC)	Hypothetical protein	Hypothetical protein Yqai	Hypoxia induced protein conserved region	IDEAL domain	IDEAL domain-containing protein	IDEAL domain.	IMP cyclohydrolase 	IMP cyclohydrolase (EC  3.5.4.10)/phosphoribosylaminoimidazolecarboxamide formyltransferase (EC 2.1.2.3)	IMP dehydrogenase	IS66 C-terminal element	IS66 Orf2 like protein	Ig family protein	Ig-like domain (group 3)	Ig-like domain (group 4)	Ig-like domain-containing protein	Imidazolonepropionase	Immunity protein 42	Immunity protein 45	Immunity protein 61	Immunity protein 8	Indolepyruvate ferredoxin oxidoreductase, alpha  and beta subunits	Inhibitor of vertebrate lysozyme (Ivy)	Initiator Replication protein	Inner membrane CreD family protein	Inner spore coat protein D.	Inorganic diphosphatase	Inorganic triphosphatase YgiF, contains CYTH and  CHAD domains	Inosine-uridine nucleoside N-ribohydrolase	Insertion element 4 transposase N-terminal	Integral membrane protein CcmA involved in cell  shape determination	Integral membrane protein TerC	Integrase	Integrase catalytic region	Integrase core domain-containing protein	Invasion protein IalB, involved in pathogenesis	Ion channel	Ion transport 2 domain protein	Iron uptake system EfeUOB, component EfeO/EfeM	Iron-binding apoprotein IscA	Iron-binding zinc finger CDGSH type	Iron-containing redox enzyme	Iron-regulated ABC transporter ATPase subunit  SufC	Iron-regulated ABC transporter membrane  component SufB	Iron-regulated ABC transporter permease protein  SufD	Iron-sulfur cluster assembly accessory protein	Isochorismatase family protein	Isochorismate hydrolase	Isoleucyl-tRNA synthetase	Isoleucyl-tRNA synthetase (EC 6.1.1.5)	Isopenicillin N synthase	Isopentenyldiphosphate isomerase	Isoprenylcysteine carboxyl methyltransferase	IstB domain protein ATP-binding protein	JAB domain-containing protein	K potassium transporter	K(+)-stimulated pyrophosphate-energized sodium  pump	K+ transport systems, NAD-binding component	K+-transporting ATPase ATPase A chain	K+-transporting ATPase ATPase B chain	K+-transporting ATPase ATPase C chain	K+-transporting ATPase, B subunit	K+-transporting ATPase, KdpF subunit	KAP P-loop domain protein	KAP family P-loop domain-containing protein	KDO transferase-3	KDO2-lipid IV(A) lauroyltransferase	KTSC domain-containing protein	KUP system potassium uptake protein	Kazal-type serine protease inhibitor  domain-containing protein	Kef-type K+ transport system, membrane component  KefB	Kef-type potassium/proton antiporter accessory  protein, CPA2 family (TC 2.A.37.1)	Kef-type potassium/proton antiporter, CPA2  family	Kef-type potassium/proton antiporter, CPA2  family (TC 2.A.37.1)	Kelch motif-containing protein	Ketoacyl-synthetase C-terminal extension	Ketosteroid isomerase homolog	Ketosteroid isomerase-related protein	KpsF/GutQ family protein	Ku protein	Kynureninase	Kynurenine formamidase	L(+)-tartrate dehydratase alpha subunit	L(+)-tartrate dehydratase beta subunit	L,D-peptidoglycan transpeptidase YkuD,  ErfK/YbiS/YcfS/YnhG family	L,D-transpeptidase catalytic domain	L-2,4-diaminobutyrate decarboxylase	L-2-amino-thiazoline-4-carboxylic acid hydrolase	L-2-hydroxyglutarate oxidase	L-2-hydroxyglutarate oxidase LhgO	L-alanine dehydrogenase	L-alanine dehydrogenase (EC 1.4.1.1)	L-alanine-DL-glutamate epimerase	L-alanine-DL-glutamate epimerase and related  enzymes of enolase superfamily	L-amino acid N-acyltransferase YncA	L-aminopeptidase/D-esterase	L-arabinose isomerase	L-ascorbate metabolism protein UlaG,  beta-lactamase superfamily	L-asparaginase	L-asparagine permease	L-aspartate 1-decarboxylase	L-aspartate 1-decarboxylase (EC 4.1.1.11)	L-aspartate aminotransferase apoenzyme (EC  2.6.1.1)	L-aspartate oxidase	L-aspartate oxidase (EC 1.4.3.16)	L-cysteine:1D-myo-inositol  2-amino-2-deoxy-alpha-D-glucopyranoside ligase	L-cystine transport system ATP-binding protein	L-cystine transport system permease protein	L-erythro-3-methylmalyl-CoA dehydratase	L-erythro-3-methylmalyl-CoA dehydratase (EC  4.2.1.-)	L-fuconate dehydratase	L-fuconate dehydratase (EC 4.2.1.68)	L-fuconolactonase	L-fucose dehydrogenase	L-fucose isomerase	L-fucose mutarotase	L-fuculose 1-phosphate aldolase	L-fuculose 1-phosphate aldolase (EC 4.1.2.17)	L-fuculose-phosphate aldolase	L-glutamate ABC transporter ATP-binding protein 	L-glutamate ABC transporter membrane protein 	L-glutaminase	L-glutamine ABC transporter ATP-binding protein 	L-glutamine synthetase	L-glutamine synthetase (EC 6.3.1.2)	L-glutamine-binding protein /L-glutamate-binding  protein /L-aspartate-binding protein /L-asparagine-binding protein	L-glyceraldehyde 3-phosphate reductase	L-gulonate 5-dehydrogenase	L-gulonolactone oxidase	L-histidine Nalpha-methyltransferase	L-iditol 2-dehydrogenase	L-idonate 5-dehydrogenase	L-lactate dehydrogenase	L-lactate dehydrogenase (cytochrome)	L-lactate dehydrogenase complex protein LldE	L-lactate dehydrogenase complex protein LldF	L-lactate dehydrogenase complex protein LldG	L-lactate permease	L-lysine 2,3-aminomutase (EC 5.4.3.2)	L-lysine 6-transaminase	L-lysine 6-transaminase precursor (EC 2.6.1.36)	L-lysine exporter family protein LysE/ArgO	L-myo-inositol-1-phosphate synthase	L-ornithine N5-oxygenase	L-proline amide hydrolase	L-proline dehydrogenase	L-proline dehydrogenase 	L-rhamnonate dehydratase	L-rhamnose isomerase / sugar isomerase	L-rhamnose mutarotase	L-ribulokinase	L-ribulokinase (EC 2.7.1.16)	L-ribulose 5-phosphate 4-epimerase	L-ribulose 5-phosphate 4-epimerase (EC 5.1.3.4)	L-serine ammonia-lyase	L-serine ammonia-lyase (EC 4.3.1.17)	L-serine dehydratase	L-serine dehydratase 1	L-serine dehydratase, iron-sulfur-dependent,  beta subunit	L-serine/L-threonine ammonia-lyase	L-seryl-tRNA(Sec) selenium transferase	L-seryl-tRNA(Ser) seleniumtransferase	L-sorbosone dehydrogenase	L-sorbosone dehydrogenase, putative	L-threonine 3-dehydrogenase	L-threonine 3-dehydrogenase (EC 1.1.1.103)	L-threonine O-3-phosphate decarboxylase	L-threonine O-3-phosphate decarboxylase (EC  4.1.1.81)	L-threonine aldolase	L-threonine ammonia-lyase	L-threonine ammonia-lyase (EC 4.3.1.19)	L-threonine synthase	L-threonylcarbamoyladenylate synthase	L-xylulokinase	LAGLIDADG DNA endonuclease family protein	LAO/AO transport system kinase	LGFP repeat-containing protein	LPPG:FO 2-phospho-L-lactate transferase	LPS export ABC transporter permease LptF	LPS export ABC transporter protein LptC	LPS sulfotransferase NodH	LPS-assembly lipoprotein	LPS-assembly protein	LPXTG-motif cell wall anchor domain-containing  protein	LPXTG-motif cell wall anchor domain-containing  protein/conserved repeat domain-containing protein	LPXTG-motif cell wall anchor domain-containing  protein/fimbrial isopeptide formation D2 domain-containing protein	LPXTG-site transpeptidase (sortase) family  protein	LRV protein FeS4 cluster	LSU ribosomal protein L10P	LSU ribosomal protein L11P	LSU ribosomal protein L12P	LSU ribosomal protein L13P	LSU ribosomal protein L14P	LSU ribosomal protein L15P	LSU ribosomal protein L16P	LSU ribosomal protein L17P	LSU ribosomal protein L18P	LSU ribosomal protein L19P	LSU ribosomal protein L1P	LSU ribosomal protein L20P	LSU ribosomal protein L21P	LSU ribosomal protein L22P	LSU ribosomal protein L23P	LSU ribosomal protein L24P	LSU ribosomal protein L25P	LSU ribosomal protein L27P	LSU ribosomal protein L28P	LSU ribosomal protein L29P	LSU ribosomal protein L2P	LSU ribosomal protein L30P	LSU ribosomal protein L31P	LSU ribosomal protein L32P	LSU ribosomal protein L33P	LSU ribosomal protein L34P	LSU ribosomal protein L35P	LSU ribosomal protein L36P	LSU ribosomal protein L3P	LSU ribosomal protein L4P	LSU ribosomal protein L5P	LSU ribosomal protein L6P	LSU ribosomal protein L9P	LTXXQ motif family protein	LacI family transcriptional regulator	Lactate dehydrogenase	Lactonase, 7-bladed beta-propeller	Lamin Tail Domain	Lanthionine synthetase C-like protein	Lantibiotic dehydratase, C terminus	Large terminase phage packaging protein	Late embryogenesis abundant protein	Lecithin:cholesterol acyltransferase	Legume lectin domain-containing protein	LemA family protein	LemA protein	Leucine rich repeat variant	Leucine rich repeat-containing protein	Leucyl aminopeptidase	Leucyl aminopeptidase (aminopeptidase T)	LexA DNA binding domain-containing protein	LexA repressor	LexA-binding, inner membrane-associated putative  hydrolase	Ligand-binding SRPBCC domain-containing protein	Lipase maturation factor	Lipid A 3-O-deacylase (PagL)	Lipid A Biosynthesis N-terminal  domain-containing protein	Lipid A core - O-antigen ligase and related  enzymes	Lipid II:glycine glycyltransferase  (Peptidoglycan interpeptide bridge formation enzyme)	Lipid-binding SYLF domain-containing protein	Lipoate-protein ligase A	Lipocalin family protein	Lipocalin-like domain-containing protein	Lipopolysaccharide biosynthesis protein	Lipopolysaccharide biosynthesis protein,  LPS:glycosyltransferase	Lipopolysaccharide biosynthesis proteins,  LPS:glycosyltransferases	Lipopolysaccharide biosynthesis regulator YciM,  contains six TPR domains and a predicted metal-binding C-terminal domain	Lipopolysaccharide kinase (Kdo/WaaP) family	Lipopolysaccharide kinase (Kdo/WaaP) family  protein	Lipopolysaccharide kinase (Kdo/WaaP) family.	Lipoprotein-anchoring transpeptidase ErfK/SrfK	Long-chain acyl-CoA synthetase (AMP-forming)	Long-chain acyl-CoA synthetases (AMP-forming)	Long-chain fatty acid transport protein	Low affinity Fe/Cu permease	Low temperature requirement protein LtrA	Low-affinity cAMP phosphodiesterase	LppP/LprE lipoprotein	LrgA family protein	LrgB family protein	Lrp/AsnC family transcriptional regulator	Lrp/AsnC family transcriptional regulator,  leucine-responsive regulatory protein	Lrp/AsnC family transcriptional regulator,  regulator for asnA, asnC and gidA	Lsr2 protein	LssY C-terminus	Luciferase-like monooxygenase	LuxR family transcriptional regulator	LuxR family transcriptional regulator,  quorum-sensing transcription factor LasR	LuxR family transcriptional regulator, maltose  regulon positive regulatory protein	LuxR family transcriptional regulator, quorum  sensing-dependent transcriptional regulator	LydA holin phage, holin superfamily III	LysM domain-containing protein	LysM repeat-containing protein	LysR family transcriptional regulator,  chromosome initiation inhibitor	LysR family transcriptional regulator,  regulatory protein for tcuABC	LysR family transcriptional regulator,  transcription activator of glutamate synthase operon	LysR family transcriptional regulator,  transcriptional activator of nhaA	LysR family transcriptional regulator, cys  regulon transcriptional activator	LysR family transcriptional regulator, glycine  cleavage system transcriptional activator	LysR family transcriptional regulator, hydrogen  peroxide-inducible genes activator	LysR family transcriptional regulator, nitrogen  assimilation regulatory protein	LysR family transcriptional regulator, pca  operon transcriptional activator	LysR family transcriptional regulator, regulator  for bpeEF and oprC	LysR family transcriptional regulator, regulator  for metE and metH	LysR family transcriptional regulator, regulator  of abg operon	LysR family transcriptional regulator, repressor  for citA	LysR substrate binding domain-containing protein	Lysine decarboxylase	Lysine exporter protein (LYSE/YGGA)	Lysophospholipase	Lysophospholipase L1	Lysophospholipase, alpha-beta hydrolase  superfamily	Lysozyme	Lysozyme family protein	Lysylphosphatidylglycerol synthetase, C-terminal  domain, DUF2156 family	LytR cell envelope-related transcriptional  attenuator	Lytic transglycosylase catalytic	Lyzozyme M1 (1,4-beta-N-acetylmuramidase), GH25  family	MASE1 protein	MCP methyltransferase, CheR-type	MCP methyltransferase/methylesterase, CheR/CheB  with PAS/PAC sensor	MEKHLA domain protein	MEKHLA domain-containing protein	MFS transporter, AAHS family,  3-hydroxyphenylpropionic acid transporter	MFS transporter, AAHS family, 4-hydroxybenzoate  transporter	MFS transporter, AAHS family, benzoate transport  protein	MFS transporter, ACS family, D-galactonate  transporter	MFS transporter, ACS family, glucarate  transporter	MFS transporter, ACS family, tartrate  transporter	MFS transporter, BCD family, chlorophyll  transporter	MFS transporter, CP family, cyanate transporter	MFS transporter, DHA1 family,  bicyclomycin/chloramphenicol resistance protein	MFS transporter, DHA1 family,  florfenicol/chloramphenicol resistance protein	MFS transporter, DHA1 family, arabinose polymer  transporter	MFS transporter, DHA1 family, chloramphenicol  resistance protein	MFS transporter, DHA1 family, multidrug  resistance protein	MFS transporter, DHA1 family, purine  ribonucleoside efflux pump	MFS transporter, DHA1 family, putative efflux  transporter	MFS transporter, DHA1 family, tetracycline  resistance protein	MFS transporter, DHA2 family, lincomycin  resistance protein	MFS transporter, DHA2 family, methylenomycin A  resistance protein	MFS transporter, DHA2 family, multidrug  resistance protein	MFS transporter, DHA3 family, macrolide efflux  protein	MFS transporter, ENTS family, enterobactin  (siderophore) exporter	MFS transporter, FHS family, L-fucose permease	MFS transporter, FSR family, fosmidomycin  resistance protein	MFS transporter, MHS family,  citrate/tricarballylate:H+ symporter	MFS transporter, MHS family, alpha-ketoglutarate  permease	MFS transporter, MHS family, metabolite:H+  symporter	MFS transporter, MHS family, proline/betaine  transporter	MFS transporter, MHS family, shikimate and  dehydroshikimate transport protein	MFS transporter, NNP family, nitrate/nitrite  transporter	MFS transporter, OFA family, oxalate/formate  antiporter	MFS transporter, OPA family,  glycerol-3-phosphate transporter	MFS transporter, PAT family, beta-lactamase  induction signal transducer AmpG	MFS transporter, PPP family, 3-phenylpropionic  acid transporter	MFS transporter, SET family, sugar efflux  transporter	MFS transporter, SP family, galactose:H+  symporter	MFS transporter, SP family, inositol transporter	MFS transporter, SP family, major inositol  transporter	MFS transporter, SP family, sugar:H+ symporter	MFS transporter, UMF1 family	MFS transporter, YNFM family, putative membrane  transport protein	MFS transporter, putative metabolite transport  protein	MFS transporter, putative metabolite:H+  symporter	MFS transporter, putative signal transducer	MFS transporter, sugar porter (SP) family	MFS-type transporter involved in bile tolerance,  Atg22 family	MFS/sugar transport protein	MIP family channel protein	MJ0042 family finger-like domain-containing  protein	MJ0042 family finger-like protein	MJ0570-related uncharacterized domain-containing  protein	MOSC domain	MOSC domain containing protein	MOSC domain-containing protein	MOSC domain-containing protein YiiM	MOSC domain.	MSHA biogenesis protein MshE	MSHA biogenesis protein MshG	MSHA biogenesis protein MshI	MSHA biogenesis protein MshJ	MSHA biogenesis protein MshK	MSHA biogenesis protein MshL	MSHA biogenesis protein MshM	MSHA biogenesis protein MshN	MSHA biogenesis protein MshO	MSHA biogenesis protein MshP	MSHA biogenesis protein MshQ	MSHA pilin protein MshA	MSHA pilin protein MshC	MSHA pilin protein MshD	MSMEG_0570 family protein	MSMEG_0572 family protein	MT-A70 family protein	MT0933-like antitoxin protein	MTH538 TIR-like domain (DUF1863)	MULE transposase domain-containing protein	Macrocin-O-methyltransferase (TylF)	Magnesium transporter NIPA	Major Facilitator Superfamily protein	Major Facilitator Superfamily.	Malate dehydrogenase  (oxaloacetate-decarboxylating)	Malate dehydrogenase  (oxaloacetate-decarboxylating) (NADP(+))	Malate/lactate/ureidoglycolate dehydrogenase,  LDH2 family	Male sterility protein	Malonyl CoA-acyl carrier protein transacylase	Maltogenic Amylase, C-terminal domain	Maltose acetyltransferase	Mammalian cell entry related domain protein	Mannitol-1-phosphate/altronate dehydrogenases	Mannose or cellobiose epimerase,  N-acyl-D-glucosamine 2-epimerase family	Mannose-6-phosphate isomerase, cupin superfamily	Mannosyl-glycoprotein  endo-beta-N-acetylglucosaminidase	Mannosyltransferase OCH1 and related enzymes	MarR family protein	MarR family transcriptional regulator,  transcriptional regulator for hemolysin	MarR family transcriptional regulator, 2-MHQ and  catechol-resistance regulon repressor	Matrixin	MauM/NapG family ferredoxin-type protein	MazG nucleotide pyrophosphohydrolase  domain-containing protein	MbtH protein	Mce-associated membrane protein	Mechanosensitive ion channel	Membrane alanyl aminopeptidase (EC 3.4.11.2).  Metallo peptidase. MEROPS family M01	Membrane alanyl aminopeptidase Metallo  peptidase. MEROPS family M01	Membrane associated serine protease, rhomboid  family	Membrane bound L-sorbosone dehydrogenase.	Membrane carboxypeptidase (penicillin-binding  protein)	Membrane carboxypeptidase/penicillin-binding  protein	Membrane glycosyltransferase	Membrane protease YdiL, CAAX protease family	Membrane protease subunit, stomatin/prohibitin  family, contains C-terminal Zn-ribbon domain	Membrane protease subunits, stomatin/prohibitin  homologs	Membrane protein TerC, possibly involved in  tellurium resistance	Membrane protein implicated in regulation of  membrane protease activity	Membrane protein involved in colicin uptake	Membrane protein involved in the export of  O-antigen and teichoic acid	Membrane proteinase PrsW, cleaves anti-sigma  factor RsiW, M82 family	Membrane proteins related to  metalloendopeptidases	Membrane transporters of cations and cationic  drugs	Membrane-anchored ribosome-binding protein,  inhibits growth in stationary phase, ElaB/YqjD/DUF883 family	Membrane-associated enzyme, PAP2 (acid  phosphatase) superfamily	Membrane-associated phospholipid phosphatase	Membrane-associated protease RseP, regulator of  RpoE activity	Membrane-bound inhibitor of C-type lysozyme	Membrane-bound lysozyme-inhibitor of c-type  lysozyme	Membrane-bound lytic murein transglycosylase B	Membrane-bound metallopeptidase	Membrane-bound serine protease (ClpP class)	MerC mercury resistance protein	MerR HTH family regulatory protein	MerR family transcriptional regulator,  redox-sensitive transcriptional activator SoxR	MerR family transcriptional regulator, glutamine  synthetase repressor	MerR family transcriptional regulator, heat  shock protein HspR	MerR family transcriptional regulator, mercuric  resistance operon regulatory protein	Metal binding domain of Ada	Metal-dependent hydrolase HDOD	Metal-dependent hydrolase,  endonuclease/exonuclease/phosphatase family	Metal-dependent hydrolase, beta-lactamase  superfamily II	Metal-sulfur cluster biosynthetic enzyme	Metallo-beta-lactamase superfamily protein	Metallo-peptidase family M12B Reprolysin-like	Methanogenic corrinoid protein MtbC1	Methionine synthase II (cobalamin-independent)	Methionyl-tRNA formyltransferase	Methyl-accepting chemotaxis protein	Methyl-accepting chemotaxis protein (MCP)  signalling domain-containing protein	Methylamine utilisation protein MauE	Methylase involved in ubiquinone/menaquinone  biosynthesis	Methylase of polypeptide chain release factors	Methylene-tetrahydrofolate reductase C terminal	Methylene-tetrahydromethanopterin dehydrogenase	Methylenetetrahydrofolate dehydrogenase  (NADP(+))	Methylmalonyl-CoA mutase, C-terminal  domain/subunit (cobalamin-binding)	Methyltransferase domain-containing protein	Methyltransferase small domain-containing  protein	Methyltransferase type 11	Methyltransferase type 12	Mg chelatase, subunit ChlI	Mg chelatase-related protein	Mg-chelatase subunit ChlD	Mg-protoporphyrin IX methyltransferase	Mg-protoporphyrin IX monomethyl ester  (oxidative) cyclase	Mg/Co/Ni transporter MgtE (contains CBS domain)	Mg2 transporter protein CorA family protein	Mg2+ and Co2+ transporter CorA	Mg2+ and Co2+ transporter CorB, contains DUF21,  CBS pair, and CorC-HlyC domains	Mg2+ and Co2+ transporters	Mg2+-importing ATPase	MgtC/SapB transporter	Micrococcal nuclease (thermonuclease) homologs	Microcystin degradation protein MlrC, contains  DUF1485 domain	Microcystin-dependent protein	MinD-like ATPase involved in chromosome  partitioning or flagellar assembly	Mismatch repair ATPase (MutS family)	MltA domain protein	Mn-containing catalase	Mn-containing catalase (includes spore coat  protein CotJC)	Mn2+ and Fe2+ transporters of the NRAMP family	Mn2+-dependent serine/threonine protein kinase	Mn2+/Fe2+ transporter, NRAMP family	Mn2+dependent serine/threonine protein kinase	Mo-nitrogenase MoFe protein subunit NifD  precursor	Mo-nitrogenase MoFe protein subunit NifK	Mo-nitrogenase iron protein subunit NifH	MobA-like NTP transferase domain-containing  protein	MobA/MobL family protein	ModE molybdate transport repressor  domain-containing protein	Modular FeS cluster scaffolding protein NifU	Molecular chaperone	Molecular chaperone (small heat shock protein)	Molecular chaperone IbpA, HSP20 family	Molybdenum cofactor biosynthesis enzyme	Molybdenum cofactor biosynthesis protein F	Molybdenum cofactor biosynthesis protein F.	Molybdopterin biosynthesis enzyme	Molybdopterin converting factor, small subunit	Molybdopterin or thiamine biosynthesis  adenylyltransferase	Molybdopterin-guanine dinucleotide biosynthesis  protein A	Monoamine oxidase	Monogalactosyldiacylglycerol synthase (EC  2.4.1.46)	Mor transcription activator family protein	MotA/TolQ/ExbB proton channel	MotA/TolQ/ExbB proton channel family protein	MotR	MoxR-like ATPase	MraZ protein	MscS Mechanosensitive ion channel	MspA protein	MtN3 and saliva related transmembrane protein	Mu DNA binding, I gamma subdomain	Mu DNA-binding domain-containing protein	Mu transposase, C-terminal	Mu-like prophage DNA circulation protein	Mu-like prophage FluMu protein gp28	Mu-like prophage FluMu protein gp41	Mu-like prophage I protein	Mu-like prophage major head subunit gpT	Mu-like prophage protein gp16	Mu-like prophage protein gp29	Mu-like prophage protein gp36	Mu-like prophage protein gp46	Mu-like prophage protein gpG	Mu-like prophage tail protein gpP	Mu-like prophage tail sheath protein gpL	Multicopper oxidase with three cupredoxin  domains (includes cell division protein FtsP and spore coat protein CotA)	Multidrug efflux pump subunit AcrA  (membrane-fusion protein)	Multidrug efflux pump subunit AcrB	Multidrug resistance efflux pump	Multidrug resistance efflux transporter	Multidrug resistance protein	Multidrug transporter EmrE	Multimeric flavodoxin WrbA	Multiple resistance and pH regulation protein F  (MrpF / PhaF)	Multisubunit Na+/H+ antiporter, MnhB subunit	Multiubiquitin	Muramidase (phage lambda lysozyme)	Murein DD-endopeptidase MepM and murein  hydrolase activator NlpD, contain LysM domain	Murein L,D-transpeptidase YafK	Murein L,D-transpeptidase YcbB/YkuD	Murein tripeptide amidase MpaA	MvaI/BcnI restriction endonuclease family  protein	MxaA protein, putative	MxaD	MxaD protein, putative	MxaK protein, putative	MxaL protein, putative	Mycothiol maleylpyruvate isomerase N-terminal  domain-containing protein	N,N-dimethylformamidase	N-6 DNA Methylase	N-6 DNA methylase	N-ATPase, AtpR subunit	N-Dimethylarginine dimethylaminohydrolase	N-acetyl sugar amidotransferase	N-acetyl-alpha-D-glucosaminyl L-malate synthase  BshA	N-acetyl-anhydromuramyl-L-alanine amidase AmpD	N-acetyl-beta-hexosaminidase	N-acetyl-gamma-glutamyl-phosphate reductase	N-acetyl-gamma-glutamyl-phosphate reductase (EC  1.2.1.38)	N-acetylglucosamine 6-phosphate deacetylase	N-acetylglucosamine 6-phosphate deacetylase (EC  3.5.1.25)	N-acetylglucosamine kinase	N-acetylglucosamine kinase (EC 2.7.1.59)	N-acetylglucosamine transport system permease  protein	N-acetylglucosamine-1-phosphate  uridyltransferase (contains nucleotidyltransferase and I-patch acetyltransferase domains)	N-acetylglucosamine-6-phosphate deacetylase	N-acetylglucosaminyl deacetylase, LmbE family	N-acetylglucosaminyl-diphospho-decaprenol  L-rhamnosyltransferase	N-acetylglucosaminyldiphosphoundecaprenol  N-acetyl-beta-D-mannosaminyltransferase	N-acetylglutamate kinase	N-acetylglutamate kinase (EC 2.7.2.8)	N-acetylglutamate synthase	N-acetylglutamate synthase (EC 2.3.1.1)	N-acetylglutamate synthase and related  acetyltransferases	N-acetylglutamate synthase, GNAT family	N-acetylmannosamine-6-phosphate 2-epimerase /  N-acetylmannosamine kinase	N-acetylmuramic acid 6-phosphate etherase	N-acetylmuramoyl-L-alanine amidase	N-acetylmuramyl-L-alanine amidase, negative  regulator of AmpC, AmpD	N-acetylneuraminate epimerase	N-acetylneuraminate synthase	N-acetylneuraminate synthase (EC 2.5.1.56)	N-acyl amino acid synthase, PEP-CTERM/exosortase  system-associated	N-acyl homoserine lactone hydrolase	N-acyl-D-amino-acid deacylase	N-acyl-D-aspartate/D-glutamate deacylase	N-acyl-D-glutamate deacylase	N-acyl-L-homoserine lactone synthetase	N-acylglucosamine-6-phosphate 2-epimerase	N-acylneuraminate cytidylyltransferase	N-carbamoyl-L-amino-acid hydrolase	N-carbamoylputrescine amidase	N-carbamoylsarcosine amidase	N-ethylmaleimide reductase	N-formylglutamate amidohydrolase	N-formylglutamate deformylase	N-formylmaleamate deformylase	N-hydroxyarylamine O-acetyltransferase	N-methyl-L-tryptophan oxidase	N-methylglutamate dehydrogenase subunit A  precursor	N-methylglutamate dehydrogenase subunit A  precursor (EC 1.5.99.5)	N-methylglutamate dehydrogenase subunit B	N-methylglutamate dehydrogenase subunit B (EC  1.5.99.5)	N-methylglutamate dehydrogenase subunit C	N-methylglutamate dehydrogenase subunit C (EC  1.5.99.5)	N-methylglutamate dehydrogenase subunit D	N-methylglutamate dehydrogenase subunit D (EC  1.5.99.5)	N-methylglutamate synthase subunit A	N-methylglutamate synthase subunit A (EC  2.1.1.21)	N-methylglutamate synthase subunit B	N-methylglutamate synthase subunit B (EC  2.1.1.21)	N-methylglutamate synthase subunit C precursor	N-methylglutamate synthase subunit C precursor  (EC 2.1.1.21)	N-methylhydantoinase A	N-methylhydantoinase A/acetone carboxylase, beta  subunit	N-methylhydantoinase A/oxoprolinase/acetone  carboxylase, beta subunit	N-methylhydantoinase B	N-terminal domain of peptidoglycan hydrolase  CwlO-containing protein	N-terminal domain of uncharacterized protein  YciW-containing protein	N-terminal double-transmembrane  domain-containing protein	N-terminal half of MaoC dehydratase	N-terminal methylation site	N6-L-threonylcarbamoyladenine synthase	N6-adenosine-specific RNA methylase IME4	NACHT domain-containing protein	NAD binding domain of 6-phosphogluconate  dehydrogenase	NAD dependent epimerase/dehydratase family  protein	NAD kinase	NAD(+) kinase	NAD(P) transhydrogenase	NAD(P) transhydrogenase subunit alpha	NAD(P) transhydrogenase subunit beta	NAD(P)-binding Rossmann-like domain-containing  protein	NAD(P)-dependent dehydrogenase, short-chain  alcohol dehydrogenase family	NAD(P)-dependent nickel-iron dehydrogenase  catalytic subunit	NAD(P)-dependent nickel-iron dehydrogenase  flavin-containing subunit	NAD(P)H dehydrogenase (quinone)	NAD(P)H-binding	NAD(P)H-dependent FMN reductase	NAD(P)H-dependent nitrite reductase catalytic  subunit	NAD(P)H-dependent nitrite reductase flavoprotein  subunit	NAD(P)H-flavin reductase	NAD(P)H-hydrate epimerase	NAD(P)H-nitrite reductase	NAD(P)H-quinone oxidoreductase subunit 5	NAD+ diphosphatase	NAD+ kinase	NAD+ synthase	NAD+ synthase (glutamine-hydrolysing)	NAD+ synthetase	NAD+---dinitrogen-reductase  ADP-D-ribosyltransferase	NAD+-dependent secondary alcohol dehydrogenase  Adh1	NAD-binding domain and a Fe-S cluster-containing  protein	NAD-dependent DNA ligase (contains BRCT domain  type II)	NAD-dependent aldehyde dehydrogenase	NAD-dependent aldehyde dehydrogenases	NAD-dependent deacetylase	NAD-dependent dihydropyrimidine dehydrogenase,  PreA subunit	NAD-dependent epimerase/dehydratase	NAD-dependent formate dehydrogenase catalytic  subunit /NAD-dependent formate dehydrogenase iron-sulfur protein	NAD-dependent formate dehydrogenase flavoprotein  subunit	NAD-dependent protein deacetylase, SIR2 family	NAD-reducing hydrogenase small subunit	NAD/FAD-utilizing enzyme apparently involved in  cell division	NAD/NADP transhydrogenase alpha subunit	NADH dehydrogenase	NADH dehydrogenase [ubiquinone] 1 alpha  subcomplex assembly factor 7	NADH dehydrogenase subunit A	NADH dehydrogenase subunit A (EC 1.6.5.3)	NADH dehydrogenase subunit B	NADH dehydrogenase subunit B (EC 1.6.5.3)	NADH dehydrogenase subunit C	NADH dehydrogenase subunit C (EC 1.6.5.3)	NADH dehydrogenase subunit D	NADH dehydrogenase subunit D (EC 1.6.5.3)	NADH dehydrogenase subunit E	NADH dehydrogenase subunit E (EC 1.6.5.3)	NADH dehydrogenase subunit F	NADH dehydrogenase subunit F (EC 1.6.5.3)	NADH dehydrogenase subunit G	NADH dehydrogenase subunit G (EC 1.6.5.3)	NADH dehydrogenase subunit H	NADH dehydrogenase subunit H (EC 1.6.5.3)	NADH dehydrogenase subunit I	NADH dehydrogenase subunit I (EC 1.6.5.3)	NADH dehydrogenase subunit J	NADH dehydrogenase subunit J (EC 1.6.5.3)	NADH dehydrogenase subunit K	NADH dehydrogenase subunit K (EC 1.6.5.3)	NADH dehydrogenase subunit L	NADH dehydrogenase subunit L (EC 1.6.5.3)	NADH dehydrogenase subunit M	NADH dehydrogenase subunit M (EC 1.6.5.3)	NADH dehydrogenase subunit N	NADH dehydrogenase subunit N (EC 1.6.5.3)	NADH dehydrogenase, FAD-containing subunit	NADH dehydrogenase/NADH:ubiquinone  oxidoreductase 75 kD subunit (chain G)	NADH(P)-binding	NADH-FMN oxidoreductase RutF, flavin reductase  (DIM6/NTAB) family	NADH-dependant formate dehydrogenase delta  subunit FdsD	NADH-quinone oxidoreductase subunit A	NADH-quinone oxidoreductase subunit B	NADH-quinone oxidoreductase subunit C	NADH-quinone oxidoreductase subunit D	NADH-quinone oxidoreductase subunit E	NADH-quinone oxidoreductase subunit F	NADH-quinone oxidoreductase subunit G	NADH-quinone oxidoreductase subunit H	NADH-quinone oxidoreductase subunit I	NADH-quinone oxidoreductase subunit J	NADH-quinone oxidoreductase subunit K	NADH-quinone oxidoreductase subunit L	NADH-quinone oxidoreductase subunit M	NADH-quinone oxidoreductase subunit N	NADH/Ubiquinone/plastoquinone (complex I)	NADH:flavin oxidoreductase/NADH oxidase	NADH:ubiquinone oxidoreductase subunit	NADH:ubiquinone oxidoreductase, NADH-binding  subunit (chain F)	NADP oxidoreductase coenzyme F420-dependent	NADP-dependent 3-hydroxy acid dehydrogenase YdfG	NADP-dependent alcohol dehydrogenase	NADP-dependent aldehyde dehydrogenase	NADPH-dependent 2,4-dienoyl-CoA reductase,  sulfur reductase	NADPH-dependent FMN reductase	NADPH-dependent ferric siderophore reductase,  contains FAD-binding and SIP domains	NADPH-glutathione reductase	NADPH2:quinone reductase	NADPH:quinone reductase	NDP-sugar epimerase, includes  UDP-GlcNAc-inverting 4,6-dehydratase FlaA1 and capsular polysaccharide biosynthesis protein EpsC	NH(3)-dependent NAD(+) synthetase	NH(3)-dependent NAD(+) synthetase (EC 6.3.1.5)	NHL repeat	NHL repeat containing protein	NHL repeat.	NIPSNAP protein	NLP/P60 protein	NMT1/THI5 like domain protein	NNMT/PNMT/TEMT family protein	NPCBM/NEW2 domain-containing protein	NRAMP (natural resistance-associated macrophage  protein) metal ion transporters	NTE family protein	NTP pyrophosphatase, house-cleaning of  non-canonical NTPs	NTP pyrophosphohydrolases containing a  Zn-finger, probably nucleic-acid-binding	NTP pyrophosphohydrolases including oxidative  damage repair enzymes	NUDIX domain	NUDIX domain-containing protein	NUDIX hydrolase	NUMOD3 motif-containing protein	NYN domain-containing protein	Na+(or H+)/acetate symporter ActP	Na+-driven multidrug efflux pump	Na+-transporting NADH:ubiquinone oxidoreductase,  subunit NqrC	Na+-transporting NADH:ubiquinone oxidoreductase,  subunit NqrF	Na+/H+ antiporter NhaA	Na+/H+ antiporter NhaC	Na+/H+ antiporter NhaD	Na+/H+ antiporter NhaD and related arsenite  permeases	Na+/H+ antiporter subunit	Na+/H+-dicarboxylate symporter	Na+/Pi-cotransporter	Na+/melibiose symporter	Na+/proline symporter	Na+/solute symporter	Na+:H+ antiporter, NhaA family	Na+:H+ antiporter, NhaC family	NagD protein	Negative regulator of beta-lactamase expression	Neisseria PilC domain protein	NfeD-like C-terminal, partner-binding	Ni,Fe-hydrogenase I large subunit	Ni,Fe-hydrogenase III large subunit	Ni,Fe-hydrogenase III small subunit	Ni/Fe-hydrogenase 1 B-type cytochrome subunit	Nickel-dependent lactate racemase	Nicotinamidase-related amidase	Nif-specific regulatory protein	NifU homolog involved in Fe-S cluster formation	NitT/TauT family transport system  substrate-binding protein	NitT/TauT family transport system ATP-binding  protein	NitT/TauT family transport system permease  protein	Nitrate and nitrite sensing	Nitrate/nitrite transporter NarK	Nitric oxide reductase activation protein	Nitrilase/cyanide hydratase and apolipoprotein  N-acyltransferase	Nitrite and sulphite reductase 4Fe-4S  domain-containing protein	Nitrogen fixation protein FixH	Nitroimidazol reductase NimA, pyridoxamine  5'-phosphate oxidase superfamily	Nitroreductase	Nitroreductase family protein	Nitroreductase family.	Nitrous oxidase accessory protein	Nitrous oxide reductase	NlpC/P60 family protein	NmrA family protein	NmrA-like family protein	NnrS family protein	NnrU protein	Nodulation protein S (NodS)	NolW domain protein	Non-ribosomal peptide synthetase component F	Non-ribosomal peptide synthetase modules and  related proteins	NosR/NirI family transcriptional regulator,  nitrous oxide reductase regulator	Novel toxin 15	Nuclease-related domain-containing protein	Nucleoid-associated protein YgaU, contains BON  and LysM domains	Nucleoside 2-deoxyribosyltransferase	Nucleoside recognition	Nucleoside-diphosphate-sugar epimerase	Nucleoside-diphosphate-sugar pyrophosphorylase  involved in lipopolysaccharide biosynthesis/translation initiation factor 2B, ga	Nucleoside-specific outer membrane channel  protein Tsx	Nucleotide-binding universal stress protein,  UspA family	Nucleotide-diphospho-sugar transferase	Nucleotidyl transferase	Nucleotidyl transferase AbiEii toxin, Type IV TA  system	Nucleotidyltransferase domain-containing protein	Nucleotidyltransferase-like	NusA antitermination factor	NusB antitermination factor	O(6)-alkylguanine repair protein YbaZ	O-Antigen ligase	O-Methyltransferase involved in polyketide  biosynthesis	O-acetyl-ADP-ribose deacetylase (regulator of  RNase III), contains Macro domain	O-acetylhomoserine (thiol)-lyase	O-acetylhomoserine sulfhydrylase	O-acetylhomoserine sulfhydrylase (EC 2.5.1.49)	O-acetylhomoserine/O-acetylserine sulfhydrylase	O-acetylserine/cysteine efflux transporter	O-antigen biosynthesis protein WbqP	O-antigen biosynthesis protein WbqV	O-antigen ligase	O-antigen ligase like membrane protein	O-antigen polymerase	O-sialoglycoprotein endopeptidase	O-sialoglycoprotein endopeptidase (EC 3.4.24.57)	O-succinylbenzoate synthase	O-succinylbenzoate synthase (EC 4.2.1.113)	O-succinylbenzoic acid--CoA ligase	O-succinylhomoserine sulfhydrylase	O-succinylhomoserine sulfhydrylase (EC 2.5.1.-)	OHCU decarboxylase	OST-HTH/LOTUS domain	OST-HTH/LOTUS domain-containing protein	Oligoribonuclease NrnB or cAMP/cGMP  phosphodiesterase, DHH superfamily	OmpA domain protein transmembrane  region-containing protein	OmpA family protein	OmpA-OmpF porin, OOP family	OmpA/MotB domain protein	OmpW family protein	Opacity protein	Opacity protein and related surface antigens	Opioid growth factor receptor (OGFr) conserved  region	Organic hydroperoxide reductase OsmC/OhrA	Organic solvent tolerance protein	Orthopoxvirus protein of unknown function  (DUF830).	OsmC family protein	Osmosensitive K channel His kinase sensor	Osmotically-inducible protein OsmY, contains BON  domain	Outer membrane cobalamin receptor protein	Outer membrane lipoprotein	Outer membrane lipoprotein carrier protein LolA	Outer membrane lipoprotein-sorting protein	Outer membrane phospholipase A	Outer membrane protein	Outer membrane protein (porin)	Outer membrane protein OmpA	Outer membrane protein TolC	Outer membrane protein and related  peptidoglycan-associated (lipo)proteins	Outer membrane protein assembly factor BamB,  contains PQQ-like beta-propeller repeat	Outer membrane protein assembly factor BamD,  BamD/ComL family	Outer membrane protein assembly factor BamE,  lipoprotein component of the BamABCDE complex	Outer membrane protein beta-barrel  domain-containing protein	Outer membrane receptor for ferrienterochelin  and colicins	Outer membrane receptor for monomeric catechols	Outer membrane receptor proteins, mostly Fe  transport	Outer membrane scaffolding protein for murein  synthesis, MipA/OmpV family	Oxidoreductase FAD-binding domain protein	Oxidoreductase-like protein, N-terminal	Oxidoreductin, endoplasmic reticulum  membrane-associated protein involved in disulfide bond formation	Oxyanion-translocating ATPase	Oxygen tolerance	P pilus assembly protein, chaperone PapD	P pilus assembly/Cpx signaling pathway  periplasmic inhibitor/zinc-resistance associated protein-like protein	P(-)rp(+) fimbrial protein	P-aminobenzoate N-oxygenase AurF	P-type conjugative transfer ATPase TrbB	P-type conjugative transfer protein TrbJ	P-type conjugative transfer protein TrbL	P2-like prophage tail protein X	P63C domain-containing protein	PA domain-containing protein	PA14 domain-containing protein	PAC2 family protein	PAP2 superfamily	PAP2 superfamily protein	PAP2 superfamily.	PAS domain S-box-containing protein	PAS domain S-box-containing protein/diguanylate  cyclase (GGDEF) domain-containing protein	PAS domain S-box-containing protein/diguanylate  cyclase (GGDEF) domain-containing protein/hemerythrin-like metal-binding domain	PAS domain-containing protein	PAS fold	PAS fold-containing protein	PAS fold.	PAS/PAC sensor hybrid histidine kinase	PAS/PAC sensor hybrid histidine kinase (EC  2.7.13.3)	PAS/PAC sensor signal transduction histidine  kinase	PAS/PAC sensor signal transduction histidine  kinase (EC 2.7.13.3)	PBP superfamily domain-containing protein	PBS lyase HEAT-like repeat-containing protein	PD-(D/E)XK nuclease superfamily	PD-(D/E)XK nuclease superfamily protein	PDDEXK-like protein of unknown function  (DUF3799)	PDZ domain-containing protein	PDZ/DHR/GLGF domain protein	PE family protein	PE-PPE domain-containing protein	PEGA domain-containing protein	PELOTA RNA binding domain-containing protein	PEP-CTERM motif	PEP-CTERM motif-containing protein	PEP-CTERM motif.	PEP-CTERM protein-sorting domain-containing  protein	PEP-CTERM protein-sorting domain-containing  protein/MYXO-CTERM domain-containing protein	PEP-CTERM protein-sorting domain-containing  protein/choice-of-anchor A domain-containing protein	PEP-CTERM/exosortase A-associated  glycosyltransferase, Daro_2409 family	PGAP1-like protein	PH domain-containing protein	PHP domain protein	PHP domain-containing protein	PII-like signaling protein	PIN domain nuclease, a component of  toxin-antitoxin system (PIN domain)	PIN domain-containing protein	PKD domain	PKHD-type hydroxylase	PLD-like domain-containing protein	PP-loop domain protein	PPE family protein	PPE-repeat protein	PPIC-type PPIASE domain-containing protein	PPOX class probable F420-dependent enzyme	PPOX class probable F420-dependent enzyme,  Rv0121 family	PQQ-dependent catabolism-associated  beta-propeller protein	PQQ-dependent catabolism-associated CXXCW motif  protein	PQQ-dependent dehydrogenase, methanol/ethanol  family	PQQ-dependent enzyme-like protein	PQQ-like domain-containing protein	PRC-barrel domain-containing protein	PRC-barrel domain.	PTS IIA-like nitrogen-regulatory protein PtsN	PTS system D-fructose-specific IIA component  (F1P-forming), Frc family (TC 4.A.2.1.4)/PTS system D-fructose-specific IIB compon	PTS system D-fructose-specific IIA component  (F1P-forming), Frc family /PTS system D-fructose-specific IIB component (F1P-formi	PTS system D-fructose-specific IIB component  (F1P-forming), Frc family (TC 4.A.2.1.1)/PTS system D-fructose-specific IIC compon	PTS system D-fructose-specific IIB component  (F1P-forming), Frc family /PTS system D-fructose-specific IIC component (F1P-formi	PTS system D-mannitol-specific IIA component,  Fru family (TC 4.A.2.1.2)/PTS system D-mannitol-specific IIB component, Fru famil	PTS system D-mannitol-specific IIA component,  Fru family /PTS system D-mannitol-specific IIB component, Fru family /PTS system 	PTS system IIA component, Fru family	PTS system IIB component, L-Asc family (TC  4.A.7)	PTS system IIC component, L-Asc family (TC  4.A.7)	PTS system beta-glucoside-specific IIA  component, Glc family /PTS system beta-glucoside-specific IIB component, Glc family /PTS	PTS system fructose subfamily IIA component	PTS system trehalose-specific IIB component, Glc  family /PTS system trehalose-specific IIC component, Glc family	PTS system, ascorbate-specific IIA component	PTS system, beta-glucosides-specific IIC  component	PTS system, cellobiose-specific IIC component	PTS system, fructose-specific IIC component	PTS system, galactitol-specific IIA component	PTS system, galactitol-specific IIB component	PTS system, galactitol-specific IIC component	PTS system, glucitol/sorbitol-specific IIA  component	PTS system, glucitol/sorbitol-specific IIC  component	PTS system, glucose subfamily, IIA component	PTS system, glucose-specific IIA component	PTS system, maltose and glucose-specific IIC  component	PTS system, mannitol-specific IIC component	PTS system, mannose-specific IIA component	PTS system, nitrogen regulatory IIA component	PTSINtr with GAF domain, PtsP	PadR family transcriptional regulator,  regulatory protein PadR	Panthothenate kinase	ParB family protein	ParB-like nuclease domain	ParB-like nuclease domain-containing protein	ParB-like nuclease domain.	ParB/RepB/Spo0J family partition protein	ParD-like antitoxin of type II toxin-antitoxin  system	ParE toxin of type II toxin-antitoxin system,  parDE	Paraquat-inducible protein A	Part of AAA domain-containing protein	Parvulin-like peptidyl-prolyl isomerase	Patatin	Patatin-like phospholipase	Pathogenicity locus.	PcfJ-like protein	Pectate lyase superfamily protein	PemK-like, MazF-like toxin of type II  toxin-antitoxin system	Penicillin V acylase, Ntn superfamily	Pentapeptide repeat-containing protein	Pentose-5-phosphate-3-epimerase	PepSY-associated TM helix domain protein	PepSY-associated TM region	Peptidase C13 family protein	Peptidase E	Peptidase M10 serralysin C terminal	Peptidase M23	Peptidase M50B-like	Peptidase M60, enhancin and enhancin-like	Peptidase MA superfamily	Peptidase S24/S26A/S26B, conserved region	Peptidase family M23	Peptidase family M41	Peptidase family M48	Peptidase family M50.	Peptidase inhibitor I78 family protein	Peptidase inhibitor I78 family.	Peptidase inhibitor I9	Peptidase inhibitor family I36	Peptidase propeptide and YPEB domain	Peptidase propeptide and YPEB domain-containing  protein	Peptidase_C39 like family protein	Peptide chain release factor 1 (eRF1)	Peptidogalycan biosysnthesis/recognition	Peptidoglycan biosynthesis protein MviN/MurJ,  putative lipid II flippase	Peptidoglycan-binding (PGRP) domain of  peptidoglycan hydrolases-containing protein	Peptidoglycan-binding LysM	Peptidoglycan-binding lysin domain protein	Peptidoglycan/LPS O-acetylase OafA/YrhL,  contains acyltransferase and SGNH-hydrolase domains	Peptidoglycan/xylan/chitin deacetylase,  PgdA/CDA1 family	Peptidyl-prolyl cis-trans isomerase (rotamase) -  cyclophilin family	Peptidylprolyl isomerase	Periplasmic protein involved in polysaccharide  export	Periplasmic serine proteases (ClpP class)	Permease of the drug/metabolite transporter  (DMT) superfamily	Permuted papain-like amidase enzyme, YaeF/YiiX,  C92 family	Peroxidase	Peroxiredoxin	Peroxiredoxin family protein	Pertactin	PfkB domain protein	Phage DNA packaging protein, Nu1 subunit of  terminase	Phage Mu protein F like protein	Phage P2 baseplate assembly protein gpV	Phage Tail Collar Domain	Phage XkdN-like tail assembly chaperone protein,  TAC	Phage antirepressor protein KilAC  domain-containing protein	Phage gp6-like head-tail connector protein	Phage integrase family	Phage integrase family protein	Phage integrase family.	Phage integrase, N-terminal SAM-like domain	Phage major capsid protein E	Phage minor capsid protein 2	Phage portal protein	Phage portal protein, SPP1 Gp6-like	Phage portal protein, SPP1 Gp6-like.	Phage protein	Phage protein (N4 Gp49/phage Sf6 gene 66) family  protein	Phage protein D	Phage protein U	Phage related hypothetical protein (DUF1799)	Phage related hypothetical protein (DUF1799).	Phage repressor protein C, contains Cro/C1-type  HTH and peptisase s24 domains	Phage tail assembly chaperone protein, E, or 41  or 14	Phage tail assembly chaperone protein, TAC	Phage tail protein	Phage tail repeat like	Phage tail sheath protein	Phage tail sheath protein FI	Phage tail tube protein	Phage tail tube protein, GTA-gp10	Phage terminase small subunit	Phage terminase, large subunit GpA	Phage terminase-like protein, large subunit	Phage terminase-like protein, large subunit,  contains N-terminal HTH domain	Phage-related baseplate assembly protein	Phage-related lysozyme (muramidase), GH24 family	Phage-related minor tail protein	Phage-related protein	Phage-related protein, tail component	Phage-related replication protein YjqB,  UPF0714/DUF867 family	Phasin protein	Phasin protein.	Phenol hydroxylase P1 protein	Phenolic acid decarboxylase (PAD)	Phenylacetate-coenzyme A ligase PaaK,  adenylate-forming domain family	Phenylalanine 4-hydroxylase	Phenylpropionate dioxygenase, large terminal  subunit	Phenylpyruvate tautomerase PptA,  4-oxalocrotonate tautomerase family	PhnB protein	PhoD-like phosphatase	PhoH family protein	PhoH-like ATPase	Phosphate-selective porin	Phosphate-selective porin O and P	Phosphate-starvation-inducible E	Phosphatidate phosphatase APP1	Phosphatidylglycerol--membrane-oligosaccharide  glycerophosphotransferase	Phosphatidylglycerophosphatase A	Phosphatidylglycerophosphate synthase	Phosphatidylinositol alpha-mannosyltransferase  (EC 2.4.1.57)	Phosphocarrier protein HPr	Phosphocarrier protein HPr /dihydroxyacetone  kinase DhaM subunit	Phosphodiesterase/alkaline phosphatase D	Phosphoenolpyruvate carboxylase, type 1	Phosphoenolpyruvate carboxylase, type 1 (EC  4.1.1.31)	Phosphoenolpyruvate-protein kinase (PTS system  EI component in bacteria)	Phosphoglycerate dehydrogenase	Phosphoglycerate dehydrogenase and related  dehydrogenases	Phosphoglycerol transferase MdoB	Phosphoglycerol transferase and related  proteins, alkaline phosphatase superfamily	Phosphoglycolate phosphatase, HAD superfamily	Phosphoheptose isomerase	Phosphohistidine phosphatase SixA	Phospholipase A(2)	Phospholipase A2	Phospholipase C	Phospholipase D	Phospholipase/lecithinase/hemolysin	Phospholipase_D-nuclease N-terminal	Phospholipid N-methyltransferase	Phospholipid methyltransferase	Phosphomannomutase	Phosphomethylpyrimidine kinase	Phosphopantetheine adenylyltransferase	Phosphopantetheine adenylyltransferase (EC  2.7.7.3)	Phosphopantetheine attachment site	Phosphopantothenate-cysteine ligase (EC  6.3.2.5)/Phosphopantothenoylcysteine decarboxylase (EC 4.1.1.36)	Phosphopentomutase	Phosphoribosyl 1,2-cyclic phosphodiesterase	Phosphoribosyl-dephospho-CoA transferase  (holo-ACP synthetase)	Phosphoserine phosphatase	Phosphotransferase enzyme family protein	Phosphotransferase enzyme family.	Phosphotransferase system, phosphocarrier  protein HPr	Photosynthesis system II assembly factor YCF48	Phthiocerol/phthiodiolone dimycocerosyl  transferase C-terminus	Phytanoyl-CoA dioxygenase (PhyH)	Phytoene dehydrogenase-related protein	PilM inner membrane family protein	PilS domain protein	PilZ domain-containing protein	PilZ domain.	Pilus assembly protein PilO	Pilus assembly protein PilP	Pilus assembly protein, PilO	Pilus biogenesis protein tapA precursor,  putative	Pilus formation protein N terminal region	Pimeloyl-ACP methyl ester carboxylesterase	Pirin domain protein	Pirin-related protein	Piwi domain-containing protein	PknH-like extracellular domain-containing  protein	Plasmid recombination enzyme	Plasmid recombination enzyme.	Plasmid replication initiator protein	Plasmid stability protein	Plasmid stabilization system protein ParE	Plastocyanin	PmbA protein	Poly A polymerase head domain-containing protein	Poly(3-hydroxyalkanoate) synthetase	Poly(3-hydroxybutyrate) depolymerase	Poly(R)-hydroxyalkanoic acid synthase subunit  (PHA_synth_III_E)	Polyferredoxin	Polygalacturonase	Polyisoprenoid-binding protein YceI	Polyketide cyclase / dehydrase and lipid  transport	Polyketide cyclase / dehydrase and lipid  transport.	Polyketide cyclase/dehydrase	Polymer-forming cytoskeletal	Polypeptide-transport-associated domain protein  ShlB-type	Polyphosphate glucokinase (EC 2.7.1.63)	Polyphosphate kinase	Polyphosphate kinase 2, PPK2 family	Polyphosphate kinase N-terminal  domain-containing protein	Polyphosphate kinase middle domain-containing  protein	Polyribonucleotide nucleotidyltransferase	Polysaccharide biosynthesis protein	Polysaccharide deacetylase	Polysaccharide lyase	Polysaccharide pyruvyl transferase	Polysaccharide pyruvyl transferase family  protein WcaK	Por secretion system C-terminal sorting  domain-containing protein	Porin subfamily protein	Porphobilinogen synthase	PpiC-type peptidyl-prolyl cis-trans isomerase	Ppx/GppA phosphatase	Ppx/GppA phosphatase family protein	PqqD family protein, HPr-rel-A system	Pre-mRNA 3'-end processing (cleavage and  polyadenylation) factor	Predicted 3-hydroxylacyl-ACP dehydratase, HotDog  domain	Predicted 5' DNA nuclease, flap  endonuclease-1-like, helix-3-turn-helix (H3TH) domain	Predicted ABC-type ATPase	Predicted ABC-type transport system involved in  lysophospholipase L1 biosynthesis, permease component	Predicted ATP-binding protein involved in  virulence	Predicted ATP-dependent carboligase, ATP-grasp  superfamily	Predicted ATP-dependent endonuclease of the OLD  family, contains P-loop ATPase and TOPRIM domains	Predicted ATP-dependent protease	Predicted ATPase	Predicted ATPase (AAA+ superfamily)	Predicted ATPase, AAA+ superfamily	Predicted Co/Zn/Cd cation transporter, cation  efflux family	Predicted Co/Zn/Cd cation transporters	Predicted DNA-binding protein, MmcQ/YjbR family	Predicted DNA-binding protein, contains  Ribbon-helix-helix (RHH) domain	Predicted DNA-binding protein, contains XRE-type  HTH domain	Predicted DNA-binding transcriptional regulator  YafY, contains an HTH and WYL domains	Predicted EndoIII-related endonuclease	Predicted Fe-S protein	Predicted Fe-S protein YdhL, DUF1289 family	Predicted Fe-S-cluster oxidoreductase	Predicted Fe2+/Mn2+ transporter, VIT1/CCC1  family	Predicted GTPases	Predicted HD phosphohydrolase	Predicted HD superfamily hydrolase	Predicted N-acetyltransferase YhbS	Predicted N-acyltransferase	Predicted N-acyltransferase, GNAT family	Predicted N-formylglutamate amidohydrolase	Predicted NAD/FAD-binding protein	Predicted NADH:ubiquinone oxidoreductase,  subunit RnfB	Predicted NTP pyrophosphohydrolase, NUDIX family	Predicted O-linked N-acetylglucosamine  transferase, SPINDLY family	Predicted O-methyltransferase	Predicted O-methyltransferase YrrM	Predicted P-loop ATPase and inactivated  derivatives	Predicted P-loop ATPase, KAP-like	Predicted PurR-regulated permease PerM	Predicted RNA binding protein YcfA, dsRBD-like  fold, HicA-like mRNA interferase family	Predicted RNA methylase	Predicted RNA-binding protein involved in  translation, contains Zn-ribbon domain, DUF1610 family	Predicted RNA-binding protein, contains PUA-like  domain	Predicted Rossmann fold nucleotide-binding  protein	Predicted S-adenosylmethionine-dependent  methyltransferase	Predicted SAM-depedendent methyltransferase	Predicted SnoaL-like aldol  condensation-catalyzing enzyme	Predicted TIM-barrel enzyme	Predicted TIM-barrel enzyme, possibly a  dioxygenase	Predicted Zn peptidase	Predicted Zn-dependent peptidase	Predicted Zn-dependent peptidases,  insulinase-like	Predicted Zn-dependent protease or its  inactivated homolog	Predicted Zn-dependent protease, minimal  metalloprotease (MMP)-like domain	Predicted acetyltransferase	Predicted acetyltransferase, GNAT superfamily	Predicted acyl-CoA transferases/carnitine  dehydratase	Predicted acylesterase/phospholipase RssA,  contains patatin domain	Predicted acyltransferase	Predicted acyltransferase, LPLAT superfamily	Predicted alpha-1,6-mannanase, GH76 family	Predicted alpha/beta hydrolase	Predicted amidohydrolase	Predicted amidohydrolase YtcJ	Predicted amidophosphoribosyltransferases	Predicted amino acid racemase	Predicted aminoglycoside phosphotransferase	Predicted aminopeptidase	Predicted anti-sigma-YlaC factor YlaD, contains  Zn-finger domain	Predicted arabinose efflux permease, MFS family	Predicted branched-chain amino acid permease  (azaleucine resistance)	Predicted carboxypeptidase	Predicted chitinase	Predicted choline kinase involved in LPS  biosynthesis	Predicted choloylglycine hydrolase	Predicted component of the ribosome quality  control (RQC) complex, YloA/Tae2 family, contains fibronectin-binding (FbpA) and DU	Predicted deacylase	Predicted dehydrogenase	Predicted dehydrogenases and related proteins	Predicted dienelactone hydrolase	Predicted dinucleotide-binding enzyme	Predicted dioxygenase of extradiol dioxygenase  family	Predicted dithiol-disulfide isomerase involved  in polyketide biosynthesis	Predicted dithiol-disulfide isomerase, DsbA  family	Predicted dithiol-disulfide oxidoreductase,  DUF899 family	Predicted endonuclease distantly related to  archaeal Holliday junction resolvase and Mrr-like restriction enzymes	Predicted enzyme of the cupin superfamily	Predicted enzyme related to lactoylglutathione  lyase	Predicted ester cyclase	Predicted esterase	Predicted esterase of the alpha-beta hydrolase  superfamily	Predicted esterase of the alpha/beta hydrolase  fold	Predicted exporter	Predicted extracellular nuclease	Predicted ferric reductase	Predicted flavin-nucleotide-binding protein	Predicted flavin-nucleotide-binding protein  structurally related to pyridoxine 5'-phosphate oxidase	Predicted flavoprotein CzcO associated with the  cation diffusion facilitator CzcD	Predicted flavoprotein involved in K+ transport	Predicted glycoside hydrolase or deacetylase  ChbG, UPF0249 family	Predicted glycosyl hydrolase	Predicted glycosyl hydrolase, GH43/DUF377 family	Predicted glycosyl transferase	Predicted glycosylase	Predicted glycosyltransferases	Predicted helicase	Predicted homoserine dehydrogenase, contains  C-terminal SAF domain	Predicted house-cleaning noncanonical NTP  pyrophosphatase, all-alpha NTP-PPase (MazG) superfamily	Predicted hydrolases of the HAD superfamily	Predicted hydrolases or acyltransferases  (alpha/beta hydrolase superfamily)	Predicted integral membrane protein	Predicted integral membrane protein (DUF2269)	Predicted integral membrane protein (DUF2282).	Predicted kinase	Predicted kinase, aminoglycoside  phosphotransferase (APT) family	Predicted lipid carrier protein YhbT, contains  SCP2 domain	Predicted lipid-binding transport protein, Tim44  family	Predicted lipoprotein	Predicted lipoprotein with conserved Yx(FWY)xxD  motif	Predicted mannose-6-phosphate isomerase	Predicted membrane metal-binding protein	Predicted membrane protein	Predicted membrane protein (DUF2142)	Predicted membrane protein (DUF2157)	Predicted membrane protein (DUF2207)	Predicted membrane protein (DUF2214)	Predicted membrane protein (DUF2232)	Predicted membrane protein (DUF2232).	Predicted membrane protein (DUF2306)	Predicted membrane protein (DUF2339)	Predicted membrane protein/domain	Predicted membrane-associated HD superfamily  hydrolase	Predicted membrane-associated, metal-dependent  hydrolase	Predicted membrane-bound metal-dependent  hydrolases	Predicted metal binding domain-containing  protein	Predicted metal-binding membrane protein	Predicted metal-binding protein	Predicted metal-binding protein related to the  C-terminal domain of SecA	Predicted metal-binding, possibly nucleic  acid-binding protein	Predicted metal-dependent enzyme of the  double-stranded beta helix superfamily	Predicted metal-dependent hydrolase	Predicted metal-dependent hydrolase of the  TIM-barrel fold	Predicted metal-dependent hydrolase, TIM-barrel  fold	Predicted metal-dependent membrane protease	Predicted metal-dependent phosphohydrolase, HD  superfamily	Predicted metalloprotease	Predicted metalloprotease, contains C-terminal  PDZ domain	Predicted methyltransferase	Predicted methyltransferase, contains TPR repeat	Predicted naringenin-chalcone synthase	Predicted neuraminidase (sialidase)	Predicted nicotinamide N-methyase	Predicted nuclease (RNAse H fold)	Predicted nuclease of restriction  endonuclease-like (RecB) superfamily, DUF1016 family	Predicted nuclease of the RNAse H fold, HicB  family	Predicted nuclease, RecB family	Predicted nucleic acid-binding protein, contains  PIN domain	Predicted nucleic acid-binding protein, contains  Zn-ribbon domain (includes truncated derivatives)	Predicted nucleic-acid-binding protein  containing a Zn-ribbon	Predicted nucleic-acid-binding protein, contains  PIN domain	Predicted nucleoside-diphosphate sugar  epimerases	Predicted nucleotide-binding protein containing  TIR-like domain-containing protein	Predicted nucleotide-utilizing enzyme	Predicted nucleotidyltransferase	Predicted nucleotidyltransferase component of  viral defense system	Predicted nucleotidyltransferases	Predicted oxidoreductase	Predicted oxidoreductase, contains short-chain  dehydrogenase (SDR) and DUF2520 domains	Predicted periplasmic lipoprotein (DUF2279).	Predicted periplasmic or secreted lipoprotein	Predicted periplasmic protein	Predicted permease	Predicted permease, DMT superfamily	Predicted permeases	Predicted peroxiredoxin	Predicted phage recombinase, RecA/RadA family	Predicted phosphatase	Predicted phosphatases	Predicted phosphoadenosine phosphosulfate  sulfurtransferase, contains C-terminal DUF3440 domain	Predicted phosphodiesterase	Predicted phosphoesterase	Predicted phosphohydrolase or phosphomutase,  AlkP superfamily	Predicted phosphohydrolase, MPP superfamily	Predicted phosphohydrolase, protein tyrosine  phosphatase (PTP) superfamily, DUF442 family	Predicted phosphohydrolases	Predicted phosphoribosyltransferase	Predicted polyphosphate- or ATP-dependent NAD  kinase	Predicted protease of the Abi (CAAX) family	Predicted protein (DUF2233)	Predicted protein (DUF2271)	Predicted protein tyrosine phosphatase	Predicted protein-tyrosine phosphatase	Predicted pyrophosphatase	Predicted pyrophosphatase or phosphodiesterase,  AlkP superfamily	Predicted restriction endonuclease	Predicted ring-cleavage extradiol dioxygenase	Predicted secreted Zn-dependent protease	Predicted secreted hydrolase	Predicted secreted protein	Predicted signal transduction protein containing  sensor and EAL domains	Predicted signal-transduction protein containing  cAMP-binding and CBS domains	Predicted small integral membrane protein	Predicted small lipoprotein YifL	Predicted small metal-binding protein	Predicted small secreted protein	Predicted soluble lytic transglycosylase fused  to an ABC-type amino acid-binding protein	Predicted spermidine synthase with an N-terminal  membrane domain	Predicted sugar kinase	Predicted thioesterase	Predicted thioesterase involved in non-ribosomal  peptide biosynthesis	Predicted thiol-disulfide oxidoreductase YuxK,  DCC family	Predicted transcription factor, homolog of  eukaryotic MBF1	Predicted transcription regulator, contains HTH  domain, MarR family	Predicted transcriptional regulator	Predicted transcriptional regulator YdeE,  contains AraC-type DNA-binding domain	Predicted transcriptional regulator YheO,  contains PAS and DNA-binding HTH domains	Predicted transcriptional regulator containing  CBS domains	Predicted transcriptional regulator containing  an HTH domain and an uncharacterized domain shared with the mammalian protein Sc	Predicted transcriptional regulator with  C-terminal CBS domains	Predicted transcriptional regulator, ArsR family	Predicted transcriptional regulator, contains  C-terminal CBS domains	Predicted transcriptional regulator, contains  HTH domain	Predicted transcriptional regulator, contains an  HTH and PUA-like domains	Predicted transcriptional regulators	Predicted transglutaminase-like cysteine  proteinase	Predicted type IV restriction endonuclease	Predicted unusual protein kinase regulating  ubiquinone biosynthesis, AarF/ABC1/UbiB family	Predicted xylanase/chitin deacetylase	Prephenate dehydrogenase	Preprotein translocase subunit SecA (ATPase, RNA  helicase)	Primase C terminal 1 (PriCT-1)	Primase C terminal 2 (PriCT-2)	Pro-Hyp dipeptidase. Metallo peptidase. MEROPS  family M38	ProP effector	Probable Zinc-ribbon domain-containing protein	Probable cobalt transporter subunit (CbtA)	Probable cobalt transporter subunit (CbtB)	Probable lipoprotein LpqN	Proline 4-hydroxylase (includes Rps23 Pro-64  3,4-dihydroxylase Tpa1), contains SM-20 domain	Proline racemase	Prolipoprotein diacylglyceryl transferase	Prolipoprotein diacylglyceryltransferase	Prolyl oligopeptidase family protein	Propeptide PepSY amd peptidase M4	Prophage CP4-57 regulatory protein (AlpA)	Prophage antirepressor	Prophage minor tail protein Z (GPZ)	Prophage tail length tape measure protein	Protease inhibitor Inh	Protease subunit of ATP-dependent Clp proteases	Proteasome assembly chaperone (PAC2) family  protein	Proteasome lid subunit RPN8/RPN11, contains  Jab1/MPN metalloenzyme (JAMM) motif	Protein N-acetyltransferase, RimJ/RimL family	Protein involved in biosynthesis of mitomycin  antibiotics/polyketide fumonisin	Protein involved in cellulose biosynthesis  (CelD)	Protein involved in initiation of plasmid  replication	Protein involved in sex pheromone biosynthesis	Protein kinase domain-containing protein	Protein of Unknown function (DUF2784)	Protein of unknown function	Protein of unknown function (DUF1016)	Protein of unknown function (DUF1018)	Protein of unknown function (DUF1045)	Protein of unknown function (DUF1049)	Protein of unknown function (DUF1059)	Protein of unknown function (DUF1064)	Protein of unknown function (DUF1097)	Protein of unknown function (DUF1116)	Protein of unknown function (DUF1153)	Protein of unknown function (DUF1173)	Protein of unknown function (DUF1176)	Protein of unknown function (DUF1190)	Protein of unknown function (DUF1194)	Protein of unknown function (DUF1203)	Protein of unknown function (DUF1217)	Protein of unknown function (DUF1232)	Protein of unknown function (DUF1236)	Protein of unknown function (DUF1282)	Protein of unknown function (DUF1289)	Protein of unknown function (DUF1292)	Protein of unknown function (DUF1302)	Protein of unknown function (DUF1311)	Protein of unknown function (DUF1311).	Protein of unknown function (DUF1328)	Protein of unknown function (DUF1329)	Protein of unknown function (DUF1344)	Protein of unknown function (DUF1353)	Protein of unknown function (DUF1355)	Protein of unknown function (DUF1398)	Protein of unknown function (DUF1402)	Protein of unknown function (DUF1403)	Protein of unknown function (DUF1416)	Protein of unknown function (DUF1419)	Protein of unknown function (DUF1439)	Protein of unknown function (DUF1446)	Protein of unknown function (DUF1449)	Protein of unknown function (DUF1450)	Protein of unknown function (DUF1488)	Protein of unknown function (DUF1490)	Protein of unknown function (DUF1499)	Protein of unknown function (DUF1510)	Protein of unknown function (DUF1516)	Protein of unknown function (DUF1523)	Protein of unknown function (DUF1524)	Protein of unknown function (DUF1538)	Protein of unknown function (DUF1572)	Protein of unknown function (DUF1579)	Protein of unknown function (DUF1622)	Protein of unknown function (DUF1624)	Protein of unknown function (DUF1625)	Protein of unknown function (DUF1631)	Protein of unknown function (DUF1638)	Protein of unknown function (DUF1640)	Protein of unknown function (DUF1648)	Protein of unknown function (DUF1653)	Protein of unknown function (DUF1656)	Protein of unknown function (DUF1657)	Protein of unknown function (DUF1674)	Protein of unknown function (DUF1688)	Protein of unknown function (DUF1761)	Protein of unknown function (DUF1811)	Protein of unknown function (DUF1826)	Protein of unknown function (DUF2004)	Protein of unknown function (DUF2023)	Protein of unknown function (DUF2029)	Protein of unknown function (DUF2283)	Protein of unknown function (DUF2380)	Protein of unknown function (DUF2384)	Protein of unknown function (DUF2397)	Protein of unknown function (DUF2441)	Protein of unknown function (DUF2442)	Protein of unknown function (DUF2469)	Protein of unknown function (DUF2470)	Protein of unknown function (DUF2474)	Protein of unknown function (DUF2478)	Protein of unknown function (DUF2484)	Protein of unknown function (DUF2487)	Protein of unknown function (DUF2490)	Protein of unknown function (DUF2493)	Protein of unknown function (DUF2497)	Protein of unknown function (DUF2505)	Protein of unknown function (DUF2507)	Protein of unknown function (DUF2508)	Protein of unknown function (DUF2510)	Protein of unknown function (DUF2516)	Protein of unknown function (DUF2530)	Protein of unknown function (DUF2531)	Protein of unknown function (DUF2531).	Protein of unknown function (DUF2533)	Protein of unknown function (DUF2535)	Protein of unknown function (DUF2537)	Protein of unknown function (DUF2541)	Protein of unknown function (DUF2550)	Protein of unknown function (DUF2562)	Protein of unknown function (DUF2563)	Protein of unknown function (DUF2567)	Protein of unknown function (DUF2568)	Protein of unknown function (DUF2569)	Protein of unknown function (DUF2580).	Protein of unknown function (DUF2584)	Protein of unknown function (DUF2585)	Protein of unknown function (DUF2587)	Protein of unknown function (DUF2599)	Protein of unknown function (DUF2619)	Protein of unknown function (DUF2627)	Protein of unknown function (DUF2628)	Protein of unknown function (DUF2628).	Protein of unknown function (DUF2630)	Protein of unknown function (DUF2631)	Protein of unknown function (DUF2637)	Protein of unknown function (DUF2639)	Protein of unknown function (DUF2642)	Protein of unknown function (DUF2690)	Protein of unknown function (DUF2694)	Protein of unknown function (DUF2695)	Protein of unknown function (DUF2721)	Protein of unknown function (DUF2726)	Protein of unknown function (DUF2730)	Protein of unknown function (DUF2730).	Protein of unknown function (DUF2735)	Protein of unknown function (DUF2750)	Protein of unknown function (DUF2752)	Protein of unknown function (DUF2758)	Protein of unknown function (DUF2768)	Protein of unknown function (DUF2771)	Protein of unknown function (DUF2778)	Protein of unknown function (DUF2782)	Protein of unknown function (DUF2783)	Protein of unknown function (DUF2786)	Protein of unknown function (DUF2788)	Protein of unknown function (DUF2789)	Protein of unknown function (DUF2793)	Protein of unknown function (DUF2794)	Protein of unknown function (DUF2796)	Protein of unknown function (DUF2797)	Protein of unknown function (DUF2798)	Protein of unknown function (DUF2802)	Protein of unknown function (DUF2809)	Protein of unknown function (DUF2818)	Protein of unknown function (DUF2840)	Protein of unknown function (DUF2842)	Protein of unknown function (DUF2845)	Protein of unknown function (DUF2846)	Protein of unknown function (DUF2848)	Protein of unknown function (DUF2849)	Protein of unknown function (DUF2852)	Protein of unknown function (DUF2853)	Protein of unknown function (DUF2863)	Protein of unknown function (DUF2865)	Protein of unknown function (DUF2867)	Protein of unknown function (DUF2871)	Protein of unknown function (DUF2878)	Protein of unknown function (DUF2891)	Protein of unknown function (DUF2892)	Protein of unknown function (DUF2909)	Protein of unknown function (DUF2914)	Protein of unknown function (DUF2924)	Protein of unknown function (DUF2927)	Protein of unknown function (DUF2933)	Protein of unknown function (DUF2934)	Protein of unknown function (DUF2934).	Protein of unknown function (DUF2937)	Protein of unknown function (DUF2938)	Protein of unknown function (DUF2939)	Protein of unknown function (DUF2945)	Protein of unknown function (DUF2946)	Protein of unknown function (DUF2946).	Protein of unknown function (DUF2948)	Protein of unknown function (DUF2950)	Protein of unknown function (DUF2958)	Protein of unknown function (DUF2970)	Protein of unknown function (DUF2971)	Protein of unknown function (DUF2975)	Protein of unknown function (DUF2975).	Protein of unknown function (DUF2993)	Protein of unknown function (DUF3000)	Protein of unknown function (DUF3006)	Protein of unknown function (DUF3012)	Protein of unknown function (DUF3014)	Protein of unknown function (DUF3016)	Protein of unknown function (DUF3017)	Protein of unknown function (DUF3018)	Protein of unknown function (DUF3024)	Protein of unknown function (DUF3025)	Protein of unknown function (DUF3027)	Protein of unknown function (DUF3034)	Protein of unknown function (DUF3037)	Protein of unknown function (DUF3039)	Protein of unknown function (DUF3040)	Protein of unknown function (DUF3043)	Protein of unknown function (DUF3046)	Protein of unknown function (DUF3047)	Protein of unknown function (DUF3052)	Protein of unknown function (DUF3054)	Protein of unknown function (DUF3055)	Protein of unknown function (DUF3060)	Protein of unknown function (DUF3068)	Protein of unknown function (DUF3071)	Protein of unknown function (DUF3072)	Protein of unknown function (DUF3073)	Protein of unknown function (DUF3085)	Protein of unknown function (DUF3088)	Protein of unknown function (DUF3093)	Protein of unknown function (DUF3095)	Protein of unknown function (DUF3096)	Protein of unknown function (DUF3097)	Protein of unknown function (DUF3099)	Protein of unknown function (DUF3100)	Protein of unknown function (DUF3102)	Protein of unknown function (DUF3106)	Protein of unknown function (DUF3107)	Protein of unknown function (DUF3108)	Protein of unknown function (DUF3108).	Protein of unknown function (DUF3117)	Protein of unknown function (DUF3126)	Protein of unknown function (DUF3135)	Protein of unknown function (DUF3137)	Protein of unknown function (DUF3139)	Protein of unknown function (DUF3140)	Protein of unknown function (DUF3141)	Protein of unknown function (DUF3144)	Protein of unknown function (DUF3145)	Protein of unknown function (DUF3149)	Protein of unknown function (DUF3151)	Protein of unknown function (DUF3152)	Protein of unknown function (DUF3157)	Protein of unknown function (DUF3159)	Protein of unknown function (DUF3164)	Protein of unknown function (DUF3168)	Protein of unknown function (DUF3175)	Protein of unknown function (DUF3180)	Protein of unknown function (DUF3182)	Protein of unknown function (DUF3189)	Protein of unknown function (DUF3221)	Protein of unknown function (DUF3225)	Protein of unknown function (DUF3231)	Protein of unknown function (DUF3237)	Protein of unknown function (DUF3240)	Protein of unknown function (DUF3253)	Protein of unknown function (DUF3261)	Protein of unknown function (DUF3263)	Protein of unknown function (DUF3268)	Protein of unknown function (DUF3293)	Protein of unknown function (DUF3297)	Protein of unknown function (DUF3298)	Protein of unknown function (DUF3298).	Protein of unknown function (DUF3300)	Protein of unknown function (DUF3301)	Protein of unknown function (DUF3302)	Protein of unknown function (DUF3303)	Protein of unknown function (DUF3305)	Protein of unknown function (DUF3306)	Protein of unknown function (DUF3307)	Protein of unknown function (DUF3309)	Protein of unknown function (DUF3311)	Protein of unknown function (DUF3313)	Protein of unknown function (DUF3325)	Protein of unknown function (DUF3349)	Protein of unknown function (DUF3375)	Protein of unknown function (DUF3379)	Protein of unknown function (DUF3388)	Protein of unknown function (DUF3429)	Protein of unknown function (DUF3445)	Protein of unknown function (DUF3460)	Protein of unknown function (DUF3465)	Protein of unknown function (DUF3486)	Protein of unknown function (DUF3489)	Protein of unknown function (DUF3499)	Protein of unknown function (DUF3500)	Protein of unknown function (DUF3501)	Protein of unknown function (DUF3515)	Protein of unknown function (DUF3553)	Protein of unknown function (DUF3558)	Protein of unknown function (DUF3565)	Protein of unknown function (DUF3572)	Protein of unknown function (DUF3574)	Protein of unknown function (DUF3579)	Protein of unknown function (DUF3592)	Protein of unknown function (DUF3604)	Protein of unknown function (DUF3606)	Protein of unknown function (DUF3613)	Protein of unknown function (DUF3616)	Protein of unknown function (DUF3617)	Protein of unknown function (DUF3617).	Protein of unknown function (DUF3618)	Protein of unknown function (DUF3619)	Protein of unknown function (DUF3620)	Protein of unknown function (DUF3631)	Protein of unknown function (DUF3634)	Protein of unknown function (DUF3644)	Protein of unknown function (DUF3710)	Protein of unknown function (DUF3750)	Protein of unknown function (DUF3754)	Protein of unknown function (DUF3768)	Protein of unknown function (DUF3775)	Protein of unknown function (DUF3780)	Protein of unknown function (DUF3800)	Protein of unknown function (DUF3829)	Protein of unknown function (DUF3830)	Protein of unknown function (DUF3832)	Protein of unknown function (DUF3833)	Protein of unknown function (DUF3891)	Protein of unknown function (DUF3892)	Protein of unknown function (DUF3954)	Protein of unknown function (DUF3967)	Protein of unknown function (DUF3987)	Protein of unknown function (DUF3995)	Protein of unknown function (DUF4003)	Protein of unknown function (DUF4007)	Protein of unknown function (DUF4011)	Protein of unknown function (DUF4012)	Protein of unknown function (DUF4031)	Protein of unknown function (DUF4038)	Protein of unknown function (DUF4046)	Protein of unknown function (DUF4089)	Protein of unknown function (DUF4197)	Protein of unknown function (DUF421)	Protein of unknown function (DUF4229)	Protein of unknown function (DUF4230)	Protein of unknown function (DUF4231)	Protein of unknown function (DUF4232)	Protein of unknown function (DUF4233)	Protein of unknown function (DUF4235)	Protein of unknown function (DUF4236)	Protein of unknown function (DUF4237)	Protein of unknown function (DUF4238)	Protein of unknown function (DUF4239)	Protein of unknown function (DUF4241)	Protein of unknown function (DUF4242)	Protein of unknown function (DUF4244)	Protein of unknown function (DUF4245)	Protein of unknown function (DUF4255)	Protein of unknown function (DUF4256)	Protein of unknown function (DUF466)	Protein of unknown function (DUF551)	Protein of unknown function (DUF559)	Protein of unknown function (DUF560)	Protein of unknown function (DUF563)	Protein of unknown function (DUF616)	Protein of unknown function (DUF642)	Protein of unknown function (DUF664)	Protein of unknown function (DUF707)	Protein of unknown function (DUF721)	Protein of unknown function (DUF732)	Protein of unknown function (DUF742)	Protein of unknown function (DUF768)	Protein of unknown function (DUF938)	Protein of unknown function (DUF968)	Protein of unknown function (DUF982)	Protein of unknown function (DUF989)	Protein of unknown function (DUF992)	Protein of unknown function (DUF993)	Protein of unknown function (DUF995)	Protein of unknown function (DUF998)	Protein of unknown function (DUF998).	Protein of unknown function (FYDLN_acid)	Protein of unknown function DUF1800	Protein of unknown function DUF2063	Protein of unknown function DUF2065	Protein of unknown function DUF2069, membrane	Protein of unknown function DUF2075	Protein of unknown function DUF2081	Protein of unknown function DUF2126	Protein of unknown function DUF2132	Protein of unknown function DUF2133	Protein of unknown function DUF2237	Protein of unknown function DUF2244,  transmembrane	Protein of unknown function DUF2292	Protein of unknown function DUF2311, membrane	Protein of unknown function DUF2339,  transmembrane	Protein of unknown function DUF262	Protein of unknown function DUF2620	Protein of unknown function DUF58	Protein of unknown function VcgC/VcgE (DUF2780)	Protein of unknown function with HXXEE  motif-containing protein	Protein of unknown function with PCYCGC  motif-containing protein	Protein of unknown function, DUF393	Protein of unknown function, DUF485	Protein of unknown function, DUF488	Protein of unknown function, DUF547	Protein of unknown function, DUF624	Protein of unknwon function (DUF3008)	Protein phosphatase 2C	Protein required for attachment to host cells	Protein tyrosine/serine phosphatase	Protein-L-isoaspartate(D-aspartate)  O-methyltransferase	Protein-S-isoprenylcysteine O-methyltransferase  Ste14	Protein-arginine kinase activator protein McsA	Protein-disulfide isomerase	Protein-tyrosine phosphatase, low molecular  weight	Protein-tyrosine-phosphatase	Proteins containing SET domain	Proteins of 100 residues with WXG	Proteolipid membrane potential modulator	Protocatechuate 3,4-dioxygenase beta subunit	Protoporphyrinogen oxidase	PsiF repeat protein	Pterin-4a-carbinolamine dehydratase	PucR C-terminal helix-turn-helix  domain-containing protein	Purine-cytosine permease	Purine-cytosine permease and related proteins	Putative ATPase subunit of terminase (gpP-like)	Putative Ca2+/H+ antiporter, TMEM165/GDT1 family	Putative DNA-binding domain-containing protein	Putative F0F1-ATPase subunit (ATPase_gene1)	Putative F0F1-ATPase subunit (ATPase_gene1).	Putative Flp pilus-assembly TadE/G-like	Putative GTPases (G3E family)	Putative Holin-X, holin superfamily III	Putative Ig domain-containing protein	Putative MetA-pathway of phenol degradation	Putative Mg2+ and Co2+ transporter CorB	Putative Mn2+ efflux pump MntP	Putative NADH-flavin reductase	Putative NADPH-quinone reductase (modulator of  drug activity B)	Putative Na+/H+ antiporter	Putative PD-(D/E)XK family member, (DUF4420)	Putative SOS response-associated peptidase YedK	Putative Zn-dependent protease	Putative Zn-dependent protease, contains TPR  repeats	Putative addiction module component	Putative adhesin	Putative amidase domain-containing protein	Putative archaeal flagellar protein D/E	Putative beta-barrel porin 2	Putative beta-barrel porin-2, OmpL-like. bbp2	Putative cell wall-binding domain	Putative component of 'biosynthetic module'	Putative cyclase	Putative effector of murein hydrolase	Putative effector of murein hydrolase LrgA,  UPF0299 family	Putative flippase GtrA (transmembrane  translocase of bactoprenol-linked glucose)	Putative hemolysin	Putative inner membrane protein (DUF1819)	Putative intracellular protease/amidase	Putative lumazine-binding	Putative membrane protein	Putative metallopeptidase	Putative mono-oxygenase ydhR	Putative motility protein	Putative multicopper oxidases	Putative multidrug resistance efflux transporter	Putative negative regulator of RcsB-dependent  stress response	Putative papain-like cysteine peptidase  (DUF1796)	Putative papain-like cysteine peptidase  (DUF1796).	Putative peptidoglycan binding domain-containing  protein	Putative peptidoglycan-binding domain-containing  protein	Putative phage abortive infection protein	Putative phage integrase	Putative phage tail protein	Putative polyhydroxyalkanoic acid system protein  (PHA_gran_rgn)	Putative porin	Putative regulator of cell autolysis	Putative rhamnosyl transferase	Putative salt-induced outer membrane protein  YdiY	Putative secretion activating protein	Putative sensory transduction regulator	Putative signal transducing protein	Putative silver efflux pump	Putative small multi-drug export protein	Putative sterol carrier protein	Putative tight adherence pilin protein F	Putative transposase of IS4/5 family (DUF4096)	Putative virulence factor	Putative zinc binding domain-containing protein	Putative zinc- or iron-chelating  domain-containing protein	Putative zinc-finger	Putative zincin peptidase	Putitive phosphate transport regulator	Pyocin activator protein PrtN	Pyridine nucleotide-disulphide oxidoreductase	Pyridoxal-dependent decarboxylase	Pyridoxamine 5'-phosphate oxidase	Pyridoxamine-phosphate oxidase	Pyridoxine/pyridoxamine 5'-phosphate oxidase	Pyrimidine reductase, riboflavin biosynthesis	Pyrophosphate-energized proton pump	Pyrroline-5-carboxylate reductase	Pyrrolo-quinoline quinone	Pyrroloquinoline quinone (Coenzyme PQQ)  biosynthesis protein C	Pyrroloquinoline quinone (PQQ) biosynthesis  protein C	Pyruvate carboxylase	Pyruvate decarboxylase and related thiamine  pyrophosphate-requiring enzymes	Pyruvate phosphate dikinase, PEP/pyruvate  binding domain	Pyruvate/2-oxoglutarate dehydrogenase complex,  dihydrolipoamide acyltransferase (E2) component, and related enzymes	Pyruvate/2-oxoglutarate dehydrogenase complex,  dihydrolipoamide dehydrogenase (E3) component	Pyruvate/2-oxoglutarate dehydrogenase complex,  dihydrolipoamide dehydrogenase (E3) component, and related enzymes	Quinohemoprotein amine dehydrogenase, gamma  subunit	Quinol monooxygenase YgiN	RDD domain containing protein	RDD family protein	REP element-mobilizing transposase RayT	RES domain protein	RES domain-containing protein	RES domain.	RHH-type transcriptional regulator, rel operon  repressor / antitoxin RelB	RHS repeat-associated core domain-containing  protein	RIO kinase 1	RIO-like kinase	RIP metalloprotease RseP	RNA ligase	RNA methyltransferase, TrmH family	RNA methyltransferase, TrmH family, group 1	RNA methyltransferase, TrmH family, group 2	RNA polymerase nonessential primary-like sigma  factor	RNA polymerase primary sigma factor	RNA polymerase sigma factor for flagellar operon  FliA	RNA polymerase sigma factor, sigma-70 family	RNA polymerase sigma-32 factor	RNA polymerase sigma-70 factor, ECF subfamily	RNA polymerase sigma-B factor	RNA polymerase sporulation-specific sigma factor	RNA polymerase, sigma 28 subunit, SigD/FliA/WhiG	RNA polymerase, sigma 29 subunit, SigE	RNA polymerase, sigma 32 subunit, RpoH	RNA polymerase, sigma 38 subunit, RpoS	RNA polymerase, sigma 54 subunit, RpoN/SigL	RNA polymerase, sigma 70 subunit, RpoD	RNA polymerase, sigma subunit, ECF family	RNA polymerase, sigma subunit, RpoX/SigF	RNA polymerase, sigma subunit, SigV	RNA polymerase, sigma subunit, SigW	RNA polymerase, sigma-24 subunit, ECF subfamily	RNA polymerase, sigma-24 subunit, RpoE	RNA polymerase, sigma-24 subunit, RpoE /RNA  polymerase, sigma subunit, ECF family	RNA polymerase-associated protein	RNA polymerase-binding protein	RNA-binding S4 domain protein	RNA-binding protein	RNA-binding protein (KH domain)	RNA-binding protein Hfq	RNA-binding protein YlmH, contains S4-like  domain	RNA-directed DNA polymerase	RNA-directed DNA polymerase (EC 2.7.7.49)	RNA-directed DNA polymerase (Reverse  transcriptase)	RNA-metabolising metallo-beta-lactamase	RNA-splicing ligase RtcB, repairs tRNA damage	RNAse E	RNAse E (EC 3.1.26.12)	RNAse G (EC 3.1.4.-)	RNAse III	RNAse III (EC 3.1.26.3)	RNAse M5	RNAse PH	RNAse PH (EC 2.7.7.56)	RNAse R	RNAse R (EC 3.1.-.-)	RND efflux system, outer membrane lipoprotein,  NodT family	RND family efflux transporter, MFP subunit	RNase HI	RNase HI (EC 3.1.26.4)	RNase HII	RNase HII (EC 3.1.26.4)	ROK family protein	RWP-RK domain-containing protein	Radical SAM domain protein	Radical SAM superfamily enzyme YgiQ, UPF0313  family	Radical SAM superfamily enzyme,  MoaA/NifB/PqqE/SkfB family	Radical SAM superfamily protein	Rare lipoprotein B	RecA protein	RecA-family ATPase	RecA/RadA recombinase	RecB	RecF/RecN/SMC N terminal domain-containing  protein	Recombinase	Recombination DNA repair protein (RAD52 pathway)	Recombination protein MgsA	Redoxin domain protein	Regulator of RNase E activity RraA	Regulator of cell morphogenesis and NO signaling	Regulator of chromosome condensation (RCC1)  repeat-containing protein	Regulator of nitric oxide reductase  transcription	Regulator of protease activity HflC,  stomatin/prohibitin superfamily	Regulator of ribonuclease activity B	Regulatory P domain of the subtilisin-like  proprotein convertase	RelA/SpoT family protein	RelE toxin of RelE / RelB toxin-antitoxin system	Relaxase/Mobilisation nuclease domain-containing  protein	Relaxase/mobilization nuclease family protein	RepA protein	RepB plasmid partitioning protein	Repeat domain-containing protein	Replication fork clamp-binding protein CrfC  (dynamin-like GTPase family)	Replication initiation factor	Replication-relaxation	Replicative DNA helicase	ResB family protein	Resolvase domain protein	Resolvase, N terminal domain	Response regulator	Response regulator containing CheY-like  receiver, AAA-type ATPase, and DNA-binding domains	Response regulator containing CheY-like receiver  domain and AraC-type DNA-binding domain	Response regulator containing a CheY-like  receiver domain and a GGDEF domain	Response regulator containing a CheY-like  receiver domain and an HD-GYP domain	Response regulator containing a CheY-like  receiver domain and an HTH DNA-binding domain	Response regulator of citrate/malate metabolism	Response regulator of the LytR/AlgR family	Response regulator receiver domain	Response regulator receiver domain-containing  protein	Response regulator with putative antiterminator  output domain	Response regulators consisting of a CheY-like  receiver domain and a winged-helix DNA-binding domain	Restriction endonuclease	Restriction endonuclease BglII	Restriction endonuclease EcoRII, N-terminal	Restriction endonuclease S subunit	Restriction endonuclease XhoI	Retron-type reverse transcriptase	Reverse transcriptase (RNA-dependent DNA  polymerase)	Rhamnan synthesis F	Rhamnose utilisation protein RhaD, predicted  bifunctional aldolase and dehydrogenase	Rho termination factor, N-terminal domain	Rhodanese domain protein	Rhodanese-related sulfurtransferase	Rhomboid family protein	Ribbon-helix-helix domain-containing protein	Ribbon-helix-helix protein, copG family	Ribbon-helix-helix protein, copG family.	Riboflavin kinase	Ribonuclease BN, tRNA processing enzyme	Ribonuclease D	Ribonuclease H	Ribonucleoside-diphosphate reductase	Ribonucleotide reductase beta subunit,  ferritin-like domain-containing	Ribonucleotide reductase, alpha subunit	Ribosomal protein L11 methylase	Ribosomal protein L16 Arg81 hydroxylase,  contains JmjC domain	Ribosomal protein L7Ae	Ribosomal protein RSM22 (predicted rRNA  methylase)	Ribosomal protein S18 acetylase RimI	Ribosome association toxin PasT (RatA) of the  RatAB toxin-antitoxin module	Ribosome-associated translation inhibitor RaiA	Ribulose-5-phosphate  4-epimerase/Fuculose-1-phosphate aldolase	Ribulose-5-phosphate 4-epimerase and related  epimerases and aldolases	Ricin-type beta-trefoil lectin domain-containing  protein	Ricin-type beta-trefoil lectin domain-like	Rickettsia 17 kDa surface antigen.	Rieske (2Fe-2S) domain protein	Rieske (2Fe-2S) iron-sulfur domain protein	Rieske 2Fe-2S family protein	Rieske Fe-S protein	Right handed beta helix region	Ring hydroxylating alpha subunit (catalytic  domain)	RloB-like protein	Rod binding protein	RraA famliy	Rrf2 family protein	RsbT co-antagonist protein rsbRD N-terminal  domain-containing protein	Rubredoxin	Rubredoxin-type Fe(Cys)4 protein	Rubrerythrin	Rv0623-like transcription factor	S-(hydroxymethyl)glutathione dehydrogenase /  alcohol dehydrogenase	S-(hydroxymethyl)glutathione synthase	S-(hydroxymethyl)mycothiol dehydrogenase	S-adenosyl-methyltransferase MraW	S-adenosylmethionine decarboxylase	S-adenosylmethionine uptake transporter	S-adenosylmethionine--tRNA  ribosyltransferase-isomerase	S-adenosylmethionine-diacylglycerol  3-amino-3-carboxypropyl transferase	S-adenosylmethionine/tRNA-ribosyltransferase-  isomerase	S-adenosylmethionine:tRNA  ribosyltransferase-isomerase	S-formylglutathione hydrolase	S-formylglutathione hydrolase FrmB	S-layer homology domain-containing protein	S-methylmethionine transporter	SAM dependent carboxyl methyltransferase	SAM-dependent methyltransferase (EC 2.1.1.-)	SAM-dependent methyltransferase, MidA family	SCP-2 sterol transfer family protein	SDR family mycofactocin-dependent oxidoreductase	SEC-C motif-containing protein	SGNH hydrolase-like domain-containing protein,  acetyltransferase AlgX	SH3 domain-containing protein	SH3 type 3 domain protein	SH3-like domain-containing protein	SIR2-like domain-containing protein	SLBB domain-containing protein	SM-20-related protein	SMI1 / KNR4 family (SUKH-1)	SMP-30/Gluconolaconase/LRE domain protein	SMP-30/Gluconolaconase/LRE-like  region-containing protein	SNARE associated Golgi protein	SNARE associated Golgi protein-like protein	SOS response UmuD protein. Serine peptidase.  MEROPS family S24	SOS-response transcriptional repressor, LexA	SOS-response transcriptional repressors  (RecA-mediated autopeptidases)	SOUL heme-binding protein	SPFH domain / Band 7 family protein	SPFH domain, Band 7 family protein	SPW repeat-containing protein	SRSO17 transposase	SS-A/Ro ribonucleoprotein	SSU ribosomal protein S10P	SSU ribosomal protein S11P	SSU ribosomal protein S12P	SSU ribosomal protein S12P methylthiotransferase	SSU ribosomal protein S12P methylthiotransferase  (EC 2.-.-.-)	SSU ribosomal protein S13P	SSU ribosomal protein S14P	SSU ribosomal protein S15P	SSU ribosomal protein S16P	SSU ribosomal protein S17P	SSU ribosomal protein S18P	SSU ribosomal protein S19P	SSU ribosomal protein S1P	SSU ribosomal protein S20P	SSU ribosomal protein S21P	SSU ribosomal protein S2P	SSU ribosomal protein S30P /sigma 54 modulation  protein	SSU ribosomal protein S30P/sigma 54 modulation  protein	SSU ribosomal protein S3P	SSU ribosomal protein S4P	SSU ribosomal protein S5P	SSU ribosomal protein S6P	SSU ribosomal protein S6P modification protein	SSU ribosomal protein S7P	SSU ribosomal protein S8P	SSU ribosomal protein S9P	STAS domain-containing protein	STE24 endopeptidase	SUKH-4 immunity protein	SWIB-domain-containing proteins implicated in  chromatin remodeling	SWIM zinc finger	Saccharopine dehydrogenase	Saccharopine dehydrogenase NADP binding  domain-containing protein	Saccharopine dehydrogenase and related proteins	Saccharopine dehydrogenase, NADP-dependent	SagB-type dehydrogenase domain-containing  protein	Sap, sulfolipid-1-addressing protein	SapC protein	Sarcosine oxidase delta subunit heterotetrameric	Sarcosine oxidase gamma subunit	Scramblase family protein	Sec-independent protein translocase TatB	Sec-independent protein translocase TatC	SecD/SecF fusion protein	Secreted repeat of unknown function	Secreted trypsin-like serine protease	Secretin and TonB N terminus short  domain-containing protein	Secretory lipase	Sel1 domain protein repeat-containing protein	Sel1 repeat-containing protein	Selenocysteine lyase/Cysteine desulfurase	Sensor histidine kinase regulating  citrate/malate metabolism	Sensors of blue-light using FAD	Septal ring factor EnvC, activator of murein  hydrolases AmiA and AmiB	Septum formation	Septum formation initiator	Ser-tRNA(Thr) hydrolase /threonyl-tRNA  synthetase	Ser/Thr protein kinase RdoA involved in Cpx  stress response, MazF antagonist	Serine acetyltransferase	Serine kinase of the HPr protein, regulates  carbohydrate metabolism	Serine phosphatase RsbU, regulator of sigma  subunit	Serine protease, subtilisin family	Serine/threonine protein kinase	Serine/threonine protein phosphatase PrpC	Serralysin	Seryl-tRNA synthetase	Shikimate 5-dehydrogenase	Shikimate dehydrogenase substrate binding domain  protein	Short C-terminal domain-containing protein	Short-chain alcohol dehydrogenase of unknown  specificity	Short-chain dehydrogenase	Short-chain dehydrogenases of various substrate  specificities	Siderophore synthetase component	Siderophore-interacting protein	Sigma 54 interacting domain protein	Sigma-54 interaction domain-containing protein	Sigma-70 factor, region 1.1	Sigma-70, region 4	Signal transduction histidine kinase	Signal transduction histidine kinase involved in  nitrogen fixation and metabolism regulation	Signal transduction histidine kinase,  glucose-6-phosphate specific	Signal transduction protein containing GAF and  PtsI domains	SipW-cognate class signal peptide	SirA family protein	Sirohydrochlorin ferrochelatase	Site-specific DNA methylase	Site-specific DNA recombinase	Site-specific DNA-methyltransferase  (adenine-specific)	Site-specific recombinase	Site-specific recombinase XerC	Site-specific recombinase XerD	Site-specific recombinases, DNA invertase Pin  homologs	SlyX protein	Small basic protein	Small integral membrane protein (DUF2273)	Small ligand-binding sensory domain FIST	Small, acid-soluble spore protein, alpha/beta  type	Small-conductance mechanosensitive channel	Smg protein	Smr protein/MutS2	SnoaL-like domain-containing protein	Soluble lytic murein transglycosylase	Soluble lytic murein transglycosylase and  related regulatory proteins (some contain LysM/invasin domains)	Sortase (surface protein transpeptidase)	Sortase and related acyltransferases	Sortase family protein	Spermidine synthase	Spermidine/putrescine-binding protein	Sphingosine kinase and enzymes related to  eukaryotic diacylglycerol kinase	Spo0E like sporulation regulatory protein	SpoIIAA-like	SpoIVB peptidase. Serine peptidase. MEROPS  family S55	Spore coat protein CotF	Spore coat protein CotH	Spore coat protein CotO	Spore germination protein	Spore germination protein YaaH	Sporulation and spore germination	Sporulation domain protein	Sporulation inhibitor A	Sporulation lipoprotein YhcN/YlaJ  (Spore_YhcN_YlaJ)	Sporulation protein YlmC, PRC-barrel domain  family	Sporulation protein YpjB (SpoYpjB)	Sporulation related domain-containing protein	SppA protein	SprT-like protein	SseB protein C-terminal domain-containing  protein	SseB protein N-terminal domain-containing  protein	SsrA-binding protein	Stage V sporulation protein SpoVR/YcgB, involved  in spore cortex formation	Stage VI sporulation protein F	Ste24 endopeptidase	Stealth protein CR1, conserved region 1	Steroid 5-alpha reductase family enzyme	Sterol desaturase	Sterol desaturase/sphingolipid hydroxylase,  fatty acid hydroxylase superfamily	Stress response protein SCP2	Stress responsive A/B Barrel Domain	Stress-induced acidophilic repeat  motif-containing protein	Stress-induced morphogen (activity unknown)	Stringent starvation protein B	Sua5/YciO/YrdC/YwlC family protein	Subtilase family protein	Subtilisin inhibitor-like	Subtilisin-like serine proteases	Succinate dehydrogenase/fumarate reductase,  flavoprotein subunit	Succinylglutamate desuccinylase/aspartoacylase	Sugar (pentulose or hexulose) kinase	Sugar diacid utilization regulator	Sugar kinase of the NBD/HSP70 family, may  contain an N-terminal HTH domain	Sugar lactone lactonase YvrE	Sugar or nucleoside kinase, ribokinase family	Sugar phosphate isomerase/epimerase	Sugar phosphate permease	Sugar transferase involved in LPS biosynthesis  (colanic, teichoic acid)	Sugar transporter	Sugar-specific transcriptional regulator TrmB	Sugar-transfer associated ATP-grasp	Sulfatase-modifying factor enzyme 1	Sulfate permease, MFS superfamily	Sulfite exporter TauE/SafE	Sulfite oxidase and related enzymes	Sulfocyanin (SoxE) domain-containing protein	Sulfotransferase domain-containing protein	Sulfotransferase family protein	Sulfurtransferase TusA	Sulphur oxidation protein SoxZ	Superfamily I DNA and RNA helicases	Superfamily I DNA or RNA helicase	Superfamily II DNA and RNA helicase	Superfamily II DNA or RNA helicase	Superfamily II DNA or RNA helicase, SNF2 family	Superfamily II DNA/RNA helicases, SNF2 family	Superfamily II RNA helicase	Superfamily II helicase	Superfamily II helicase and inactivated  derivatives	Superinfection immunity protein	Superoxide dismutase	Suppressor of fused protein (SUFU)	Surface antigen	Surface polysaccharide O-acyltransferase,  integral membrane enzyme	Surfactin synthase thioesterase subunit	T/G mismatch-specific endonuclease	T1SS-143 domain-containing protein	T1SS-143 domain-containing protein/type I  secretion C-terminal target domain (VC_A0849 subclass)	T5orf172 domain-containing protein	TIGR00159 family protein	TIGR00255 family protein	TIGR00266 family protein	TIGR00267 family protein	TIGR00645 family protein	TIGR00659 family protein	TIGR01244 family protein	TIGR02099 family protein	TIGR02217 family protein	TIGR02300 family protein	TIGR02301 family protein	TIGR02302 family protein	TIGR02391 family protein	TIGR02444 family protein	TIGR02449 family protein	TIGR02453 family protein	TIGR02569 family protein	TIGR02588 family protein	TIGR02594 family protein	TIGR02646 family protein	TIGR02677 family protein	TIGR02678 family protein	TIGR02679 family protein	TIGR02687 family protein	TIGR03032 family protein	TIGR03083 family protein	TIGR03084 family protein	TIGR03085 family protein	TIGR03086 family protein	TIGR03089 family protein	TIGR03643 family protein	TIGR03790 family protein	TIGR03943 family protein	TIGR04255 family protein	TIR domain-containing protein	TLP18.3, Psb32 and MOLO-1 founding protein of  phosphatase	TLP18.3, Psb32 and MOLO-1 founding proteins of  phosphatase	TM2 domain-containing membrane protein YozV	TM2 domain-containing protein	TMP repeat-containing protein	TOBE domain protein	TOPRIM domain protein	TPR repeat	TPR repeat-containing protein	TQXA domain-containing protein	TRAG family protein	TRAP transporter solute receptor, TAXI family	TRAP transporter, 4TM/12TM fusion protein	TRAP transporter, DctM subunit	TRAP-type C4-dicarboxylate transport system,  small permease component	TRAP-type C4-dicarboxylate transport system,  substrate-binding protein	TRAP-type mannitol/chloroaromatic compound  transport system, small permease component	TRAP-type mannitol/chloroaromatic compound  transport system, substrate-binding protein	TRAP-type uncharacterized transport system,  substrate-binding protein	TROVE domain-containing protein	TRSP domain C terminus to PRTase_2	TSCPD domain-containing protein	TadE family protein	TadE-like protein	TaqI-like C-terminal specificity  domain-containing protein	Tar ligand binding domain homologue	Tat (twin-arginine translocation) pathway signal  sequence	Tat proofreading chaperone FdhE	TatD DNase family protein	TatD-related deoxyribonuclease	Taurine catabolism dioxygenase TauD, TfdA family	Taurine dioxygenase,  alpha-ketoglutarate-dependent	Tautomerase enzyme	TctA family transporter	Tellurite resistance protein	Tellurite resistance protein TehA	Tellurite resistance protein TehB	Tellurite resistance protein TerB	TerF vWA domain-containing protein	Terminase-like family protein	Terminase-like family.	Tetratrico peptide repeat-containing protein	Tetratricopeptide (TPR) repeat	Tetratricopeptide TPR_2 repeat protein	Tetratricopeptide TPR_4	Tetratricopeptide domain protein	Tetratricopeptide repeat	Tetratricopeptide repeat-containing protein	TfoX C-terminal domain-containing protein	TfoX N-terminal domain-containing protein	TfoX domain protein	Tfp pilus assembly protein FimV-like protein	Tfp pilus assembly protein PilF	Tfp pilus assembly protein PilN	Tfp pilus assembly protein PilO	Tfp pilus assembly protein PilX	Thermostable hemolysin	ThiJ/PfpI domain protein	ThiS family protein	Thiaminase	Thiamine kinase	Thiamine pyrophosphate enzyme, C-terminal TPP  binding domain	Thioesterase domain-containing protein	Thioesterase domains of type I polyketide  synthases or non-ribosomal peptide synthetases	Thioesterase superfamily	Thioesterase-like superfamily protein	Thiol-disulfide interchange protein, contains  DsbC and DsbD domains	Thiol-disulfide isomerase or thioredoxin	Thiol:disulfide interchange protein	Thiol:disulfide interchange protein DsbB	Thiol:disulfide interchange protein DsbC	Thiolase, C-terminal domain	Thiopurine S-methyltransferase	Thioredoxin	Thioredoxin domain protein	Thioredoxin domain-containing protein	Thioredoxin reductase	Thioredoxin-like domain	Thioredoxin-like domain-containing protein	Thioredoxin-related protein	Thiosulfate reductase cytochrome B subunit  (membrane anchoring protein)	Thiosulfate reductase cytochrome b subunit	Three-deoxy-D-manno-octulosonic-acid transferase  domain protein	Threonine dehydrogenase	Threonine/homoserine efflux transporter RhtA	Threonine/homoserine/homoserine lactone efflux  protein	Ti-type conjugative transfer relaxase TraA	TldD protein	Tn3 transposase DDE domain-containing protein	TniB family protein	TniQ protein	TnsA endonuclease N terminal	Tol-Pal system beta propeller repeat protein  TolB	TolA protein	TolB amino-terminal domain-containing protein	TolB protein	TonB C terminal	TonB family C-terminal domain-containing protein	TonB family protein	TonB-dependent Receptor Plug Domain	TonB-dependent receptor	TonB-dependent receptor plug	TonB-dependent siderophore receptor	Topoisomerase DNA binding C4 zinc finger	Toprim domain-containing protein	Toprim-like	Toxin of toxin-antitoxin type 1 system	TraC-like protein	TraX protein	Trans-hexaprenyltranstransferase	Transcription antitermination factor NusG	Transcription elongation factor, GreA/GreB  family	Transcription factor WhiB	Transcription factor zinc-finger	Transcription regulator of the Arc/MetJ class	Transcription termination factor nusG	Transcriptional Coactivator p15 (PC4)	Transcriptional activator of acetoin/glycerol  metabolism	Transcriptional antiterminator	Transcriptional regulator	Transcriptional regulator GlxA family, contains  an amidase domain and an AraC-type DNA-binding HTH domain	Transcriptional regulator PadR-like family  protein	Transcriptional regulator containing PAS,  AAA-type ATPase, and DNA-binding Fis domains	Transcriptional regulator containing an amidase  domain and an AraC-type DNA-binding HTH domain	Transcriptional regulator of acetoin/glycerol  metabolism	Transcriptional regulator, AbiEi antitoxin, Type  IV TA system	Transcriptional regulator, contains XRE-family  HTH domain	Transcriptional regulators	Transcriptional regulators of sugar metabolism	Transglutaminase-like enzyme, putative cysteine  protease	Transglutaminase-like enzymes, putative cysteine  proteases	Transglutaminase-like superfamily protein	Transglycosylase	Transglycosylase SLT domain	Transglycosylase SLT domain-containing protein	Transglycosylase SLT domain.	Transglycosylase associated protein	Transglycosylase-like domain-containing protein	Transmembrane protein of unknown function  (DUF3566)	Transmembrane secretion effector	Transmembrane transcriptional regulator  (anti-sigma factor RsiW)	Transposase	Transposase (or an inactivated derivative)	Transposase DDE domain group 1	Transposase DDE domain-containing protein	Transposase IS116/IS110/IS902 family protein	Transposase InsO and inactivated derivatives	Transposase and inactivated derivatives	Transposase and inactivated derivatives, IS30  family	Transposase and inactivated derivatives, TnpA  family	Transposase zinc-ribbon domain-containing  protein	TrbL/VirB6 plasmid conjugal transfer protein	Trehalose and maltose hydrolase (possible  phosphorylase)	Trehalose and maltose hydrolases (possible  phosphorylases)	Trehalose utilization protein	TrfA protein	Tripartite ATP-independent transporter, DctQ  component	Tripartite tricarboxylate transporter TctB  family protein	Tripartite-type tricarboxylate transporter,  receptor component TctC	Triphosphoribosyl-dephospho-CoA synthetase	Trk K+ transport system, NAD-binding component	Trk-type K+ transport system, membrane component	TrkA-N domain protein	TrkA-N domain-containing protein	Trp operon repressor family	Truncated hemoglobin YjbI	Truncated, possibly inactive, lysyl-tRNA  synthetase (class II)	Trypsin	Trypsin-like peptidase domain-containing protein	Trypsin-like protein serine protease	Trypsin-like serine proteases, typically  periplasmic, contain C-terminal PDZ domain	Tryptophan 2,3-dioxygenase apoenzyme	TspO and MBR related proteins	Tubulin like	Tumour necrosis factor receptor superfamily  member 19	TupA-like ATPgrasp	TusA-related sulfurtransferase	Two-component response regulator, AmiR/NasT  family, consists of REC and RNA-binding antiterminator (ANTAR) domains	Two-component response regulator, FixJ family,  consists of REC and HTH domains	Two-component response regulator, SAPR family,  consists of REC, wHTH and BTAD domains	Two-component sensor histidine kinase, contains  HisKA and HATPase domains	Two-component signal transduction system YycFG,  regulatory protein YycH	Two-component signal transduction system YycFG,  regulatory protein YycI	Type I phosphodiesterase / nucleotide  pyrophosphatase	Type I restriction enzyme R protein N terminus  (HSDR_N)	Type I restriction-modification system  methyltransferase subunit	Type I site-specific deoxyribonuclease	Type II restriction/modification system, DNA  methylase subunit YeeA	Type II secretion system (T2SS), protein F	Type II secretion system (T2SS), protein M	Type II secretion system (T2SS), protein M  subtype b	Type II secretion system F domain protein	Type II secretory pathway ATPase GspE/PulE or  T4P pilus assembly pathway ATPase PilB	Type II secretory pathway, ATPase PulE/Tfp pilus  assembly pathway, ATPase PilB	Type II secretory pathway, component ExeA  (predicted ATPase)	Type II secretory pathway, component PulD	Type II secretory pathway, pseudopilin PulG	Type IIA topoisomerase (DNA gyrase/topo II,  topoisomerase IV), A subunit	Type III restriction enzyme, res subunit	Type III secretion system lipoprotein chaperone  (YscW)	Type IV pilin N-term methylation site GFxxxE	Type IV pilus biogenesis	Type IV secretion system protein	Type IV secretory pathway VirD4 protein-like  protein	Type IV secretory pathway, VirB10 components	Type IV secretory pathway, VirB11 components,  and related ATPases involved in archaeal flagella biosynthesis	Type IV secretory pathway, VirD2 components  (relaxase)	Type IV secretory pathway, VirD4 component,  TraG/TraD family ATPase	Type IV secretory pathway, VirD4 components	Type IV secretory pathway, VirJ component	Tyrosine phosphatase family protein	UBA/THIF-type NAD/FAD binding protein	UDP-2,3-diacylglucosamine hydrolase	UDP-2,3-diacylglucosamine hydrolase (EC  3.6.1.54)	UDP-2,3-diacylglucosamine pyrophosphatase LpxH	UDP-2-acetamido-2-deoxy-ribo-hexuluronate  aminotransferase	UDP-2-acetamido-3-amino-2,3-dideoxy-glucuronate  N-acetyltransferase	UDP-3-O-[3-hydroxymyristoyl] N-acetylglucosamine  deacetylase	UDP-3-O-[3-hydroxymyristoyl] N-acetylglucosamine  deacetylase (EC 3.5.1.108)	UDP-3-O-[3-hydroxymyristoyl] glucosamine  N-acyltransferase	UDP-3-O-[3-hydroxymyristoyl] glucosamine  N-acyltransferase (EC 2.3.1.191)	UDP-4-amino-4-deoxy-L-arabinose-oxoglutarate  aminotransferase	UDP-GlcNAc3NAcA epimerase	UDP-GlcNAc:undecaprenyl-phosphate  GlcNAc-1-phosphate transferase	UDP-L-arabinose 4-epimerase	UDP-MurNAc hydroxylase	UDP-N-Acetylglucosamine 2-epimerase	UDP-N-Acetylglucosamine 2-epimerase (EC  5.1.3.14)	UDP-N-acetyl-2-amino-2-deoxyglucuronate  dehydrogenase	UDP-N-acetyl-D-galactosamine dehydrogenase	UDP-N-acetyl-D-glucosamine dehydrogenase	UDP-N-acetyl-D-mannosaminuronic acid  dehydrogenase	UDP-N-acetylglucosamine  1-carboxyvinyltransferase	UDP-N-acetylglucosamine  1-carboxyvinyltransferase (EC 2.5.1.7)	UDP-N-acetylglucosamine  2-epimerase/UDP-N-acetyl-D-glucosamine 2-epimerase, UDP-hydrolysing,TIGR03568	UDP-N-acetylglucosamine 2-epimerase  (non-hydrolysing)	UDP-N-acetylglucosamine 4,6-dehydratase  (inverting)	UDP-N-acetylglucosamine 4-epimerase	UDP-N-acetylglucosamine pyrophosphorylase 	UDP-N-acetylglucosamine pyrophosphorylase (EC  2.7.7.23)/glucosamine-1-phosphate N-acetyltransferase (EC 2.3.1.157)	UDP-N-acetylglucosamine:LPS N-acetylglucosamine  transferase	UDP-N-acetylmuramate	UDP-N-acetylmuramate dehydrogenase	UDP-N-acetylmuramate dehydrogenase (EC  1.1.1.158)	UDP-N-acetylmuramate--L-alanine ligase	UDP-N-acetylmuramate--L-alanine ligase (EC  6.3.2.8)	UDP-N-acetylmuramate:  L-alanyl-gamma-D-glutamyl-meso-diaminopimelate ligase	UDP-N-acetylmuramoylalanine--D-glutamate ligase	UDP-N-acetylmuramoylalanine--D-glutamate ligase  (EC 6.3.2.9)	UDP-N-acetylmuramyl pentapeptide  phosphotransferase/UDP-N-acetylglucosamine-1-phosphate transferase	UDP-N-acetylmuramyl tripeptide synthase	UDP-galactopyranose mutase	UDP-galactose 4-epimerase	UDP-galactose 4-epimerase (EC 5.1.3.2)	UDP-glucose 4-epimerase	UDP-glucose dehydrogenase	UDP-glucose pyrophosphorylase	UDP-glucose pyrophosphorylase (EC 2.7.7.9)	UDP-glucose:(heptosyl)LPS  alpha-1,3-glucosyltransferase	UDP-glucuronate 4-epimerase	UDP-glucuronate decarboxylase	UDP-glucuronosyltransferase-like glycosyl  transferase	UDP-perosamine 4-acetyltransferase	UDP-sulfoquinovose synthase	UDP:flavonoid glycosyltransferase YjiC, YdhE  family	UDPglucose 6-dehydrogenase	UDPglucose--hexose-1-phosphate  uridylyltransferase	UPF0042 nucleotide-binding protein	UPF0176 protein	UPF0271 protein	UPF0716 protein FxsA	UPF0755 protein	UTP--GlnB (protein PII) uridylyltransferase,  GlnD	UTP--glucose-1-phosphate uridylyltransferase	UTP:GlnB (protein PII) uridylyltransferase	UV-damage endonuclease	UbiA prenyltransferase	UbiD family decarboxylase	Ubiquinone biosynthesis hydroxylase,  UbiH/UbiF/VisC/COQ6 family	Ubiquinone biosynthesis protein COQ9	Ubiquinone/menaquinone biosynthesis C-methylase  UbiE	Ubiquitin fusion-degradation protein	Uncaracterized surface protein containing  fasciclin (FAS1) repeats	Uncharacterised 5xTM membrane BCR, YitT family  COG1284	Uncharacterised nucleotidyltransferase	Uncharacterised protein family (UPF0158)	Uncharacterised protein family (UPF0233)	Uncharacterised protein family protein	Uncharacterized 2Fe-2 and 4Fe-4S  clusters-containing protein, contains DUF4445 domain	Uncharacterized ACR, COG1399	Uncharacterized ATPase, putative transposase	Uncharacterized Fe-S cluster protein YjdI	Uncharacterized Fe-S protein	Uncharacterized MnhB-related membrane protein	Uncharacterized N-terminal domain of  lipid-A-disaccharide synthase	Uncharacterized NAD(FAD)-dependent  dehydrogenases	Uncharacterized NAD(P)/FAD-binding protein YdhS	Uncharacterized OsmC-related protein	Uncharacterized SAM-binding protein YcdF, DUF218  family	Uncharacterized SPBc2 prophage-derived protein  YoqJ	Uncharacterized alpha/beta hydrolase domain  (DUF2235)	Uncharacterized anaerobic dehydrogenase	Uncharacterized archaeal kinase related to  aspartokinases, uridylate kinases	Uncharacterized bacitracin resistance protein	Uncharacterized beta-barrel protein YwiB,  DUF1934 family	Uncharacterized conserved protein	Uncharacterized conserved protein (DUF2132)	Uncharacterized conserved protein (DUF2249)	Uncharacterized conserved protein (DUF2278)	Uncharacterized conserved protein (DUF2285)	Uncharacterized conserved protein (DUF2303)	Uncharacterized conserved protein (some members  contain a von Willebrand factor type A (vWA) domain)	Uncharacterized conserved protein GlcG, DUF336  family	Uncharacterized conserved protein PhnB,  glyoxalase superfamily	Uncharacterized conserved protein UCP015557	Uncharacterized conserved protein UCP019302	Uncharacterized conserved protein UCP037205	Uncharacterized conserved protein YaaN involved  in tellurite resistance	Uncharacterized conserved protein YabE, contains  G5 and tandem DUF348 domains	Uncharacterized conserved protein YacL, contains  PIN and TRAM domains	Uncharacterized conserved protein YaeQ,  suppresses RfaH defect	Uncharacterized conserved protein YafD,  endonuclease/exonuclease/phosphatase (EEP) superfamily	Uncharacterized conserved protein YbaA, DUF1428  family	Uncharacterized conserved protein YbaR, Trm112  family	Uncharacterized conserved protein YbbC, DUF1343  family	Uncharacterized conserved protein YbcV, DUF1398  family	Uncharacterized conserved protein YbjQ, UPF0145  family	Uncharacterized conserved protein YbjT, contains  NAD(P)-binding and DUF2867 domains	Uncharacterized conserved protein YcbK, DUF882  family	Uncharacterized conserved protein YcfJ, contains  glycine zipper 2TM domain	Uncharacterized conserved protein YciI, contains  a putative active-site phosphohistidine	Uncharacterized conserved protein YdaU, DUF1376  family	Uncharacterized conserved protein YdbL, DUF1318  family	Uncharacterized conserved protein YdeI,  YjbR/CyaY-like superfamily, DUF1801 family	Uncharacterized conserved protein YdgA, DUF945  family	Uncharacterized conserved protein YdhG,  YjbR/CyaY-like superfamily, DUF1801 family	Uncharacterized conserved protein YdiU, UPF0061  family	Uncharacterized conserved protein YeaO, DUF488  family	Uncharacterized conserved protein YecE, DUF72  family	Uncharacterized conserved protein YecT, DUF1311  family	Uncharacterized conserved protein YegJ, DUF2314  family	Uncharacterized conserved protein YegL, contains  vWA domain of TerY type	Uncharacterized conserved protein YegP, UPF0339  family	Uncharacterized conserved protein YehS, DUF1456  family	Uncharacterized conserved protein YfdQ, DUF2303  family	Uncharacterized conserved protein YgbK, DUF1537  family	Uncharacterized conserved protein YgiB, involved  in bioifilm formation, UPF0441/DUF1190 family	Uncharacterized conserved protein YgiM, contains  N-terminal SH3 domain, DUF1202 family	Uncharacterized conserved protein YidB, DUF937  family	Uncharacterized conserved protein YjbJ, UPF0337  family	Uncharacterized conserved protein YjgD, DUF1641  family	Uncharacterized conserved protein YjiS, DUF1127  family	Uncharacterized conserved protein YkwD, contains  CAP (CSP/antigen 5/PR1) domain	Uncharacterized conserved protein YloU, alkaline  shock protein (Asp23) family	Uncharacterized conserved protein YlxW, UPF0749  family	Uncharacterized conserved protein YndB,  AHSA1/START domain	Uncharacterized conserved protein YqgV,  UPF0045/DUF77 family	Uncharacterized conserved protein YraI	Uncharacterized conserved protein YtfP,  gamma-glutamylcyclotransferase (GGCT)/AIG2-like family	Uncharacterized conserved protein YukE	Uncharacterized conserved protein YurZ,  alkylhydroperoxidase/carboxymuconolactone decarboxylase family	Uncharacterized conserved protein YutE,  UPF0331/DUF86 family	Uncharacterized conserved protein YybS, DUF2232  family	Uncharacterized conserved protein, Alpha-E  superfamily	Uncharacterized conserved protein, DUF1330  family	Uncharacterized conserved protein, DUF1499  family	Uncharacterized conserved protein, DUF1501  family	Uncharacterized conserved protein, DUF1697  family	Uncharacterized conserved protein, DUF1778  family	Uncharacterized conserved protein, DUF1800  family	Uncharacterized conserved protein, DUF2126  family	Uncharacterized conserved protein, DUF2141  family	Uncharacterized conserved protein, DUF2147  family	Uncharacterized conserved protein, DUF2164  family	Uncharacterized conserved protein, DUF2236  family	Uncharacterized conserved protein, DUF2249  family	Uncharacterized conserved protein, DUF2252  family	Uncharacterized conserved protein, DUF2267  family	Uncharacterized conserved protein, DUF2336  family	Uncharacterized conserved protein, DUF302 family	Uncharacterized conserved protein, DUF305 family	Uncharacterized conserved protein, DUF427 family	Uncharacterized conserved protein, DUF433 family	Uncharacterized conserved protein, DUF4415  family	Uncharacterized conserved protein, DUF58 family,  contains vWF domain	Uncharacterized conserved protein, DUF697 family	Uncharacterized conserved protein, DUF736 family	Uncharacterized conserved protein, DUF849 family	Uncharacterized conserved protein, DUF885  familyt	Uncharacterized conserved protein, DUF924 family	Uncharacterized conserved protein, DUF934 family	Uncharacterized conserved protein, DUF952 family	Uncharacterized conserved protein, DUF983 family	Uncharacterized conserved protein, LabA/DUF88  family	Uncharacterized conserved protein, MAPEG  superfamily	Uncharacterized conserved protein, NAD-dependent  epimerase/dehydratase family	Uncharacterized conserved protein, Ntn-hydrolase  superfamily	Uncharacterized conserved protein, UPF0276  family	Uncharacterized conserved protein, UPF0335  family	Uncharacterized conserved protein, circularly  permuted ATPgrasp superfamily	Uncharacterized conserved protein, contains  DUF4213 and DUF364 domains	Uncharacterized conserved protein, contains  FIST_N domain	Uncharacterized conserved protein, contains  Mth938-like domain	Uncharacterized conserved protein, contains  ParB-like and HNH nuclease domains	Uncharacterized conserved protein, contains  Zn-finger domain	Uncharacterized conserved protein, contains  double-stranded beta-helix domain	Uncharacterized conserved protein, contains  ferritin-like DUF455 domain	Uncharacterized conserved protein, contains FHA  domain	Uncharacterized conserved protein, contains GH25  family domain	Uncharacterized conserved protein, contains HEPN  domain	Uncharacterized conserved protein, contains LGFP  repeats	Uncharacterized conserved protein, contains NRDE  domain	Uncharacterized conserved protein, contains Zn  finger domain	Uncharacterized conserved protein, contains a  C-terminal beta-barrel porin domain	Uncharacterized conserved protein, cupin  superfamily	Uncharacterized conserved protein, heparinase  superfamily	Uncharacterized conserved protein, tellurite  resistance protein B (TerB) family	Uncharacterized conserved small protein	Uncharacterized copper-binding protein	Uncharacterized copper-binding protein,  cupredoxin-like subfamily	Uncharacterized damage-inducible protein DinB  (forms a four-helix bundle)	Uncharacterized enzyme involved in biosynthesis  of extracellular polysaccharides	Uncharacterized enzyme of heme biosynthesis	Uncharacterized flavoproteins	Uncharacterized integral membrane protein	Uncharacterized iron-regulated membrane protein	Uncharacterized iron-regulated protein	Uncharacterized kinase	Uncharacterized lipoprotein YddW, UPF0748 family	Uncharacterized low-complexity proteins	Uncharacterized membrane protein	Uncharacterized membrane protein (homolog of  Drosophila rhomboid)	Uncharacterized membrane protein HdeD, DUF308  family	Uncharacterized membrane protein SpoIIM,  required for sporulation	Uncharacterized membrane protein YadS	Uncharacterized membrane protein YcaP, DUF421  family	Uncharacterized membrane protein YccC	Uncharacterized membrane protein YccF, DUF307  family	Uncharacterized membrane protein YcfT	Uncharacterized membrane protein YckC, RDD  family	Uncharacterized membrane protein YczE	Uncharacterized membrane protein YdcZ, DUF606  family	Uncharacterized membrane protein YdjX,  TVP38/TMEM64 family, SNARE-associated domain	Uncharacterized membrane protein YeaQ/YmgE,  transglycosylase-associated protein family	Uncharacterized membrane protein YebE, DUF533  family	Uncharacterized membrane protein YeiH	Uncharacterized membrane protein YfcA	Uncharacterized membrane protein YfcC, ion  transporter superfamily	Uncharacterized membrane protein YfhO	Uncharacterized membrane protein YgaE,  UPF0421/DUF939 family	Uncharacterized membrane protein YgcG, contains  a TPM-fold domain	Uncharacterized membrane protein YgdD,  TMEM256/DUF423 family	Uncharacterized membrane protein YhaH, DUF805  family	Uncharacterized membrane protein YheB, UPF0754  family	Uncharacterized membrane protein YhhN	Uncharacterized membrane protein YjgN, DUF898  family	Uncharacterized membrane protein YjjB, DUF3815  family	Uncharacterized membrane protein YjjP, DUF1212  family	Uncharacterized membrane protein YkgB	Uncharacterized membrane protein YkoI	Uncharacterized membrane protein YkvA, DUF1232  family	Uncharacterized membrane protein YoaK, UPF0700  family	Uncharacterized membrane protein YoaT, DUF817  family	Uncharacterized membrane protein YphA,  DoxX/SURF4 family	Uncharacterized membrane protein YpjA	Uncharacterized membrane protein YqaE, homolog  of Blt101, UPF0057 family	Uncharacterized membrane protein YqiK, contains  Band7/PHB/SPFH domain	Uncharacterized membrane protein YqjE	Uncharacterized membrane protein YsdA, DUF1294  family	Uncharacterized membrane protein YtjA, UPF0391  family	Uncharacterized membrane protein YvbJ	Uncharacterized membrane protein, DUF2068 family	Uncharacterized membrane protein, DUF373 family	Uncharacterized membrane protein, DUF4010 family	Uncharacterized membrane protein, DUF441 family	Uncharacterized membrane protein, DUF485 family	Uncharacterized membrane protein, YccA/Bax  inhibitor family	Uncharacterized membrane protein, predicted  cobalt tansporter CbtA	Uncharacterized membrane-anchored protein	Uncharacterized membrane-anchored protein YitT,  contains DUF161 and DUF2179 domains	Uncharacterized membrane-anchored protein YjiN,  DUF445 family	Uncharacterized membrane-bound protein	Uncharacterized metal-binding protein YceD,  DUF177 family	Uncharacterized phage protein gp47/JayE	Uncharacterized phage-associated protein	Uncharacterized protein	Uncharacterized protein (ATP-grasp superfamily)	Uncharacterized protein YPO0396	Uncharacterized protein YaaQ	Uncharacterized protein YbcI	Uncharacterized protein YcnI	Uncharacterized protein YcsI, UPF0317 family	Uncharacterized protein YebE, UPF0316 family	Uncharacterized protein YfkK, UPF0435 family	Uncharacterized protein YhfF	Uncharacterized protein YigE, DUF2233 family	Uncharacterized protein YjaZ	Uncharacterized protein YjbI, contains  pentapeptide repeats	Uncharacterized protein YjbK	Uncharacterized protein YjcR	Uncharacterized protein YjiK	Uncharacterized protein YjlB	Uncharacterized protein YktA, UPF0223 family	Uncharacterized protein YktB, UPF0637 family	Uncharacterized protein YkvS	Uncharacterized protein YlaI	Uncharacterized protein YmfQ in lambdoid  prophage, DUF2313 family	Uncharacterized protein YneR	Uncharacterized protein YnzC, UPF0291/DUF896  family	Uncharacterized protein YoxC, contains an  MCP-like domain	Uncharacterized protein YpbB	Uncharacterized protein YpiB, UPF0302 family	Uncharacterized protein YpmB	Uncharacterized protein YpmS	Uncharacterized protein YqkB	Uncharacterized protein YtpQ, UPF0354 family	Uncharacterized protein YunC, DUF1805 family	Uncharacterized protein YutD	Uncharacterized protein YuzE	Uncharacterized protein YwqG	Uncharacterized protein conserved in bacteria	Uncharacterized protein conserved in bacteria  (DUF2059).	Uncharacterized protein conserved in bacteria,  prophage-related	Uncharacterized protein conserved in bacteria,  putative lipoprotein	Uncharacterized protein containing a Zn-ribbon  (DUF2116)	Uncharacterized protein containing a divergent  version of the methyl-accepting chemotaxis-like domain	Uncharacterized protein containing a von  Willebrand factor type A (vWA) domain	Uncharacterized protein containing caspase  domain	Uncharacterized protein family UPF0324	Uncharacterized protein involved in  exopolysaccharide biosynthesis	Uncharacterized protein involved in cysteine  biosynthesis	Uncharacterized protein involved in methicillin  resistance	Uncharacterized protein involved in outer  membrane biogenesis	Uncharacterized protein with SCP/PR1 domains	Uncharacterized protein with an alpha/beta  hydrolase fold	Uncharacterized protein with protein kinase and  helix-hairpin-helix DNA-binding domains	Uncharacterized protein, DUF1810 family	Uncharacterized protein, PA2063/DUF2235 family	Uncharacterized protein, RmlC-like cupin domain	Uncharacterized protein, UPF0160 family	Uncharacterized protein, UPF0261 family	Uncharacterized protein, UPF0262 family	Uncharacterized protein, UPF0264 family	Uncharacterized protein, UPF0303 family	Uncharacterized protein, UPF0548 family	Uncharacterized protein, contains FMN-binding  domain	Uncharacterized protein, contains GBA2_N and  DUF608 domains	Uncharacterized protein, contains GYD domain	Uncharacterized protein, contains HEPN domain,  UPF0332 family	Uncharacterized protein, contains PIN domain	Uncharacterized protein, contains SIS (Sugar  ISomerase) phosphosugar binding domain	Uncharacterized protein, contains Zn-finger  domain of CHY type	Uncharacterized protein, contains caspase domain	Uncharacterized protein, contains metal-binding  DGC domain	Uncharacterized protein, contains von Willebrand  factor type A (vWA) domain	Uncharacterized protein, homolog of phage Mu  protein gp30	Uncharacterized protein, linocin/CFP29 family	Uncharacterized protein, possibly involved in  aromatic compounds catabolism	Uncharacterized protein, possibly involved in  utilization of glycolate and propanediol	Uncharacterized proteins of the AP superfamily	Uncharacterized proteins, LmbE homologs	Uncharacterized short protein YbdD, DUF466  family	Uncharacterized small protein (DUF2158)	Uncharacterized small protein (DUF2292)	Uncharacterized small protein, DUF1192 family	Uncharcterized protein, DUF927 family	Undecaprenyl pyrophosphate synthetase	Undecaprenyl pyrophosphate synthetase (EC  2.5.1.31)	Undecaprenyl-diphosphatase	Undecaprenyl-diphosphatase (EC 3.6.1.27)	Undecaprenyl-phosphate galactose  phosphotransferase	Undecaprenyl-phosphate galactose  phosphotransferase, WbaP/exopolysaccharide biosynthesis polyprenyl glycosylphosphotransferase	Undecaprenyl-phosphate glucose  phosphotransferase	Universal stress protein UspA and related  nucleotide-binding proteins	Universal stress protein family protein	Uracil DNA glycosylase superfamily protein	Uracil phosphoribosyltransferase	Uracil-DNA glycosylase	Uracil-DNA glycosylase (EC 3.2.2.-)	UreE urease accessory domain protein	Urease accessory protein UreD	Urease accessory protein UreF	Urease accessory protein UreH	Uridine kinase	Uridine phosphorylase	Uroporphyrin-III C/tetrapyrrole  (Corrin/Porphyrin) methyltransferase	Uroporphyrinogen III synthase HEM4	Usg protein (tryptophan operon, function  unknown)	UspA domain protein	UvrD-like helicase C-terminal domain-containing  protein	UvrD/REP helicase	V-type H(+)-translocating pyrophosphatase	V/A-type H+-transporting ATPase subunit A	V/A-type H+-transporting ATPase subunit B	V/A-type H+-transporting ATPase subunit K	V4R domain-containing protein	V8-like Glu-specific endopeptidase	VCBS repeat-containing protein	VIT family	VIT family.	VPLPA-CTERM protein sorting domain-containing  protein	VTC domain-containing protein	VacJ family lipoprotein	VanW like protein	VanZ family protein	VanZ like family	VanZ like family protein	VanZ like family.	Very-short-patch-repair endonuclease	Vesicle coat complex COPII, subunit  SEC24/subunit SFB2/subunit SFB3	Virulence factor	Virulence-associated protein VapD	Voltage-dependent anion channel	WD-40 repeat-containing protein	WD40 repeat	WD40-like Beta Propeller Repeat	WGR domain-containing protein, predicted  DNA-binding domain in MolR	WVELL protein	WXG100 family type VII secretion target	WYL domain-containing protein	Wax ester synthase-like Acyl-CoA acyltransferase  domain-containing protein	WbqC-like protein family protein	WhiB family transcriptional regulator,  redox-sensing transcriptional regulator	Winged helix DNA-binding domain	Winged helix DNA-binding domain-containing  protein	Winged helix-turn helix	Winged helix-turn-helix DNA-binding	Wobble nucleotide-excising tRNase	WxcM domain protein	WxcM-like, C-terminal	Wyosine [tRNA(Phe)-imidazoG37] synthetase,  radical SAM superfamily	XTP/dITP diphosphohydrolase	Xaa-Pro aminopeptidase	Xaa-Pro dipeptidase	Xanthine and CO dehydrogenases maturation  factor, XdhC/CoxF family	Xanthine/uracil permease	XapX domain-containing protein	YARHG domain-containing protein	YCII-related	YCII-related domain-containing protein	YCII-related protein	YD repeat-containing protein	YHS domain-containing protein	YHS domain.	YKOF-related Family	YMGG-like Gly-zipper	YVTN beta-propeller repeat-containing protein	YXWGXW repeat-containing protein	YadA domain protein	YaeQ family protein	YbaB/EbfC DNA-binding family protein	YbaK/prolyl-tRNA synthetase associated region	YbbR domain-containing protein	YceG-like family protein	YceI family protein	YceI-like domain-containing protein	YcfA-like protein	YcgR	YcgR family protein	YcxB-like protein	YdjC family protein	YfdX protein	YfhD-like protein	YfhE-like protein	YggT family protein	YhfH-like protein	YibE/F-like protein	YidC/Oxa1 family membrane protein insertase	Yip1 domain-containing protein	YjbR protein	YjzC-like protein	YlaH-like protein	YlqD protein	YmaF family protein	YolD-like protein	YppF-like protein	YqaJ-like recombinase domain-containing protein	YqaJ-like viral recombinase domain	YqfQ-like protein	YqjK-like protein	YtkA-like	YugN-like family protein	YuzL-like protein	YvbH-like oligomerisation region	YvrJ protein family protein	YwhD family protein	Z1 domain-containing protein	ZIP Zinc transporter	Zeta toxin	Zinc carboxypeptidase.	Zinc dependent phospholipase C	Zinc finger, CHCC-type	Zinc metalloprotease (elastase)	Zinc transporter ZupT	Zinc-finger domain-containing protein	Zinc-ribbon containing domain-containing protein	Zinicin-like metallopeptidase	ZipA FtsZ-binding region	ZipA, C-terminal FtsZ-binding domain	Zn-dependent dipeptidase, dipeptidase homolog	Zn-dependent dipeptidase, microsomal dipeptidase  homolog	Zn-dependent hydrolases, including glyoxylases	Zn-dependent metalloprotease	Zn-dependent peptidase ImmA, M78 family	Zn-dependent protease (includes SpoIVFB)	Zn-dependent protease with chaperone function	Zn-ribbon protein, possibly nucleic acid-binding	Zn-ribbon-containing, possibly RNA-binding  protein and truncated derivatives	Zonular occludens toxin	Zonular occludens toxin (Zot)	[Acyl-carrier-protein] S-malonyltransferase	[Acyl-carrier-protein] S-malonyltransferase (EC  2.3.1.39)	[LSU ribosomal protein L11P]-lysine  N-methyltransferase	[LSU ribosomal protein L11P]-lysine  N-methyltransferase (EC 2.1.1.-)	[LSU ribosomal protein L3P]-glutamine  N5-methyltransferase (EC 2.1.1.-)	[NiFe] hydrogenase assembly chaperone, HybE  family	[NiFe] hydrogenase diaphorase moiety small  subunit	[NiFe]-hydrogenase I apoprotein, large subunit	[NiFe]-hydrogenase I apoprotein, small subunit	[SSU ribosomal protein S18P]-alanine  acetyltransferase (EC 2.3.1.128)	[SSU ribosomal protein S5P]-alanine  acetyltransferase (EC 2.3.1.128)	[acyl-carrier-protein] S-malonyltransferase	[protein release factor]-glutamine  N5-methyltransferase	[protein release factor]-glutamine  N5-methyltransferase (EC 2.1.1.-)	[sulfur carrier protein ThiS]  adenylyltransferase	aa3 type cytochrome c oxidase subunit IV	abortive infection protein, AbiV family	accessory colonization factor AcfC	accessory regulator family	acetaldehyde dehydrogenase	acetaldehyde dehydrogenase (EC 1.2.1.10)	acetaldehyde dehydrogenase (acetylating)	acetaldehyde/propanal dehydrogenase	acetate kinase	acetate kinase (EC 2.7.2.1)	acetoacetate decarboxylase	acetoacetyl-CoA reductase	acetoacetyl-CoA synthetase	acetoin utilization protein AcuA	acetoin utilization protein AcuB	acetoin utilization protein AcuC	acetolactate decarboxylase	acetolactate synthase, large subunit	acetolactate synthase, large subunit (EC  2.2.1.6)	acetolactate synthase, small subunit	acetolactate synthase, small subunit (EC  2.2.1.6)	acetolactate synthase-1/2/3 large subunit	acetone carboxylase, alpha subunit	acetone carboxylase, beta subunit	acetone carboxylase, gamma subunit	acetone monooxygenase	acetyl esterase	acetyl-CoA C-acetyltransferase	acetyl-CoA acetyltransferase	acetyl-CoA acetyltransferase (EC 2.3.1.9)	acetyl-CoA acetyltransferases	acetyl-CoA acyltransferase	acetyl-CoA carboxylase biotin carboxyl carrier  protein	acetyl-CoA carboxylase carboxyl transferase  subunit alpha	acetyl-CoA carboxylase carboxyl transferase  subunit beta	acetyl-CoA carboxylase carboxyltransferase  subunit alpha	acetyl-CoA carboxylase carboxyltransferase  subunit beta	acetyl-CoA carboxylase, biotin carboxylase	acetyl-CoA carboxylase, biotin carboxylase  subunit	acetyl-CoA hydrolase	acetyl-CoA synthetase	acetyl-CoA/propionyl-CoA carboxylase carboxyl  transferase subunit	acetyl-CoA/propionyl-CoA carboxylase, biotin  carboxylase, biotin carboxyl carrier protein	acetyl-coenzyme A synthetase	acetyl-coenzyme A synthetase (EC 6.2.1.1)	acetylornithine aminotransferase	acetylornithine aminotransferase apoenzyme	acetylornithine aminotransferase apoenzyme (EC  2.6.1.11)	acetylornithine deacetylase	acetylornithine deacetylase (EC 3.5.1.16)	acetylornithine deacetylase or  succinyl-diaminopimelate desuccinylase	acetylornithine/N-succinyldiaminopimelate  aminotransferase	acetyltransferase	acid phosphatase (class A)	acireductone dioxygenase apoprotein	acireductone synthase	aconitase	aconitase (EC 4.2.1.3)	aconitate hydratase	acriflavin resistance protein	activator of photopigment and puc with BLUF  domain	acyl carrier protein	acyl carrier protein NodF	acyl carrier protein-related protein	acyl homoserine lactone synthase	acyl-CoA dehydrogenase	acyl-CoA hydrolase	acyl-CoA thioester hydrolase	acyl-CoA thioester hydrolase, YbgC/YbaW family	acyl-CoA thioesterase	acyl-CoA thioesterase YciA	acyl-CoA thioesterase-1	acyl-CoA thioesterase-2	acyl-[acyl-carrier-protein] desaturase	acyl-[acyl-carrier-protein]-phospholipid  O-acyltransferase / long-chain-fatty-acid--[acyl-carrier-protein] ligase	acyl-homoserine lactone synthase	acyl-phosphate glycerol-3-phosphate  acyltransferase	acylglycerol lipase	acylneuraminate cytidylyltransferase	acylphosphatase	acylpyruvate hydrolase	acyltransferase 3	acyltransferase, WS/DGAT/MGAT	adapter protein MecA 1/2	addiction module antidote protein, HigA family	addiction module toxin, RelE/StbE family	adenine deaminase	adenine phosphoribosyltransferase	adenine phosphoribosyltransferase (EC 2.4.2.7)	adenine specific DNA methyltransferase	adenine-specific DNA-methyltransferase	adenosine deaminase	adenosine deaminase (EC 3.5.4.4)	adenosine kinase	adenosylcobinamide hydrolase	adenosylcobinamide kinase 	adenosylcobinamide kinase (EC  2.7.1.156)/adenosylcobinamide-phosphate guanylyltransferase (EC 2.7.7.62)	adenosylcobinamide-phosphate synthase	adenosylcobinamide-phosphate synthase (EC  6.3.1.10)	adenosylcobyric acid synthase  (glutamine-hydrolysing)	adenosylcobyric acid synthase  (glutamine-hydrolysing) (EC 6.3.5.10)	adenosylhomocysteinase	adenosylhomocysteinase (EC 3.3.1.1)	adenosylhomocysteine nucleosidase	adenosylmethionine-8-amino-7-oxononanoate  aminotransferase	adenosylmethionine-8-amino-7-oxononanoate  aminotransferase apoenzyme (EC 2.6.1.62)	adenylate cyclase	adenylate kinase	adenylate/guanylate cyclase	adenylosuccinate lyase	adenylylsulfate kinase	adenylylsulfate kinase (EC 2.7.1.25)	adenylylsulfate kinase (EC 2.7.1.25)/sulfate  adenylyltransferase subunit 1 (EC 2.7.7.4)	adenylylsulfate kinase /sulfate  adenylyltransferase subunit 1	adenylyltransferase and sulfurtransferase	adsorption protein B	aerobic C4-dicarboxylate transport protein	agmatinase	agmatinase (EC 3.5.3.11)	agmatine deiminase	agmatine deiminase (EC 3.5.3.12)	alanine adding enzyme	alanine dehydrogenase	alanine or glycine:cation symporter, AGCS family	alanine racemase	alanine racemase (EC 5.1.1.1)	alanine racemase domain protein	alanine-glyoxylate aminotransferase apoenzyme  (EC 2.6.1.44)	alanine-glyoxylate transaminase /  (R)-3-amino-2-methylpropionate-pyruvate transaminase	alanine-glyoxylate transaminase /  serine-glyoxylate transaminase / serine-pyruvate transaminase	alanine-synthesizing transaminase	alanyl-tRNA synthetase	alanyl-tRNA synthetase (EC 6.1.1.7)	alcohol dehydrogenase	alcohol dehydrogenase (cytochrome c)	alcohol dehydrogenase, propanol-preferring	aldehyde dehydrogenase	aldehyde dehydrogenase (NAD+)	aldehyde dehydrogenase (acceptor)	aldehyde dehydrogenase (acceptor) (EC 1.2.99.3)	aldehyde oxidase and xanthine dehydrogenase  molybdopterin binding	aldehyde oxidase and xanthine dehydrogenase  molybdopterin binding protein	aldehyde:ferredoxin oxidoreductase	aldo/keto reductase	aldose 1-epimerase	aldose 1-epimerase (EC 5.1.3.3)	aldoxime dehydratase	alginate O-acetyltransferase complex protein  AlgI	alginate O-acetyltransferase complex protein  AlgJ	aliphatic nitrilase	aliphatic sulfonates family ABC transporter,  periplsmic ligand-binding protein	alkaline phosphatase	alkaline phosphatase (EC 3.1.3.1)	alkaline phosphatase D	alkane 1-monooxygenase	alkane 1-monooxygenase (EC 1.14.15.3)	alkanesulfonate monooxygenase	alkanesulfonate monooxygenase, FMNH(2)-dependent	alkyl hydroperoxide reductase subunit F	alkyl hydroperoxide reductase, F subunit	alkyl hydroperoxide reductase/ Thiol specific  antioxidant/ Mal allergen	alkylated DNA repair protein (DNA oxidative  demethylase)	alkyldihydroxyacetonephosphate synthase	alkylhydroperoxidase AhpD family core  domain-containing protein	alkylhydroperoxidase domain protein, Avi_7169  family	alkylhydroperoxidase like protein, AhpD family	alkylphosphonate utilization operon protein PhnA	alkylresorcinol O-methyltransferase	alkylresorcinol/alkylpyrone synthase	allantoate deiminase	allantoicase	allantoin racemase	allantoinase	allophanate hydrolase	allosteric NADP-dependent malic enzyme	allosteric NADP-dependent malic enzyme (EC  1.1.1.40)	alpha amylase catalytic region	alpha,alpha-trehalase	alpha,alpha-trehalose phosphorylase	alpha-1,2-mannosyltransferase	alpha-1,3-mannosyltransferase	alpha-1,3-rhamnosyl/mannosyltransferase	alpha-1,4-digalacturonate transport system  permease protein	alpha-1,4-glucan:maltose-1-phosphate  maltosyltransferase	alpha-1,6-mannosyltransferase	alpha-2-macroglobulin domain protein	alpha-D-ribose 1-methylphosphonate  5-triphosphate diphosphatase	alpha-D-ribose 1-methylphosphonate  5-triphosphate synthase subunit PhnG	alpha-D-ribose 1-methylphosphonate  5-triphosphate synthase subunit PhnH	alpha-D-ribose 1-methylphosphonate  5-triphosphate synthase subunit PhnI	alpha-D-ribose 1-methylphosphonate  5-triphosphate synthase subunit PhnL	alpha-D-ribose 1-methylphosphonate 5-phosphate  C-P lyase	alpha-D-xyloside xylohydrolase	alpha-L-fucosidase	alpha-L-fucosidase 2	alpha-L-glutamate ligase, RimK family	alpha-L-rhamnosidase	alpha-N-arabinofuranosidase	alpha-amylase	alpha-amylase (EC:3.2.1.1)	alpha-galactosidase	alpha-glucosidase	alpha-glucoside transport system  substrate-binding protein	alpha-glucoside transport system ATP-binding  protein	alpha-glucoside transport system permease  protein	alpha-mannosidase	alpha-methylacyl-CoA racemase	alpha-ribazole kinase	alpha-ribazole phosphatase	alpha/beta hydrolase fold	alpha/beta hydrolase fold protein	alternative oxidase (EC 1.10.3.11)	altronate hydrolase	amicyanin apoprotein	amidase	amidase, hydantoinase/carbamoylase family	amidohydrolase	amidohydrolase 2	amidophosphoribosyltransferase	amidophosphoribosyltransferase (EC 2.4.2.14)	amine oxidase	amino acid ABC transporter ATP-binding protein,  PAAT family	amino acid ABC transporter ATP-binding protein,  PAAT family (TC 3.A.1.3.-)	amino acid ABC transporter membrane protein 1,  PAAT family	amino acid ABC transporter membrane protein 1,  PAAT family (TC 3.A.1.3.-)	amino acid ABC transporter membrane protein 2,  PAAT family	amino acid ABC transporter membrane protein 2,  PAAT family (TC 3.A.1.3.-)	amino acid ABC transporter membrane protein,  PAAT family	amino acid ABC transporter membrane protein,  PAAT family (TC 3.A.1.3.-)	amino acid ABC transporter membrane protein,  PAAT family /amino acid ABC transporter ATP-binding protein, PAAT family	amino acid ABC transporter substrate-binding  protein, PAAT family	amino acid ABC transporter substrate-binding  protein, PAAT family (TC 3.A.1.3.-)	amino acid ABC transporter substrate-binding  protein, PAAT family (TC 3.A.1.3.-)/amino acid ABC transporter membrane protein, P	amino acid ABC transporter substrate-binding  protein, PAAT family /amino acid ABC transporter membrane protein, PAAT family	amino acid adenylation domain-containing protein	amino acid carrier protein	amino acid transporter, AAT family	amino acid/amide ABC transporter  substrate-binding protein, HAAT family	amino acid/amide ABC transporter  substrate-binding protein, HAAT family (TC 3.A.1.4.-)	amino acid/amide ABC transporter ATP-binding  protein 1, HAAT family	amino acid/amide ABC transporter ATP-binding  protein 1, HAAT family (TC 3.A.1.4.-)	amino acid/amide ABC transporter ATP-binding  protein 2, HAAT family	amino acid/amide ABC transporter ATP-binding  protein 2, HAAT family (TC 3.A.1.4.-)	amino acid/amide ABC transporter membrane  protein 1, HAAT family	amino acid/amide ABC transporter membrane  protein 1, HAAT family (TC 3.A.1.4.-)	amino acid/amide ABC transporter membrane  protein 1, HAAT family /amino acid/amide ABC transporter membrane protein 2, HAAT fam	amino acid/amide ABC transporter membrane  protein 2, HAAT family	amino acid/amide ABC transporter membrane  protein 2, HAAT family (TC 3.A.1.4.-)	amino acid/amide ABC transporter membrane  protein 2, HAAT family (TC 3.A.1.4.-)/amino acid/amide ABC transporter ATP-binding pr	amino acid/amide ABC transporter membrane  protein 2, HAAT family /amino acid/amide ABC transporter ATP-binding protein 1, HAAT 	amino acid/polyamine/organocation transporter,  APC superfamily	amino acid/polyamine/organocation transporter,  APC superfamily (TC 2.A.3)	amino-acid N-acetyltransferase	aminoacrylate hydrolase	aminoacrylate peracid reductase	aminobenzoyl-glutamate utilization protein B	aminobutyraldehyde dehydrogenase	aminocarboxymuconate-semialdehyde decarboxylase	aminodeoxychorismate lyase	aminodeoxychorismate synthase, glutamine  amidotransferase subunit (EC 2.6.1.85)	aminodeoxychorismate synthase, subunit I	aminoethylphosphonate catabolism associated LysR  family transcriptional regulator	aminoglycoside 2''-phosphotransferase	aminoglycoside 2'-N-acetyltransferase I	aminoglycoside 3'-phosphotransferase-2	aminoglycoside 3-N-acetyltransferase I	aminoglycoside 6'-N-acetyltransferase	aminoglycoside phosphotransferase	aminomethyltransferase	aminomethyltransferase (EC 2.1.2.10)	aminopeptidase	aminopeptidase A. Metallo peptidase. MEROPS  family M17	aminopeptidase G. Metallo peptidase. MEROPS  family M01	aminopeptidase II. Metallo peptidase. MEROPS  family M29	aminopeptidase N	aminopeptidase P (EC:3.4.11.9). Metallo  peptidase. MEROPS family M24B	aminopeptidase T. Metallo peptidase. MEROPS  family M29	aminopeptidase Y	aminopeptidase Y (EC:3.4.11.15). Metallo  peptidase. MEROPS family M28A	aminopeptidase Y Metallo peptidase. MEROPS  family M28A	aminopeptidase-like domain-containing protein	aminotransferase	aminotransferase class I and II	aminotransferase class IV	aminotransferase class-III	ammonium transporter	ammonium transporter (TC 1.A.11)	ammonium transporter, Amt family	amylosucrase	amylovoran biosynthesis glycosyltransferase AmsB	anaerobic magnesium-protoporphyrin IX monomethyl  ester cyclase	anaerobic nitric oxide reductase transcription  regulator	anaerobic ribonucleoside-triphosphate reductase  activating protein	anhydro-N-acetylmuramic acid kinase	anion transporter	antagonist of KipI	anthranilate 1,2-dioxygenase large subunit	anthranilate phosphoribosyltransferase	anthranilate phosphoribosyltransferase (EC  2.4.2.18)	anthranilate synthase component 1	anthranilate synthase component 2	anthranilate synthase, component I	anthranilate synthase, component I (EC 4.1.3.27)	anthranilate synthase, component I /anthranilate  synthase, component II	anthranilate synthase, component II	anthranilate synthase, component II 	anthranilate synthase, component II (EC  4.1.3.27)	anthraniloyl-CoA monooxygenase	anti sigma-E protein, RseA	anti-ECFsigma factor, ChrR	anti-anti-sigma factor	anti-sigma B factor antagonist	anti-sigma-28 factor, FlgM family	anti-sigma-factor antagonist	antibiotic biosynthesis monooxygenase	antitoxin ChpS	antitoxin CptB	antitoxin MazE	antitoxin ParD1/3/4	antitoxin StbD	antitoxin VapB	antitoxin YefM	antitoxin of type II TA system, VapB	apolipoprotein D and lipocalin family protein	apolipoprotein N-acyltransferase	aquaporin Z	arabinofuranan 3-O-arabinosyltransferase	arabinofuranosyltransferase	arabinose-5-phosphate isomerase	arabinosyltransferase A	arabinosyltransferase B	arabinosyltransferase C	arginase	arginine decarboxylase	arginine deiminase	arginine transport system permease protein	arginine-tRNA-protein transferase	arginine:ornithine antiporter / lysine permease	arginine:pyruvate transaminase	argininosuccinate lyase	argininosuccinate lyase (EC 4.3.2.1)	argininosuccinate synthase	argininosuccinate synthase (EC 6.3.4.5)	arginyl-tRNA synthetase	arginyl-tRNA synthetase (EC 6.1.1.19)	aromatic amino acid aminotransferase apoenzyme	aromatic-L-amino-acid decarboxylase	aromatic-amino-acid transaminase	arsenate reductase	arsenate reductase (glutaredoxin)	arsenate reductase and related	arsenate reductase related protein	arsenate-mycothiol transferase	arsenical pump membrane protein	arsenical resistance protein ArsH	arsenical-resistance protein	arsenite efflux ATP-binding protein ArsA	arsenite efflux ATP-binding protein ArsA (TC  3.A.4.1.1)	arsenite efflux membrane protein ArsB	arsenite efflux membrane protein ArsB (TC  3.A.4.1.1; TC 2.A.45.1.1)	arsenite oxidase large subunit	arsenite oxidase small subunit	arsenite transporter, ACR3 family	arsenite-transporting ATPase	aryl-alcohol dehydrogenase	aryl-alcohol dehydrogenase (NADP+)	arylamine N-acetyltransferase	arylformamidase	arylsulfatase	asparaginase	asparagine synthase (glutamine-hydrolysing)	asparagine:proton symporter, AAT family	asparagine:proton symporter, AAT family (TC  2.A.3.1.8)	aspartate 4-decarboxylase	aspartate aminotransferase	aspartate ammonia-lyase	aspartate carbamoyltransferase	aspartate carbamoyltransferase (EC 2.1.3.2)	aspartate dehydrogenase	aspartate kinase	aspartate kinase (EC 2.7.2.4)	aspartate racemase	aspartate racemase (EC 5.1.1.13)	aspartate semialdehyde dehydrogenase	aspartate semialdehyde dehydrogenase (EC  1.2.1.11)	aspartate-alanine antiporter	aspartate-semialdehyde dehydrogenase	aspartate/glutamate/uridylate kinase	aspartyl aminopeptidase	aspartyl protease family protein	aspartyl-tRNA synthetase	aspartyl-tRNA synthetase (EC 6.1.1.12)	aspartyl-tRNA(Asn)/glutamyl-tRNA(Gln)  amidotransferase subunit A	aspartyl/glutamyl-tRNA(Asn/Gln) amidotransferase  subunit A	aspartyl/glutamyl-tRNA(Asn/Gln) amidotransferase  subunit A (EC 6.3.5.-)	aspartyl/glutamyl-tRNA(Asn/Gln) amidotransferase  subunit B	aspartyl/glutamyl-tRNA(Asn/Gln) amidotransferase  subunit B (EC 6.3.5.-)	aspartyl/glutamyl-tRNA(Asn/Gln) amidotransferase  subunit C	aspartyl/glutamyl-tRNA(Asn/Gln) amidotransferase  subunit C (EC 6.3.5.-)	assimilatory nitrate reductase (NADH) alpha  subunit apoprotein	assimilatory nitrate reductase (NADH) alpha  subunit apoprotein (EC 1.7.1.1)	assimilatory nitrate reductase (NADH) beta  subunit	assimilatory nitrate reductase (NADH) beta  subunit (EC 1.7.1.1)	assimilatory nitrate reductase catalytic subunit	assimilatory nitrite reductase (NAD(P)H) large  subunit precursor (EC 1.7.1.4)	assimilatory nitrite reductase (NAD(P)H) small  subunit	assimilatory nitrite reductase (NAD(P)H) small  subunit (EC 1.7.1.4)	atypical dual specificity phosphatase	autotransporter secretion inner membrane protein  TamB	autotransporter secretion outer membrane protein  TamA	autotransporter-associated beta strand  repeat-containing protein	azurin	bacillithiol biosynthesis cysteine-adding enzyme  BshC	bacillithiol biosynthesis deacetylase BshB2	bacillithiol system protein YtxJ	bacitracin transport system permease protein	bacterial nucleoid protein HU beta subunit	bacterial nucleoid protein Hbs	bacterial peptide chain release factor 1 (bRF-1)	bacterial peptide chain release factor 2 (bRF-2)	bacterial peptide chain release factor 3 (bRF-3)	bacterial translation initiation factor 1  (bIF-1)	bacterial translation initiation factor 2  (bIF-2)	bacterial translation initiation factor 3  (bIF-3)	bacteriocin biosynthesis cyclodehydratase  domain-containing protein	bacterioferritin	bacterioferritin-associated ferredoxin	band 7 protein	barbiturase (EC 3.5.2.1)	basic amino acid/polyamine antiporter, APA  family	basic membrane protein A	benzoate membrane transport protein	benzoate transport	benzoate/toluate 1,2-dioxygenase alpha subunit	benzoate/toluate 1,2-dioxygenase beta subunit	benzoate/toluate 1,2-dioxygenase reductase  subunit	benzoyl-CoA reductase subunit B	benzoyl-CoA reductase subunit C	benzoyl-CoA reductase, bcr type, subunit D	benzoylformate decarboxylase	benzoylsuccinyl-CoA thiolase BbsB subunit	benzylsuccinate CoA-transferase BbsE subunit	benzylsuccinate CoA-transferase BbsF subunit	beta-1,4-glucosyltransferase	beta-1,4-mannosyl-glycoprotein  beta-1,4-N-acetylglucosaminyltransferase	beta-N-acetylhexosaminidase	beta-RFAP synthase	beta-alanine--pyruvate transaminase	beta-carotene 3-hydroxylase	beta-fructofuranosidase	beta-galactosidase	beta-glucosidase	beta-glucuronidase	beta-hydroxylase	beta-ketoacyl ACP synthase	beta-ketodecanoyl-[acyl-carrier-protein]  synthase	beta-lactamase class A	beta-lactamase class D	beta-lactamase domain protein	beta-lactamase-like protein	beta-mannosidase	beta-mannosidase (EC 3.2.1.25)	beta-methylmalyl-CoA/L-malyl-CoA lyase	beta-methylmalyl-CoA/L-malyl-CoA lyase (EC  4.1.3.24)	beta-ribofuranosylaminobenzene 5'-phosphate  synthase	beta-ribofuranosylaminobenzene 5'-phosphate  synthase family	betaine aldehyde dehydrogenase (EC 1.2.1.8)	betaine-aldehyde dehydrogenase	betaine/carnitine transporter, BCCT family	bifunctional NMN adenylyltransferase/nudix  hydrolase	bifunctional UDP-N-acetylglucosamine  pyrophosphorylase / Glucosamine-1-phosphate N-acetyltransferase	bifunctional enzyme CysN/CysC	bifunctional isochorismate lyase / aryl carrier  protein	bifunctional non-homologous end joining protein  LigD	bile acid:Na+ symporter, BASS family	binding-protein-dependent transport systems  inner membrane component	biofilm PGA synthesis lipoprotein PgaB	biopolymer transport protein ExbB	biopolymer transport protein ExbD	biopolymer transport protein TolQ	biopolymer transport protein TolR	biotin biosynthesis protein BioC	biotin biosynthesis protein BioZ	biotin carboxyl carrier protein	biotin carboxyl carrier protein /biotin  carboxylase	biotin carboxyl carrier protein/biotin  carboxylase (EC 6.3.4.14)	biotin carboxylase (EC 6.3.4.14)/acetyl-CoA  carboxylase carboxyltransferase subunit alpha	biotin synthase	biotin synthase (EC 2.8.1.6)	biotin transport system ATP-binding protein	biotin transport system permease protein	biotin transport system substrate-specific  component	biotin-dependent carboxylase uncharacterized  domain-containing protein	biotin/acetyl-CoA-carboxylase ligase	biotin/methionine sulfoxide reductase	branched chain amino acid aminotransferase  apoenzyme	branched chain amino acid aminotransferase  apoenzyme (EC 2.6.1.42)	branched chain amino acid:  2-keto-4-methylthiobutyrate aminotransferase apoenzyme	branched-chain alpha-keto acid dehydrogenase E1  component	branched-chain alpha-keto acid dehydrogenase E1  component (EC 1.2.4.4)	branched-chain amino acid aminotransferase	branched-chain amino acid transport system  ATP-binding protein	branched-chain amino acid transport system  permease protein	branched-chain amino acid transport system  substrate-binding protein	branched-chain amino acid:cation transporter,  LIVCS family	broad-specificity cellobiase (EC 3.2.1.21)	butyryl-CoA dehydrogenase	butyryl-CoA dehydrogenase (EC 1.3.99.2)	c-di-AMP phosphodiesterase, consists of a  GGDEF-like and DHH domains	c-di-GMP-binding flagellar brake protein YcgR,  contains PilZNR and PilZ domains	c-di-GMP-related signal transduction protein,  contains EAL and HDOD domains	c-type cytochrome, methanol metabolism-related	cAMP-binding domain of CRP or a regulatory  subunit of cAMP-dependent protein kinases	cadmium-sensing regulator, CadC	calcium-binding EF-hand-containing protein	camphor resistance protein CrcB	capsular exopolysaccharide family	capsular polysaccharide export protein	capsular polysaccharide transport system  ATP-binding protein	capsular polysaccharide transport system  permease protein	carbamate kinase	carbamoyl-phosphate synthase large subunit	carbamoyl-phosphate synthase small subunit	carbamoyltransferase	carbohydrate ABC transporter ATP-binding  protein, CUT1 family	carbohydrate ABC transporter ATP-binding  protein, CUT1 family (TC 3.A.1.1.-)	carbohydrate ABC transporter membrane protein 1,  CUT1 family	carbohydrate ABC transporter membrane protein 1,  CUT1 family (TC 3.A.1.1.-)	carbohydrate ABC transporter membrane protein 2,  CUT1 family	carbohydrate ABC transporter membrane protein 2,  CUT1 family (TC 3.A.1.1.-)	carbohydrate ABC transporter substrate-binding  protein, CUT1 family	carbohydrate ABC transporter substrate-binding  protein, CUT1 family (TC 3.A.1.1.-)	carbohydrate diacid regulator	carbohydrate kinase, YjeF related protein	carbon dioxide concentrating mechanism protein  CcmM	carbon monoxide dehydrogenase, large subunit  apoprotein	carbon starvation protein	carbon starvation protein CstA	carbon storage regulator, CsrA	carbon-monoxide dehydrogenase large subunit	carbon-monoxide dehydrogenase medium subunit	carbon-monoxide dehydrogenase small subunit	carbon-nitrogen hydrolase family protein	carbonic anhydrase	carboxyl-terminal processing protease	carboxyl-terminal protease	carboxylate-amine ligase	carboxylesterase	carboxylesterase BioH (pimeloyl-CoA synthesis)  (EC 3.1.1.85)	carboxymethylenebutenolidase	carboxynorspermidine decarboxylase	carboxynorspermidine decarboxylase (EC 4.1.1.-)	carboxynorspermidine dehydrogenase	carboxypeptidase Taq	carboxypeptidase Taq Metallo peptidase. MEROPS  family M32	carboxyvinyl-carboxyphosphonate phosphorylmutase	cardiolipin synthase	cardiolipin synthetase 2 (EC 2.7.8.-)	carnitine 3-dehydrogenase	carotenoid 1,2-hydratase	carotenoid cleavage dioxygenase	catabolite repression HPr-like protein	catalase	catalase-peroxidase	catalase/peroxidase HPI	catechol 1,2-dioxygenase	catechol 2,3-dioxygenase	catechol O-methyltransferase	catecholate siderophore receptor	cation diffusion facilitator family transporter	cation efflux protein	cation transport protein ChaC	cation-transporting ATPase E	cation-transporting ATPase G	cation-transporting P-type ATPase A/B	cation-transporting P-type ATPase C	cation/acetate symporter	cation:H+ antiporter	cell cycle transcriptional regulator CtrA	cell division ATP-binding protein FtsE	cell division checkpoint GTPase YihA	cell division inhibitor SepF	cell division inhibitor SlmA/transcriptional  regulator, TetR family	cell division initiation protein	cell division protease FtsH	cell division protein DivIC	cell division protein FtsA	cell division protein FtsB	cell division protein FtsI (penicillin-binding  protein 3)	cell division protein FtsL	cell division protein FtsQ	cell division protein FtsW	cell division protein FtsW, lipid II flippase	cell division protein FtsX	cell division protein FtsZ	cell division protein ZapA	cell division protein ZapB	cell division protein ZapD	cell division protein ZapE	cell division topological specificity factor	cell division topological specificity factor  MinE	cell division transport system ATP-binding  protein	cell division transport system permease protein	cell division-specific peptidoglycan  biosynthesis regulator FtsW	cell elongation-specific peptidoglycan  D,D-transpeptidase	cell elongation-specific peptidoglycan  biosynthesis regulator RodA	cell volume regulation protein A	cellulose synthase (UDP-forming)	cellulose synthase catalytic subunit  (UDP-forming)	cellulose synthase subunit	cellulose synthase subunit B	cephalosporin-C deacetylase	ceramide glucosyltransferase	chain length determinant protein EpsF	chain length determinant protein tyrosine kinase  EpsG	channel protein, hemolysin III family	chaperone TorD involved in molybdoenzyme TorA  maturation	chaperone modulatory protein CbpM	chaperone protein	chaperone protein DnaJ	chaperone protein DnaK	chaperonin Cpn10	chaperonin GroEL	chaperonin GroES	chemosensory pili system protein ChpA (sensor  histidine kinase/response regulator)	chemotaxis phosphatase, CheZ	chemotaxis protein CheC	chemotaxis protein CheD	chemotaxis protein CheX	chemotaxis protein CheZ	chemotaxis protein MotA	chemotaxis protein MotB	chemotaxis protein MotC	chemotaxis protein MotD	chemotaxis protein methyltransferase CheR	chemotaxis protein methyltransferase WspC	chemotaxis-related protein WspB	chemotaxis-related protein WspD	chitinase	chitinase family 18 (EC:3.2.1.14)	chitosanase of glycosyl hydrolase group 75	chloramphenicol 3-O phosphotransferase	chloramphenicol O-acetyltransferase type B	chloramphenicol-sensitive protein RarD	chloride channel protein, CIC family	chlorite dismutase	chlorophyll synthase	chlorophyllide a reductase subunit X	chlorophyllide a reductase subunit Y	chlorophyllide a reductase subunit Z	cholesterol oxidase	cholesterol transport system auxiliary component	choline ABC transporter, periplasmic binding  protein	choline dehydrogenase	choline dehydrogenase (EC 1.1.99.1)	choline oxidase	choline-sulfatase	choline/carnitine/betaine transport	choline/glycine/proline betaine transport  protein	choloylglycine hydrolase	chorismate lyase	chorismate lyase (EC 4.1.3.40)	chorismate mutase	chorismate mutase (EC 5.4.99.5)	chorismate mutase (EC 5.4.99.5)/prephenate  dehydratase (EC 4.2.1.51)	chorismate synthase	chorismate synthase (EC 4.2.3.5)	chromate transporter	chromate transporter, chromate ion transporter  (CHR) family	chromosomal replication initiator protein	chromosomal replication initiator protein DnaA	chromosome partitioning protein	chromosome partitioning protein, ParB family	chromosome segregation ATPase	chromosome segregation DNA-binding protein	chromosome segregation protein	circadian clock protein KaiB	circadian clock protein KaiC	citrate carrier protein, CCS family	citrate lyase subunit beta / citryl-CoA lyase	citrate synthase	citrate synthase (EC 2.3.3.1)	citrate-Mg2+:H+ or citrate-Ca2+:H+ symporter,  CitMHS family	citrate/tricarballylate utilization protein	citronellol/citronellal dehydrogenase	class II aldolase/adducin family protein	co-chaperone Hsc20	cob(I)alamin adenosyltransferase	cob(I)yrinic acid a,c-diamide  adenosyltransferase	cob(I)yrinic acid a,c-diamide  adenosyltransferase (EC 2.5.1.17)	cob(II)yrinic acid a,c-diamide reductase	cob(II)yrinic acid a,c-diamide reductase 	cobalamin biosynthesis protein CobW	cobalamin synthesis protein P47K	cobalamin-5'-phosphate synthase	cobalamin-5'-phosphate synthase (EC 2.7.8.26)	cobalt transporter subunit CbtA	cobalt transporter subunit CbtB	cobalt-precorrin 5A acetaldehyde-lyase (EC  3.7.1.12)	cobalt-precorrin 5A hydrolase	cobalt-precorrin 5A hydrolase / precorrin-3B  C17-methyltransferase	cobalt-precorrin-5B (C1)-methyltransferase	cobalt-zinc-cadmium efflux system protein	cobalt-zinc-cadmium resistance protein CzcA	cobalt/nickel transport protein	cobalt/nickel transport system ATP-binding  protein	cobalt/nickel transport system permease protein	cobaltochelatase CobN	cobaltochelatase CobN subunit	cobaltochelatase CobN subunit (EC 6.6.1.2)	cobaltochelatase CobS subunit	cobaltochelatase CobT subunit	cobyrinic acid a,c-diamide synthase	cobyrinic acid ac-diamide synthase	coenzyme F420 hydrogenase subunit beta	coenzyme F420-0 gamma-glutamyl ligase (EC  6.3.2.31)	coenzyme F420-0:L-glutamate ligase / coenzyme  F420-1:gamma-L-glutamate ligase	coenzyme F420-dependent glucose-6-phosphate  dehydrogenase	coenzyme PQQ biosynthesis protein A	coenzyme PQQ biosynthesis protein B	coenzyme PQQ biosynthesis protein C	coenzyme PQQ biosynthesis protein E	coenzyme PQQ precursor peptide PqqA	coenzyme PQQ synthesis D	coenzyme Q-binding protein COQ10	colanic acid biosynthesis glycosyl transferase  WcaI	colanic acid biosynthesis protein WcaH	colanic acid/amylovoran biosynthesis  glycosyltransferase	colanic acid/amylovoran biosynthesis protein	cold shock protein (beta-ribbon, CspA family)	cold-shock DNA-binding domain protein	cold-shock DNA-binding protein family	colicin V processing peptidase. Cysteine  peptidase. MEROPS family C39	colicin import membrane protein	collagen, type I/II/III/V/XI/XXIV/XXVII, alpha	comF family protein	competence protein ComEA	competence protein ComEA helix-hairpin-helix  repeat protein	competence protein ComEC	competence protein ComER	competence protein ComFA	competence protein ComGB	competence protein ComGD	competence protein ComGF	competence protein ComK	competence-related pilin export protein ComGB	concentrative nucleoside transporter, CNT family	condensin subunit ScpA	condensin subunit ScpB	condensin subunit Smc	coniferyl-aldehyde dehydrogenase	conjugal transfer protein	conjugal transfer/type IV secretion protein  DotA/TraY	conjugation TrbI family protein	conjugation peptidase TraF. Serine peptidase.  MEROPS family S26C	conjugative relaxase domain-containing protein,  TrwC/TraI family	conjugative transfer region protein TrbK	conjugative transfer signal peptidase TraF	conserved hypothetical integral membrane protein	conserved hypothetical integral membrane protein  TIGR02206	conserved hypothetical phage tail region protein	conserved hypothetical protein	conserved hypothetical protein EF_0839/AHA_3917	conserved hypothetical protein TIGR01655	conserved hypothetical protein, PP_1857 family	conserved hypothetical protein, cofD-related	conserved hypothetical protein, putative P-loop  containing nucleoside triphosphate hydrolase	conserved hypothetical protein, steroid  delta-isomerase-related	conserved hypothetical protein; putative signal  peptide	conserved hypothetical tiny transmembrane  protein	conserved repeat domain-containing  protein/fimbrial isopeptide formation D2 domain-containing protein	conserved repeat domain-containing protein	copper chaperone	copper chaperone NosL	copper homeostasis protein	copper ion binding protein	copper resistance D	copper resistance protein B	copper resistance protein CopC	copper transport protein	copper-resistance protein, CopA family	coproporphyrinogen III oxidase, anaerobic (EC  1.3.99.22)	coproporphyrinogen oxidase	coproporphyrinogen oxidase (EC 1.3.3.3)	creatinase	creatinine amidohydrolase	crescentin	crossover junction endodeoxyribonuclease RusA	crotonobetaine/carnitine-CoA ligase	crotonobetainyl-CoA hydratase	crotonyl-CoA carboxylase/reductase	cryptochrome, DASH family	cupin 2 domain-containing protein	cupin fold metalloprotein, WbuC family	curli production assembly/transport component  CsgF	curli production assembly/transport component  CsgG	curved DNA-binding protein	cutinase	cyanate lyase	cyanophycin synthetase	cyanuric acid amidohydrolase	cyclase	cyclase/dehydrase	cyclic beta-1,2-glucan synthetase	cyclic nucleotide-binding protein	cyclic nucleotide-regulated FAD-dependent  pyridine nucleotide-disulphide oxidoreductase	cyclic pyranopterin monophosphate synthase  subunit MoaA	cyclic pyranopterin monophosphate synthase  subunit MoaA (EC 4.1.99.18)	cyclic pyranopterin monophosphate synthase  subunit MoaC	cyclic pyranopterin monophosphate synthase  subunit MoaC (EC 4.1.99.18)	cyclic pyranopterin phosphate synthase	cyclic-di-GMP phosphodiesterase, flagellum  assembly factor TipF	cyclic-di-GMP-binding biofilm dispersal mediator  protein	cyclohexadieny/prephenate dehydrogenase	cyclohexanecarboxyl-CoA dehydrogenase	cyclohexanecarboxylate-CoA ligase	cyclohexyl-isocyanide hydratase	cyclomaltodextrinase	cyclopentanol dehydrogenase	cyclopropane-fatty-acyl-phospholipid synthase	cyclopropane-fatty-acyl-phospholipid synthase  (EC 2.1.1.79)	cyd operon protein YbgT	cystathione beta-lyase	cystathionine beta-lyase	cystathionine beta-lyase (EC 4.4.1.8)	cystathionine beta-synthase	cystathionine beta-synthase (EC 4.2.1.22)	cystathionine gamma-lyase	cystathionine gamma-lyase (EC 4.4.1.1)	cystathionine gamma-synthase	cystathionine gamma-synthase (EC 2.5.1.48)	cysteine desulfurase	cysteine desulfurase (EC  2.8.1.7)/L-selenocysteine selenide-lyase (L-alanine-forming) (EC 4.4.1.16)	cysteine desulfurase (EC 2.8.1.7)	cysteine desulfurase / selenocysteine lyase	cysteine desulfurase IscS	cysteine desulfurase family protein, VC1184  subfamily	cysteine desulfurase, SufS subfamily	cysteine desulfuration protein SufE	cysteine synthase	cysteine synthase (EC 2.5.1.47)	cysteine synthase (EC 2.5.1.47)/cystathionine  gamma-synthase (EC 2.5.1.48)	cysteine synthase A	cysteine synthase B	cysteinyl-tRNA synthetase	cysteinyl-tRNA synthetase (EC 6.1.1.16)	cystine transport system ATP-binding protein	cystine transport system permease protein	cystine transport system substrate-binding  protein	cytidine deaminase	cytidylate kinase	cytidylate kinase (EC 2.7.4.14)	cytidyltransferase-related domain protein	cytochrome B561	cytochrome C biogenesis protein	cytochrome C oxidase mono-heme subunit/FixO	cytochrome P450 / NADPH-cytochrome P450  reductase	cytochrome b pre-mRNA-processing protein 3	cytochrome b561	cytochrome ba3 quinol oxidase subunit 1  apoprotein	cytochrome ba3 quinol oxidase subunit 3	cytochrome bd-I ubiquinol oxidase subunit 1  apoprotein	cytochrome bd-I ubiquinol oxidase subunit 1  apoprotein (EC 1.10.3.10)	cytochrome bd-I ubiquinol oxidase subunit 2  apoprotein	cytochrome bd-I ubiquinol oxidase subunit 2  apoprotein (EC 1.10.3.10)	cytochrome bo3 quinol oxidase subunit 1  apoprotein	cytochrome bo3 quinol oxidase subunit 1  apoprotein (EC 1.10.3.-)	cytochrome bo3 quinol oxidase subunit 2 (EC  1.10.3.-)	cytochrome bo3 quinol oxidase subunit 3	cytochrome bo3 quinol oxidase subunit 3 (EC  1.10.3.-)	cytochrome bo3 quinol oxidase subunit 4	cytochrome bo3 quinol oxidase subunit 4 (EC  1.10.3.-)	cytochrome c	cytochrome c assembly protein	cytochrome c biogenesis protein	cytochrome c biogenesis protein CcmG,  thiol:disulfide interchange protein DsbE	cytochrome c biogenesis protein transmembrane  region	cytochrome c class I	cytochrome c family protein	cytochrome c oxidase accessory protein CcoG	cytochrome c oxidase accessory protein FixG	cytochrome c oxidase assembly protein CtaG/Cox11	cytochrome c oxidase assembly protein subunit 11	cytochrome c oxidase assembly protein subunit 15	cytochrome c oxidase cbb3-type subunit 1	cytochrome c oxidase cbb3-type subunit 2	cytochrome c oxidase cbb3-type subunit 3	cytochrome c oxidase cbb3-type subunit 4	cytochrome c oxidase subunit 1	cytochrome c oxidase subunit 2	cytochrome c oxidase subunit 3	cytochrome c oxidase subunit I+III	cytochrome c oxidase subunit III	cytochrome c oxidase, cbb3-type, subunit I	cytochrome c oxidase, cbb3-type, subunit II	cytochrome c oxidase, cbb3-type, subunit III	cytochrome c oxidase, subunit I	cytochrome c oxidase, subunit II	cytochrome c peroxidase	cytochrome c(L)	cytochrome c-550 PedF	cytochrome c-L	cytochrome c-type biogenesis protein	cytochrome c-type biogenesis protein CcmE	cytochrome c-type biogenesis protein CcmF	cytochrome c-type biogenesis protein CcmH	cytochrome c-type biogenesis protein CcmI	cytochrome c-type biogenesis protein CcsB	cytochrome c1	cytochrome c1 precursor protein	cytochrome c551	cytochrome cL apoprotein	cytochrome d ubiquinol oxidase subunit I	cytochrome d ubiquinol oxidase subunit II	cytochrome o ubiquinol oxidase operon protein  cyoD	cytochrome o ubiquinol oxidase subunit 1	cytochrome o ubiquinol oxidase subunit 2	cytochrome o ubiquinol oxidase subunit 3	cytochrome oxidase assembly	cytochrome oxidase maturation protein, cbb3-type	cytochrome-dependent sulfide dehydrogenase  (flavoprotein) (EC 1.8.2.-)	cytosine deaminase	cytosine permease	cytoskeleton protein RodZ	dATP pyrophosphohydrolase	dCTP deaminase	dCTP deaminase (EC 3.5.4.13)	dGTPase	dTDP-4-amino-4,6-dideoxygalactose transaminase	dTDP-4-dehydrorhamnose 3,5-epimerase	dTDP-4-dehydrorhamnose 3,5-epimerase (EC  5.1.3.13)	dTDP-4-dehydrorhamnose reductase	dTDP-4-dehydrorhamnose reductase 	dTDP-4-dehydrorhamnose reductase (EC 1.1.1.133)	dTDP-L-rhamnose 4-epimerase	dTDP-glucose 4,6-dehydratase	dTDP-glucose 4,6-dehydratase (EC 4.2.1.46)	dTMP kinase	dUTP pyrophosphatase	death on curing protein	deazaflavin-dependent oxidoreductase,  nitroreductase family	decaprenyl-phosphate phosphoribosyltransferase	decaprenylphospho-beta-D-ribofuranose 2-oxidase	deferrochelatase/peroxidase EfeB	delta-1-piperideine-6-carboxylate dehydrogenase  (EC 1.2.1.-)	delta-1-pyrroline-5-carboxylate dehydrogenase	demethylmenaquinone methyltransferase	demethylmenaquinone methyltransferase 	demethylmenaquinone methyltransferase (EC  2.1.1.163)	demethylmenaquinone methyltransferase /  2-methoxy-6-polyprenyl-1,4-benzoquinol methylase	demethylspheroidene O-methyltransferase	deoxycytidine triphosphate deaminase	deoxyguanosinetriphosphate triphosphohydrolase	deoxynucleoside kinase	deoxyribodipyrimidine photo-lyase	deoxyribodipyrimidine photo-lyase family protein  (cryptochrome)	deoxyribodipyrimidine photo-lyase type I	deoxyribodipyrimidine photolyase-related protein	deoxyribonuclease-4	deoxyribose-phosphate aldolase	deoxyuridine 5'-triphosphate nucleotidohydrolase	deoxyuridine 5'-triphosphate nucleotidohydrolase  (EC 3.6.1.23)	deoxyuridine 5'-triphosphate nucleotidohydrolase  Dut	dephospho-CoA kinase	dephospho-CoA kinase (EC 2.7.1.24)	dethiobiotin synthase	dethiobiotin synthase (EC 6.3.3.3)	dethiobiotin synthetase	diacylglycerol O-acyltransferase / trehalose  O-mycolyltransferase	diacylglycerol kinase	diacylglycerol kinase (ATP)	diacylglycerol kinase (EC 2.7.1.107)	diacylglycerol kinase catalytic region	diadenylate cyclase	diamine N-acetyltransferase	diaminobutyrate acetyltransferase	diaminobutyrate aminotransferase apoenzyme	diaminobutyrate aminotransferase apoenzyme (EC  2.6.1.76)	diaminobutyrate-2-oxoglutarate transaminase	diaminohydroxyphosphoribosylaminopyrimidine  deaminase	diaminohydroxyphosphoribosylaminopyrimidine  deaminase (EC 3.5.4.26)	diaminohydroxyphosphoribosylaminopyrimidine  deaminase (EC 3.5.4.26)/5-amino-6-(5-phosphoribosylamino)uracil reductase (EC 1.1.1	diaminohydroxyphosphoribosylaminopyrimidine  deaminase / 5-amino-6-(5-phosphoribosylamino)uracil reductase	diaminopimelate decarboxylase	diaminopimelate decarboxylase (EC 4.1.1.20)	diaminopimelate dehydrogenase	diaminopimelate epimerase	diaminopimelate epimerase (EC 5.1.1.7)	diaminopropionate ammonia-lyase	dibenzothiophene monooxygenase (EC 1.14.13.-)	dienelactone hydrolase	diguanylate cyclase	diguanylate cyclase (GGDEF) domain-containing  protein	diguanylate cyclase (GGDEF) domain-containing  protein/hemerythrin-like metal-binding domain protein	diguanylate cyclase with GAF sensor	diguanylate cyclase with PAS/PAC and GAF sensors	diguanylate cyclase with PAS/PAC sensor	diguanylate cyclase/phosphodiesterase	diguanylate cyclase/phosphodiesterase with  PAS/PAC and Chase sensor(s)	diguanylate cyclase/phosphodiesterase with  PAS/PAC and GAF sensor(s)	diguanylate cyclase/phosphodiesterase with  PAS/PAC sensor(s)	diguanylate cyclase/phosphodiesterase with  extracellular sensor	diguanylate phosphodiesterase	diheme cytochrome SoxA (sulfur oxidation)	dihydrodipicolinate reductase	dihydrodipicolinate reductase (EC 1.3.1.26)	dihydrodipicolinate synthase	dihydrodipicolinate synthase (EC 4.2.1.52)	dihydrodipicolinate synthetase	dihydroflavonol-4-reductase	dihydrofolate reductase	dihydrofolate reductase (EC 1.5.1.3)	dihydrofolate synthase / folylpolyglutamate  synthase	dihydrolipoamide dehydrogenase	dihydrolipoamide dehydrogenase (EC 1.8.1.4)	dihydromethanopterin reductase	dihydroneopterin aldolase	dihydroneopterin triphosphate pyrophosphatase	dihydroorotase	dihydroorotase (EC 3.5.2.3)	dihydroorotate dehydrogenase (NAD+) catalytic  subunit	dihydroorotate dehydrogenase electron transfer  subunit	dihydroorotate oxidase A	dihydroorotate oxidase A (EC 1.3.3.1)	dihydroorotate oxidase B, catalytic subunit 	dihydroorotate oxidase B, electron transfer  subunit (EC 1.3.3.1)	dihydropteroate synthase	dihydropteroate synthase DHPS	dihydropteroate synthase-related protein	dihydropyrimidinase	dihydropyrimidinase (EC 3.5.2.2)	dihydropyrimidine dehydrogenase (NAD+) subunit  PreA	dihydroxy-acid dehydratase	dihydroxyacetone kinase	dihydroxyacetone kinase DhaK subunit	dihydroxyacetone kinase DhaK subunit (EC  2.7.1.121)	dihydroxyacetone kinase DhaL subunit	dihydroxyacetone kinase DhaL subunit (EC  2.7.1.121)	dihydroxyacetone kinase DhaM subunit (EC  2.7.1.121)	dihydroxyacetone kinase, C-terminal domain	dihydroxyacetone kinase, N-terminal domain	dihydroxyacetone kinase, phosphotransfer subunit	dihydroxyacid dehydratase	dihydroxyacid dehydratase (EC 4.2.1.9)	dihydroxycyclohexadiene carboxylate  dehydrogenase	dimethyladenosine transferase	dimethyladenosine transferase (EC 2.1.1.-)	dimethylamine dehydrogenase apoprotein	dimethylamine/trimethylamine dehydrogenase	dimethylamine:proton symporter, ABT family (TC  2.A.3.6.2)	dimethylargininase	dimethylglycine dehydrogenase	dimethylglycine oxidase (EC 1.5.3.10)	dimethylhistidine N-methyltransferase	dimethylsulfone monooxygenase	dimethylsulfone monooxygenase (EC 1.14.14.-)	dinuclear metal center protein, YbgI/SA1388  family	dipeptidase AC. Metallo peptidase. MEROPS family  M19	dipeptide transport system ATP-binding protein	dipeptide transport system permease protein	dipeptide transport system substrate-binding  protein	dipicolinate synthase subunit A	dissimilatory nitrite reductase (NO-forming),  copper type apoprotein	disulfide bond formation protein DsbB	divalent cation tolerance protein	divinylchlorophyllide 8-vinylreductase	dnaA protein helix-turn-helix	dolichol-phosphate mannosyltransferase	domain of unknown function DUF1732	domain of unknown function DUF1738	domain of unknown function DUF1745	doubled CXXCH domain-containing protein	drug resistance transporter, Bcr/CflA subfamily	drug resistance transporter, EmrB/QacA subfamily	drug/metabolite transporter, DME family	ectoine synthase (EC 4.2.1.108)	effector-binding domain-containing protein	efflux transporter, RND family, MFP subunit	efflux transporter, outer membrane factor (OMF)  lipoprotein, NodT family	electron transfer flavoprotein alpha subunit	electron transfer flavoprotein alpha subunit  apoprotein	electron transfer flavoprotein beta subunit	electron transfer flavoprotein-quinone  oxidoreductase	electron transport complex protein RnfA	electron transport complex protein RnfB	electron transport complex protein RnfC	electron transport complex protein RnfD	electron transport complex protein RnfE	electron transport complex protein RnfG	electron transport complex, RnfABCDGE type, A  subunit	electron transport complex, RnfABCDGE type, B  subunit	electron transport complex, RnfABCDGE type, C  subunit	electron transport complex, RnfABCDGE type, D  subunit	electron transport complex, RnfABCDGE type, E  subunit	electron transport complex, RnfABCDGE type, G  subunit	electron transport protein SCO1/SenC	electron-transferring-flavoprotein dehydrogenase	elongation factor G	elongation factor P	elongation factor Ts	elongation factor Tu	enamidase	endo-1,3-1,4-beta-glycanase ExoK	endo-1,4-beta-xylanase	endo-alpha-N-acetylgalactosaminidase	endodeoxyribonuclease RusA	endoglucanase	endonuclease	endonuclease G	endonuclease IV	endonuclease-3	endonuclease-8	endoribonuclease L-PSP	endothelin-converting enzyme (EC 3.4.24.71).  Metallo peptidase. MEROPS family M13	endothelin-converting enzyme Metallo peptidase.  MEROPS family M13	energy coupling factor transporter S component  ThiW	energy-coupling factor transport system  ATP-binding protein	energy-coupling factor transport system  substrate-specific component	energy-coupling factor transport system permease  protein	enolase	enolase (EC 4.2.1.11)	enolase-phosphatase E1	enoyl-CoA hydratase	enoyl-[acyl-carrier protein] reductase III	enterobactin synthetase component F	enterochelin esterase	entry exclusion lipoprotein TrbK	entry exclusion protein TrbK, Ti-type	epoxide hydrolase	epoxyqueuosine reductase	ergothioneine biosynthesis protein EgtB	error-prone DNA polymerase	error-prone DNA polymerase, DnaE-like	error-prone DNA polymerase, DnaE-like (EC  2.7.7.7)	erythritol kinase	erythritol transport system ATP-binding protein	erythritol transport system permease protein	erythritol transport system substrate-binding  protein	esterase	esterase, PHB depolymerase family	esterase/lipase-like protein	ethanolamine permease	ethanolamine transporter	ethanolamine utilization protein EutA	ethanolamine utilization protein EutL	ethanolamine utilization protein EutN	ethanolamine:proton symporter, EAT family	ethanolamine:proton symporter, EAT family (TC  2.A.3.5.1)	ethylbenzene dioxygenase ferredoxin subunit	excinuclease ABC subunit A	excinuclease ABC, A subunit	exo-1,4-beta-D-glucosaminidase	exodeoxyribonuclease III Xth	exodeoxyribonuclease V alpha subunit	exodeoxyribonuclease VII large subunit	exodeoxyribonuclease X	exodeoxyribonuclease-3	exodeoxyribonuclease-5	exonuclease RecJ	exonuclease RecJ (EC 3.1.-.-)	exonuclease SbcC	exopolyphosphatase /  guanosine-5'-triphosphate,3'-diphosphate pyrophosphatase	exopolysaccharide biosynthesis operon protein  EpsL	exopolysaccharide biosynthesis polyprenyl  glycosylphosphotransferase	exopolysaccharide production protein ExoF	exopolysaccharide production protein ExoQ	exopolysaccharide production protein ExoY	exopolysaccharide production protein ExoZ	exopolysaccharide production repressor protein	exopolysaccharide transport protein family	exoribonuclease-2	exosortase 2	exosortase A	exosortase B	exosortase D, VPLPA-CTERM-specific	exosortase E/protease, VPEID-CTERM system	exosortase/archaeosortase family protein	extracellular repeat protein, HAF family	extracellular solute-binding protein family 1	extracellular solute-binding protein family 3	extracellular solute-binding protein family 5	fagellar hook-basal body protein	farnesyl diphosphate synthase	farnesyl-diphosphate farnesyltransferase	farnesyl-diphosphate farnesyltransferase (EC  2.5.1.21)	farnesyl-diphosphate synthase (EC 2.5.1.10)	fatty acid CoA ligase FadD21	fatty acid CoA ligase FadD32	fatty acid CoA ligase FadD36	fatty acid CoA ligase FadD9	fatty acid desaturase	fatty acid hydroxylase	fatty acid synthase	fatty acid synthase, bacterial type (EC 2.3.1.-)	fatty-acyl-CoA synthase	ferredoxin	ferredoxin III, nif-specific	ferredoxin hydrogenase small subunit	ferredoxin like protein	ferredoxin protochlorophyllide reductase subunit  B	ferredoxin protochlorophyllide reductase subunit  L	ferredoxin protochlorophyllide reductase subunit  N	ferredoxin, 2Fe-2S	ferredoxin, 2Fe-2S type, ISC system	ferredoxin--NADP+ reductase	ferredoxin-NAD(P)+ reductase (naphthalene  dioxygenase ferredoxin-specific)	ferredoxin-nitrite reductase	ferredoxin-type protein NapG	ferredoxin-type protein NapH	ferric iron reductase protein FhuF	ferric uptake regulator, Fur family	ferritin	ferrochelatase	ferrochelatase (EC 4.99.1.1)	ferrous iron transport protein A	ferrous iron transport protein B	feruloyl esterase	fibronectin type 3 domain-containing protein	fibronectin-binding autotransporter adhesin	filamentation induced by cAMP protein Fic	filamentous hemagglutinin	filamentous hemagglutinin family N-terminal  domain-containing protein	filamentous hemagglutinin family N-terminal  domain-containing protein/PEP-CTERM protein-sorting domain-containing protein	filamentous hemagglutinin family outer membrane  protein	fimbrial biogenesis outer membrane usher protein	fission protein ELM1	fkbp-type peptidyl-prolyl cis-trans isomerase	flagella basal body P-ring formation protein  FlgA	flagella synthesis protein FlgN	flagellar FliJ protein	flagellar FliL protein	flagellar L-ring protein	flagellar L-ring protein precursor FlgH	flagellar M-ring protein FliF	flagellar P-ring protein	flagellar P-ring protein precursor FlgI	flagellar assembly factor FliW	flagellar assembly protein FliH	flagellar basal body FlaE domain protein	flagellar basal body rod protein	flagellar basal body-associated protein FliL	flagellar basal-body rod modification protein  FlgD	flagellar basal-body rod protein FlgB	flagellar basal-body rod protein FlgC	flagellar basal-body rod protein FlgF	flagellar basal-body rod protein FlgG	flagellar biosynthesis protein	flagellar biosynthesis protein FlhA	flagellar biosynthesis protein FlhF	flagellar biosynthesis protein FlhG	flagellar biosynthesis protein FliO	flagellar biosynthetic protein FlhB	flagellar biosynthetic protein FlhF	flagellar biosynthetic protein FliO	flagellar biosynthetic protein FliP	flagellar biosynthetic protein FliQ	flagellar biosynthetic protein FliR	flagellar export protein FliJ	flagellar hook capping protein	flagellar hook protein FlgE	flagellar hook-associated 2 domain protein	flagellar hook-associated protein 1 FlgK	flagellar hook-associated protein 2	flagellar hook-associated protein 3	flagellar hook-associated protein 3 FlgL	flagellar hook-associated protein FlgK	flagellar hook-basal body complex protein FliE	flagellar hook-basal body complex subunit FliE	flagellar hook-length control protein	flagellar hook-length control protein FliK	flagellar motor protein MotA	flagellar motor switch protein FliG	flagellar motor switch protein FliM	flagellar motor switch protein FliN	flagellar motor switch protein FliN/FliY	flagellar operon protein	flagellar operon protein TIGR03826	flagellar protein FhlB-like protein	flagellar protein FlaF	flagellar protein FlaG	flagellar protein FlaG protein	flagellar protein FlbT	flagellar protein FlgJ	flagellar protein FliO/FliZ	flagellar protein FliS	flagellar protein FliT	flagellar protein export ATPase FliI	flagellar rod assembly protein/muramidase FlgJ	flagellar transcriptional activator	flagellar transcriptional activator FlhC	flagellar transcriptional activator FlhD	flagellin	flagellin C-terminal helical region	flagellin domain protein	flagellum-specific ATP synthase	flavin reductase	flavin reductase domain protein FMN-binding	flavin reductase domain protein FMN-binding  protein	flavodoxin I	flavodoxin/nitric oxide synthase	flavoprotein	flavoprotein WrbA	flotillin	fluoroacetyl-CoA thioesterase	folate-binding protein YgfZ	foldase protein PrsA	formaldehyde activating enzyme	formaldehyde activating enzyme (EC 4.3.-.-)	formaldehyde-activating enzyme	formamidase	formamidopyrimidine-DNA glycosylase	formate dehydrogenase	formate dehydrogenase (quinone-dependent)  catalytic subunit	formate dehydrogenase (quinone-dependent)  cytochrome b subunit	formate dehydrogenase (quinone-dependent)  iron-sulfur subunit	formate dehydrogenase F4A subunit	formate dehydrogenase F4B subunit	formate dehydrogenase alpha subunit	formate dehydrogenase alpha subunit (EC 1.2.1.2)	formate dehydrogenase beta subunit	formate dehydrogenase beta subunit (EC 1.2.1.2)	formate dehydrogenase delta subunit (EC 1.2.1.2)	formate dehydrogenase family accessory protein  FdhD	formate dehydrogenase gamma subunit	formate dehydrogenase gamma subunit (EC 1.2.1.2)	formate dehydrogenase iron-sulfur subunit	formate dehydrogenase major subunit	formate dehydrogenase region TAT target	formate dehydrogenase subunit delta	formate dehydrogenase subunit gamma	formate-dependent phosphoribosylglycinamide  formyltransferase	formate-dependent phosphoribosylglycinamide  formyltransferase (EC 6.3.4.-)	formate/nitrite transporter	formiminoglutamase	formiminoglutamate deiminase	formyl-CoA transferase	formylmethanofuran dehydrogenase subunit C	formylmethanofuran dehydrogenase, subunit A	formylmethanofuran dehydrogenase, subunit A 	formylmethanofuran dehydrogenase, subunit A (EC  1.2.99.5)/formyltransferase/hydrolase complex subunit A	formylmethanofuran dehydrogenase, subunit B	formylmethanofuran dehydrogenase, subunit B (EC  1.2.99.5)/formyltransferase/hydrolase complex subunit B	formylmethanofuran dehydrogenase, subunit C	formylmethanofuran dehydrogenase, subunit C (EC  1.2.99.5)/formyltransferase/hydrolase complex subunit C	formylmethanofuran-tetrahydromethanopterin  formyltransferase	formylmethanofuran-tetrahydromethanopterin  formyltransferase (EC 2.3.1.101)/formyltransferase/hydrolase complex subunit D	formylmethanofuran-tetrahydromethanopterin  formyltransferase /formyltransferase/hydrolase complex subunit D	formyltetrahydrofolate deformylase	formyltetrahydrofolate deformylase (EC 3.5.1.10)	formyltetrahydrofolate-dependent  phosphoribosylglycinamide formyltransferase	formyltetrahydrofolate-dependent  phosphoribosylglycinamide formyltransferase (EC 2.1.2.2)	four helix bundle protein	fructokinase	fructose transport system permease protein	fructose transport system substrate-binding  protein	fructose-1,6-bisphosphatase	fructose-1,6-bisphosphatase I	fructose-1,6-bisphosphatase I /  sedoheptulose-1,7-bisphosphatase	fructose-1,6-bisphosphatase II	fructose-1,6-bisphosphatase II /  sedoheptulose-1,7-bisphosphatase	fructose-1,6-bisphosphatase-3	fructose-1-phosphate kinase	fructose-1-phosphate kinase (EC 2.7.1.56)	fructose-6-phosphate aldolase 2	fructose-bisphosphate aldolase	fructose-bisphosphate aldolase (EC 4.1.2.13)	fructose-bisphosphate aldolase, class I	fructose-bisphosphate aldolase, class II	fructoselysine 6-kinase	fructuronate reductase	fumarase, class I, homodimeric	fumarase, class I, homodimeric (EC 4.2.1.2)	fumarase, class II	fumarate hydratase, class I	fumarate reductase flavoprotein subunit	fumarate reductase iron-sulfur subunit	fumarate reductase subunit C	fumarylacetoacetate (FAA) hydrolase	fumarylacetoacetate hydrolase	fumarylpyruvate hydrolase	fused signal recognition particle receptor	galactan 5-O-arabinofuranosyltransferase	galactarate dehydratase	galactarate dehydratase (EC 4.2.1.42)/L-talarate  dehydratase (EC 4.2.1.-)	galactarate dehydratase /L-talarate dehydratase	galactokinase	galactokinase (EC 2.7.1.6)	galactose 1-dehydrogenase (EC 1.1.1.48)	gamma-aminobutyrate:proton symporter, AAT family	gamma-glutamyl-gamma-aminobutyraldehyde  dehydrogenase	gamma-glutamyl-gamma-aminobutyrate hydrolase	gamma-glutamylmethylamide synthetase	gamma-glutamylmethylamide synthetase (EC  6.3.4.12)	gamma-glutamylputrescine oxidase	gamma-glutamyltransferase 1 (EC:2.3.2.2).  Threonine peptidase. MEROPS family T03	gamma-glutamyltransferase 1 Threonine peptidase.  MEROPS family T03	gamma-glutamyltransferase 2. Threonine  peptidase. MEROPS family T03	gamma-glutamyltranspeptidase / glutathione  hydrolase	general L-amino acid ABC transporter ATP-binding  protein	general L-amino acid ABC transporter membrane  protein	general L-amino acid transport system  ATP-binding protein	general L-amino acid transport system  substrate-binding protein	general L-amino acid transport system permease  protein	general L-amino acid-binding protein	general secretion pathway protein D	general secretion pathway protein E	general secretion pathway protein F	general secretion pathway protein G	general secretion pathway protein H	general secretion pathway protein I	general secretion pathway protein J	general secretion pathway protein K	general secretion pathway protein L	general secretion pathway protein M	general secretion pathway protein N	general secretion pathway protein, ATPase	general secretion pathway transmembrane protein	gentisate 1,2-dioxygenase	gentisate 1,2-dioxygenase (EC 1.13.11.4)	geranial dehydrogenase	geranylgeranyl diphosphate synthase, type I	geranylgeranyl diphosphate synthase, type II	geranylgeranyl reductase	geranylgeranyl reductase family	geranylgeranyl-diphosphate synthase (EC  2.5.1.29)	germination protein M	germination protein, Ger(x)C family	glc operon protein GlcG	globin	glucan 1,3-beta-glucosidase	glucans biosynthesis protein	glucarate dehydratase	glucitol operon activator protein	glucoamylase	glucokinase	glucokinase (EC 2.7.1.2)	gluconate 2-dehydrogenase	gluconate 2-dehydrogenase alpha chain	gluconate 2-dehydrogenase gamma chain	gluconate 5-dehydrogenase	gluconate kinase, FGGY family	gluconate kinase, FGGY family (EC 2.7.1.12)	gluconate kinase, SKI family	gluconate kinase, SKI family (EC 2.7.1.12)	gluconate permease GntP	gluconate transporter	gluconate:H+ symporter, GntP family	gluconokinase	gluconolactonase	gluconolactonase (EC 3.1.1.17)	glucosamine kinase	glucosamine--fructose-6-phosphate  aminotransferase (isomerizing)	glucosamine-6-phosphate deaminase	glucose 1-dehydrogenase	glucose 1-dehydrogenase (EC 1.1.1.47)	glucose 6-O-methyltransferase	glucose inhibited division protein A	glucose sorbosone dehydrogenase	glucose-1-phosphate adenylyltransferase	glucose-1-phosphate cytidylyltransferase	glucose-1-phosphate thymidylyltransferase	glucose-6-phosphate 1-dehydrogenase	glucose-6-phosphate 1-dehydrogenase (EC  1.1.1.49)	glucose-6-phosphate 1-epimerase	glucose-6-phosphate dehydrogenase assembly  protein OpcA	glucose-6-phosphate isomerase	glucose-6-phosphate isomerase (EC 5.3.1.9)	glucose-fructose oxidoreductase	glucose-methanol-choline oxidoreductase	glucose/galactose transporter	glucose/mannose transport system  substrate-binding protein	glucose/mannose transport system permease  protein	glucosyl-3-phosphoglycerate phosphatase (pgm  family)	glucosyl-3-phosphoglycerate synthase	glucosylglycerol-phosphate synthase	glucuronate isomerase	glucuronide carrier protein	glutaconate CoA-transferase subunit A	glutaconate CoA-transferase subunit B	glutamate 5-kinase	glutamate 5-kinase (EC 2.7.2.11)	glutamate N-acetyltransferase	glutamate N-acetyltransferase (EC 2.3.1.35)	glutamate carboxypeptidase	glutamate decarboxylase	glutamate dehydrogenase	glutamate dehydrogenase (NAD(P)+)	glutamate dehydrogenase (NAD)	glutamate dehydrogenase (NAD) (EC 1.4.1.2)	glutamate dehydrogenase (NADP)	glutamate dehydrogenase (NADP) (EC 1.4.1.4)	glutamate dehydrogenase (NADP+)	glutamate racemase	glutamate racemase (EC 5.1.1.3)	glutamate synthase (NADH) large subunit	glutamate synthase (NADH) large subunit (EC  1.4.1.14)	glutamate synthase (NADH) small subunit	glutamate synthase (NADH) small subunit (EC  1.4.1.14)	glutamate synthase (NADPH) large subunit	glutamate synthase (NADPH) small subunit	glutamate synthase (NADPH/NADH) large chain	glutamate synthase (NADPH/NADH) small chain	glutamate synthase conserved region-containing  protein	glutamate transport system permease protein	glutamate transport system substrate-binding  protein	glutamate--cysteine ligase	glutamate--putrescine ligase	glutamate--tRNA(Gln) ligase	glutamate-1-semialdehyde 2,1-aminomutase	glutamate-1-semialdehyde 2,1-aminomutase (EC  5.4.3.8)	glutamate-5-semialdehyde dehydrogenase	glutamate-5-semialdehyde dehydrogenase (EC  1.2.1.41)	glutamate-ammonia-ligase adenylyltransferase	glutamate/aspartate transport system  substrate-binding protein	glutamate/aspartate transport system ATP-binding  protein	glutamate/cysteine ligase	glutamate:Na+ symporter, ESS family	glutamin-(asparagin-)ase	glutamine amidotransferase	glutamine amidotransferase class-I	glutamine synthetase	glutamine transport system ATP-binding protein	glutamine transport system permease protein	glutamine transport system substrate-binding  protein	glutamine--fructose-6-phosphate transaminase	glutaminyl-tRNA synthetase	glutaminyl-tRNA synthetase (EC 6.1.1.18)	glutamyl endopeptidase	glutamyl-Q tRNA(Asp) synthetase	glutamyl-tRNA reductase	glutamyl-tRNA reductase (EC 1.2.1.70)	glutamyl-tRNA synthetase	glutamyl-tRNA synthetase (EC 6.1.1.17)	glutaredoxin	glutaredoxin 2	glutaredoxin 3	glutaredoxin-like protein	glutaredoxin-like protein NrdH	glutaryl-CoA dehydrogenase	glutathione S-transferase	glutathione peroxidase	glutathione synthase	glutathione synthase (EC 6.3.2.3)	glutathione transport system ATP-binding protein	glutathione-independent formaldehyde  dehydrogenase	glutathione-regulated potassium-efflux system  ancillary protein KefG	glutathione-regulated potassium-efflux system  protein KefB	glyceraldehyde 3-phosphate dehydrogenase	glyceraldehyde-3-phosphate dehydrogenase (NAD+)	glyceraldehyde-3-phosphate dehydrogenase (NAD+)  (EC 1.2.1.12)	glyceraldehyde-3-phosphate dehydrogenase (NADP+)	glyceraldehyde-3-phosphate dehydrogenase, type I	glycerate 2-kinase	glycerate 2-kinase (EC 2.7.1.165)	glycerate dehydrogenase	glycerate kinase	glycerol 3-phosphate dehydrogenase (NAD(P)+) (EC  1.1.1.94)	glycerol dehydrogenase	glycerol kinase	glycerol kinase (EC 2.7.1.30)	glycerol transport system permease protein	glycerol uptake facilitator protein	glycerol-1-phosphate dehydrogenase [NAD(P)+]	glycerol-3-phosphate acyltransferase	glycerol-3-phosphate acyltransferase PlsY	glycerol-3-phosphate cytidylyltransferase	glycerol-3-phosphate dehydrogenase	glycerol-3-phosphate dehydrogenase (NAD(P)+)	glycerophosphoryl diester phosphodiesterase	glycine C-acetyltransferase	glycine amidinotransferase	glycine betaine transporter	glycine betaine/L-proline ABC transporter,  ATPase subunit	glycine betaine/choline-binding (lipo)protein of  an ABC-type transport system (osmoprotectant binding protein)	glycine betaine/proline transport system  ATP-binding protein	glycine betaine/proline transport system  permease protein	glycine betaine/proline transport system  substrate-binding protein	glycine cleavage T protein (aminomethyl  transferase)	glycine cleavage system H protein	glycine dehydrogenase	glycine dehydrogenase (decarboxylating) alpha  subunit	glycine dehydrogenase (decarboxylating) alpha  subunit (EC 1.4.4.2)	glycine dehydrogenase (decarboxylating) alpha  subunit (EC 1.4.4.2)/glycine dehydrogenase (decarboxylating) beta subunit (EC 1.4	glycine dehydrogenase (decarboxylating) alpha  subunit /glycine dehydrogenase (decarboxylating) beta subunit	glycine dehydrogenase (decarboxylating) beta  subunit	glycine dehydrogenase (decarboxylating) beta  subunit (EC 1.4.4.2)	glycine dehydrogenase subunit 1	glycine dehydrogenase subunit 2	glycine hydroxymethyltransferase	glycine oxidase	glycine oxidase (EC 1.4.3.19)	glycogen debranching enzyme GlgX	glycogen operon protein	glycogen phosphorylase	glycogen synthase (ADP-glucose)	glycogen/starch synthase, ADP-glucose type	glycolate oxidase	glycolate oxidase FAD binding subunit	glycolate oxidase iron-sulfur subunit	glycoside hydrolase family 3 domain protein	glycoside hydrolase family 57	glycoside/pentoside/hexuronide:cation symporter,  GPH family	glycosyl transferase family 11	glycosyl transferase family 2	glycosyl transferase family 25	glycosyl transferase family 39	glycosyl transferase family 9	glycosyl transferase family protein	glycosyl transferase group 1	glycosyl transferase, WecB/TagA/CpsF family	glycosyl transferase, family 25	glycosyltransferase 36	glycosyltransferase, MGT family	glycosyltransferase, MSMEG_0565 family	glycyl-tRNA synthetase	glycyl-tRNA synthetase alpha chain	glycyl-tRNA synthetase alpha chain (EC 6.1.1.14)	glycyl-tRNA synthetase beta chain	glycyl-tRNA synthetase beta chain (EC 6.1.1.14)	glyoxalase family protein	glyoxylase I family protein	glyoxylate reductase	glyoxylate/hydroxypyruvate reductase A	gpW protein	guanidinopropionase	guanine deaminase	guanosine-3',5'-bis(diphosphate)  3'-pyrophosphohydrolase	guanylate cyclase	guanylate kinase	guanylate kinase (EC 2.7.4.8)	haloacetate dehalogenase	haloacid dehalogenase superfamily, subfamily IA,  variant 1 with third motif having Dx(3-4)D or Dx(3-4)E	haloacid dehalogenase superfamily, subfamily IA,  variant 3 with third motif having DD or ED	haloacid dehalogenase superfamily, subfamily IA,  variant 3 with third motif having DD or ED/beta-phosphoglucomutase family hydr	haloacid dehalogenase superfamily, subfamily IA,  variant 3 with third motif having DD or ED/haloacid dehalogenase superfamily, 	haloacid dehalogenase-like hydrolase	haloalkane dehalogenase	head-tail adaptor	heat shock protein DnaJ domain protein	heat shock protein HslJ	heat shock protein Hsp15	heat shock protein Hsp20	heat shock protein Hsp90	heat shock protein HspQ	heat shock protein HtpX	heat-inducible transcription repressor HrcA	heavy metal efflux pump, CzcA family	heavy metal sensor kinase	heavy metal sensor signal transduction histidine  kinase	heavy metal translocating P-type ATPase	heavy metal-(Cd/Co/Hg/Pb/Zn)-translocating  P-type ATPase	heavy-metal exporter, HME family	helicase c2	helicase domain protein	helicase/secretion neighborhood CpaE-like  protein	helicase/secretion neighborhood TadE-like  protein	helix-turn-helix domain protein	helix-turn-helix, Psq domain	heme acquisition protein HasR	heme exporter protein A	heme exporter protein B	heme exporter protein C	heme exporter protein CcmA	heme exporter protein CcmB	heme exporter protein CcmC	heme exporter protein CcmD	heme exporter protein D	heme oxygenase	hemerythrin	hemerythrin-like metal-binding domain protein	hemerythrin-like metal-binding protein	hemin transport system, hemin uptake protein	hemoglobin	hemoglobin/transferrin/lactoferrin receptor  protein	hemolysin D	hemolysin III	hemolysin-type calcium-binding region	hemophore	hemophore-related protein, Rv0203/Rv1174c family	heparin binding hemagglutinin HbhA	heptaprenyl diphosphate synthase	heptose I phosphotransferase	heptose-I-phosphate  ethanolaminephosphotransferase	heptosyltransferase-1	heptosyltransferase-2	heterodimeric methylmalonyl-CoA mutase large  subunit precursor	heterodimeric methylmalonyl-CoA mutase small  subunit	hexosaminidase	hexulose-6-phosphate isomerase	high affinity sulphate transporter 1	high-affinity gluconate transporter	high-affinity iron transporter	high-affinity nickel-transport protein	hippurate hydrolase	histidine ammonia-lyase	histidine ammonia-lyase (EC 4.3.1.3)	histidine biosynthesis protein	histidine kinase	histidine kinase (EC 2.7.13.3)	histidine kinase internal region	histidine phosphotransferase ChpT	histidine transporter	histidine triad (HIT) family protein	histidine triad (HIT) protein	histidine:proton symporter, AAT family	histidine:proton symporter, AAT family (TC  2.A.3.1.9)	histidinol dehydrogenase	histidinol dehydrogenase (EC 1.1.1.23)	histidinol phosphate aminotransferase apoenzyme  (EC 2.6.1.9)	histidinol-phosphatase (PHP family)	histidinol-phosphatase, inositol monophosphatase  family	histidinol-phosphate aminotransferase	histidinol-phosphate phosphatase	histidyl-tRNA synthetase	histidyl-tRNA synthetase (EC 6.1.1.21)	histidyl-tRNA synthetase 2	histone family protein DNA-binding protein	holin, SPP1 family	holin-like protein	holo-[acyl-carrier protein] synthase	holo-[acyl-carrier-protein] synthase	holo-acyl-carrier-protein synthase	homocitrate synthase NifV	homocysteine S-methyltransferase	homodimeric dihydroxyacetone kinase	homodimeric dihydroxyacetone kinase (EC  2.7.1.29)	homodimeric glycerol 3-phosphate dehydrogenase  (quinone)	homodimeric glycerol 3-phosphate dehydrogenase  (quinone) (EC 1.1.5.3)	homogentisate 1,2-dioxygenase	homoserine O-acetyltransferase	homoserine O-acetyltransferase (EC 2.3.1.31)	homoserine O-succinyltransferase	homoserine dehydrogenase	homoserine dehydrogenase (EC 1.1.1.3)	homoserine kinase	homoserine kinase (EC 2.7.1.39)	homoserine/homoserine lactone efflux protein	homospermidine synthase	homospermidine synthase (EC 2.5.1.44)	hook-length control protein FliK	hopanoid biosynthesis associated protein HpnK	hopanoid biosynthesis associated radical SAM  protein HpnH	hopanoid biosynthesis associated radical SAM  protein HpnJ	hopanoid-associated phosphorylase	hopene-associated glycosyltransferase HpnB	host factor-I protein	htrA-like peptidase. Serine peptidase. MEROPS  family S01B	hyaluronate lyase	hyaluronoglucosaminidase	hydrogenase (NiFe) small subunit (hydA)	hydrogenase expression/formation protein HypC	hydrogenase expression/formation protein HypD	hydrogenase expression/formation protein HypE	hydrogenase large subunit	hydrogenase maturation protease	hydrogenase maturation protein HypF	hydrogenase nickel incorporation protein  HypA/HybF	hydrogenase nickel incorporation protein HypB	hydrogenase small subunit	hydrogenase-1 operon protein HyaE	hydrogenase-1 operon protein HyaF	hydrogenase-4 component E	hydrogenase-4 component F	hydrogenobyrinic acid a,c-diamide synthase  (glutamine-hydrolysing) (EC 6.3.5.9)/cobyrinate a,c-diamide synthase (EC 6.3.5.11)	hydrogenobyrinic acid a,c-diamide synthase  (glutamine-hydrolysing) /cobyrinate a,c-diamide synthase	hydrolase, TatD family	hydrolase, peptidase M42 family	hydrophobe/amphiphile efflux-1 (HAE1) family  protein	hydrophobic/amphiphilic exporter-1, HAE1 family	hydroxyacylglutathione hydrolase	hydroxyethylthiazole kinase	hydroxylaminobenzene mutase	hydroxylysine kinase /5-phosphonooxy-L-lysine  phospho-lyase apoenzyme	hydroxymethyl cephem carbamoyltransferase	hydroxymethylbilane synthase	hydroxymethylbilane synthase (EC 2.5.1.61)	hydroxymethylglutaryl-CoA lyase	hydroxymethylglutaryl-CoA lyase (EC 4.1.3.4)	hydroxymethylpyrimidine  kinase/phosphomethylpyrimidine kinase	hydroxymethylpyrimidine kinase 	hydroxymethylpyrimidine synthase	hydroxymethylpyrimidine/phosphomethylpyrimidine  kinase	hydroxyneurosporene-O-methyltransferase (EC  2.1.1.-)	hydroxypyruvate isomerase	hydroxypyruvate reductase	hydroxyquinol 1,2-dioxygenase	hyperosmotically inducible protein	hypothetical chaperone protein	hypothetical protein	hypothetical protein (DUF2059)	hypothetical protein (DUF2065)	hypothetical protein (DUF2066)	hypothetical protein (DUF2087)	hypothetical protein (DUF2125)	hypothetical protein (DUF2147)	hypothetical protein (DUF2155)	hypothetical protein (DUF2188)	hypothetical protein (DUF2200)	hypothetical protein (DUF2236)	hypothetical protein (DUF2252)	hypothetical protein (DUF2264)	hypothetical protein (DUF2272)	hypothetical protein (DUF2325)	hypothetical protein (DUF2336)	hypothetical protein NreA	hypoxanthine phosphoribosyltransferase	hypoxanthine phosphoribosyltransferase (EC  2.4.2.8)	imidazole glycerol phosphate synthase subunit  hisF	imidazole glycerol phosphate synthase subunit  hisF (EC 4.1.3.-)	imidazole glycerol phosphate synthase subunit  hisH	imidazole glycerol phosphate synthase subunit  hisH (EC 2.4.2.-)	imidazoleglycerol phosphate synthase, cyclase  subunit	imidazoleglycerol-phosphate dehydratase	imidazoleglycerol-phosphate dehydratase (EC  4.2.1.19)	imidazolonepropionase	import inner membrane translocase subunit Tim44	indole-3-glycerol phosphate synthase	indole-3-glycerol phosphate synthase (EC  4.1.1.48)	indolepyruvate decarboxylase	indolepyruvate ferredoxin oxidoreductase	indolepyruvate ferredoxin oxidoreductase alpha  subunit	indolepyruvate ferredoxin oxidoreductase beta  subunit	inhibitor of KinA	initiator RepB protein	inner membrane protein	inner membrane transporter RhtA	inorganic phosphate transporter, PiT family	inorganic pyrophosphatase	inosine-5'-monophosphate dehydrogenase	inosine-5'-monophosphate dehydrogenase (EC  1.1.1.205)	inositol monophosphatase	inositol transport system ATP-binding protein	inositol transport system substrate-binding  protein	inositol-phosphate phosphatase	inosose dehydratase	integral membrane protein	integral membrane protein MviN	integral membrane protein TIGR01906	integral membrane protein, YjbE family	integral membrane protein, YkoY family	integral membrane sensor hybrid histidine kinase	integral membrane sensor signal transduction  histidine kinase	integrase	integrase family protein	integrase/recombinase XerC	integrase/recombinase XerD	integration host factor subunit alpha	integration host factor subunit beta	integration host factor, alpha subunit	integration host factor, beta subunit	integron integrase	intein N-terminal splicing region	intracellular septation protein	intracellular septation protein A	intradiol ring-cleavage dioxygenase	iojap-like protein	ipoprotein LpqH	iron (metal) dependent repressor, DtxR family	iron complex outermembrane recepter protein	iron complex transport system ATP-binding  protein	iron complex transport system permease protein	iron complex transport system substrate-binding  protein	iron permease FTR1	iron uptake system component EfeO	iron(II)-dependent oxidoreductase	iron(III) transport system ATP-binding protein	iron(III) transport system permease protein	iron(III) transport system substrate-binding  protein	iron-containing alcohol dehydrogenase	iron-sulfur cluster assembly accessory protein	iron-sulfur cluster assembly protein	iron-sulfur cluster assembly protein IscA	iron-sulfur cluster binding protein	iron-sulfur cluster insertion protein	iron/zinc/copper transport system  substrate-binding protein	iron/zinc/copper transport system ATP-binding  protein	iron/zinc/copper transport system permease  protein	isoamylase	isochorismatase hydrolase	isochorismate pyruvate lyase	isochorismate synthase	isocitrate dehydrogenase	isocitrate dehydrogenase (NAD+)	isocitrate dehydrogenase (NADP)	isocitrate dehydrogenase (NADP) (EC 1.1.1.42)	isocitrate dehydrogenase kinase/phosphatase	isocitrate lyase	isocitrate lyase (EC 4.1.3.1)	isopenicillin-N epimerase	isopentenyl-diphosphate delta-isomerase	isoquinoline 1-oxidoreductase, alpha subunit	isoquinoline 1-oxidoreductase, beta subunit	isovaleryl-CoA dehydrogenase	itaconyl-CoA hydratase	ketol-acid reductoisomerase	ketol-acid reductoisomerase (EC 1.1.1.86)	ketopantoate hydroxymethyltransferase	ketopantoate hydroxymethyltransferase (EC  2.1.2.11)	ketopantoate reductase	ketopantoate reductase (EC 1.1.1.169)	kinase-associated protein B	kumamolisin	kumamolisin. Serine peptidase. MEROPS family S53	lactaldehyde dehydrogenase / glycolaldehyde  dehydrogenase	lactate 2-monooxygenase	lactate permease	lactose/L-arabinose transport system  substrate-binding protein	lactoylglutathione lyase	large conductance mechanosensitive channel	large conductance mechanosensitive channel  protein	large subunit ribosomal protein L1	large subunit ribosomal protein L10	large subunit ribosomal protein L11	large subunit ribosomal protein L13	large subunit ribosomal protein L15	large subunit ribosomal protein L16	large subunit ribosomal protein L17	large subunit ribosomal protein L18	large subunit ribosomal protein L19	large subunit ribosomal protein L2	large subunit ribosomal protein L20	large subunit ribosomal protein L21	large subunit ribosomal protein L22	large subunit ribosomal protein L23	large subunit ribosomal protein L24	large subunit ribosomal protein L25	large subunit ribosomal protein L27	large subunit ribosomal protein L28	large subunit ribosomal protein L29	large subunit ribosomal protein L3	large subunit ribosomal protein L30	large subunit ribosomal protein L31	large subunit ribosomal protein L32	large subunit ribosomal protein L33	large subunit ribosomal protein L35	large subunit ribosomal protein L36	large subunit ribosomal protein L4	large subunit ribosomal protein L5	large subunit ribosomal protein L6	large subunit ribosomal protein L7/L12	large subunit ribosomal protein L9	lathosterol oxidase	leader peptidase (prepilin peptidase) /  N-methyltransferase	leucine dehydrogenase	leucine-rich repeat-containing protein	leucyl aminopeptidase	leucyl-tRNA synthetase	leucyl-tRNA synthetase (EC 6.1.1.4)	leucyl/phenylalanyl-tRNA--protein transferase	leucyl/phenylalanyl-tRNA/protein transferase	levanase	levanbiose-producing levanase	levansucrase	light-harvesting complex 1 alpha chain	light-harvesting complex 1 beta chain	limonene-1,2-epoxide hydrolase	lincosamide and streptogramin A transport system  ATP-binding/permease protein	linoleoyl-CoA desaturase	lipase	lipid A ABC exporter family, fused ATPase and  inner membrane subunits	lipid A ABC exporter, fused ATPase and inner  membrane subunits MsbA	lipid A biosynthesis acyltransferase	lipid A ethanolaminephosphotransferase	lipid kinase, YegS/Rv2252/BmrU family	lipid-A-disaccharide kinase	lipid-A-disaccharide kinase (EC 2.7.1.130)	lipid-A-disaccharide synthase	lipid-A-disaccharide synthase (EC 2.4.1.182)	lipoate-protein ligase A	lipoate-protein ligase B	lipoic acid synthetase	lipolytic protein G-D-S-L family	lipooligosaccharide transport system ATP-binding  protein	lipooligosaccharide transport system permease  protein	lipopolysaccharide O-acetyltransferase	lipopolysaccharide export system ATP-binding  protein	lipopolysaccharide export system permease  protein	lipopolysaccharide export system protein LptA	lipopolysaccharide export system protein LptC	lipopolysaccharide heptosyltransferase I	lipopolysaccharide heptosyltransferase II	lipopolysaccharide kinase	lipopolysaccharide transport periplasmic protein  LptA	lipopolysaccharide transport protein LptA/LPS  export ABC transporter protein LptC,TIGR04409	lipopolysaccharide transport system ATP-binding  protein	lipopolysaccharide transport system permease  protein	lipoprotein	lipoprotein LprG	lipoprotein NlpD	lipoprotein antigen	lipoprotein releasing system, ATP-binding  protein	lipoprotein releasing system, transmembrane  protein, LolC/E family	lipoprotein, osmotically inducible	lipoprotein-attachment site-containing protein	lipoprotein-releasing system ATP-binding protein	lipoprotein-releasing system permease protein	lipoteichoic acid synthase	lipoyl(octanoyl) transferase	localization factor PodJL	long chain fatty acid CoA FadD26	long chain fatty acid CoA ligase FadD10	long-chain acyl-CoA synthetase	long-chain fatty acid transport protein	long-chain-fatty-acid--CoA ligase-related  protein	long-chain-fatty-acid--[acyl-carrier-protein]  ligase	looped-hinge helix DNA binding domain-containing  protein, AbrB family	luciferase family oxidoreductase, group 1	luciferase-type oxidoreductase, BA3436 family	lycopene beta-cyclase	lycopene cyclase domain-containing protein	lycopene elongase	lysine 2,3-aminomutase	lysine N6-hydroxylase	lysine decarboxylase	lysine:proton symporter, APA family	lysine:proton symporter, APA family (TC  2.A.3.2.6)	lyso-ornithine lipid acyltransferase	lysophospholipase	lysozyme	lysyl-tRNA synthetase, class 2	lysyl-tRNA synthetase, class I	lysyl-tRNA synthetase, class II	lysyl-tRNA synthetase, class II (EC 6.1.1.6)	lytic murein transglycosylase	mRNA interferase ChpB	mRNA interferase HigB	mRNA interferase MazF	mRNA interferase RelE/StbE	mRNA-degrading endonuclease (mRNA interferase)  YafQ, toxin component of the YafQ-DinJ toxin-antitoxin module	mRNA-degrading endonuclease RelE, toxin  component of the RelBE toxin-antitoxin system	macrolide transport system ATP-binding/permease  protein	maf protein	magnesium and cobalt transport protein CorA	magnesium and cobalt transporter	magnesium chelatase accessory protein	magnesium chelatase family protein	magnesium chelatase subunit D	magnesium chelatase subunit H	magnesium chelatase subunit I	magnesium transporter	major facilitator superfamily MFS_1	major intrinsic protein	major membrane protein I	malate dehydrogenase	malate dehydrogenase  (oxaloacetate-decarboxylating)	malate dehydrogenase  (oxaloacetate-decarboxylating)(NADP+)	malate dehydrogenase (NAD)	malate dehydrogenase (NAD) (EC 1.1.1.37)	malate dehydrogenase (quinone)	malate synthase	malate synthase (EC 2.3.3.9)	malate thiokinase large subunit	malate thiokinase small subunit	malate-CoA ligase subunit alpha	malate-CoA ligase subunit beta	malate/quinone oxidoreductase	malate:Na+ symporter	maleamate amidohydrolase	maleate isomerase	maleylacetate reductase	maleylacetoacetate isomerase	maleylpyruvate isomerase	malonate decarboxylase  holo-[acyl-carrier-protein] synthase	malonate decarboxylase alpha subunit	malonate decarboxylase beta subunit	malonate decarboxylase delta subunit	malonate decarboxylase epsilon subunit	malonate decarboxylase gamma subunit	malonate transporter, MadL subunit	malonate transporter, MadM subunit	malonate-semialdehyde dehydrogenase  (acetylating) / methylmalonate-semialdehyde dehydrogenase	malonyl CoA-acyl carrier protein transacylase	malonyl-CoA O-methyltransferase	malonyl-CoA decarboxylase	malonyl-CoA/methylmalonyl-CoA synthetase	malto-oligosyltrehalose trehalohydrolase	maltokinase	maltooligosyl trehalose hydrolase	maltooligosyl trehalose hydrolase (EC 3.2.1.141)	maltooligosyl trehalose synthase	maltooligosyl trehalose synthase (EC 5.4.99.15)	maltooligosyltrehalose trehalohydrolase	maltose O-acetyltransferase	maltose alpha-D-glucosyltransferase/  alpha-amylase	mandelamide amidase	manganese transport protein	manganese transport system ATP-binding protein	manganese transport system permease protein	manganese transport system substrate-binding  protein	manganese-dependent inorganic pyrophosphatase	manganese/iron transport system  substrate-binding protein	manganese/iron transport system ATP-binding  protein	manganese/iron transport system permease protein	mannan endo-1,4-beta-mannosidase	mannitol 2-dehydrogenase	mannitol operon transcriptional antiterminator	mannonate dehydratase	mannose ABC transporter ATP-binding  protein/fructose ABC transporter ATP-binding protein/ribose ABC transporter ATP-binding pro	mannose ABC transporter ATP-binding protein 	mannose ABC transporter membrane protein 	mannose-1-phosphate  guanylyltransferase/mannose-6-phosphate isomerase	mannose-1-phosphate guanylyltransferase	mannose-1-phosphate guanylyltransferase (GDP) 	mannose-1-phosphate guanylyltransferase (GDP)  (EC 2.7.7.22)/mannose-6-phosphate isomerase, type 2 (EC 5.3.1.8)	mannose-1-phosphate guanylyltransferase /  mannose-6-phosphate isomerase	mannose-6-phosphate isomerase	mannose-6-phosphate isomerase, type 1	mannose-6-phosphate isomerase, type 2	mannose-binding protein /fructose-binding  protein /ribose-binding protein	mannose-sensitive hemagglutinin A	mannose-sensitive hemagglutinin a	mannosyltransferase	membrane dipeptidase	membrane fusion protein	membrane fusion protein, Cu(I)/Ag(I) efflux  system	membrane fusion protein, adhesin transport  system	membrane fusion protein, cobalt-zinc-cadmium  efflux system	membrane fusion protein, macrolide-specific  efflux system	membrane fusion protein, multidrug efflux system	membrane fusion protein, protease secretion  system	membrane glycosyltransferase	membrane protease FtsH catalytic subunit	membrane protease FtsH catalytic subunit (EC  3.4.24.-)	membrane protease subunit HflC	membrane protease subunit HflK	membrane protein	membrane protein DedA, SNARE-associated domain	membrane protein GlpM	membrane protein YqaA, SNARE-associated domain	membrane protein involved in aromatic  hydrocarbon degradation	membrane protein of unknown function	membrane protein required for colicin V  production	membrane protein, MarC family	membrane-anchored mycosin MYCP	membrane-associated protein	membrane-associated zinc metalloprotease	membrane-bound lytic murein transglycosylase A	membrane-bound lytic murein transglycosylase B	membrane-bound lytic murein transglycosylase D	membrane-bound lytic murein transglycosylase F	membrane-bound metal-dependent hydrolase	membrane-bound serine protease (ClpP class)	menaquinol-cytochrome c reductase cytochrome b  subunit	menaquinol-cytochrome c reductase cytochrome b  subunit precursor	menaquinol-cytochrome c reductase cytochrome b/c  subunit	menaquinol-cytochrome c reductase cytochrome c1  subunit precursor	menaquinol-cytochrome c reductase iron-sulfur  subunit precursor	menaquinone-dependent protoporphyrinogen oxidase	mercuric ion binding protein	mercuric ion transport protein	mercuric reductase	meso-butanediol dehydrogenase / (S,S)-butanediol  dehydrogenase / diacetyl reductase	metabolite-proton symporter	metal dependent phosphohydrolase	metallo-beta-lactamase family protein	metallophosphoesterase	methanesulfonate monooxygenase hydrolase  component, alpha subunit	methanesulfonate monooxygenase hydrolase  component, beta subunit	methanesulfonate monooxygenase reductase  component	methanol dehydrogenase (cytochrome c) subunit 1	methanol dehydrogenase (cytochrome c) subunit 2	methanol dehydrogenase (cytochrome) large  subunit apoprotein	methanol dehydrogenase (cytochrome) large  subunit apoprotein (EC 1.1.2.7)	methanol dehydrogenase (cytochrome) small  subunit	methanol dehydrogenase (cytochrome) small  subunit (EC 1.1.2.7)	methenyltetrahydrofolate cyclohydrolase	methenyltetrahydrofolate cyclohydrolase 	methenyltetrahydrofolate cyclohydrolase (EC  3.5.4.9)/5,10-methylenetetrahydrofolate dehydrogenase (NADP+) (EC 1.5.1.5)	methenyltetrahydromethanopterin cyclohydrolase	methenyltetrahydromethanopterin cyclohydrolase  (EC 3.5.4.27)	methionine adenosyltransferase	methionine adenosyltransferase (EC 2.5.1.6)	methionine aminopeptidase, type I	methionine aminopeptidase, type I (EC 3.4.11.18)	methionine aminotransferase	methionine biosynthesis protein MetW	methionine synthase (B12-dependent)	methionine synthase (B12-dependent) (EC  2.1.1.13)	methionine synthase (B12-independent)	methionine synthase (B12-independent) (EC  2.1.1.14)	methionine-R-sulfoxide reductase	methionine-gamma-lyase	methionyl aminopeptidase	methionyl-tRNA formyltransferase	methionyl-tRNA formyltransferase (EC 2.1.2.9)	methionyl-tRNA synthetase	methionyl-tRNA synthetase (EC 6.1.1.10)	methyl-accepting chemotaxis protein	methyl-accepting chemotaxis protein WspA	methyl-accepting chemotaxis protein-2, aspartate  sensor receptor	methyl-accepting chemotaxis sensory transducer	methyl-accepting chemotaxis sensory transducer  with Cache sensor	methyl-accepting chemotaxis sensory transducer  with Pas/Pac sensor	methyl-accepting chemotaxis sensory transducer  with TarH sensor	methyl-accepting chemotaxis sensory transducer  with TarH sensor /methyl-accepting chemotaxis sensory transducer with Pas/Pac se	methylamine dehydrogenase accessory protein MauD	methylamine dehydrogenase large subunit	methylamine dehydrogenase large subunit (EC  1.4.98.1)	methylamine dehydrogenase small subunit  precursor	methylamine dehydrogenase small subunit  precursor (EC 1.4.98.1)	methylamine utilisation MauE	methylated-DNA-[protein]-cysteine  S-methyltransferase	methylated-DNA-protein-cysteine  methyltransferase related protein	methylated-DNA/protein-cysteine  methyltransferase	methylene-tetrahydromethanopterin dehydrogenase	methylenetetrahydrofolate dehydrogenase (NADP+) 	methylenetetrahydrofolate reductase (NADPH)	methylenetetrahydromethanopterin dehydrogenase  (NADP)	methylglutaconyl-CoA hydratase	methylglyoxal synthase	methylisocitrate lyase	methylisocitrate lyase (EC 4.1.3.30)	methylmalonate-semialdehyde dehydrogenase	methylmalonate-semialdehyde dehydrogenase  [acylating]	methylmalonate-semialdehyde dehydrogenase  [acylating] (EC 1.2.1.27)	methylmalonyl-CoA epimerase	methylmalonyl-CoA epimerase (EC 5.1.99.1)	methylmalonyl-CoA epimerase /ethylmalonyl-CoA  epimerase	methylmalonyl-CoA mutase	methylmalonyl-CoA mutase (EC 5.4.99.2)	methylmalonyl-CoA mutase /heterodimeric  methylmalonyl-CoA mutase large subunit precursor	methylmalonyl-CoA mutase C-terminal  domain-containing protein	methylmalonyl-CoA mutase metallochaperone MeaB	methylmalonyl-CoA mutase, C-terminal domain	methylthioadenosine phosphorylase (EC 2.4.2.28)	methylthioribose-1-phosphate isomerase	methylthioribose-1-phosphate isomerase (EC  5.3.1.23)	methylthioribulose-1-phosphate dehydratase	methyltransferase	methyltransferase FkbM family	methyltransferase small	methyltransferase type 11	methyltransferase, FkbM family	methyltransferase, TIGR00027 family	microcin C transport system ATP-binding protein	microcin C transport system permease protein	microcin C transport system substrate-binding  protein	microcin-processing peptidase 1. Unknown type  peptidase. MEROPS family U62	microcin-processing peptidase 2. Unknown type  peptidase. MEROPS family U62	micrococcal nuclease	miniconductance mechanosensitive channel	misacylated tRNA(Ala) deacylase	mobile mystery protein A	mobilisation protein	mobilisation protein (MobC)	modification methylase	molecular chaperone DnaJ	molecular chaperone DnaK	molecular chaperone GrpE	molecular chaperone HscA	molecular chaperone HscB	molecular chaperone Hsp33	molecular chaperone HtpG	molecular chaperone IbpA	molybdate ABC transporter, ATPase subunit	molybdate ABC transporter, inner membrane  subunit	molybdate transport system ATP-binding protein	molybdate transport system permease protein	molybdate transport system regulatory protein	molybdate transport system substrate-binding  protein	molybdenum ABC transporter, molybdate-binding  protein	molybdenum ABC transporter, periplasmic  molybdate-binding protein	molybdenum cofactor biosynthesis protein A	molybdenum cofactor biosynthesis protein B	molybdenum cofactor cytidylyltransferase	molybdenum cofactor guanylyltransferase	molybdenum cofactor guanylyltransferase (EC  2.7.7.77)	molybdenum cofactor synthesis domain protein	molybdenum cofactor synthesis domain-containing  protein	molybdenum storage protein	molybdenum transport protein	molybdenum-pterin binding domain-containing  protein	molybdopterin adenylyltransferase	molybdopterin adenylyltransferase (EC 2.7.7.75)	molybdopterin binding domain protein	molybdopterin dinucleotide-binding region	molybdopterin guanine dinucleotide biosynthesis  accessory protein MobB	molybdopterin molybdochelatase	molybdopterin molybdochelatase (EC  2.10.1.1)/molybdenum cofactor cytidylyltransferase (EC 2.7.7.76)	molybdopterin molybdochelatase (EC 2.10.1.1)	molybdopterin molybdochelatase /molybdenum  cofactor cytidylyltransferase	molybdopterin molybdotransferase	molybdopterin oxidoreductase	molybdopterin synthase catalytic subunit	molybdopterin synthase subunit MoaD	molybdopterin synthase subunit MoaD (EC  2.8.1.12)	molybdopterin synthase subunit MoaE	molybdopterin synthase subunit MoaE (EC  2.8.1.12)	molybdopterin synthase sulfur carrier subunit	molybdopterin-guanine dinucleotide biosynthesis  protein A	molybdopterin-guanine dinucleotide biosynthesis  protein B	monoamine oxidase	monofunctional biosynthetic peptidoglycan  transglycosylase	monoheme cytochrome SoxX (sulfur oxidation)	monooxygenase	monosaccharide ABC transporter ATP-binding  protein, CUT2 family	monosaccharide ABC transporter ATP-binding  protein, CUT2 family (TC 3.A.1.2.-)	monosaccharide ABC transporter membrane protein,  CUT2 family	monosaccharide ABC transporter membrane protein,  CUT2 family (TC 3.A.1.2.-)	monosaccharide ABC transporter substrate-binding  protein, CUT2 family	monosaccharide ABC transporter substrate-binding  protein, CUT2 family (TC 3.A.1.2.-)	monothiol glutaredoxin	monovalent cation:H+ antiporter, CPA1 family	monovalent cation:H+ antiporter-2, CPA2 family	morphogenetic protein associated with SpoVID	muconate cycloisomerase	muconolactone delta-isomerase	multi-sensor hybrid histidine kinase	multi-sensor signal transduction histidine  kinase	multi-sensor signal transduction histidine  kinase (EC 2.7.13.3)	multicomponent K+:H+ antiporter subunit A	multicomponent K+:H+ antiporter subunit C	multicomponent K+:H+ antiporter subunit D	multicomponent K+:H+ antiporter subunit E	multicomponent K+:H+ antiporter subunit F	multicomponent K+:H+ antiporter subunit G	multicomponent Na+:H+ antiporter subunit B	multicomponent Na+:H+ antiporter subunit C	multicomponent Na+:H+ antiporter subunit D	multicomponent Na+:H+ antiporter subunit E	multicomponent Na+:H+ antiporter subunit F	multicomponent Na+:H+ antiporter subunit G	multicopper oxidase type 2	multicopper oxidase type 3	multidrug efflux pump	multidrug resistance protein (efflux  pump/antiporter)	multidrug resistance protein EbrA	multidrug resistance protein EbrB	multidrug resistance protein MdtO	multidrug resistance protein, MATE family	multiple antibiotic resistance (MarC)-related  protein	multiple antibiotic resistance protein	multiple monosaccharide ABC transporter  ATP-binding protein	multiple monosaccharide ABC transporter membrane  protein	multiple monosaccharide-binding protein	multiple sugar transport system  substrate-binding protein	multiple sugar transport system ATP-binding  protein	multiple sugar transport system permease protein	multisubunit potassium/proton antiporter, PhaA  subunit /multisubunit potassium/proton antiporter, PhaB subunit	multisubunit potassium/proton antiporter, PhaC  subunit	multisubunit potassium/proton antiporter, PhaD  subunit	multisubunit potassium/proton antiporter, PhaE  subunit	multisubunit potassium/proton antiporter, PhaF  subunit	multisubunit potassium/proton antiporter, PhaG  subunit	multisubunit sodium/proton antiporter, MrpA  subunit	multisubunit sodium/proton antiporter, MrpA  subunit (TC 2.A.63.1)/multisubunit sodium/proton antiporter, MrpB subunit (TC 2.A.6	multisubunit sodium/proton antiporter, MrpA  subunit /multisubunit sodium/proton antiporter, MrpB subunit	multisubunit sodium/proton antiporter, MrpB  subunit	multisubunit sodium/proton antiporter, MrpC  subunit	multisubunit sodium/proton antiporter, MrpC  subunit (TC 2.A.63.1)	multisubunit sodium/proton antiporter, MrpD  subunit	multisubunit sodium/proton antiporter, MrpD  subunit (TC 2.A.63.1)	multisubunit sodium/proton antiporter, MrpE  subunit	multisubunit sodium/proton antiporter, MrpE  subunit (TC 2.A.63.1)	multisubunit sodium/proton antiporter, MrpF  subunit	multisubunit sodium/proton antiporter, MrpG  subunit	multisubunit sodium/proton antiporter, MrpG  subunit (TC 2.A.63.1)	murein endopeptidase. Metallo peptidase. MEROPS  family M74	murein-DD-endopeptidase. Serine peptidase.  MEROPS family S11	mutator MutT protein	mxaA protein	mxaC protein	mxaD protein	mxaJ protein	mxaK protein	mxaL protein	mycobactin lysine-N-oxygenase	mycobactin peptide synthetase MbtE	mycobactin peptide synthetase MbtF	mycobactin polyketide synthetase MbtC	mycobactin polyketide synthetase MbtD	mycobactin salicyl-AMP ligase	mycocerosic acid synthase	mycofactocin system creatininase family protein	mycofactocin system glycosyltransferase	mycoredoxin	mycothiol S-conjugate amidase	mycothiol synthase	mycothiol system anti-sigma-R factor	mycothione reductase	myo-inositol 2-dehydrogenase (EC 1.1.1.18)	myo-inositol 2-dehydrogenase / D-chiro-inositol  1-dehydrogenase	myo-inositol catabolism protein IolH	myo-inositol-1(or 4)-monophosphatase	myo-inositol-1-phosphate synthase	myxalamid-type polyketide synthase MxaB	naphthoate synthase	natural product biosynthesis luciferase-like  monooxygenase domain-containing protein	natural resistance-associated macrophage protein	negative transcriptional regulator, PaiB family	neurotransmitter:Na+ symporter, NSS family	nickel superoxide dismutase	nickel transport protein	nickel transport system ATP-binding protein	nickel transport system permease protein	nickel transport system substrate-binding  protein	nicotinamidase/pyrazinamidase	nicotinamide mononucleotide transporter	nicotinamide phosphoribosyltransferase	nicotinamide-nucleotide adenylyltransferase,  NadR type	nicotinamide-nucleotide amidase	nicotinate dehydrogenase subunit A	nicotinate dehydrogenase subunit B	nicotinate phosphoribosyltransferase	nicotinate-nucleotide adenylyltransferase	nicotinate-nucleotide adenylyltransferase (EC  2.7.7.18)	nicotinate-nucleotide pyrophosphorylase  [carboxylating]	nicotinate-nucleotide pyrophosphorylase  [carboxylating] (EC 2.4.2.19)	nicotinate-nucleotide--dimethylbenzimidazole  phosphoribosyltransferase	nicotinate-nucleotide-dimethylbenzimidazole  phosphoribosyltransferase	nicotinate-nucleotide-dimethylbenzimidazole  phosphoribosyltransferase (EC 2.4.2.21)	nitrate ABC transporter, ATPase subunits C and D	nitrate ABC transporter, inner membrane subunit	nitrate reductase alpha subunit	nitrate reductase gamma subunit	nitrate transporter periplasmic component	nitrate/nitrite transport system  substrate-binding protein	nitrate/nitrite transport system ATP-binding  protein	nitrate/nitrite transport system permease  protein	nitrate/sulfonate/bicarbonate ABC transporter  periplasmic ligand-binding protein	nitric oxide dioxygenase	nitric oxide reductase NorD protein	nitric oxide reductase NorE protein	nitric oxide reductase NorQ protein	nitric oxide reductase subunit B	nitric oxide reductase subunit C	nitric oxide reductase, NorB subunit apoprotein	nitric oxide reductase, NorC subunit apoprotein	nitric oxide reductase, NorZ apoprotein	nitric-oxide synthase	nitrilase	nitrile hydratase	nitrile hydratase accessory protein	nitrite and sulphite reductase 4Fe-4S region	nitrite reductase (NAD(P)H), large subunit	nitrite reductase (NADH) large subunit	nitrite reductase (NADH) small subunit	nitrite reductase (NO-forming)	nitrite transporter	nitroalkane oxidase (EC 1.7.3.1)	nitrogen fixation protein NifB	nitrogen fixation protein NifQ	nitrogen fixation protein NifT	nitrogen fixation protein NifU	nitrogen fixation protein NifX	nitrogen fixation protein NifZ	nitrogen metabolism transcriptional regulator,  NtrC, Fis Family	nitrogen metabolism transcriptional regulator,  NtrC, Fis family	nitrogen regulatory protein P-II family	nitrogenase molybdenum-cofactor synthesis  protein NifE	nitrogenase molybdenum-iron protein NifN	nitrogenase-associated protein	nitrogenase-stabilizing/protective protein	nitronate monooxygenase	nitroreductase	nitrous oxidase accessory protein	nitrous oxide reductase apoprotein	nitrous-oxide reductase	nodulation protein E	nodulation protein F	non-canonical purine NTP pyrophosphatase,  rdgB/HAM1 family	non-heme chloroperoxidase	non-ribosomal peptide synthase domain  TIGR01720/amino acid adenylation domain-containing protein	non-ribosomal peptide synthetase	non-ribosomal peptide synthetase terminal domain  of unknown function	non-specific serine/threonine protein kinase	nondiscriminating glutamyl-tRNA synthetase	nonpolar-amino-acid-transporting ATPase	nuclease (SNase domain protein)	nucleobase:cation symporter-1, NCS1 family	nucleobase:cation symporter-2, NCS2 family	nucleoid DNA-binding protein	nucleoid-associated protein	nucleoside ABC transporter ATP-binding protein	nucleoside ABC transporter membrane protein	nucleoside diphosphate kinase	nucleoside diphosphate kinase (EC 2.7.4.6)	nucleoside recognition GATE domain-containing  membrane protein YjiH	nucleoside transport protein	nucleoside triphosphatase	nucleoside-binding protein	nucleotide sugar dehydrogenase	nucleotidyltransferase	nucleotidyltransferase substrate binding  protein, HI0074 family	nudix-type nucleoside diphosphatase, YffH/AdpP  family	octaprenyl-diphosphate synthase	octopine/nopaline transport system  substrate-binding protein	octopine/nopaline transport system ATP-binding  protein	octopine/nopaline transport system permease  protein	oleate hydratase	oligo-1,6-glucosidase	oligoendopeptidase F	oligopeptidase A	oligopeptidase A (EC:3.4.24.70). Metallo  peptidase. MEROPS family M03A	oligopeptidase B	oligopeptidase B (EC:3.4.21.83). Serine  peptidase. MEROPS family S09A	oligopeptidase B Serine peptidase. MEROPS family  S09A	oligopeptidase F. Metallo peptidase. MEROPS  family M03B	oligopeptide transport system ATP-binding  protein	oligopeptide transport system permease protein	oligopeptide transport system substrate-binding  protein	oligopeptide/dipeptide ABC transporter,  ATP-binding protein, C-terminal domain-containing protein	oligoribonuclease	omega-6 fatty acid desaturase (delta-12  desaturase)	opine dehydrogenase	ornithine carbamoyltransferase	ornithine carbamoyltransferase (EC 2.1.3.3)	ornithine cyclodeaminase	ornithine cyclodeaminase (EC 4.3.1.12)	ornithine decarboxylase	ornithine--oxo-acid transaminase	ornithine-acyl(acyl carrier protein)  N-acyltransferase	ornithine-acyl[acyl carrier protein]  N-acyltransferase	orotate phosphoribosyltransferase	orotate phosphoribosyltransferase (EC 2.4.2.10)	orotidine-5'-phosphate decarboxylase	orotidine-5'-phosphate decarboxylase (EC  4.1.1.23)	osmoprotectant transport system  substrate-binding protein	osmoprotectant transport system ATP-binding  protein	osmoprotectant transport system permease protein	osmosensitive K+ channel signal transduction  histidine kinase (EC 2.7.13.3)	osmotically inducible lipoprotein	osmotically inducible lipoprotein OsmB	osmotically inducible protein OsmC	outer membrane adhesin like proteiin	outer membrane autotransporter barrel  domain-containing protein	outer membrane autotransporter barrel domain  protein	outer membrane efflux protein	outer membrane immunogenic protein	outer membrane insertion C-terminal signal	outer membrane lipase/esterase	outer membrane lipoprotein LolB	outer membrane lipoprotein SlyB	outer membrane lipoprotein carrier protein	outer membrane lipoprotein carrier protein LolA	outer membrane protein	outer membrane protein OmpU	outer membrane protein assembly factor BamB	outer membrane protein assembly factor BamC	outer membrane protein assembly factor BamD	outer membrane protein assembly factor BamE	outer membrane protein insertion porin family	outer membrane protein, YaiO family	outer membrane protein, adhesin transport system	outer membrane protein, cobalt-zinc-cadmium  efflux system	outer membrane protein, multidrug efflux system	outer membrane protein, protease secretion  system	outer membrane receptor for ferrienterochelin  and colicins	outer membrane surface antigen	outer membrane transport energization protein  ExbB	outer membrane transport energization protein  ExbB (TC 2.C.1.1.1)	outer membrane transport energization protein  ExbD	outer membrane transport energization protein  ExbD (TC 2.C.1.1.1)	outer membrane transport energization protein  TonB	outer membrane transport energization protein  TonB (TC 2.C.1.1.1)	outer membrane usher protein	outer-membrane receptor for ferric coprogen and  ferric-rhodotorulic acid	oxalate decarboxylase	oxalate/formate antiporter	oxaloacetate decarboxylase alpha subunit	oxaloacetate decarboxylase, alpha subunit	oxalyl-CoA decarboxylase	oxepin-CoA hydrolase /  3-oxo-5,6-dehydrosuberyl-CoA semialdehyde dehydrogenase	oxidoreductase FAD/NAD(P)-binding domain protein	oxidoreductase alpha (molybdopterin) subunit	oxidoreductase domain protein	oxidoreductase molybdopterin binding	oxidoreductase molybdopterin binding protein	oxygen-dependent protoporphyrinogen oxidase	oxygen-independent coproporphyrinogen III  oxidase	oxygen-independent coproporphyrinogen-3 oxidase	p-hydroxybenzoate 3-monooxygenase	p-hydroxybenzoic acid efflux pump subunit AaeA	pRiA4b ORF-3-like protein	pTet43	paired small multidrug resistance pump	palmitoyl transferase	pantoate--beta-alanine ligase	pantothenate kinase	pantothenate synthetase	pantothenate synthetase (EC 6.3.2.1)	parB-like partition protein	para-aminobenzoate synthase, subunit I	para-aminobenzoate synthetase	para-aminobenzoate synthetase /  4-amino-4-deoxychorismate lyase	para-aminobenzoate synthetase component 1	para-aminobenzoate synthetase component 2	para-nitrobenzyl esterase	parallel beta-helix repeat (two copies)	paraquat-inducible protein A	paraquat-inducible protein B	patatin-related protein	penicillin amidase	penicillin amidase (EC 3.5.1.11). Cysteine  peptidase. MEROPS family C59	penicillin-binding protein	penicillin-binding protein 1A	penicillin-binding protein 1C	penicillin-binding protein 2	penicillin-binding protein 2A	penicillin-binding protein 2B	penicillin-binding protein 6. Serine peptidase.  MEROPS family S11	penicillin-binding protein, 1A family	penicillin-insensitive murein endopeptidase	pentachlorophenol monooxygenase	pentapeptide MXKDX repeat protein	pentapeptide repeat protein	peptidase A24A prepilin type IV	peptidase A2A	peptidase M16 domain protein	peptidase M17 leucyl aminopeptidase domain  protein	peptidase M22 glycoprotease	peptidase M48 Ste24p	peptidase M50	peptidase M61 domain protein	peptidase S1 and S6 chymotrypsin/Hap	peptidase S15	peptidase S16 lon domain protein	peptidase S24 and S26 domain protein	peptidase S49	peptidase U32	peptide chain release factor 1	peptide chain release factor 2	peptide chain release factor 3	peptide deformylase	peptide deformylase (EC 3.5.1.88)	peptide methionine sulfoxide reductase	peptide-methionine (R)-S-oxide reductase	peptide-methionine (S)-S-oxide reductase	peptide/bleomycin uptake transporter	peptide/nickel transport system  substrate-binding protein	peptide/nickel transport system ATP-binding  protein	peptide/nickel transport system permease protein	peptidoglycan L-alanyl-D-glutamate endopeptidase  CwlK	peptidoglycan binding domain-containing protein	peptidoglycan endopeptidase LytE	peptidoglycan glycosyltransferase	peptidoglycan glycosyltransferase (EC  2.4.1.129)/cell elongation-specific peptidoglycan D,D-transpeptidase	peptidoglycan glycosyltransferase (EC 2.4.1.129)	peptidoglycan synthetase FtsI (EC 2.4.1.129)	peptidoglycan transpeptidase precursor,  ErfK-YbiS-YhnG family	peptidoglycan-N-acetylmuramic acid deacetylase	peptidoglycan-associated lipoprotein	peptidyl-dipeptidase Dcp	peptidyl-dipeptidase Dcp (EC 3.4.15.5). Metallo  peptidase. MEROPS family M03A	peptidyl-prolyl cis-trans isomerase A  (cyclophilin A)	peptidyl-prolyl cis-trans isomerase B  (cyclophilin B)	peptidyl-prolyl cis-trans isomerase C	peptidyl-prolyl cis-trans isomerase D	peptidyl-prolyl cis-trans isomerase SurA	peptidyl-prolyl cis-trans isomerase cyclophilin  type	peptidyl-prolyl cis-trans isomerase, EpsD family	peptidyl-tRNA hydrolase	peptidyl-tRNA hydrolase (EC 3.1.1.29)	peptidyl-tRNA hydrolase, PTH1 family	peptidylprolyl isomerase	peptidylprolyl isomerase FKBP-type	periplasmic binding protein	periplasmic chaperone for outer membrane  proteins Skp	periplasmic chaperone for outer membrane  proteins SurA	periplasmic nitrate reductase subunit NapH	periplasmic protein thiol/disulfide  oxidoreductase DsbE	periplasmic sensor diguanylate  cyclase/phosphodiesterase	periplasmic solute binding protein	permease YjgP/YjgQ family protein	permease, urea carboxylase system	perosamine synthetase	peroxiredoxin	peroxiredoxin (alkyl hydroperoxide reductase  subunit C)	peroxiredoxin Q/BCP	peroxiredoxin, Ohr subfamily	peroxiredoxin, SACOL1771 subfamily	phage SPO1 DNA polymerase-related protein	phage baseplate assembly protein V	phage conserved hypothetical protein	phage conserved hypothetical protein BR0599	phage conserved hypothetical protein, phiE125  gp8 family	phage head morphogenesis protein, SPP1 gp7  family	phage head-tail adaptor, putative, SPP1 family	phage integrase family protein	phage major capsid protein, HK97 family	phage major tail protein, TP901-1 family	phage portal protein, HK97 family	phage portal protein, lambda family	phage prohead protease, HK97 family	phage prohead protease, HK97 family/phage major  capsid protein, HK97 family,TIGR01554	phage protein	phage protein, HK97 gp10 family	phage recombination protein Bet	phage regulatory protein	phage regulatory protein, rha family	phage replication initiation protein	phage shock protein A (PspA) family protein	phage shock protein C (PspC) family protein	phage tail protein domain-containing protein	phage tail protein, P2 protein I family	phage tail tape measure protein, TP901 family,  core region	phage tail tape measure protein, lambda family	phage tape measure protein	phage terminase large subunit	phage terminase small subunit	phage terminase, large subunit, PBSX family	phage terminase, small subunit, putative, P27  family	phage transcriptional regulator, ArpU family	phage uncharacterized protein (putative large  terminase), C-terminal domain-containing protein	phage virion morphogenesis (putative tail  completion) protein	phage-associated protein, BcepMu gp16 family	phage-related minor tail protein	phage/plasmid replication protein, gene II/X  family	phage/plasmid-like protein TIGR03299	phasin	phasin family protein	phenazine biosynthesis protein PhzF family	phenol 2-monooxygenase	phenol 2-monooxygenase P2 subunit	phenol 2-monooxygenase P4 subunit	phenol 2-monooxygenase P5 subunit	phenol hydroxylase P0 protein	phenol hydroxylase P2 protein	phenol hydroxylase P3 protein	phenol hydroxylase P4 protein	phenol hydroxylase P5 protein	phenolic acid decarboxylase	phenylacetaldehyde dehydrogenase	phenylacetate-CoA ligase	phenylacetic acid degradation protein	phenylacetic acid degradation protein paaN	phenylalanine-4-hydroxylase	phenylalanyl-tRNA synthetase beta subunit	phenylalanyl-tRNA synthetase beta subunit (EC  6.1.1.20)	phenylalanyl-tRNA synthetase, alpha subunit	phenylalanyl-tRNA synthetase, alpha subunit (EC  6.1.1.20)	pheromone shutdown-related protein TraB	phosphate ABC transporter ATP-binding protein,  PhoT family	phosphate ABC transporter ATP-binding protein,  PhoT family (TC 3.A.1.7.1)	phosphate ABC transporter membrane protein 1,  PhoT family	phosphate ABC transporter membrane protein 1,  PhoT family (TC 3.A.1.7.1)	phosphate ABC transporter membrane protein 2,  PhoT family	phosphate ABC transporter membrane protein 2,  PhoT family (TC 3.A.1.7.1)	phosphate ABC transporter substrate-binding  protein, PhoT family	phosphate ABC transporter substrate-binding  protein, PhoT family (TC 3.A.1.7.1)	phosphate ABC transporter, phosphate-binding  protein	phosphate acetyltransferase	phosphate butyryltransferase	phosphate butyryltransferase (EC 2.3.1.19)	phosphate starvation-inducible protein PhoH	phosphate transport system ATP-binding protein	phosphate transport system permease protein	phosphate transport system protein	phosphate transport system substrate-binding  protein	phosphate transporter	phosphate uptake regulator, PhoU	phosphate-selective porin O and P	phosphate-selective porin OprO and OprP	phosphate-starvation-inducible E	phosphate:Na+ symporter	phosphate:acyl-[acyl carrier protein]  acyltransferase	phosphatidate cytidylyltransferase	phosphatidylcholine synthase	phosphatidylethanolamine N-methyltransferase 	phosphatidylethanolamine:Kdo2-lipid A  phosphoethanolamine transferase	phosphatidylglycerol lysyltransferase	phosphatidylglycerol:prolipoprotein  diacylglycerol transferase	phosphatidylglycerophosphatase (EC 3.1.3.27)	phosphatidylglycerophosphatase A	phosphatidylinositol  alpha-1,6-mannosyltransferase	phosphatidylinositol alpha  1,6-mannosyltransferase	phosphatidylserine decarboxylase	phosphatidylserine decarboxylase precursor	phosphinothricin acetyltransferase	phosphoadenosine phosphosulfate reductase	phosphoadenylylsulfate reductase (thioredoxin)	phosphoadenylylsulfate reductase (thioredoxin)  (EC 1.8.4.8)	phosphocarrier protein	phosphocarrier protein FPr	phosphoenolpyruvate carboxykinase (ATP)	phosphoenolpyruvate carboxykinase (GTP)	phosphoenolpyruvate mutase	phosphoenolpyruvate mutase (EC 5.4.2.9)	phosphoenolpyruvate synthase	phosphoenolpyruvate synthase (EC 2.7.9.2)	phosphoenolpyruvate--protein phosphotransferase	phosphoenolpyruvate--protein phosphotransferase  (EC 2.7.3.9)	phosphoenolpyruvate-protein phosphotransferase	phosphoesterase PA-phosphatase related	phosphoesterase PA-phosphatase related protein	phosphoesterase RecJ domain protein	phosphoesterase RecJ domain-containing protein	phosphoesterase, MJ0936 family	phosphoglucomutase	phosphoglucomutase/phosphomannomutase  alpha/beta/alpha domain I	phosphoglucosamine mutase	phosphoglucosamine mutase (EC 5.4.2.10)	phosphoglycerate kinase	phosphoglycerate kinase (EC 2.7.2.3)	phosphoglycerate mutase	phosphoglycerate mutase (EC 5.4.2.1)	phosphoglycerol transferase	phosphoglycolate phosphatase	phosphoheptose isomerase (EC 5.3.1.-)	phosphohistidine phosphatase	phosphohistidine phosphatase, SixA	phospholipase A1	phospholipase C	phospholipase D/Transphosphatidylase	phospholipase D1/2	phospholipase/carboxylesterase	phospholipid transport system  transporter-binding protein	phospholipid transport system substrate-binding  protein	phospholipid-binding lipoprotein MlaA	phospholipid-binding protein, PBP family	phospholipid/cholesterol/gamma-HCH transport  system ATP-binding protein	phospholipid/cholesterol/gamma-HCH transport  system permease protein	phospholipid/cholesterol/gamma-HCH transport  system substrate-binding protein	phospholipid/glycerol acyltransferase	phosphomannomutase	phosphomannomutase (EC 5.4.2.8)	phosphomannomutase / phosphoglucomutase	phosphomethylpyrimidine kinase	phosphomethylpyrimidine synthase	phosphonatase-like hydrolase	phosphonate metabolim protein, transferase  hexapeptide repeat family	phosphonate metabolism-associated  iron-containing alcohol dehydrogenase	phosphonate transport system ATP-binding protein	phosphonate transport system permease protein	phosphonate transport system substrate-binding  protein	phosphonoacetaldehyde dehydrogenase	phosphonoacetaldehyde dehydrogenase (EC 1.2.1.-)	phosphonoacetaldehyde hydrolase	phosphonoacetaldehyde hydrolase (EC 3.11.1.1)	phosphonoacetate hydrolase	phosphonoacetate hydrolase (EC 3.11.1.2)	phosphonopyruvate decarboxylase	phosphonopyruvate decarboxylase (EC 4.1.1.82)	phosphopantetheine-binding	phosphopantetheine-binding protein	phosphopantetheinyl transferase-like protein	phosphopantothenoylcysteine decarboxylase /  phosphopantothenate--cysteine ligase	phosphopentomutase	phosphoribosyl 1,2-cyclic phosphate  phosphodiesterase	phosphoribosyl-AMP cyclohydrolase	phosphoribosyl-AMP cyclohydrolase (EC 3.5.4.19)	phosphoribosyl-ATP pyrophosphatase	phosphoribosyl-ATP pyrophosphatase (EC 3.6.1.31)	phosphoribosyl-dephospho-CoA transferase	phosphoribosylamine--glycine ligase	phosphoribosylamine--glycine ligase (EC  6.3.4.13)	phosphoribosylaminoimidazole-succinocarboxamide  synthase	phosphoribosylaminoimidazole-succinocarboxamide  synthase (EC 6.3.2.6)	phosphoribosylaminoimidazolecarboxamide  formyltransferase / IMP cyclohydrolase	phosphoribosylanthranilate isomerase	phosphoribosylanthranilate isomerase (EC  5.3.1.24)	phosphoribosylformimino-5-aminoimidazole  carboxamide ribotide isomerase	phosphoribosylformylglycinamidine cyclo-ligase	phosphoribosylformylglycinamidine cyclo-ligase  (EC 6.3.3.1)	phosphoribosylformylglycinamidine synthase	phosphoribosylformylglycinamidine synthase  subunit I	phosphoribosylformylglycinamidine synthase  subunit I (EC 6.3.5.3)	phosphoribosylformylglycinamidine synthase  subunit II	phosphoribosylformylglycinamidine synthase  subunit II (EC 6.3.5.3)	phosphoribosylglycinamide formyltransferase 2	phosphoribosylglycinamide formyltransferase-1	phosphoribosylglycinamide synthetase	phosphoribosyltransferase	phosphoribulokinase	phosphoserine aminotransferase apoenzyme	phosphoserine aminotransferase apoenzyme (EC  2.6.1.52)	phosphoserine phosphatase	phosphoserine phosphatase (EC 3.1.3.3)	phosphosulfolactate synthase	phosphotransacetylase (EC 2.3.1.8)	phosphotransferase system, enzyme I, PtsI	phosphotransferase system, enzyme I, PtsP	phosphotriesterase-related protein	photoactive yellow protein	photosynthetic reaction center H subunit	photosynthetic reaction center L subunit	photosynthetic reaction center M subunit	photosynthetic reaction center cytochrome c  subunit	phthiocerol/phenolphthiocerol synthesis type-I  polyketide synthase B	phthiocerol/phenolphthiocerol synthesis type-I  polyketide synthase E	phthiodiolone/phenolphthiodiolone  dimycocerosates ketoreductase	phytoene desaturase	phytoene synthase	phytoene synthase (EC 2.5.1.32)	pilus (MSHA type) biogenesis protein MshL	pilus assembly protein CpaB	pilus assembly protein CpaC	pilus assembly protein CpaD	pilus assembly protein CpaE	pilus assembly protein CpaF	pilus assembly protein FimV	pilus assembly protein Flp/PilA	pilus retraction ATPase PilT	pimeloyl-CoA biosynthesis protein BioC	pimeloyl-[acyl-carrier protein] methyl ester  esterase	plasma-membrane calcium-translocating P-type  ATPase	plasmid maintenance system antidote protein, XRE  family	plasmid maintenance system killer	plasmid mobilization system relaxase	plasmid replicase	polar amino acid transport system  substrate-binding protein	polar amino acid transport system ATP-binding  protein	polar amino acid transport system permease  protein	poly acetylglucosamine porin (TC 1.B.55)	poly(3-hydroxyalkanoate) depolymerase	poly(3-hydroxybutyrate) depolymerase	poly(A) polymerase	poly(glycerol-phosphate)  alpha-glucosyltransferase	poly-gamma-glutamate synthesis protein (capsule  biosynthesis protein)	polyhydroxyalkanoate depolymerase, intracellular	polyhydroxyalkanoate synthase	polyhydroxyalkanoate synthesis repressor PhaR	polyhydroxybutyrate depolymerase	polyketide synthase 13	polyketide-type polyunsaturated fatty acid  synthase PfaA	polymer biosynthesis protein, WecB/TagA/CpsF  family	polynucleotide adenylyltransferase/metal  dependent phosphohydrolase	polyol permease family	polyphosphate glucokinase	polyphosphate kinase	polyphosphate kinase 2, PA0141 family	polyphosphate:AMP phosphotransferase	polyphosphate:nucleotide phosphotransferase,  PPK2 family	polyribonucleotide nucleotidyltransferase	polysaccharide biosynthesis protein	polysaccharide biosynthesis protein CapD	polysaccharide chain length determinant protein,  PEP-CTERM locus subfamily	polysaccharide deacetylase	polysaccharide deacetylase family protein,  PEP-CTERM locus subfamily	polysaccharide export inner-membrane protein,  BexC/CtrB/KpsE family	polysaccharide export outer membrane protein	polysaccharide export protein	polysaccharide export protein EpsE	polysaccharide pyruvyl transferase	polysaccharide transporter, PST family	porin	porin LamB type	porin, OprB family	porin, OprB family (TC 1.B.19)	porphobilinogen synthase	porphobilinogen synthase (EC 4.2.1.24)	positive regulator of sigma(E), RseC/MucC	possible tyrosine transporter P-protein	potassium transporter	potassium uptake protein, TrkH family	potassium-transporting ATPase, A subunit	potassium-transporting ATPase, C subunit	potassium/proton antiporter membrane subunit,  CPA2 family	potassium/proton antiporter membrane subunit,  CPA2 family (TC 2.A.37.5.2)	potassium/proton antiporter regulatory subunit,  CPA2 family	potassium/proton antiporter, CPA1 family	potassium/proton antiporter, CPA1 family (TC  2.A.36)	ppGpp synthetase catalytic domain-containing  protein (RelA/SpoT-type nucleotidyltranferase)	preQ(0) biosynthesis protein QueC	preQ(0) biosynthesis protein QueE	precorrin-2 C20-methyltransferase	precorrin-2 C20-methyltransferase (EC  2.1.1.130)/cobalt-factor II C20-methyltransferase (EC 2.1.1.151)	precorrin-2 C20-methyltransferase / precorrin-3B  C17-methyltransferase	precorrin-2 dehydrogenase / sirohydrochlorin  ferrochelatase	precorrin-2/cobalt-factor-2  C20-methyltransferase	precorrin-3 methyltransferase	precorrin-3 methyltransferase (EC 2.1.1.131)	precorrin-3B C17-methyltransferase	precorrin-3B synthase	precorrin-4 C11-methyltransferase	precorrin-4 C11-methyltransferase (EC 2.1.1.133)	precorrin-4/cobalt-precorrin-4  C11-methyltransferase	precorrin-6A reductase	precorrin-6A reductase (EC 1.3.1.54)	precorrin-6A synthase (deacetylating)	precorrin-6A/cobalt-precorrin-6A reductase	precorrin-6Y C5,15-methyltransferase  (decarboxylating)	precorrin-8X methylmutase	predicted D-glycerate permease	predicted aconitase subunit 1	predicted aconitase subunit 2	predicted sulfurylase large subunit,  molybdopterin cytosine dinucleotide biosynthesis	predicted sulfurylase small subunit,  molybdopterin cytosine dinucleotide biosynthesis	prephenate dehydratase	prephenate dehydratase (EC 4.2.1.51)	prephenate dehydrogenase	prephenate dehydrogenase (EC 1.3.1.12)	prepilin peptidase CpaA	prepilin-type N-terminal cleavage/methylation  domain-containing protein	prepilin-type processing-associated H-X9-DG  domain-containing protein	preprotein translocase subunit SecA	preprotein translocase subunit SecB	preprotein translocase subunit SecD	preprotein translocase subunit SecE	preprotein translocase subunit SecF	preprotein translocase subunit SecG	preprotein translocase subunit YajC	prespore-specific regulator	prevent-host-death family protein	primary replicative DNA helicase	primary replicative DNA helicase (EC 3.6.1.-)	primary-amine oxidase	primosomal protein DnaI	primosome, DnaD subunit	pro-sigmaK processing inhibitor BofA	probable DNA repair protein	probable F420-dependent oxidoreductase,  MSMEG_2516 family	probable F420-dependent oxidoreductase,  MSMEG_2906 family	probable F420-dependent oxidoreductase,  MSMEG_4141 family	probable F420-dependent oxidoreductase, Rv1855c  family	probable F420-dependent oxidoreductase, Rv2161c  family	probable F420-dependent oxidoreductase, Rv3520c  family	probable H4MPT-linked C1 transfer pathway  protein	probable O-glycosylation ligase, exosortase  A-associated	probable Rubsico expression protein CbbX	probable addiction module antidote protein	probable biosynthetic protein, Pnap_2097 family	probable blue pigment (indigoidine) exporter	probable extracellular repeat, HAF family	probable nitrogen fixation protein	probable non-F420 flavinoid oxidoreductase	probable oxidoreductase, LLM family	probable phosphoglycerate mutase	probable phosphomutase, MSMEG_4193 family	probable rRNA maturation factor	prohead peptidase. Unknown type peptidase.  MEROPS family U35	prohead serine protease	prokaryotic ubiquitin-like protein Pup	prolin-rich transmembrane protein	proline iminopeptidase	proline racemase	proline racemase (EC 5.1.1.4)	proline-rich region	proline-specific permease ProY	prolipoprotein diacylglyceryl transferase	prolyl 4-hydroxylase	prolyl aminopeptidase (EC:3.4.11.5). Serine  peptidase. MEROPS family S33	prolyl aminopeptidase 2. Serine peptidase.  MEROPS family S33	prolyl oligopeptidase	prolyl-tRNA synthetase	prolyl-tRNA synthetase (EC 6.1.1.15)	propane monooxygenase coupling protein	propane monooxygenase large subunit	propane monooxygenase reductase subunit	propane monooxygenase small subunit	propanediol dehydratase large subunit	propanediol dehydratase small subunit	propanediol dehydratase, small subunit (EC  4.2.1.28)	prophage antirepressor	propionate CoA-transferase	propionate CoA-transferase (EC 2.8.3.1)	propionyl-CoA carboxylase alpha chain	propionyl-CoA carboxylase beta chain	propionyl-CoA carboxylase carboxyltransferase  subunit	propionyl-CoA synthetase	propionyl-CoA synthetase (EC 6.2.1.17)	protease Do	protease FtsH subunit HflC	protease FtsH subunit HflK	protease I	protease-4	proteasome accessory factor A	proteasome accessory factor B	proteasome accessory factor C	proteasome alpha subunit	proteasome beta subunit	proteasome endopeptidase complex, beta component  (EC 3.4.25.1). Threonine peptidase. MEROPS family T01B	proteasome endopeptidase complex, beta component  Threonine peptidase. MEROPS family T01B	proteasome-associated ATPase	proteic killer suppression protein	protein C (EC:3.4.21.69). Serine peptidase.  MEROPS family S49	protein CcmA, bactofilin family	protein FrlC	protein ImuA	protein ImuB	protein PsiE	protein RodZ, contains Xre-like HTH and DUF4115  domains	protein SCO1/2	protein TonB	protein TorT	protein YqhG of unknown function	protein arginine N-methyltransferase 1	protein disulfide-isomerase	protein gp37	protein involved in methylation	protein involved in ribonucleotide reduction	protein of unknown function (DU1801)	protein of unknown function (DUF1080)	protein of unknown function (DUF1127)	protein of unknown function (DUF1206)	protein of unknown function (DUF1259)	protein of unknown function (DUF1508)	protein of unknown function (DUF1540)	protein of unknown function (DUF1707)	protein of unknown function (DUF1713)	protein of unknown function (DUF1737)	protein of unknown function (DUF1772)	protein of unknown function (DUF1788)	protein of unknown function (DUF1794)	protein of unknown function (DUF1798)	protein of unknown function (DUF1833)	protein of unknown function (DUF1835)	protein of unknown function (DUF1836)	protein of unknown function (DUF1837)	protein of unknown function (DUF1839)	protein of unknown function (DUF1840)	protein of unknown function (DUF1841)	protein of unknown function (DUF1849)	protein of unknown function (DUF1852)	protein of unknown function (DUF1854)	protein of unknown function (DUF1876)	protein of unknown function (DUF1877)	protein of unknown function (DUF1905)	protein of unknown function (DUF1906)	protein of unknown function (DUF1918)	protein of unknown function (DUF1924)	protein of unknown function (DUF1931)	protein of unknown function (DUF1942)	protein of unknown function (DUF1987)	protein of unknown function (DUF1992)	protein of unknown function (DUF1998)	protein of unknown function (DUF2017)	protein of unknown function (DUF202)	protein of unknown function (DUF2088)	protein of unknown function (DUF222)	protein of unknown function (DUF2703)	protein of unknown function (DUF2935)	protein of unknown function (DUF296)	protein of unknown function (DUF303)	protein of unknown function (DUF305)	protein of unknown function (DUF326)	protein of unknown function (DUF3291)	protein of unknown function (DUF349)	protein of unknown function (DUF3576)	protein of unknown function (DUF3597)	protein of unknown function (DUF3806)	protein of unknown function (DUF3862)	protein of unknown function (DUF3883)	protein of unknown function (DUF3885)	protein of unknown function (DUF397)	protein of unknown function (DUF4032)	protein of unknown function (DUF4034)	protein of unknown function (DUF4055)	protein of unknown function (DUF4062)	protein of unknown function (DUF4082)	protein of unknown function (DUF4083)	protein of unknown function (DUF4102)	protein of unknown function (DUF4105)	protein of unknown function (DUF4112)	protein of unknown function (DUF4118)	protein of unknown function (DUF4124)	protein of unknown function (DUF4126)	protein of unknown function (DUF4129)	protein of unknown function (DUF4132)	protein of unknown function (DUF4139)	protein of unknown function (DUF4142)	protein of unknown function (DUF4145)	protein of unknown function (DUF4149)	protein of unknown function (DUF4150)	protein of unknown function (DUF4153)	protein of unknown function (DUF4154)	protein of unknown function (DUF4157)	protein of unknown function (DUF4159)	protein of unknown function (DUF4160)	protein of unknown function (DUF4164)	protein of unknown function (DUF4166)	protein of unknown function (DUF4167)	protein of unknown function (DUF4169)	protein of unknown function (DUF4170)	protein of unknown function (DUF4173)	protein of unknown function (DUF4174)	protein of unknown function (DUF4177)	protein of unknown function (DUF4178)	protein of unknown function (DUF4179)	protein of unknown function (DUF4180)	protein of unknown function (DUF4185)	protein of unknown function (DUF4186)	protein of unknown function (DUF4188)	protein of unknown function (DUF4189)	protein of unknown function (DUF4190)	protein of unknown function (DUF4191)	protein of unknown function (DUF4192)	protein of unknown function (DUF4193)	protein of unknown function (DUF4194)	protein of unknown function (DUF4198)	protein of unknown function (DUF4202)	protein of unknown function (DUF4224)	protein of unknown function (DUF4226)	protein of unknown function (DUF4234)	protein of unknown function (DUF4253)	protein of unknown function (DUF4258)	protein of unknown function (DUF4260)	protein of unknown function (DUF4262)	protein of unknown function (DUF4263)	protein of unknown function (DUF4265)	protein of unknown function (DUF4268)	protein of unknown function (DUF4272)	protein of unknown function (DUF4274)	protein of unknown function (DUF4276)	protein of unknown function (DUF4281)	protein of unknown function (DUF4287)	protein of unknown function (DUF4297)	protein of unknown function (DUF4304)	protein of unknown function (DUF4307)	protein of unknown function (DUF4317)	protein of unknown function (DUF4326)	protein of unknown function (DUF4328)	protein of unknown function (DUF4331)	protein of unknown function (DUF4332)	protein of unknown function (DUF4333)	protein of unknown function (DUF4334)	protein of unknown function (DUF4336)	protein of unknown function (DUF4337)	protein of unknown function (DUF4339)	protein of unknown function (DUF4340)	protein of unknown function (DUF4345)	protein of unknown function (DUF4349)	protein of unknown function (DUF4350)	protein of unknown function (DUF4352)	protein of unknown function (DUF4353)	protein of unknown function (DUF4357)	protein of unknown function (DUF4365)	protein of unknown function (DUF4375)	protein of unknown function (DUF4376)	protein of unknown function (DUF4380)	protein of unknown function (DUF4381)	protein of unknown function (DUF4383)	protein of unknown function (DUF4384)	protein of unknown function (DUF4387)	protein of unknown function (DUF4389)	protein of unknown function (DUF4390)	protein of unknown function (DUF4391)	protein of unknown function (DUF4392)	protein of unknown function (DUF4394)	protein of unknown function (DUF4395)	protein of unknown function (DUF4396)	protein of unknown function (DUF4398)	protein of unknown function (DUF4399)	protein of unknown function (DUF4405)	protein of unknown function (DUF4411)	protein of unknown function (DUF4424)	protein of unknown function (DUF4434)	protein of unknown function (DUF4438)	protein of unknown function (DUF4439)	protein of unknown function (DUF4440)	protein of unknown function (DUF4442)	protein of unknown function (DUF4652)	protein of unknown function (DUF4755)	protein of unknown function (DUF4760)	protein of unknown function (DUF4815)	protein of unknown function (DUF4824)	protein of unknown function (DUF4844)	protein of unknown function (DUF4845)	protein of unknown function (DUF4864)	protein of unknown function (DUF4865)	protein of unknown function (DUF4868)	protein of unknown function (DUF4872)	protein of unknown function (DUF4873)	protein of unknown function (DUF4878)	protein of unknown function (DUF4893)	protein of unknown function (DUF4912)	protein of unknown function (DUF4913)	protein of unknown function (DUF4916)	protein of unknown function (DUF4919)	protein of unknown function (DUF4926)	protein of unknown function (DUF4936)	protein of unknown function (DUF4956)	protein of unknown function (DUF5051)	protein of unknown function (DUF5058)	protein of unknown function (DUF5060)	protein of unknown function (DUF5063)	protein of unknown function (DUF5076)	protein of unknown function (DUF5078)	protein of unknown function (DUF748)	protein of unknown function (DUF839)	protein of unknown function (DUF898)	protein of unknown function (DUF916)	protein of unknown function (DUF930)	protein of unknown function (DUF932)	protein of unknown function (DUF937)	protein of unknown function (DUF946)	protein of unknown function (DUF948)	protein of unknown function (DUF955)	protein of unknown function (Gcw_chp)	protein of unknown function DUF1003	protein of unknown function DUF1022	protein of unknown function DUF1058	protein of unknown function DUF107	protein of unknown function DUF1211	protein of unknown function DUF1223	protein of unknown function DUF1232	protein of unknown function DUF1239	protein of unknown function DUF125 transmembrane	protein of unknown function DUF1255	protein of unknown function DUF1275	protein of unknown function DUF1282	protein of unknown function DUF1289	protein of unknown function DUF1295	protein of unknown function DUF1328	protein of unknown function DUF1330	protein of unknown function DUF1342	protein of unknown function DUF1345	protein of unknown function DUF1348	protein of unknown function DUF1365	protein of unknown function DUF1376	protein of unknown function DUF140	protein of unknown function DUF1458	protein of unknown function DUF1486	protein of unknown function DUF150	protein of unknown function DUF1501	protein of unknown function DUF1504	protein of unknown function DUF1508	protein of unknown function DUF152	protein of unknown function DUF1555	protein of unknown function DUF156	protein of unknown function DUF159	protein of unknown function DUF163	protein of unknown function DUF1643	protein of unknown function DUF1656	protein of unknown function DUF177	protein of unknown function DUF179	protein of unknown function DUF181	protein of unknown function DUF182	protein of unknown function DUF185	protein of unknown function DUF188	protein of unknown function DUF190	protein of unknown function DUF195	protein of unknown function DUF201	protein of unknown function DUF202	protein of unknown function DUF21	protein of unknown function DUF214	protein of unknown function DUF218	protein of unknown function DUF224 cysteine-rich  region domain protein	protein of unknown function DUF262	protein of unknown function DUF264	protein of unknown function DUF28	protein of unknown function DUF29	protein of unknown function DUF299	protein of unknown function DUF302	protein of unknown function DUF323	protein of unknown function DUF326	protein of unknown function DUF329	protein of unknown function DUF330	protein of unknown function DUF336	protein of unknown function DUF339	protein of unknown function DUF34	protein of unknown function DUF343	protein of unknown function DUF344	protein of unknown function DUF347	protein of unknown function DUF37	protein of unknown function DUF395 YeeE/YedE	protein of unknown function DUF399	protein of unknown function DUF403	protein of unknown function DUF404	protein of unknown function DUF442	protein of unknown function DUF447	protein of unknown function DUF45	protein of unknown function DUF455	protein of unknown function DUF461	protein of unknown function DUF466	protein of unknown function DUF47	protein of unknown function DUF477	protein of unknown function DUF480	protein of unknown function DUF481	protein of unknown function DUF482	protein of unknown function DUF484	protein of unknown function DUF486	protein of unknown function DUF493	protein of unknown function DUF494	protein of unknown function DUF498	protein of unknown function DUF502	protein of unknown function DUF513 hemX	protein of unknown function DUF519	protein of unknown function DUF520	protein of unknown function DUF526	protein of unknown function DUF55	protein of unknown function DUF556	protein of unknown function DUF558	protein of unknown function DUF58	protein of unknown function DUF583	protein of unknown function DUF59	protein of unknown function DUF6 transmembrane	protein of unknown function DUF615	protein of unknown function DUF692	protein of unknown function DUF72	protein of unknown function DUF721	protein of unknown function DUF748	protein of unknown function DUF779	protein of unknown function DUF805	protein of unknown function DUF808	protein of unknown function DUF81	protein of unknown function DUF815	protein of unknown function DUF853 NPT hydrolase  putative	protein of unknown function DUF861 cupin_3	protein of unknown function DUF87	protein of unknown function DUF88	protein of unknown function DUF883 ElaB	protein of unknown function DUF894 DitE	protein of unknown function DUF898 transmembrane	protein of unknown function DUF937	protein of unknown function DUF955	protein of unknown function DUF971	protein of unknown function RIO1	protein of unknown function UPF0005	protein of unknown function UPF0029	protein of unknown function UPF0044	protein of unknown function UPF0047	protein of unknown function UPF0054	protein of unknown function UPF0060	protein of unknown function UPF0061	protein of unknown function UPF0075	protein of unknown function UPF0079	protein of unknown function UPF0102	protein of unknown function UPF0118	protein of unknown function UPF0125	protein of unknown function UPF0126	protein of unknown function UPF0153	protein of unknown function UPF0187	protein of unknown function YGGT	protein of unknown function zinc  metallopeptidase putative	protein phosphatase	protein refolding chaperone Spy/CpxP family	protein serine/threonine phosphatase	protein structure with unknown function	protein translocase subunit secA	protein translocase subunit secB	protein translocase subunit secE/sec61 gamma	protein translocase subunit secF	protein translocase subunit secG	protein translocase subunit secY/sec61 alpha	protein translocase subunit yajC	protein translocase subunit yidC	protein translocase, SecG subunit	protein tyrosine phosphatase	protein-L-isoaspartate O-methyltransferase	protein-L-isoaspartate(D-aspartate)  O-methyltransferase	protein-disulfide reductase (glutathione)	protein-export membrane protein SecD	protein-glutamine gamma-glutamyltransferase	protein-histidine pros-kinase	protein-tyrosine kinase	protein-tyrosine phosphatase	protocatechuate 3,4-dioxygenase alpha subunit	protocatechuate 3,4-dioxygenase beta subunit	protocatechuate 3,4-dioxygenase, alpha subunit	protocatechuate 3,4-dioxygenase, beta subunit	protoheme IX farnesyltransferase	proton glutamate symport protein	proton-dependent oligopeptide transporter, POT  family	protoporphyrin IX magnesium-chelatase (EC  6.6.1.1)	protoporphyrinogen oxidase (EC 1.3.3.4)	pseudaminic acid biosynthesis-associated  methylase	pseudoazurin	pseudouridine kinase	pseudouridine synthase, RluA family	pseudouridine-5'-phosphate glycosidase	psiF repeat-containing protein	pteridine reductase	pterin-4-alpha-carbinolamine dehydratase (EC  4.2.1.96)	pullulanase	purine catabolism regulatory protein	purine nucleosidase	purine nucleoside transport protein	purine operon repressor, PurR	purine-binding chemotaxis protein CheW	purine-nucleoside phosphorylase	putative (di)nucleoside polyphosphate hydrolase	putative 3-demethylubiquinone-9  3-O-methyltransferase	putative ABC transport system ATP-binding  protein	putative ABC transport system permease protein	putative ABC transport system substrate-binding  protein	putative ATP-binding cassette transporter	putative ATP-dependent endonuclease of the OLD  family	putative ATPase	putative Chase2 sensor protein	putative DNA modification/repair radical SAM  protein	putative DNA primase/helicase	putative DNA repair protein	putative DNA-invertase from lambdoid prophage  Rac	putative DeoR family transcriptional regulator,  stage III sporulation protein D	putative FMN-dependent luciferase-like  monooxygenase, KPN_01858 family	putative GAF sensor protein	putative GTP pyrophosphokinase	putative HD superfamily hydrolase of NAD  metabolism	putative MFS transporter, AGZA family,  xanthine/uracil permease	putative Mg2+ transporter-C (MgtC) family  protein	putative N-acetyltransferase, MSMEG_0567  N-terminal domain family	putative N6-adenine-specific DNA methylase	putative NAD(P)H nitroreductase	putative NAD(P)H quinone oxidoreductase, PIG3  family	putative PAS/PAC sensor protein	putative PEP-CTERM system TPR-repeat lipoprotein	putative PEP-CTERM system histidine kinase	putative RNA 2'-phosphotransferase	putative RNA methylase	putative RNA-binding protein, YhbY family	putative RecB family exonuclease	putative TIM-barrel protein, nifR3 family	putative Tn7-like transposition protein B	putative acetyltransferase	putative acyl-CoA dehydrogenase	putative addiction module antidote	putative addiction module antidote protein	putative addiction module antidote protein,  CC2985 family	putative addiction module component, TIGR02574  family	putative addiction module killer protein	putative adenylate-forming enzyme	putative adenylate/guanylate cyclase	putative aldouronate transport system  substrate-binding protein	putative aldouronate transport system permease  protein	putative bacilliredoxin, YphP/YqiW family	putative baseplate assembly protein	putative beta (1-6) glucan synthase	putative cardiolipin synthase	putative cation efflux system protein CusC	putative chitinase	putative choline sulfate-utilization  transcription factor	putative colanic acid biosynthesis  acetyltransferase WcaF	putative colanic acid biosysnthesis UDP-glucose  lipid carrier transferase	putative copper resistance protein D	putative copper resistance-related lipoprotein	putative dibenzothiophene desulfurization enzyme  B	putative diguanylate cyclase	putative drug exporter of the RND superfamily	putative dual specificity phosphatase	putative efflux protein, MATE family	putative endonuclease	putative endopeptidase	putative exonuclease RdgC	putative exported protein of unknown function	putative ferredoxin 2Fe-2S protein	putative flagellar biosynthetic protein	putative flagellar synthesis (flagellar regulon)	putative flavoprotein involved in K+ transport	putative galactosyl transferase	putative general secretion pathway GspG related  transmembrane protein	putative glutamine amidotransferase	putative glutathione S-transferase	putative glycerol-1-phosphate prenyltransferase	putative glycosyltransferase, TIGR04348 family	putative hemin transport protein	putative hemolysin	putative holliday junction resolvase	putative hydrolase	putative hydrolase of the HAD superfamily	putative hydrolase/uncharacterized protein,  coenzyme F420 biosynthesis associated	putative hydrolases of HD superfamily	putative hydroxymethylpyrimidine transport  system ATP-binding protein	putative hydroxymethylpyrimidine transport  system permease protein	putative hydroxymethylpyrimidine transport  system substrate-binding protein	putative integral membrane protein	putative integral membrane protein TIGR02587	putative iron uptake protein	putative iron-dependent peroxidase	putative iron-regulated protein	putative lipoprotein	putative lipoprotein transmembrane	putative lipoprotein-like protein	putative long chain acyl-CoA synthase	putative luciferase-like monooxygenase,  FMN-dependent, CE1758 family	putative mRNA 3-end processing factor	putative mannose-sensitive agglutinin (MSHA)  biogenesis protein MshI	putative mannose-sensitive agglutinin (MSHA)  biogenesis protein MshJ	putative membrane protein	putative membrane-associated protein	putative metal dependent phosphohydrolase	putative metallohydrolase, TIGR04338 family	putative metalloprotease	putative molybdopterin biosynthesis protein	putative multiple sugar transport system  ATP-binding protein	putative multiple sugar transport system  permease protein	putative multiple sugar transport system  substrate-binding protein	putative oligopeptide transporter, OPT family	putative outer membrane protein	putative oxidoreductase	putative peptide zinc metalloprotease protein	putative peptidoglycan lipid II flippase	putative permease	putative phage cell wall peptidase, NlpC/P60  family	putative phage repressor	putative phage-type endonuclease	putative phosphoesterase	putative phosphohistidine phosphatase, SixA	putative phospholipase	putative phosphonate catabolism associated  alcohol dehydrogenase	putative phosphonate metabolism protein	putative phosphonate transport system  ATP-binding protein	putative phosphonoacetaldehyde dehydrogenase	putative phosphoribosyl transferase	putative phosphoserine phosphatase /  1-acylglycerol-3-phosphate O-acyltransferase	putative phosphotransacetylase	putative photosynthetic complex assembly protein	putative photosynthetic complex assembly protein  2	putative plasmid maintenance system antidote  protein, XRE family	putative polymerase	putative prolin-rich transmembrane protein	putative proline rich signal peptide protein	putative protease	putative proteasome-type protease	putative quinone oxidoreductase, YhdH/YhfP  family	putative redox protein	putative regulatory protein, FmdB family	putative restriction endonuclease	putative rhizobiocin/RTX toxin and  hemolysin-type calcium binding protein	putative salt-induced outer membrane protein	putative secreted protein	putative secretion ATPase, PEP-CTERM locus  subfamily	putative serine protease PepD	putative serine protein kinase, PrkA	putative serine-rich protein	putative sigma-54 modulation protein	putative sigma54 specific transcriptional  regulator	putative signal peptide protein	putative signal transduction protein	putative signal transduction protein with CBS  domains	putative signal transduction protein with EFhand  domain	putative signal transduction protein with Nacht  domain	putative site-specific recombinase, prophage  insertion	putative solute:sodium symporter small subunit	putative spermidine/putrescine transport system  ATP-binding protein	putative spermidine/putrescine transport system  permease protein	putative spermidine/putrescine transport system  substrate-binding protein	putative sporulation protein YyaC	putative tRNA adenosine deaminase-associated  protein	putative thiol-disulfide oxidoreductase DCC	putative thiol:disulphide interchange protein	putative thioredoxin	putative toxin-antitoxin system antitoxin  component, TIGR02293 family	putative toxin-antitoxin system toxin component,  PIN family	putative transcriptional acitvator, Baf family	putative transcriptional activator, TenA family	putative transcriptional regulator	putative transcriptional regulator, Crp/Fnr  family	putative transcriptional regulator, ModE family	putative transmembrane protein	putative transport protein	putative transposase	putative tricarboxylic transport membrane  protein	putative two-component system response regulator	putative type 4 fimbrial biogenesis  transmembrane protein	putative urate catabolism protein	putative xylitol transport system permease  protein	putrescine aminotransferase	putrescine carbamoyltransferase	putrescine oxidase	putrescine transport system ATP-binding protein	putrescine transport system permease protein	putrescine transport system substrate-binding  protein	pyochelin biosynthetic protein PchC	pyochelin synthetase	pyridine nucleotide-disulfide oxidoreductase  family protein	pyridoxal 5'-phosphate synthase pdxS subunit	pyridoxal 5-phosphate dependent beta-lyase	pyridoxal phosphate synthase yaaD subunit	pyridoxal phosphate synthase yaaE subunit	pyridoxamine 5'-phosphate oxidase-related  FMN-binding	pyridoxamine 5'-phosphate oxidase-related  FMN-binding protein	pyridoxine 4-dehydrogenase	pyridoxine 5'-phosphate synthase	pyridoxine 5'-phosphate synthase (EC 2.6.99.2)	pyridoxine 5-phosphate synthase	pyridoxine kinase	pyrimidine 5'-nucleotidase	pyrimidine operon attenuation protein / uracil  phosphoribosyltransferase	pyrimidine oxygenase	pyrimidine-nucleoside phosphorylase	pyrimidine-specific ribonucleoside hydrolase	pyroglutamyl-peptidase	pyroglutamyl-peptidase I Cysteine peptidase.  MEROPS family C15	pyrophosphatase PpaX	pyrroline-5-carboxylate reductase	pyrroline-5-carboxylate reductase (EC 1.5.1.2)	pyrroloquinoline quinone biosynthesis protein B	pyrroloquinoline quinone biosynthesis protein D	pyrroloquinoline quinone biosynthesis protein E	pyrroloquinoline-quinone synthase	pyruvate carboxylase	pyruvate carboxylase subunit A	pyruvate carboxylase subunit B	pyruvate dehydrogenase (quinone)	pyruvate dehydrogenase (quinone) (EC 1.2.5.1)	pyruvate dehydrogenase E1 component	pyruvate dehydrogenase E1 component alpha  subunit	pyruvate dehydrogenase E1 component beta subunit	pyruvate dehydrogenase E2 component  (dihydrolipoamide acetyltransferase)	pyruvate dehydrogenase complex dihydrolipoamide  acetyltransferase	pyruvate formate lyase activating enzyme	pyruvate kinase	pyruvate kinase (EC 2.7.1.40)	pyruvate kinase /pyruvate kinase	pyruvate phosphate dikinase	pyruvate phosphate dikinase (EC 2.7.9.1)	pyruvate phosphate dikinase PEP/pyruvate-binding  protein	pyruvate, orthophosphate dikinase	pyruvate, water dikinase	quaternary ammonium compound-resistance protein  SugE	queuine tRNA-ribosyltransferase	quinate dehydrogenase (quinone)	quinohemoprotein amine dehydrogenase	quinohemoprotein amine dehydrogenase, beta  subunit	quinohemoprotein ethanol dehydrogenase	quinolinate synthetase	quinolinate synthetase (EC 2.5.1.72)	quinoprotein dehydrogenase-associated probable  ABC transporter substrate-binding protein	quinoprotein glucose dehydrogenase	quinoprotein relay system zinc metallohydrolase  1	quinoprotein relay system zinc metallohydrolase  2	rRNA methylases	radical SAM methylthiotransferase, MiaB/RimO  family	radical SAM protein, MSMEG_0568 family	radical SAM/CxCxxxxC motif protein YfkAB	radical SAM/Cys-rich domain-containing protein	raffinose/stachyose/melibiose transport system  permease protein	raffinose/stachyose/melibiose transport system  substrate-binding protein	rarD protein	rare lipoprotein A	reactive intermediate/imine deaminase	recA protein	receptor protein-tyrosine kinase	recombination associated protein RdgC	recombination protein RecA	recombination protein RecT	recombination protein U	redox-sensing transcriptional repressor	reduced coenzyme F420:NADP oxidoreductase	reduced coenzyme F420:NADP oxidoreductase (EC  1.6.99.-)	regulator RcnB of Ni and Co efflux	regulator of CtrA degradation	regulator of cell morphogenesis and NO signaling	regulator of nucleoside diphosphate kinase	regulator of ribonuclease activity A	regulator of sigma E protease	regulatory inactivation of DnaA Hda protein	regulatory protein	regulatory protein RecX	regulatory protein, Fis family	regulatory protein, FmdB family	regulatory protein, arsR family	regulatory protein, luxR family	relaxasome subunit MobC	release factor glutamine methyltransferase	repeat domain (List_Bact_rpt)	replication initiation factor	replication initiation protein RepC	replication region DNA-binding N-term	replication restart DNA helicase PriA	replication termination protein	replicative DNA helicase	replicative DNA helicase loader DnaB	repressor LexA	resistance to homoserine/threonine (RhtB) family  protein	respiratory nitrate reductase alpha subunit  apoprotein	respiratory nitrate reductase beta subunit	respiratory nitrate reductase chaperone NarJ	respiratory nitrate reductase gamma subunit	response regulator receiver and ANTAR domain  protein	response regulator receiver modulated  diguanylate cyclase	response regulator receiver modulated  diguanylate cyclase with PAS/PAC sensor	response regulator receiver modulated  diguanylate cyclase/phosphodiesterase	response regulator receiver modulated  diguanylate cyclase/phosphodiesterase with PAS/PAC sensor(s)	response regulator receiver modulated CheB  methylesterase	response regulator receiver modulated metal  dependent phosphohydrolase	response regulator receiver protein	restart primosome assembly protein PriB	restriction modification system DNA specificity  domain protein	restriction system protein	restriction system-associated AAA family ATPase	rfaE bifunctional protein, domain I	rfaE bifunctional protein, domain II	rhamnose transport system ATP-binding protein	rhamnose transport system permease protein	rhamnose transport system substrate-binding  protein	rhamnosyl/mannosyltransferase	rhamnosyltransferase	rhamnulokinase	rhamnulose-1-phosphate aldolase	rhamnulose-1-phosphate aldolase/alcohol  dehydrogenase	rhomboid protease GluP	ribitol 2-dehydrogenase	riboflavin biosynthesis RibT protein	riboflavin kinase / FMN adenylyltransferase	riboflavin synthase alpha chain	riboflavin synthase alpha chain (EC 2.5.1.9)	riboflavin-specific deaminase C-terminal  domain-containing protein	ribokinase	ribonuclease BN	ribonuclease D	ribonuclease E	ribonuclease G	ribonuclease HI	ribonuclease HIII	ribonuclease II	ribonuclease III	ribonuclease J	ribonuclease P protein component	ribonuclease P protein component (EC 3.1.26.5)	ribonuclease PH	ribonuclease R	ribonuclease T1	ribonuclease T2	ribonuclease Z	ribonuclease, Rne/Rng family	ribonuclease-3	ribonucleoside-diphosphate reductase alpha chain	ribonucleoside-diphosphate reductase beta chain	ribonucleoside-diphosphate reductase class II	ribonucleoside-diphosphate reductase class II  (EC 1.17.4.-)	ribonucleoside-diphosphate reductase class Ia  alpha subunit	ribonucleoside-diphosphate reductase class Ia  beta subunit	ribonucleoside-diphosphate reductase class Ib  alpha subunit	ribonucleoside-diphosphate reductase class Ib  beta subunit	ribonucleoside-diphosphate reductase class Ib  glutaredoxin subunit	ribonucleoside-diphosphate reductase, alpha  subunit	ribonucrease Y	ribose 1,5-bisphosphokinase	ribose 5-phosphate isomerase B	ribose transport system ATP-binding protein	ribose transport system permease protein	ribose transport system substrate-binding  protein	ribose-5-phosphate isomerase	ribose-5-phosphate isomerase (EC 5.3.1.6)	ribose-phosphate pyrophosphokinase	ribosomal large subunit pseudouridine synthase A	ribosomal large subunit pseudouridine synthase B  (EC 5.4.99.-)	ribosomal large subunit pseudouridine synthase C  (EC 5.4.99.24)	ribosomal large subunit pseudouridine synthase D	ribosomal large subunit pseudouridine synthase D  (EC 5.4.99.-)	ribosomal large subunit pseudouridine synthase E  (EC 5.4.99.-)	ribosomal protein L11 methyltransferase	ribosomal protein L3 glutamine methyltransferase	ribosomal protein L30	ribosomal protein L31	ribosomal protein L34	ribosomal protein L4/L1e	ribosomal protein L6	ribosomal protein S1	ribosomal protein S10	ribosomal protein S11	ribosomal protein S12	ribosomal protein S12 methylthiotransferase	ribosomal protein S12 methylthiotransferase  accessory factor	ribosomal protein S13	ribosomal protein S16	ribosomal protein S6--L-glutamate ligase	ribosomal protein S8	ribosomal small subunit pseudouridine synthase A  (EC 5.4.99.-)	ribosomal subunit interface protein	ribosomal-protein-alanine N-acetyltransferase	ribosome biogenesis GTP-binding protein YlqF	ribosome biogenesis GTPase	ribosome biogenesis GTPase A	ribosome maturation factor RimP	ribosome recycling factor	ribosome small subunit-dependent GTPase A	ribosome-associated GTPase EngA	ribosome-associated heat shock protein Hsp15	ribosome-associated protein	ribosome-binding factor A	ribosome-dependent ATPase	ribosyldihydronicotinamide dehydrogenase  (quinone)	ribulokinase	ribulose 1,5-bisphosphate carboxylase large  subunit	ribulose 1,5-bisphosphate carboxylase small  subunit	ribulose 1,5-bisphosphate carboxylase small  subunit (EC 4.1.1.39)	ribulose-5-phosphate 3-epimerase	ribulose-5-phosphate 3-epimerase (EC 5.1.3.1)	ribulose-bisphosphate carboxylase large chain	ribulose-bisphosphate carboxylase small chain	ribulose-phosphate 3-epimerase	rifampin ADP-ribosylating transferase	ring-1,2-phenylacetyl-CoA epoxidase subunit PaaA	ring-1,2-phenylacetyl-CoA epoxidase subunit PaaB	ring-1,2-phenylacetyl-CoA epoxidase subunit PaaC	ring-1,2-phenylacetyl-CoA epoxidase subunit PaaD	ring-1,2-phenylacetyl-CoA epoxidase subunit PaaE	rod shape determining protein RodA	rod shape-determining protein MreB	rod shape-determining protein MreC	rod shape-determining protein MreD	rsbT antagonist protein RsbS	rsbT co-antagonist protein RsbR	rubredoxin-NAD+ reductase	saccharopine dehydrogenase (NAD+, L-lysine  forming)	salicylate hydroxylase	salicylate synthase (EC 4.1.3.-)	salicylate synthetase	sarcosine oxidase	sarcosine oxidase subunit alpha	sarcosine oxidase subunit beta	sarcosine oxidase subunit delta	sarcosine oxidase subunit gamma	sarcosine oxidase, alpha subunit family	sarcosine oxidase, beta subunit family	scyllo-inositol 2-dehydrogenase (NADP+)	sec-independent protein translocase protein TatA	sec-independent protein translocase protein TatB	sec-independent protein translocase protein TatC	secondary thiamine-phosphate synthase enzyme	secretion protein HlyD family protein	segregation and condensation protein B	selenium-binding protein 1	selenocysteine-specific elongation factor	selenocysteine-specific translation elongation  factor SelB	selenophosphate synthase	selenophosphate synthase (EC 2.7.9.3)	selenoprotein W-related protein	self-protective colicin-like immunity	sensor c-di-GMP phosphodiesterase, contains  CSS-motif sensor and EAL domain	sensor domain CHASE1-containing protein	sensor domain CHASE2-containing protein	sensor domain CHASE3-containing protein	sensor histidine kinase inhibitor, KipI family	septation ring formation regulator	septum formation protein	septum site-determining protein MinC	septum site-determining protein MinD	serine O-acetyltransferase	serine O-acetyltransferase (EC 2.3.1.30)	serine hydroxymethyltransferase	serine hydroxymethyltransferase (EC 2.1.2.1)	serine palmitoyltransferase (EC 2.3.1.50)	serine protease	serine protease AprX	serine protease DegQ	serine protease Do	serine protease SohB	serine protease, ClpP class	serine protease, S1-C subfamily, contains  C-terminal PDZ domain	serine-glyoxylate aminotransferase apoenzyme	serine-glyoxylate aminotransferase apoenzyme (EC  2.6.1.45)	serine/threonine protein kinase	serine/threonine protein kinase with  extracellular ligand sensor(s)	serine/threonine protein phosphatase 1	serine/threonine-protein kinase HipA	serine/threonine-protein kinase PknG	serine/threonine-protein kinase PknK	serine/threonine-protein kinase RsbT	serine/threonine-protein kinase RsbW	serralysin	seryl-tRNA synthetase	seryl-tRNA synthetase (EC 6.1.1.11)	shikimate 5-dehydrogenase	shikimate dehydrogenase	shikimate dehydrogenase (EC 1.1.1.25)	shikimate kinase	shikimate kinase (EC 2.7.1.71)	short chain amide porin	short chain amide porin (TC 1.B.16)	short chain dehydrogenase	short chain enoyl-CoA hydratase	short chain enoyl-CoA hydratase (EC  4.2.1.17)/3-hydroxyacyl-CoA dehydrogenase (EC 1.1.1.35)	short chain enoyl-CoA hydratase (EC 4.2.1.17)	short-chain Z-isoprenyl diphosphate synthase	short-chain dehydrogenase/reductase SDR	short-chain fatty acids transporter	sialidase-1	sigma 54 modulation protein /SSU ribosomal  protein S30P	sigma E regulatory protein, MucB/RseB	sigma-54 specific transcriptional regulator	sigma-B regulation protein RsbU (phosphoserine  phosphatase)	sigma-E factor negative regulatory protein RseA	sigma54 specific transcriptional regulator, Fis  family	signal peptidase I	signal peptidase I (EC:3.4.21.89). Serine  peptidase. MEROPS family S26A	signal peptidase I Serine peptidase. MEROPS  family S26A	signal peptidase II	signal peptidase II (EC:3.4.23.36). Aspartic  peptidase. MEROPS family A08	signal peptidase II Aspartic peptidase. MEROPS  family A08	signal peptidase, endoplasmic reticulum-type	signal peptide peptidase A. Serine peptidase.  MEROPS family S49	signal peptide peptidase SppA	signal peptide protein	signal recognition particle subunit FFH/SRP54  (srp54)	signal recognition particle-docking protein FtsY	signal transduction histidine kinase	signal transduction histidine kinase (EC  2.7.13.3)	signal transduction histidine kinase regulating  citrate/malate metabolism	signal transduction histidine kinase,  glucose-6-phosphate specific (EC 2.7.13.3)	signal transduction histidine kinase,  nitrate/nitrite-specific, NarQ (EC 2.7.13.3)	signal transduction histidine kinase, nitrogen  specific, NtrB	signal transduction histidine kinase, nitrogen  specific, NtrB (EC 2.7.13.3)	similar to stage IV sporulation protein	simple sugar transport system ATP-binding  protein	simple sugar transport system permease protein	simple sugar transport system substrate-binding  protein	single stranded DNA-binding protein (ssb)	single-component resorcinol 4-hydroxylase	single-strand DNA-binding protein	single-strand binding protein	single-stranded-DNA-specific exonuclease	single-stranded-DNA-specific exonuclease RecJ	sirohydrochlorin cobaltochelatase	site-2 protease. Metallo peptidase. MEROPS  family M50B	site-specific DNA-methyltransferase  (adenine-specific)	site-specific recombinase Gcr	small GTP-binding protein	small GTP-binding protein domain-containing  protein	small acid-soluble spore protein  (thioredoxin-like protein)	small acid-soluble spore protein E (minor  gamma-type SASP)	small acid-soluble spore protein H (minor)	small conductance mechanosensitive channel	small multidrug resistance family-3 protein	small multidrug resistance protein	small multidrug resistance pump	small redox-active disulfide protein 2	small subunit ribosomal protein S1	small subunit ribosomal protein S11	small subunit ribosomal protein S12	small subunit ribosomal protein S13	small subunit ribosomal protein S14	small subunit ribosomal protein S15	small subunit ribosomal protein S16	small subunit ribosomal protein S17	small subunit ribosomal protein S18	small subunit ribosomal protein S19	small subunit ribosomal protein S2	small subunit ribosomal protein S20	small subunit ribosomal protein S21	small subunit ribosomal protein S3	small subunit ribosomal protein S4	small subunit ribosomal protein S5	small subunit ribosomal protein S6	small subunit ribosomal protein S7	small subunit ribosomal protein S8	small subunit ribosomal protein S9	small, acid-soluble spore protein, gamma-type	small-conductance mechanosensitive channel	sn-glycerol 3-phosphate transport system  ATP-binding protein	sn-glycerol 3-phosphate transport system  permease protein	sn-glycerol 3-phosphate transport system  substrate-binding protein	sodium/calcium exchanger membrane region	sodium/proline symporter	sodium/proton antiporter, CPA1 family	sodium/proton antiporter, CPA1 family (TC  2.A.36)	sodium/proton antiporter, NhaA family	sodium/proton antiporter, NhaA family (TC  2.A.33.1.1)	sodium:dicarboxylate symporter	soluble lytic murein transglycosylase	solute carrier family 10 (sodium/bile acid  cotransporter), member 7	solute carrier family 13 (sodium-dependent  dicarboxylate transporter), member 2/3/5	solute:Na+ symporter, SSS family	sorbitol ABC transporter ATP-binding protein 	sorbitol ABC transporter membrane protein 	sorbitol-6-phosphate 2-dehydrogenase	sorbitol-binding protein /mannitol-binding  protein	sorbitol/mannitol transport system  substrate-binding protein	sorbitol/mannitol transport system permease  protein	sortase	sortase A	spermidine dehydrogenase	spermidine synthase	spermidine/putrescine ABC transporter ATPase  subunit	spermidine/putrescine transport system  ATP-binding protein	spermidine/putrescine transport system  substrate-binding protein	spermidine/putrescine transport system permease  protein	spoIIIJ-associated protein	sporadically distributed protein, TIGR04141  family	spore coat assembly protein SafA/uncharacterized  protein, YkwD family	spore coat protein D	spore coat protein H	spore coat protein JA	spore coat protein JB	spore coat protein JC	spore coat protein SA	spore cortex biosynthesis protein YabQ	spore cortex peptidoglycan biosynthesis  regulator SpoVE	spore germination protein	spore germination protein (amino acid permease)	spore germination protein D	spore germination protein KA	spore germination protein KB	spore germination protein KC	spore maturation protein B	spore maturation protein CgeB	spore photoproduct lyase	spore photoproduct lyase family protein	sporulation integral membrane protein YlbJ	sporulation integral membrane protein YtvI	sporulation lipoprotein, YhcN/YlaJ family	sporulation protein YqfC	sporulation protein YunB	sporulation-control protein	squalene synthase HpnC	squalene-associated FAD-dependent desaturase	squalene-hopene/tetraprenyl-beta-curcumene  cyclase	stage II sporulation protein AB (anti-sigma F  factor)	stage II sporulation protein D	stage II sporulation protein E	stage II sporulation protein GA (sporulation  sigma-E factor processing peptidase)	stage II sporulation protein P	stage II sporulation protein Q	stage II sporulation protein R	stage III sporulation protein AC	stage III sporulation protein AE	stage III sporulation protein AH	stage IV sporulation protein A	stage IV sporulation protein B	stage IV sporulation protein FB	stage V sporulation protein AA	stage V sporulation protein AB	stage V sporulation protein AC	stage V sporulation protein AD	stage V sporulation protein AF	stage V sporulation protein B	stage V sporulation protein D  (sporulation-specific penicillin-binding protein)	stage V sporulation protein K	stage V sporulation protein R	stage VI sporulation protein D	starch phosphorylase	starch synthase	starch synthase (maltosyl-transferring)	starvation-inducible DNA-binding protein	stearoyl-CoA desaturase (delta-9 desaturase)	steroid delta-isomerase	streptomycin 6-kinase	stringent starvation protein B	substrate-binding protein	subtilisin	succinate dehydrogenase / fumarate reductase  flavoprotein subunit	succinate dehydrogenase / fumarate reductase  iron-sulfur subunit	succinate dehydrogenase / fumarate reductase  membrane anchor subunit	succinate dehydrogenase subunit A	succinate dehydrogenase subunit A (EC 1.3.5.1)	succinate dehydrogenase subunit B	succinate dehydrogenase subunit B (EC 1.3.5.1)	succinate dehydrogenase subunit C	succinate dehydrogenase subunit C (EC 1.3.5.1)	succinate dehydrogenase subunit D	succinate dehydrogenase subunit D (EC 1.3.5.1)	succinate semialdehyde dehydrogenase	succinate semialdehyde dehydrogenase (EC  1.2.1.16)	succinate-semialdehyde dehydrogenase /  glutarate-semialdehyde dehydrogenase	succinoglycan biosynthesis protein ExoA	succinoglycan biosynthesis protein ExoL	succinoglycan biosynthesis protein ExoM	succinoglycan biosynthesis protein ExoO	succinoglycan biosynthesis protein ExoU	succinoglycan biosynthesis protein ExoW	succinoglycan biosynthesis transport protein  ExoP	succinyl-CoA synthetase (ADP-forming) alpha  subunit	succinyl-CoA synthetase (ADP-forming) alpha  subunit (EC 6.2.1.5)	succinyl-CoA synthetase (ADP-forming) beta  subunit	succinyl-CoA synthetase (ADP-forming) beta  subunit (EC 6.2.1.5)	succinyl-CoA synthetase alpha subunit	succinyl-CoA synthetase beta subunit	succinyl-CoA:(R)-citramalate CoA-transferase	succinyl-CoA:acetate CoA-transferase	succinyl-diaminopimelate desuccinylase	succinyldiaminopimelate aminotransferase  apoenzyme	succinyldiaminopimelate aminotransferase  apoenzyme (EC 2.6.1.17)	succinyldiaminopimelate desuccinylase	succinyldiaminopimelate desuccinylase (EC  3.5.1.18)	sucrose-phosphate synthase	sugar O-acyltransferase, sialic acid  O-acetyltransferase NeuD family	sugar fermentation stimulation protein A	sugar isomerase (SIS)	sugar transferase	sugar transferase, PEP-CTERM system  associated/exopolysaccharide biosynthesis polyprenyl glycosylphosphotransferase	sugar transferase, PEP-CTERM/EpsH1 system  associated	sugar transporter	sugar-phosphatase	sulfane dehydrogenase subunit SoxC	sulfatase	sulfate ABC transporter, ATPase subunit	sulfate ABC transporter, inner membrane subunit  CysT	sulfate ABC transporter, inner membrane subunit  CysW	sulfate ABC transporter, periplasmic  sulfate-binding protein	sulfate adenylyltransferase	sulfate adenylyltransferase subunit 1	sulfate adenylyltransferase subunit 1 (EC  2.7.7.4)	sulfate adenylyltransferase subunit 2	sulfate adenylyltransferase subunit 2 (EC  2.7.7.4)	sulfate permease, SulP family	sulfate thiol esterase SoxB	sulfate transport system ATP-binding protein	sulfate transport system permease protein	sulfate transport system substrate-binding  protein	sulfate transporter	sulfate-transporting ATPase	sulfide dehydrogenase (flavocytochrome c),  flavoprotein subunit (EC 1.8.2.3)	sulfide:quinone oxidoreductase	sulfite dehydrogenase	sulfite dehydrogenase (cytochrome) subunit SorA  apoprotein (EC 1.8.2.1)	sulfite dehydrogenase (cytochrome) subunit SorB	sulfite dehydrogenase (cytochrome) subunit SorB  (EC 1.8.2.1)	sulfite oxidase	sulfite reductase (NADPH) beta subunit (EC  1.8.1.2)	sulfite reductase (NADPH) flavoprotein  alpha-component	sulfite reductase (NADPH) hemoprotein  beta-component	sulfite reductase (ferredoxin)	sulfoacetaldehyde acetyltransferase	sulfoacetaldehyde acetyltransferase (EC  2.3.3.15)	sulfoacetaldehyde dehydrogenase	sulfofructose kinase	sulfofructosephosphate aldolase	sulfonate ABC transporter, periplasmic  sulfonate-binding protein SsuA	sulfonate transport system ATP-binding protein	sulfonate transport system permease protein	sulfonate transport system substrate-binding  protein	sulfopyruvate decarboxylase, alpha subunit	sulfoquinovose isomerase	sulfoxide reductase catalytic subunit YedY	sulfoxide reductase heme-binding subunit YedZ	sulfur acquisition oxidoreductase, SfnB family	sulfur carrier protein	sulfur carrier protein ThiS	sulfur compound chelating protein SoxZ	sulfur dehydrogenase subunit SoxC	sulfur dehydrogenase subunit SoxC (EC 1.-.-.-)	sulfur dehydrogenase subunit SoxD	sulfur dehydrogenase subunit SoxD (EC 1.-.-.-)	sulfur oxidation protein SoxZ	sulfur-oxidizing protein SoxA	sulfur-oxidizing protein SoxB	sulfur-oxidizing protein SoxX	sulfur-oxidizing protein SoxY	sulfur-oxidizing protein SoxZ	sulphate transporter	sun protein	superoxide dismutase copper/zinc binding	superoxide dismutase, Cu-Zn family	superoxide dismutase, Fe-Mn family	suppressor for copper-sensitivity B	surface adhesion protein	surface carbohydrate biosynthesis protein	surfeit locus 1	surfeit locus 1 family protein	tRNA  (5-methylaminomethyl-2-thiouridylate)-methyltransferase	tRNA  (5-methylaminomethyl-2-thiouridylate)-methyltransferase (EC 2.1.1.61)	tRNA  (adenine57-N1/adenine58-N1)-methyltransferase	tRNA (Guanine37-N(1)-) methyltransferase	tRNA (Guanine37-N(1)-) methyltransferase (EC  2.1.1.31)	tRNA (adenine-58-N(1)-) methyltransferase	tRNA (adenine22-N1)-methyltransferase	tRNA (cmo5U34)-methyltransferase	tRNA (cytidine/uridine-2'-O-)-methyltransferase	tRNA (guanine-N(7)-)-methyltransferase	tRNA (guanine-N(7)-)-methyltransferase (EC  2.1.1.33)	tRNA (guanine-N7-)-methyltransferase	tRNA (guanine37-N1)-methyltransferase	tRNA 2-selenouridine synthase	tRNA 2-thiocytidine biosynthesis protein TtcA	tRNA 2-thiouridine synthesizing protein A	tRNA 2-thiouridine synthesizing protein D	tRNA 5-methylaminomethyl-2-thiouridine  biosynthesis bifunctional protein	tRNA A-37 threonylcarbamoyl transferase  component Bud32	tRNA A37 threonylcarbamoyladenosine dehydratase	tRNA G10 N-methylase Trm11	tRNA G18 (ribose-2'-O)-methylase SpoU	tRNA G46 methylase TrmB	tRNA U-34 5-methylaminomethyl-2-thiouridine  biosynthesis protein MnmC	tRNA U34  5-methylaminomethyl-2-thiouridine-forming methyltransferase MnmC	tRNA delta(2)-isopentenylpyrophosphate  transferase	tRNA dimethylallyltransferase	tRNA modification GTPase	tRNA modification GTPase trmE	tRNA nucleotidyltransferase (CCA-adding enzyme)	tRNA nucleotidyltransferase/poly(A) polymerase	tRNA pseudouridine synthase A	tRNA pseudouridine synthase B	tRNA pseudouridine synthase B (EC 4.2.1.70)	tRNA pseudouridine32 synthase / 23S rRNA  pseudouridine746 synthase	tRNA pseudouridine38-40 synthase	tRNA pseudouridine55 synthase	tRNA pseudouridine65 synthase	tRNA threonylcarbamoyl adenosine modification  protein YeaZ	tRNA threonylcarbamoyl adenosine modification  protein, Sua5/YciO/YrdC/YwlC family	tRNA threonylcarbamoyladenosine biosynthesis  protein TsaB	tRNA threonylcarbamoyladenosine biosynthesis  protein TsaE	tRNA uridine 5-carboxymethylaminomethyl  modification enzyme	tRNA(Arg) A34 adenosine deaminase TadA	tRNA(Ile)-lysidine synthase	tRNA(Ile)-lysidine synthetase	tRNA(adenine34) deaminase	tRNA(fMet)-specific endonuclease VapC	tRNA-(MS[2]IO[6]A)-hydroxylase (MiaE)-like	tRNA-2-methylthio-N6-dimethylallyladenosine  synthase	tRNA-Thr(GGU) m(6)t(6)A37 methyltransferase TsaA	tRNA-U16,U17-dihydrouridine synthase	tRNA-U20-dihydrouridine synthase	tRNA-adenosine deaminase (EC 3.5.4.-)	tRNA-binding protein	tRNA-dihydrouridine synthase	tRNA-dihydrouridine synthase A	tRNA-dihydrouridine synthase B	tRNA-dihydrouridine synthase C	tRNA-guanine transglycosylase	tRNA-guanine transglycosylase (EC 2.4.2.29)	tRNA-i(6)A37 thiotransferase enzyme MiaB	tRNA-specific 2-thiouridylase	tRNA-splicing ligase RtcB	tRNA/rRNA methyltransferase	tRNA/rRNA methyltransferase (SpoU)	tRNA/tmRNA/rRNA uracil-C5-methylase,  TrmA/RlmC/RlmD family	tRNA1(Val) A37 N6-methylase TrmN6	tRNA_anti-like	tagatose 1,6-diphosphate aldolase	tagatose 6-phosphate kinase	tankyrase	tape measure domain-containing protein	tartrate dehydrogenase/decarboxylase / D-malate  dehydrogenase	tartrate-resistant acid phosphatase type 5	tartronate-semialdehyde synthase	taurine dehydrogenase large subunit	taurine dehydrogenase small subunit	taurine dioxygenase	taurine transport system ATP-binding protein	taurine transport system permease protein	taurine transport system substrate-binding  protein	taurine---2-oxoglutarate transaminase	taurine-pyruvate aminotransferase	teichoic acid transport system ATP-binding  protein	teichoic acid transport system permease protein	tellurite resistance protein	tellurite resistance protein TerC	tellurium resistance protein TerD	tellurium resistance protein TerZ	tetrahydromethanopterin S-methyltransferase,  subunit E	tetraprenyl-beta-curcumene synthase	tetrapyrrole methylase family protein / MazG  family protein	tetratricopeptide domain protein	tetratricopeptide repeat protein	thiaminase (transcriptional activator TenA)	thiamine biosynthesis lipoprotein	thiamine biosynthesis protein ThiI	thiamine biosynthesis protein ThiS	thiamine monophosphate synthase	thiamine pyrophosphokinase	thiamine transport system ATP-binding protein	thiamine transport system permease protein	thiamine transport system substrate-binding  protein	thiamine-monophosphate kinase	thiamine-phosphate diphosphorylase	thiamine-phosphate kinase	thiamine-phosphate pyrophosphorylase	thiazole synthase	thiazole tautomerase (transcriptional regulator  TenI)	thiazole-phosphate synthase	thiazolinyl imide reductase	thioesterase domain-containing protein, putative	thiol peroxidase (atypical 2-Cys peroxiredoxin)  (EC 1.11.1.5)	thiol peroxidase, atypical 2-Cys peroxiredoxin	thiol:disulfide interchange protein DsbA	thiol:disulfide interchange protein DsbC	thiol:disulfide interchange protein DsbD	thiopeptide-type bacteriocin biosynthesis  domain-containing protein	thiopurine S-methyltransferase	thioredoxin	thioredoxin 1	thioredoxin domain protein	thioredoxin reductase	thioredoxin reductase (NADPH)	thiosulfate dehydrogenase [quinone] large  subunit	thiosulfate oxidation carrier complex protein  SoxZ	thiosulfate sulfurtransferase	thiosulfate sulfurtransferase (EC 2.8.1.1)	thiosulfate-binding protein SoxY	thiosulfate/3-mercaptopyruvate sulfurtransferase	three-Cys-motif partner protein	threonine 3-dehydrogenase	threonine dehydratase	threonine kinase	threonine synthase	threonyl-tRNA synthetase	threonyl-tRNA synthetase (EC  6.1.1.3)/Ser-tRNA(Thr) hydrolase (EC 3.1.1.-)	threonylcarbamoyladenosine tRNA  methylthiotransferase MtaB	thymidine kinase	thymidine phosphorylase	thymidine phosphorylase (EC 2.4.2.4)	thymidylate kinase	thymidylate kinase (EC 2.7.4.9)	thymidylate synthase	thymidylate synthase (EC 2.1.1.45)	thymidylate synthase (FAD)	thymidylate synthase (FAD) (EC 2.1.1.148)	tight adherence protein B	tight adherence protein C	tol-pal system protein YbgF	tol-pal system-associated acyl-CoA thioesterase	toluene 4-monooxygenase protein C	toluene monooxygenase electron transfer  component	toluene monooxygenase system ferredoxin subunit	toluene monooxygenase system protein A	toluene monooxygenase system protein B	toluene monooxygenase system protein E	toluene tolerance family protein	toluene tolerance protein, putative	topoisomerase-4 subunit A	topoisomerase-4 subunit B	toxin CptA	toxin ParE1/3/4	toxin YoeB	toxin secretion/phage lysis holin	toxin-antitoxin system PIN domain toxin	toxin-antitoxin system, toxin component,  Txe/YoeB family	trans,polycis-decaprenyl diphosphate synthase	trans-2,3-dihydro-3-hydroxyanthranilate  isomerase	trans-aconitate 2-methyltransferase	transaldolase	transaldolase (EC 2.2.1.2)	transcription antitermination protein nusG	transcription elongation factor GreA	transcription elongation factor GreB	transcription factor WhiB	transcription termination factor Rho	transcription-repair coupling factor	transcription-repair coupling factor  (superfamily II helicase)	transcriptional activator domain-containing  protein	transcriptional activator of comK gene	transcriptional activator, Baf family	transcriptional antiterminator RfaH	transcriptional antiterminator, BglG family	transcriptional attenuator, LytR family	transcriptional modulator of MazE/toxin, MazF	transcriptional pleiotropic regulator of  transition state genes	transcriptional pleiotropic repressor	transcriptional regulator	transcriptional regulator /transcriptional  regulator, Crp/Fnr family	transcriptional regulator EpsA	transcriptional regulator PpsR	transcriptional regulator, AlpA family	transcriptional regulator, AraC family	transcriptional regulator, AraC family with  amidase-like domain	transcriptional regulator, ArgR family	transcriptional regulator, ArsR family	transcriptional regulator, AsnC family	transcriptional regulator, BadM/Rrf2 family	transcriptional regulator, BolA protein family	transcriptional regulator, CarD family	transcriptional regulator, CdaR family	transcriptional regulator, CopG family	transcriptional regulator, Crp/Fnr family	transcriptional regulator, DeoR family	transcriptional regulator, Fis family	transcriptional regulator, GntR family	transcriptional regulator, HxlR family	transcriptional regulator, IclR family	transcriptional regulator, LacI family	transcriptional regulator, LuxR family	transcriptional regulator, LysR family	transcriptional regulator, LytTR family	transcriptional regulator, MarR family	transcriptional regulator, MerR family	transcriptional regulator, MucR family	transcriptional regulator, NifA subfamily, Fis  family	transcriptional regulator, NifA, Fis family	transcriptional regulator, Nlp family	transcriptional regulator, PaaX family	transcriptional regulator, PadR family	transcriptional regulator, RpiR family	transcriptional regulator, Spx/MgsR family	transcriptional regulator, TetR family	transcriptional regulator, TraR/DksA family	transcriptional regulator, XRE family	transcriptional regulator, XRE family with  shikimate kinase activity /shikimate kinase	transcriptional regulator, XRE family with cupin  sensor	transcriptional regulator, y4mF family	transcriptional regulator-like protein	transcriptional regulator/antitoxin, MazE	transcriptional regulatory protein RtcR	transcriptional repressor NrdR	transferase 2, rSAM/selenodomain-associated	transferase hexapeptide (six repeat-containing  protein)	transferase hexapeptide repeat containing  protein	transglutaminase domain protein	transglutaminase family protein cysteine  peptidase BTLCP	transglutaminase-like cysteine proteinase BTLCP	transitional endoplasmic reticulum ATPase	transketolase	transketolase (EC 2.2.1.1)	transketolase subunit A	transketolase subunit B	transketolase subunit B (EC 2.2.1.1)	translation elongation factor 1A (EF-1A/EF-Tu)	translation elongation factor 2 (EF-2/EF-G)	translation elongation factor P (EF-P)	translation elongation factor Ts (EF-Ts)	translation elongation factor Tu	translation factor SUA5	translation initiation factor IF-1	translation initiation factor IF-2	translation initiation factor IF-3	translocation and assembly module TamA	translocation and assembly module TamB	transmembrane protein	transport factor 2 (NTF2) domain-containing  protein	transport system permease protein	transport-associated	transport-associated protein	transporter family protein	transporter family-2 protein	transporter, CPA2 family	transporter, CPA2 family (TC 2.A.37)	transporter, UIT1 family	transporter, UIT1 family (TC 9.B.48)	transporter, UIT6 family	transporter, YbiR family	transporter, hydrophobe/amphiphile efflux-1  (HAE1) family	transposase	transposase IS116/IS110/IS902 family protein	transposase IS3/IS911 family protein	transposase, IS4 family	trehalose 6-phosphatase	trehalose 6-phosphatase (EC 3.1.3.12)	trehalose 6-phosphate phosphatase	trehalose 6-phosphate synthase	trehalose 6-phosphate synthase (EC 2.4.1.15)	trehalose synthase	trehalose synthase (EC:5.4.99.16)	trehalose-6-phosphate hydrolase	trehalose-phosphatase	tricarballylate dehydrogenase	tricorn protease	trigger factor	trimethylamine dehydrogenase apoprotein	trimethylamine dehydrogenase apoprotein (EC  1.5.8.2)	trimethylamine monooxygenase	trimethylamine---corrinoid protein  Co-methyltransferase	triosephosphate isomerase	triosephosphate isomerase (EC 5.3.1.1)	tripartite ATP-independent transporter solute  receptor, DctP family	tripeptide aminopeptidase	tripeptidyl-peptidase B. Serine peptidase.  MEROPS family S33	triphosphoribosyl-dephospho-CoA protein	triphosphoribosyl-dephospho-CoA synthase	trk system potassium uptake protein TrkA	trk system potassium uptake protein TrkH	trp region conserved hypothetical membrane  protein	tryptophan 2,3-dioxygenase	tryptophan 2-monooxygenase	tryptophan synthase beta chain	tryptophan synthase, alpha chain	tryptophan synthase, alpha chain (EC 4.2.1.20)	tryptophan synthase, beta chain	tryptophan synthase, beta chain (EC 4.2.1.20)	tryptophan-rich conserved hypothetical protein	tryptophanyl-tRNA synthetase	tryptophanyl-tRNA synthetase (EC 6.1.1.2)	tungstate transport system ATP-binding protein	tungstate transport system permease protein	tungstate transport system substrate-binding  protein	twin arginine-targeting protein translocase,  TatA/E family	twin-arg-translocated uncharacterized  repeat-containing protein	twin-arginine translocation protein, TatA/E  family subunit	twin-arginine translocation protein, TatB  subunit	twin-arginine translocation signal/Cys-rich four  helix bundle protein	twinkle protein	twitching motility protein	twitching motility protein PilI	twitching motility protein PilJ	twitching motility protein PilT	twitching motility protein PilU	twitching motility two-component system response  regulator PilG	twitching motility two-component system response  regulator PilH	two component heavy metal response  transcriptional regulator, winged helix family	two component transcriptional regulator PhoB,  winged helix family	two component transcriptional regulator, Fis  family	two component transcriptional regulator, LuxR  family	two component transcriptional regulator, LytTR  family	two component transcriptional regulator, winged  helix family	two component, sigma54 specific, transcriptional  regulator, Fis family	two-component system, CitB family, response  regulator	two-component system, CitB family, response  regulator CitT	two-component system, CitB family, sensor  histidine kinase CitS	two-component system, CitB family, sensor kinase	two-component system, LuxR family, response  regulator DctR	two-component system, LuxR family, response  regulator FixJ	two-component system, LuxR family, sensor  histidine kinase DctS	two-component system, LuxR family, sensor kinase  FixL	two-component system, LytT family, sensor  histidine kinase AlgZ	two-component system, LytT family, sensor kinase	two-component system, NarL family,  nitrate/nitrite response regulator NarL	two-component system, NarL family,  nitrate/nitrite sensor histidine kinase NarX	two-component system, NarL family, invasion  response regulator UvrY	two-component system, NarL family, response  regulator DesR	two-component system, NarL family, response  regulator DevR	two-component system, NarL family, response  regulator LiaR	two-component system, NarL family, sensor  histidine kinase BarA	two-component system, NarL family, sensor  histidine kinase DegS	two-component system, NarL family, sensor  histidine kinase DesK	two-component system, NarL family, sensor  histidine kinase LiaS	two-component system, NarL family, sensor  histidine kinase UhpB	two-component system, NarL family, sensor kinase	two-component system, NtrC family,  C4-dicarboxylate transport response regulator DctD	two-component system, NtrC family,  C4-dicarboxylate transport sensor histidine kinase DctB	two-component system, NtrC family, nitrogen  regulation response regulator GlnG	two-component system, NtrC family, nitrogen  regulation response regulator NtrX	two-component system, NtrC family, nitrogen  regulation sensor histidine kinase GlnL	two-component system, NtrC family, nitrogen  regulation sensor histidine kinase NtrY	two-component system, NtrC family, response  regulator	two-component system, NtrC family, response  regulator AtoC	two-component system, NtrC family, response  regulator GlrR	two-component system, NtrC family, response  regulator PilR	two-component system, NtrC family, sensor  histidine kinase AtoS	two-component system, NtrC family, sensor  histidine kinase GlrK	two-component system, NtrC family, sensor  histidine kinase PilS	two-component system, NtrC family, sensor kinase	two-component system, OmpR family, KDP operon  response regulator KdpE	two-component system, OmpR family, bacitracin  resistance response regulator BceR	two-component system, OmpR family, bacitracin  resistance sensor histidine kinase BceS	two-component system, OmpR family, catabolic  regulation response regulator CreB	two-component system, OmpR family, copper  resistance phosphate regulon response regulator CusR	two-component system, OmpR family, heavy metal  sensor histidine kinase CusS	two-component system, OmpR family, osmolarity  sensor histidine kinase EnvZ	two-component system, OmpR family, phosphate  regulon response regulator OmpR	two-component system, OmpR family, phosphate  regulon response regulator PhoB	two-component system, OmpR family, phosphate  regulon sensor histidine kinase PhoR	two-component system, OmpR family, response  regulator	two-component system, OmpR family, response  regulator ChvI	two-component system, OmpR family, response  regulator CpxR	two-component system, OmpR family, response  regulator MprA	two-component system, OmpR family, response  regulator MtrA	two-component system, OmpR family, response  regulator PrrA	two-component system, OmpR family, response  regulator RegX3	two-component system, OmpR family, response  regulator ResD	two-component system, OmpR family, response  regulator TctD	two-component system, OmpR family, response  regulator VanR	two-component system, OmpR family, response  regulator VicR	two-component system, OmpR family, sensor  histidine kinase BaeS	two-component system, OmpR family, sensor  histidine kinase ChvG	two-component system, OmpR family, sensor  histidine kinase CreC	two-component system, OmpR family, sensor  histidine kinase KdpD	two-component system, OmpR family, sensor  histidine kinase MprB	two-component system, OmpR family, sensor  histidine kinase MtrB	two-component system, OmpR family, sensor  histidine kinase PrrB	two-component system, OmpR family, sensor  histidine kinase QseC	two-component system, OmpR family, sensor  histidine kinase ResE	two-component system, OmpR family, sensor  histidine kinase SenX3	two-component system, OmpR family, sensor  histidine kinase TctE	two-component system, OmpR family, sensor  histidine kinase TorS	two-component system, OmpR family, sensor  histidine kinase VanS	two-component system, OmpR family, sensor  histidine kinase VicK	two-component system, OmpR family, sensor kinase	two-component system, OmpR family, torCAD operon  response regulator TorR	two-component system, cell cycle response  regulator	two-component system, cell cycle response  regulator CpdR	two-component system, cell cycle response  regulator CtrA	two-component system, cell cycle response  regulator DivK	two-component system, cell cycle sensor  histidine kinase DivJ	two-component system, cell cycle sensor  histidine kinase PleC	two-component system, cell cycle sensor  histidine kinase and response regulator CckA	two-component system, chemotaxis family,  CheB/CheR fusion protein	two-component system, chemotaxis family,  response regulator CheB	two-component system, chemotaxis family,  response regulator CheV	two-component system, chemotaxis family,  response regulator CheY	two-component system, chemotaxis family,  response regulator WspF	two-component system, chemotaxis family, sensor  histidine kinase and response regulator WspE	two-component system, chemotaxis family, sensor  kinase CheA	two-component system, repressor protein LuxO	two-component system, response regulator FlrC	two-component system, response regulator RegA	two-component system, response regulator RpfG	two-component system, response regulator YcbB	two-component system, response regulator, stage  0 sporulation protein A	two-component system, response regulator, stage  0 sporulation protein F	two-component system, sensor histidine kinase  FlrB	two-component system, sensor histidine kinase  RegB	two-component system, sensor histidine kinase  RpfC	two-component system, sensor histidine kinase  YcbA	two-component system, sporulation sensor kinase  A	two-component system, sporulation sensor kinase  B	two-component system, unclassified family,  response regulator	type 1 secretion target domain-containing  protein	type 4 prepilin peptidase 1 (EC:3.4.23.43).  Aspartic peptidase. MEROPS family A24A	type I restriction enzyme M protein	type I restriction enzyme, R subunit	type I restriction enzyme, S subunit	type I restriction-modification system  methyltransferase subunit	type I secretion C-terminal target domain  (VC_A0849 subclass)	type I secretion membrane fusion protein, HlyD  family	type I secretion outer membrane protein, TolC  family	type I secretion system ABC transporter, HlyB  family	type I secretion system ATPase	type I site-specific deoxyribonuclease, HsdR  family	type II and III secretion system protein	type II restriction enzyme	type II secretion system protein	type II secretion system protein E	type II secretion system protein E (GspE)	type II secretion system protein F (GspF)	type II secretion system protein G (GspG)	type II/III secretion system short  domain-containing protein	type III pantothenate kinase	type III restriction enzyme	type III secretion exporter	type III secretion system ATPase, FliI/YscN	type IV fimbrial biogenesis protein FimT	type IV pilus assembly PilZ	type IV pilus assembly protein PilA	type IV pilus assembly protein PilB	type IV pilus assembly protein PilC	type IV pilus assembly protein PilE	type IV pilus assembly protein PilF	type IV pilus assembly protein PilM	type IV pilus assembly protein PilN	type IV pilus assembly protein PilO	type IV pilus assembly protein PilP	type IV pilus assembly protein PilQ	type IV pilus assembly protein PilV	type IV pilus assembly protein PilW	type IV pilus assembly protein PilX	type IV pilus assembly protein PilY1	type IV pilus assembly protein PilZ	type IV pilus biogenesis protein PilE	type IV pilus biogenesis protein PilP	type IV pilus biogenesis/stability protein PilW	type IV pilus secretin PilQ	type IV secretion system T-DNA border  endonuclease VirD2	type IV secretion system protein TrbL	type IV secretion system protein VirB1	type IV secretion system protein VirB10	type IV secretion system protein VirB11	type IV secretion system protein VirB2	type IV secretion system protein VirB3	type IV secretion system protein VirB4	type IV secretion system protein VirB5	type IV secretion system protein VirB6	type IV secretion system protein VirB7	type IV secretion system protein VirB8	type IV secretion system protein VirB9	type IV secretion system protein VirD4	type IV-A pilus assembly ATPase PilB	type IVB pilus formation outer membrane protein,  R64 PilN family	type VI secretion system Vgr family protein	type VI secretion system protein	type VI secretion system protein ImpA	type VI secretion system protein ImpB	type VI secretion system protein ImpC	type VI secretion system protein ImpF	type VI secretion system protein ImpG	type VI secretion system protein ImpH	type VI secretion system protein ImpJ	type VI secretion system protein ImpK	type VI secretion system protein ImpL	type VI secretion system protein ImpM	type VI secretion system protein VasD	type VI secretion system protein VasG	type VI secretion system secreted protein Hcp	type VI secretion system secreted protein VgrG	type VII secretion AAA-ATPase EccA	type VII secretion integral membrane protein  EccD	type VII secretion protein EccB	type VII secretion protein EccCa	type VII secretion protein EccCb	type VII secretion protein EccE	type VII secretion-associated protein, Rv3446c  family, C-terminal domain-containing protein	type VII secretion-associated serine protease  mycosin	tyrosinase	tyrosine recombinase XerC	tyrosine recombinase XerD	tyrosine recombinase XerD subunit	tyrosyl-tRNA synthetase	tyrosyl-tRNA synthetase (EC 6.1.1.1)	ubiquinol oxidase	ubiquinol-cytochrome c reductase cytochrome b  subunit	ubiquinol-cytochrome c reductase cytochrome c  subunit	ubiquinol-cytochrome c reductase cytochrome c1  subunit	ubiquinol-cytochrome c reductase iron-sulfur  subunit	ubiquinol-cytochrome c reductase, iron-sulfur  subunit	ubiquinone biosynthesis monooxygenase Coq7	ubiquinone biosynthesis protein	ubiquinone biosynthesis protein COQ7	ubiquinone biosynthesis protein COQ9	ubiquinone biosynthesis protein UbiJ	ubiquitin-hydrolase Zn-finger-containing protein	uncharacterized HhH-GPD family protein	uncharacterized domain 1-containing protein	uncharacterized hydrophobic domain-containing  protein	uncharacterized oxidoreductase	uncharacterized peroxidase-related enzyme	uncharacterized phage protein (possible DNA  packaging)	uncharacterized phage protein (possible DNA  packaging)/phage conserved hypothetical protein, phiE125 gp8 family	uncharacterized protein	uncharacterized protein involved in response to  NO	uncharacterized protein, MTH1187 family	uncharacterized protein, PEP-CTERM system  associated	uncharacterized protein, PH0010  family/AmmeMemoRadiSam system protein A	uncharacterized protein, YigZ family	uncharacterized protein, YkwD family	uncharacterized radical SAM protein YgiQ	uncharacterized sulfatase	uncharacterized zinc-type alcohol  dehydrogenase-like protein	undecaprenyl diphosphate synthase	undecaprenyl-diphosphatase	undecaprenyl-phosphate galactose  phosphotransferase	unsaturated chondroitin disaccharide hydrolase	unspecific monooxygenase	uracil permease	uracil phosphoribosyltransferase	uracil-DNA glycosylase	uracil-DNA glycosylase, family 4	uracil-xanthine permease	urate oxidase	urea ABC transporter, ATP-binding protein UrtD	urea carboxylase	urea carboxylase precursor	urea carboxylase-associated protein 1	urea carboxylase-associated protein 2	urea transport system ATP-binding protein	urea transport system permease protein	urea transport system substrate-binding protein	urea transporter	urease accessory protein	urease accessory protein UreG	urease subunit alpha	urease subunit beta	urease subunit gamma	urease subunit gamma/beta	urease, beta subunit	urease, gamma subunit	urease. Metallo peptidase. MEROPS family M38	ureidoacrylate peracid hydrolase	ureidoglycolate lyase	uridylate kinase	uridylate kinase (EC 2.7.4.22)	urocanate hydratase	uronate dehydrogenase	uroporphyrin-3 C-methyltransferase	uroporphyrin-III C-methyltransferase	uroporphyrin-III C-methyltransferase /  precorrin-2 dehydrogenase / sirohydrochlorin ferrochelatase	uroporphyrinogen III methyltransferase /  synthase	uroporphyrinogen decarboxylase	uroporphyrinogen decarboxylase (EC 4.1.1.37)	uroporphyrinogen-III C-methyltransferase (EC  2.1.1.107)	uroporphyrinogen-III C-methyltransferase (EC  2.1.1.107)/precorrin-2 dehydrogenase (EC 1.3.1.76)	uroporphyrinogen-III synthase	uroporphyrinogen-III synthase (EC  4.2.1.75)/uroporphyrinogen-III C-methyltransferase (EC 2.1.1.107)	uroporphyrinogen-III synthase (EC 4.2.1.75)	valine dehydrogenase (NAD+)	valyl-tRNA synthetase	valyl-tRNA synthetase (EC 6.1.1.9)	vancomycin resistance protein VanJ	vanillate O-demethylase ferredoxin subunit	vanillate O-demethylase monooxygenase subunit	viral A-type inclusion protein	virginiamycin A acetyltransferase	virginiamycin B lyase	virulence factor Mce family protein	virus ReqiPepy6 Gp37-like protein	vitamin B12 transporter	voltage-gated potassium channel	voltage-gated sodium channel	von Hippel-Lindau disease tumour suppressor  protein	von Willebrand factor type A	von Willebrand factor type A domain-containing  protein	von Willebrand factor, type A	xanthine dehydrogenase YagR molybdenum-binding  subunit	xanthine dehydrogenase YagS FAD-binding subunit	xanthine dehydrogenase YagT iron-sulfur-binding  subunit	xanthine dehydrogenase accessory factor	xanthine dehydrogenase small subunit	xanthine dehydrogenase, molybdenum binding  subunit apoprotein	xanthine dehydrogenase, molybdenum binding  subunit apoprotein (EC 1.17.1.4)	xanthine permease	xanthine phosphoribosyltransferase	xylan 1,4-beta-xylosidase	xylitol oxidase	xylose isomerase	xylose-binding protein	xylulokinase	xylulose-5-phosphate/fructose-6-phosphate  phosphoketolase	yjeF C-terminal region, hydroxyethylthiazole  kinase-related	yjeF C-terminal region, hydroxyethylthiazole  kinase-related/yjeF N-terminal region	zinc and cadmium transporter	zinc protease	zinc resistance-associated protein	zinc transport system ATP-binding protein	zinc transport system permease protein	zinc transport system substrate-binding protein	zinc transporter	zinc transporter, ZIP family	zinc uptake regulator, Fur family	zinc-binding alcohol  dehydrogenase/oxidoreductase	zinc-binding alcohol dehydrogenase family  protein	zinc-ribbon domain	zinc/iron permease	zinc/manganese transport system  substrate-binding protein	zinc/manganese transport system ATP-binding  protein	zinc/manganese transport system permease protein
LakWasMeta2_LOW4_2_rpkm	7	2	0	0	0	39	6	10	8	1	8	22	11	167	17	2	0	10	17	0	2	0	2	110	1	4	0	0	2	63	0	9	0	38	3	42	6	1	24	2	2	0	4	28	80	140	121	48	3	13	8	6	0	0	0	22	0	66	105	75	154	2	2	53	24	1	0	0	22	73	5	2	2	0	8	1	0	4	0	0	1	29	2	1	1	0	7	1	4	1	1	8	66	11	50	5	7	0	9	2	2	4	2	0	0	1	0	2	0	2	8	4	88	10	46	5	0	1	1	2	1	1	6	14	1	0	10	2	1	2	0	108	12	2	0	0	2	2	26	1	0	1	0	42	3	3	0	3	50	2	20	62	2	5	44	0	28	44	33	0	45	8	0	54	15	6	0	27	2	56	1	4	0	0	1	5	0	2	1	2	4	8	2	4	0	131	1	0	0	13	57	1	36	9	7	1	1	13	9	651	56	4	38	0	0	4	50	1	43	27	11	2	63	24	43	0	8	4	3	8	1	9	32	10	3	14	0	2	13	0	9	6	290	0	4	1	81	16	56	13	0	1	60	16	114	23	0	2	10	102	15	73	44	0	2531	606	2	4	1	2	13	1	22	48	20	2	24	3	14	80	35	3	50	0	0	2	0	3	74	2	12	60	33	40	96	1	0	1	110	1	12	4	0	2	21	3	0	12	24	0	1	104	165	19	44	4	64	53	76	8	46	1	90	149	4	0	5	0	91	0	5	4	3	13	109	2310	4	0	6	2	12	6	1	0	2	0	17	2	2	0	0	20	26	52	57	10	31	13	3	2	7	13	2	2	23	3	1	0	0	145	13	2	14	0	1	75	22	80	26	16	4	33	2	1	67	10	3	18	4	19	3	0	12	32	9	0	300	0	0	0	3	0	71	1	1	63	59	1	0	39	0	17	1	312	69	0	26	0	4	8	3	68	12	18	6	63	45	32	16	2	0	0	1	2	0	0	0	2	16	2	7	7	13	2	1	7	5	4	28	0	144	40	1	2	4	150	3	3	2	3	0	155	12	393	1	61	120	6	2	19	6	8	0	29	22	42	9	0	4	2	25	55	48	11	9	0	58	10	24	1	11	0	45	3	2	5	1	88	94	7	3	2	228	220	9	0	4	0	2	0	3	4	13	5	0	2	0	9	0	7	0	0	0	7	6	1	19	1	18	23	2	1	3	2	3	0	4	2	2	0	6	0	0	8	42	3	47	11	0	56	0	13	29	26	151	1	11	2	3	2	5	2	2	0	0	21	1	0	0	0	0	1	1	4	14	3	69	0	38	1	0	10	0	21	11	10	54	134	10	67	28	310	102	7	154	13	12	17	123	0	1	1	1181	7	49	17	2	0	7	1	93	2	1	7	58	39	1	111	6	29	2	261	87	170	6	0	211	2	329	22	112	55	34	47	0	57	10	33	2	10	39	46	3	2	6	0	1	3	4	18	0	59	2	2	0	12	0	52	66	7	36	2	29	40	5	1	1	4	5	6	3	274	3	13	0	1	0	3	57	34	2	78	2	0	8	0	4	0	2	1	6	1	15	0	1	9	3	0	0	55	5	0	25	8	397	0	2	14	2	21	3	37	0	13	36	0	24	3	101	0	3	5	2	0	66	31	0	0	54	9	0	5	22	26	8	3	2	4	44	2	0	4	8	1	2	0	3	2	1	22	1	75	27	1	59	93	4	0	0	78	4	0	2	1	0	5	9	0	52	21	0	5	0	157	6	6	10	2	0	0	0	0	0	0	1	61	1	1	1	0	0	0	17	1	0	2	6	1	0	33	10	30	2	6	0	5	58	5	1	61	0	1	0	0	41	5	306	1	6	0	0	0	8	2	0	0	11	0	26	0	1	0	4	3	31	9	7	46	8	1	10	0	0	4	0	0	11	74	59	0	0	0	3	0	4	0	1	5	45	10	0	0	10	1	0	0	12	5	0	39	97	48	61	12	0	7	1	0	18	5	0	1	16	2	0	1	6	0	108	8	0	0	0	8	9	9	19	1	2	0	0	0	4	5	4	0	2	2	0	0	1	0	11	10	0	7	7	5	0	0	2	0	0	0	86	35	76	57	47	2	0	3	5	2	1	0	0	0	0	1	60	2	2	1	0	0	1	0	0	9	5	0	0	36	52	1	5	5	1	1	4	7	0	0	4	0	1	1	12	1	3	1	2	2	2	8	3	0	0	4	5	7	6	321	16	74	1	4	0	4	11	29	96	2	120	0	0	1	1	0	0	11	1	0	15	2	8	9	7	0	2	12	3	0	2	1	0	0	1	7	2	0	5	0	1	0	1	142	7	2	0	91	14	1	0	25	0	0	568	11	7	0	0	0	2	3	0	2	16	0	0	6	1	1	2	0	3	3	0	3	7	0	3	26	12	0	5	0	1	17	5	22	0	2660	0	0	2	1	70	3	20	0	8	7	13	8	16	3	47	8	0	18	2	0	1	2	0	0	9	100	10	0	1	0	1	6	6	5	0	2	0	0	3	1	7	100	31	0	6	29	0	8	2	1	2	1	0	28	7	2	1	3	6	1	0	2	5	15	62	5	9	0	9	0	2	18	4	0	5	0	0	1	0	0	0	1	1	0	0	0	1	7	0	1	2	2	4	5	0	10	3	0	1	0	0	0	0	3	3	0	6	6	0	0	4	0	0	13	9	0	0	0	14	0	7	0	0	21	1	0	15	20	12	24	148	164	5	4	0	47	44	8	0	9	3	46	12	3	0	2	13	0	0	0	7	0	13	125	2	5	0	4	108	2	4	0	2	0	21	9	0	4	4	3	23	1	3	28	7	0	58	6	563	17	1	14	5	2	0	0	26	8	5	109	263	0	1	8	23	4	27	1	1	40	0	13	1	0	0	0	1	6	73	16	5	144	11	29	17	24	0	10	8	8	0	25	0	0	26	4	0	9	1	1	0	26	0	1	15	10	3	0	2	0	0	7	11	13	4	71	1	15	0	5	0	3	5	3	3	3	0	0	37	5	0	2	4	1	20	0	0	0	3	37	11	5	119	27	66	17	0	4	20	1	1	2	7	9	9	49	1	2	7	1	1	0	53	41	0	2	0	1	5	8	23	0	52	17	8	52	0	2	105	35	6	36	30	11	20	0	0	1	10	0	55	2	9	19	9	81	100	37	93	3	0	9	200	56	0	9	4	10	3	38	40	0	21	1	4	24	6	54	41	66	2	1	33	0	1	1	0	1	6	23	16	0	0	9	220	16	36	115	11	6	91	2	45	37	11	11	0	18	2	45	0	9	1	2	8	3	0	1	24	3630	114	68	195	0	0	8	0	3	3	0	15	100	96	20	8	69	3	0	1	45	417	194	47	38	2	13	0	190	0	0	3	0	6	0	11	4	155	40	37	79	151	42	0	20	79	26	0	0	6	0	0	0	89	8	0	0	0	56	3	29	7	5	3	4	0	38	4	8	1	0	2	4	43	0	0	8	3	9	6	28	10	85	0	0	0	0	0	4	1	7	0	9	0	0	4	6	0	0	27	2	2	2	2	0	5	22	0	13	2	117	0	0	0	0	0	2	0	0	1	0	0	86	0	0	0	0	6	0	0	0	3	5	0	235	9	0	35	3	6	3	0	185	4	4	54	0	2	521	5	150	2	7	2	2	20	0	217	0	44	1	1	4	2	1	79	3	0	5	35	2	5	3	68	6	0	4	5	0	4	0	0	3	2	43	11	103	9	10	1	1	0	4	0	1	1	15	11	0	1	7	7	16	1	7	117	9	22	12	41	61	68	0	8	22	0	1	16	23	2	43	13	13	0	0	17	0	0	2	4	3	2	0	20	0	117	33	113	109	222	13	135	22	0	1	0	17	4	26	0	2	10	7	131	0	0	0	8	3	3	0	3	77	94	0	87	33	2	17	0	25	2	53	5	1	52	8	0	0	1	0	4	12	0	148	2	3	66	20	0	5	77	0	23	251	59	3	11	12	23	1	0	56	134	116	27	159	0	10	16	78	4	1251	0	0	4	15	1	2	144	2	7	3	1	17	0	10	15	7	120	30	0	0	0	2	0	8	0	4	0	0	6	0	8	4	25	0	0	1	13	0	51	6	4	111	77	60	3	746	9	2	5	2	0	0	2	0	21	4	0	1	0	17	0	1	6	115	2	2	1	3	0	0	67	11	0	136	0	9	0	6	46	15	57	0	0	10	8	0	14	20	2	6	45	0	14	0	1	0	0	1	73	2	1	80	9	1	2	0	62	325	13	112	2	141	233	1	101	6	105	11	84	19	29	14	28	6	1	68	6	1	0	2	4	8	4	0	0	5	5	14	1	0	11	10	5	10	0	33	181	0	0	2	0	0	0	0	4	1	0	2	0	0	0	0	0	2	35	24	36	26	12	1	4	0	16	24	8	4	2	0	45	0	16	2	0	2	0	3	3	0	1	1	0	0	1	16	0	1	4	25	0	1	3	1	4	0	0	0	326	8	58	22	17	9	15	0	59	4	35	201	187	31	2	9	2	0	3	0	2	2	0	38	0	2	51	21	0	0	3	6	0	0	0	0	4	14	6	0	39	4	9	5	37	21	1	101	15	3	1	3	54	13	61	0	4	0	0	0	0	2	0	3	3	0	33	2	2	1	0	0	6	1	2	0	2	0	13	7	4	5	9	0	2	4	8	0	0	8	35	185	6	6	1	0	4	1	0	3	5	2	0	36	0	0	0	0	6	42	4	0	25	0	11	6	34	0	10	26	22	1	5	130	7	3	2	0	2	0	0	1	19	1	0	13	0	0	3	0	5	89	0	6	3	93	0	111	93	89	4	0	11	0	0	0	15	0	57	29	0	3	0	0	0	7	0	12	8	2	2	0	4	3	1	0	15	0	0	4	0	3	0	0	0	19	4	0	0	3	49	36	0	0	4	4	1	1	7	0	0	0	0	0	3	0	0	0	21	4	1	0	2	6	54	2	9	36	17	0	2	790	0	5	75	172	5	35	2	0	66	9	4	0	0	0	1	7	92	2	15	21	10	12	26	0	2	0	40	0	62	0	3	4	17	120	0	0	57	0	17	0	9	14	0	0	2	15	0	0	0	8	3	66	19	0	6	2	2	34	1	4	94	19	2	56	12	2	0	0	7	11	0	0	4	0	1	0	2	4	35	8	0	14	2	21	183	6	6	0	2	0	7	6	0	10	10	11	1	0	0	3	1	12	1	2	5	1	10	3	2	4	2	0	0	3	1	1	18	3	0	1	8	0	0	0	3	1	10	4	31	5	17	1	19	3	0	2	5	1	0	0	0	21	33	11	0	0	0	0	50	168	79	117	275	123	138	350	36	122	213	116	510	209	31	121	32	374	560	24	60	12	610	709	429	375	728	200	202	52	135	40	158	6	2	16	1	7	1	0	9	0	2	0	76	211	31	0	4	0	3	4	0	0	4	4	17	0	1	28	0	21	0	4	2	0	27	0	78	0	55	30	1	0	8	1	0	5	3	0	4	11	4	4	0	2	2	0	6	2	0	37	1	1	0	0	6	3	18	69	12	1	4	13	0	0	0	11	0	0	14	14	0	2	1	8	104	4	0	16	2	0	0	0	3	7	2	2	4	7	18	46	0	34	0	1	0	5	7	4	2	36	1	6	2	4	0	16	5	19	5	215	14	3	40	50	1	0	1	1	1	8	4	5	8	0	11	3	2	11	29	2	0	0	0	2	0	2	6	4	5	10	3	7	3	2	0	0	1	15	3	8	4	2	0	0	5	4	0	0	114	0	16	10	10	1	0	0	0	36	0	2	9	2	2	2	19	0	0	0	1	0	11	30	2	0	17	3	5	1	1	2	2	2	19	3	0	166	10	21	0	1224	32	6	2	0	0	3	5	0	0	14	8	0	0	0	0	0	48	1	63	123	2	0	0	0	48	2	0	45	28	2	37	4	1	204	8	13	9	2	3	1	0	1	5	7	1	63	9	38	2	2	11	0	13	2	9	1	1	2	9	3	1	3	5	4	0	1	10	0	10	0	15	0	4	7	3	5	52	4	7	0	0	19	7	1	224	318	25	4	14	1	1	1	0	3	0	1	1	0	2	0	0	0	0	2	91	27	18	222	24	3	5	10	0	0	3	1	142	71	14	1	6	4	92	0	0	0	0	13	4	1	4	0	1	0	2	2	90	22	4	5	0	1	0	0	4	17	0	2	56	25	35	2	3	5	1	4	76	4	2	11	2	0	4	0	2	2	2	8	8	15	2	2	109	15	18	2	28	1	27	14	8	9	19	7	69	4	46	4	33	5	34	5	22	0	1	35	0	5	5	0	0	21	2	4	0	0	1	3	1	18	18	0	271	6	6	41	0	18	5	15	14	2	10	1	0	34	5	44	6	1	0	0	3	0	9	5	15	20	0	1	1	0	1	0	152	1	10	215	101	16	0	98	47	12	4	42	3	44	3	31	3	54	5	27	0	74	71	4	4	40	8	44	2	51	3	0	0	72	6	0	6	16	26	9	23	26	7	17	4	0	23	11	16	0	31	0	7	1	127	51	2	4	4	18	5	55	54	32	1	0	0	4	2	4	4	8	0	0	1	33	44	7	2	0	13	70	0	0	3	1	0	0	0	0	29	1	0	33	0	14	48	2	4	0	2	0	0	0	1	0	0	6	0	294	16	3	119	119	112	7	64	5	12	0	5	10	246	0	2	2	0	9	8	0	4	0	20	5	1	0	30	0	4	93	6	0	90	4	1	241	0	64	0	6	0	138	120	0	0	0	12	12	15	3	0	0	32	3	40	9	6	4	60	5	0	1	69	4	1	0	22	2	6	0	1203	280	244	79	1	0	0	3	0	12	10	193	1	5	0	2	1	3	121	578	132	9	5	1	1	0	3	0	100	15	9	6	0	3	5	0	2	9	0	0	6	0	5	0	1	0	0	2	7	0	344	729	15	12	5	0	6	4	3	26	3	3	0	0	0	0	96	16	8	8	5	0	0	3	4	259	16	5	8	0	8	3	1	0	12	2	0	35	4	12	0	5	0	2	0	10	2	2330	7	2	11	0	14	1	11	2	3	0	1	0	0	0	0	6	1	66	0	0	1	0	0	4	0	2	0	3	0	4	6	3	2	0	9	0	0	0	0	2	0	0	0	1	2	6	0	10	0	0	0	1	1	0	3	1	1	0	1	48	0	0	0	2	0	0	166	3	4	0	3	0	0	720	13	0	0	1	15	20	19	121	12	2	37	3	0	45	4	17	199	10	0	18	5	0	7	0	5	0	0	1	18	1	0	4	0	0	0	0	4	4	0	0	0	0	4	2	0	0	2	0	1	3	3	11	2	1	4	7	5	2	0	3	2	26	0	0	0	0	1	38	3	41	1	28	82	9	38	19	3	0	0	2	1	0	2	6	15	43	0	5	0	52	2	6	0	0	0	0	1	0	2	8	5	25	2	11	55	12	3	35	0	32	0	1	1	0	4	0	1	1	7	0	9	9	0	6	9	0	71	6	190	51	0	1	2	2	0	2	0	8	13	14	0	2	1	0	0	2	126	1512	0	117	0	0	7	9	2	0	0	9	0	1	0	9	5	0	12	10	32	41	1	0	0	0	7	2	2	2	74	6	33	16	0	2	2	4	3	7	8	11	0	1	0	0	44	2	0	2	48	0	81	4	58	5	3	49	1	5	2	0	157	0	1	0	80	1	0	2	3	0	2	8	713	0	1	6	4	0	2	4	5	2	1	4	15	0	2	0	1	0	0	433	12	0	0	3	1	1	0	133	0	3	0	6	2	5	15	0	0	0	8	4	4	0	1	2	6	0	0	11	7	3	5	1	11	1	0	2	8	4	5	4	9	2	0	2	15	3	14	0	2	0	1	38	1	29	1	0	4	0	5	9	0	0	0	4	0	0	22	1	11	0	2	4	16	0	8	2	1	1	2	0	0	6	2	2	5	3	5	0	0	3	3	0	34	1	0	5	105	4	0	10	2	1	0	4	3	7	2	0	3	67	2	0	2	0	12	4	1	2	4	0	4	2	0	3	1	7	2	2	5	0	44	5	0	0	18	8	0	0	0	1	4	8	0	40	3	2	0	5	11	63	0	0	0	197	129	0	3	12	5	0	0	0	0	2	0	3	0	0	1	1	57	0	1	33	0	0	0	8	29	1	0	3	983	3	0	0	0	11	3	8	0	6	0	9	0	9	156	1	0	2	1	0	4	0	3	24	3	39	0	0	2	3	0	141	3	5	0	0	0	3	11	0	0	50	1	0	0	0	0	0	0	0	0	5	0	0	8	0	0	0	1	0	3	0	0	0	0	0	0	0	0	8	0	0	4	0	20	7	1	0	13	0	0	0	2	0	0	4	1	0	5	0	0	3	4	0	0	0	0	0	0	2	3	6	0	0	0	0	0	0	0	2	3	0	0	3	0	0	0	1	0	0	0	0	0	35	0	0	3	6	3	0	0	6	0	9	102	0	5	271	25	3	3	2	0	41	0	0	50	0	5	3	7	0	4	12	0	0	3	13	0	0	0	139	142	18	5	4	36	237	0	37	0	2	0	3	0	6	3	4	0	3	9	0	1	0	0	47	2	6	0	5	6	9	3	2	0	9	30	2	0	4	3	0	0	3	0	1	4	0	0	0	2	0	0	1	0	2	1	192	0	315	0	0	0	0	1	4	0	0	4	2	298	6	0	0	4	8	15	0	0	4	0	0	3	5	0	8	5	0	0	0	0	5	0	0	1	50	0	4	0	0	13	16	0	1	0	0	5	0	0	5	70	0	39	8	4	0	1	2	5	0	2	10	8	0	115	3	3	0	4	8	58	0	4	177	0	0	7	2	14	3	0	3	0	2	4	2	0	0	11	2	9	7	2	1	128	0	23	0	0	7	1	0	0	132	0	3	0	4	6	3	0	0	1	13	26	0	0	0	0	4	4	19	0	7	2	11	0	0	2	2	61	3	0	0	4	0	5	4	0	0	0	0	0	0	1	3	0	0	1	1	4	9	12	6	37	0	18	4	10	3	48	0	0	0	4	0	0	1	2	0	3	3	2	16	34	0	71	2	24	0	5	11	0	24	6	3	3	4	0	0	0	0	0	0	98	0	5	1	5	0	0	4	2	0	13	36	10	125	0	0	0	0	0	0	1	1	0	2	7	58	49	0	26	0	0	1	0	0	6	1	56	2	0	15	6	5	0	12	8	6	0	4	3	1	0	26	0	0	0	0	0	1	1	0	105	0	11	5	5	0	27	2	2	0	0	0	9	0	0	0	0	0	6	24	1	0	27	11	15	0	0	3	0	0	3	4	4	2	0	39	16	2	3	55	5	4	132	301	35	0	9	0	599	1	68	155	15	0	7	0	40	597	0	51	0	11	95	0	1825	0	3	1	0	2	1	0	39	61	6	33	0	15	51	3	64	21	219	3	54	44	2	6	0	33	1	0	62	4	6	7	0	1	1	2	0	32	9	10	0	2	4	31	6	4	2	0	5	4	1	0	7	1	0	0	0	5	2	0	3	51	1	0	17	51	14	0	0	53	4	47	7	0	0	3	60	0	0	1	0	0	45	167	1	0	21	5	4	6	0	6	4	3	0	2	0	0	0	24	59	0	16	3	4	1	20	7	19	9	3	12	0	0	4	2	3	2	0	22	80	4	6	2	3	28	6	3	1	1	2	57	2	5	16	2	0	1	37	0	0	12	2	66	9	12	3	0	43	0	15	34	2	2	33	0	0	0	1	78	17	0	2	118	92	353	12	43	65	99	569	9	191	106	194	26	397	526	302	0	327	59	150	145	136	15	136	15	285	8	44	0	51	0	1	0	0	5	2	8	2	4	2	2	6	59	6	5	10	2	1	0	206	3	8	13	30	4	0	6	3	0	4	312	0	13	73	0	3	1	0	8	8	155	0	8	0	6	10	0	0	354	53	4	0	2	36	0	0	49	6	34	6	175	5	5	0	0	45	0	11	629	10	60	7	41	0	8	0	2	6	1	7	3	0	0	0	0	0	0	10	29	9	0	3	0	57	2	3	0	12	94	1	0	8	4	8	0	7	0	4	8	5	3	2	703	0	9	19	0	7	2	40	13	20	44	53	3	7	0	2	3	6	2	2	0	1	51	0	34	1	12	162	3	0	18	2	1	0	0	124	2	21	1	0	9	0	0	1	0	70	0	0	98	11	20	34	16	7	6	8	0	4	64	4	1	0	10	2	1	0	1	1	0	0	0	4	2	0	35	6	9	0	12	0	0	0	0	0	0	1	31	338	2	0	1	4	80	28	12	6	36	5	0	2	120	5	67	0	1	7	0	97	4	0	0	0	19	3	1	2	5	2	0	0	2	5	42	0	5	0	153	0	0	7	0	7	1	0	42	36	7	0	41	9	0	0	0	3	1	7	63	2	47	5	0	14	13	140	1	11	9	24	15	3	13	3	18	65	26	2	8	0	0	8	5	12	0	8	59	0	9	8	12	76	3	13	22	0	0	0	0	0	15	0	22	2	2	0	2	0	1	0	4	26	0	1	11	89	15	32	4	0	42	6	5	1	2	123	2	0	3	0	3	18	54	12	15	4	0	2	12	6	4	0	1	2	0	0	0	0	23	44	0	32	4	3	1	0	2	0	2	172	4	8	0	13	2	0	0	15	6	2	0	22	3	0	0	7	8	1	2	8	0	4	15	47	1	60	5	833	0	0	0	3	0	1	1	2	0	4	4	2	8	0	119	57	8	8	1	2	177	56	56	15	0	2	7	0	0	1	0	1	11	4	3	96	10	1	6	2	0	1	23	1	26	66	5	88	17	45	86	11	5	1	5	0	7	79	9	1	19	18	53	35	0	0	1	8	56	0	90	43	11	40	57	38	19	4	0	1	1	54	0	7	0	40	4	2	9	0	16	0	0	0	0	0	0	14	0	17	18	24	4	7	0	2	8	0	185	30	0	0	12	1	19	23	26	1	8	0	1	1	0	49	2	5	0	0	0	6	45	14	250	4	0	0	152	0	0	48	6	3	3	0	0	0	0	7	8	2	0	2	50	0	17	5	0	1	54	0	13	2	0	0	0	0	42	16	5	24	0	0	5	15	37	82	0	7	148	10	3	10	36	2	0	0	11	13	1	0	17	3	0	48	9	19	6	9	2	0	5	13	59	4	83	30	0	26	0	20	1	7	21	2	0	0	18	4	8	3	0	0	3	13	0	2	3	0	36	1	8	0	0	471	2	23	2	0	4	40	16	6	17	0	0	7	26	5	116	41	0	138	8	1	6	56	2	14	10	0	5	0	83	0	8	5	14	0	0	6	318	19	0	0	0	0	26	0	43	0	0	23	8	3	2	0	2	5	10	0	1	0	0	0	3	0	0	0	0	1	101	0	0	2	0	0	0	0	0	0	0	0	0	1	0	0	0	0	0	0	4	0	0	99	0	0	3	2	3	2	4	1	81	3	0	41	0	0	6	6	3	2	0	3	0	9	0	0	2	0	0	0	9	4	0	1	32	2	6	6	0	0	4	0	180	0	6	12	1	5	48	0	46	0	2	11	7	13	0	13	52	2	4	3	3	0	0	0	9	0	0	6	0	1	464	3	2	0	0	2	27	0	0	11	0	44	1	0	0	10	0	26	3	0	0	0	256	2	0	0	0	4	0	0	0	4	0	3	0	0	1	0	3	0	63	54	1	0	1	4	7	4	0	4	3	24	3	0	4	6	0	1	2	0	0	0	0	72	0	0	0	0	26	0	0	0	0	12	0	1	18	4	7	0	0	3	0	0	0	0	0	0	52	3	3	0	12	0	0	1	74	0	1	25	0	0	3	0	0	3	4	28	1	3	1	0	6	47	33	1	0	1	3	0	33	1	60	39	6	5	0	2	32	0	37	0	43	3	53	0	0	0	3	1	0	1	6	63	5	2	11	0	0	0	1	92	25	70	2	20	4	3	4	9	7	65	8	5	0	14	29	23	27	110	0	30	65	1	91	0	5	5	103	17	1	74	17	0	1	35	57	4	0	3	106	23	13	27	0	1472	0	0	0	103	37	158	0	9	5	61	8	1	71	4	100	0	0	4	7	11	1	0	35	13	4	16	10	3	10	2	4	54	4	18	4	31	6	21	10	101	21	6	63	0	194	2	3	9	28	2	3	3	5	1	33	19	5	2	2	1	5	6	23	354	4	0	2	4	62	61	14	11	36	6	292	72	0	0	4	3	14	8	2	0	3	1	1	9	0	2	2	5	0	0	38	1	44	8	72	2	3	8	0	3	7	0	0	1	0	5	6	13	1	5	1	1	0	0	1	9	0	14	2	2	3	3	22	1	10	4	8	5	4	2	3	1	2	0	4	16	1	2	0	4	5	0	29	0	4	8	5	6	21	0	25	5	85	23	6	14	8	6	6	6	2	3	4	4	52	599	1	2	25	5	0	75	27	31	13	41	15	41	16	3	67	18	1	5	123	122	5	2	3	2	6	210	12	2	0	1	1	0	0	0	2	11	67	3	3	99	0	0	18	15	1	0	0	1	0	2	42	4	11	18	118	97	1	21	3	2	0	48	3	0	1	14	49	17	126	2	85	0	4	0	36	6	207	4	7	0	112	4	0	0	57	9	13	0	15	14	0	56	11	255	2	1	85	1	1	1	0	63	5	0	44	5	1	34	120	67	26	71	20	0	3	2	61	1	7	0	3	1	17	5	5	0	4	0	1	0	32	1	17	133	0	0	83	4	15	2	3	1	77	3	62	5	1	77	16	0	0	3	99	0	17	2	36	39	66	16	36	51	13	92	13	100	19	3	4	1	4	33	0	3	4	16	4	14	3	3	0	0	0	0	9	15	52	16	39	274	81	58	0	425	5	4	0	10	5	21	2	0	0	0	3	0	3	4	1	0	1	0	1	101	4	10	0	3	12	14	0	0	0	1	7	6	59	6	1	0	9	0	40	4	3	14	6	2	51	11	1	3	2	30	0	142	118	60	33	9	2	114	6	0	1	75	23	0	6	6	9	1	0	2	69	0	4	0	81	41	195	51	0	0	4	0	9	4	0	6	97	0	23	22	7	6	4	5	1	102	89	60	7	11	47	18	29	36	43	39	0	339	0	1	90	24	0	8	16	21	0	130	257	47	11	6	36	153	0	1	2	7	2	1	17	3	3	1	2	0	91	30	1	0	14	0	41	79	2	8	3	1	0	0	75	42	3	39	65	8	19	0	72	0	150	26	71	45	84	17	4	65	297	161	0	70	11	0	4	13	19	79	4	51	1	4	1	2	1	1	6	14	3	0	2	13	1	14	86	115	682	761	40	7	2	4	26	4	39	40	7	1	10	0	0	0	0	2	0	4	0	6	10	4	4	0	0	2	1	10	0	18	2	1	9	2	0	0	27	0	46	0	3	68	16	29	10	15	60	67	30	83	69	1	0	2	3	286	152	31	5	1	4	13	0	22	4	2	39	0	0	64	48	7	4	9	0	3	0	6	44	148	0	0	4	3	2	10	7	6	16	0	3	0	0	0	267	11	29	29	1068	8	6	4	2	0	1	208	2	7840	1	67	1	19	44	65	97	0	0	0	0	2	0	0	3	56	32	34	4	4	2	0	0	4	0	4	8	0	0	276	0	0	17	1	7	4	2	37	0	11	111	7	7	0	0	5	3	3	5	1	59	7	6	20	0	3	2	5	7	1	0	0	0	0	0	6	5	64	0	68	11	4	31	0	3	6	2	9	123	6	2	4	0	3	0	1	3	102	8	0	20	3	0	8	0	3	0	19	2	186	40	5	30	226	0	6	6	7	72	1	90	22	73	4	9	13	3	12	22	2	0	62	3	2	3	2	340	0	4	13	17	12	6	2	1	2	0	0	0	0	5216	25	85	23	14	1327	3	8	100	12	91	40	437	274	241	70	187	103	111	1	0	119	54	35	26	13	12	0	12	2631	12	16	28	38	3	105	10	0	0	88	36	7	3	1	7	4	8	97	0	14	1	22	11	128	78	39	18	43	7	33	1	9	1	70	19	8	60	34	9	1	0	8	1	2	0	0	2	20	27	0	10	4	82	2	7	17	0	16	3	6	13	10	14	0	2	22	2	1	12	55	3	1	2	0	0	0	0	7	1	37	3	41	52	0	82	15	13	2	13	61	475	8	5	13	34	78	11	20	82	4	56	0	86	37	3	84	0	2	50	39	57	149	8	0	69	71	55	60	0	0	59	8	0	0	23	4	29	5	11	2	96	2	6	38	4	33	3	9	12	0	6	32	1	5	58	5	4	2	0	2	1	55	6	5	53	0	5	8	19	0	615	25	83	0	2	57	9	2	15	29	8	74	0	0	9	55	45	5	94	139	0	71	23	37	42	58	71	14	14	5	6	16	6	10	54	171	96	20	1	1	0	2	2	3	2	4	2	66	123	10	22	1	1	0	5	8	16	104	38	0	29	119	1	9	0	0	2	42	10	7	7	1	0	1	3	1	3	7	3	3	0	0	0	0	3	2	0	18	2	0	16	1	0	2	166	43	8	8	2	31	9	1	6	1	4	3	14	1	29	4	2	5	0	1	1	1	22	2	9	1	21	44	1	28	1	5	1	4	3	4	0	0	43	309	0	2	0	0	1	2	77	4	100	1	0	2	0	4	20	0	43	10	47	47	1	0	5	3	4	26	0	1	1	0	21	14	10	5	8	3	5	23	3	43	0	12	3	8	11	15	46	21	52	69	12	32	20	8	3	22	7	0	23	59	17	22	0	39	31	16	17	13	4	17	4	6	4	25	7	23	29	13	34	0	0	0	6	13	71	15	12	3	19	0	0	2	64	31	8	735	0	231	11	4	0	2	0	9	34	2	5	0	14	1	1765	170	479	12	1	32	2	0	3	5	11	166	43	36	132	97	21	223	56	48	98	0	4	14	96	18	2	3	6	26	22	43	10	11	39	9	33	9	5	11	47	92	10	0	2	0	39	2	3	4	14	8	161	5	1	0	1	0	42	137	11	1	2	6	44	9	23	5	3	2	3	0	3	9	28	2	0	0	0	1	3	0	0	13	6	6	1	5	2	0	2	16	0	6	11	18	12	1	44	79	9	39	40	3	2	433	1	6	4	4	0	4	1	1	1	9	3	2	0	0	0	0	19	2	11	1	3	0	33	2	1	3	2	7	0	0	0	0	1	1	11	2	3	2	1	21	10	5	2	0	20	0	142	102	51	120	3	47	5	62	3	0	1	2	2	3	0	3	0	4	2	5	4	12	65	66	7	3	2	3	2	1	4	4	2	76	33	7	4	103	3	25	1	1	26	123	0	1	1	90	1	0	22	116	146	18	38	2	0	7	0	5	29	5	122	2	4	5	84	56	12	6	18	73	9	53	19	2	5	67	43	0	22	144	353	59	2	1	2	2	9	21	31	100	1	0	4	1	6	2	35	1	13	4	1	4	0	1	14	0	24	23	14	1	0	0	0	1	15	17	17	0	116	11	4	1	3	1	1	4	1	1	28	62	11	1	21	73	1	13	11	4	8	9	19	0	4	20	0	4	2	56	21	5	4	1	0	3	5	62	5	47	15	5	13	8	0	0	1	12	2	4	51	14	1	51	108	3	6	0	0	7	5	0	15	21	8	14	116	88	57	1	0	21	4	4	11	3	0	13	3	0	5	10	39	12	4	4	8	0	15	0	29	0	0	0	74	17	0	7	1	0	0	0	23	19	27	16	28	4	1	1	1	2	2	12	10	47	7	4	2	48	2	1	8	2	25	39	1	0	41	69	42	3	0	93	0	51	6	10	514	0	0	28	0	0	3	0	2	3	6	3	4	75	14	0	62	20	41	10	4	188	0	6	0	3	3	0	1	28	0	4	1	4	3	3	2	19	4	1	0	7	14	0	2	2	3	11	1	4	0	12	67	29	0	0	1	1	73	10	8	1	1	0	173	143	1	12	8	1	0	5	65367	0	0	2	0	2	3	0	0	0	1	0	1	2	0	6	0	43	2	5	5	4	98	21	110	38	4	7	53	11	5	2	0	0	0	1	7	5	66	139	6	110	11	0	1	2	0	5	9	2	20	0	0	37	1	138	61	66	240	208	82	30	38	3	73	11	0	26	5	0	247	43	101	38	3	6	1	23	33	33	2	296	108	59	3	266	5	3	1	2	21	0	6	20	0	89	20	2	289	10	15	0	115	105	1	0	97	28	1	6	9	6	0	3	2	6	3	11	1	80	175	62	94	179	3	311	20	6	47	53	149	142	169	19	7	54	30	155	59	0	154	40	18	16	0	7	12	0	99	36	142	200	30	4	50	1	1	98	54	10	49	3	3	1	2	0	0	0	0	4	0	11	2	7	38	6	27	4	35	4	3	4	73	0	1	0	2	77	103	73	70	8	6	12	7	2	27	53	15	0	23	0	10	11	32	59	43	54	0	37	6	1	0	31	35	0	4	4	22	6	0	0	0	1	4	0	0	1	28	12	8	6	9	58	15	20	0	4	7	0	0	0	13	6	4	85	1	41	2	3	4	151	91	0	8	15	9	453	20	0	27	18	2	2	5	0	0	9	0	0	6	0	0	9	0	2	7	8	1	9	0	0	13	2	23	8	9	1	1	8	3	0	3	1	10	12	2	9	2	0	0	4	2	7	11	1	4	0	11	0	12	2	3	59	1	25	12	1	5	1	4	38	0	4	4	3	6	102	83	6	132	3	14	15	220	7	12	49	21	0	5	12	7	98	2	2	43	7	51	41	40	58	0	2	0	5	0	0	2	2	46	0	6	4	66	29	55	0	1	0	1	5	13	1	2	16	4	6	1	3	8	44	128	39	1	110	0	66	71	11	1031	11	6	3	14	12	67	67	7	54	0	3	41	1	37	4	3	2	0	1	0	0	0	24	0	14	42	39	15	4	3	0	59	7	8	3	1	3	0	6	34	1	1	7	14	0	57	0	28	0	0	2	10	12	13	10	22	27	18	52	69	10	3	0	3	0	9	9	146	392	167	33	52	36	116	33	8	5	29	64	47	22	0	2	12	2	20	2	16	2	10	0	1	17	66	2	14	17	4	34	1	30	0	15	12	29	4	37	21	68	15	25	9	3	86	0	2	14	4	12	5	7	2	162	2	22	0	4	0	6	11	5	6	3	1	0	4	7	2	7	2	2	0	0	3	13	152	0	0	1523	0	13	0	29	1	1	7	23	22	22	2	3	3	2	0	0	4	0	3	0	0	22	4	1	3	2	9	3	3	1	157	0	47	34	245	27	10	59	0	1	0	0	0	1	1	0	11	0	1	2	5	2	0	3	1	148	4	2	0	1	5	6	10	0	0	1	1	2	2	4	2	0	69	0	2	5	40	4	51	4	0	53	15	8	9	28	13	5	71	31	54	210	53	39	87	91	459	135	31	631	1	1	48	20	7	10	2	64	37	1	1	1	7	2	0	425	3	5	8	0	355	2	3	0	0	10	29	9	80	3	5	4	12	4	4	1	7	3	0	2	2	22	39	0	0	6	16	320	86	0	4	0	7	2	1	0	2	76	2	0	0	4	1	11	21	95	9	18	2	0	73	24	9	1	134	8	0	61	21	12	4	8	0	2	5	86	7	29	8	3	3	9	1	0	249	12	6	20	7	32	57	0	1	51	232	28	10	591	1	1	4	14	0	2	0	466	65	42	0	1	0	4	46	5	21	1	38	2	36	0	1	13	1	11	4	25	14	16	15	5	1	26	165	0	16	3	0	7	48	97	11	3	15	0	25	2	4	30	0	6	1	16	9	1	0	0	1	48	11	10	2	0	71	10	16	1	9	14	10	18	39	0	4	55	8	1	0	0	1	0	6	19	15	70	11	89	181	23	35	114	3	148	238	261	0	0	0	1	45	1	16	0	2	362	12	0	40	67	99	81	3	30	20	0	37	6	14	7	9	110	52	5	2	1	0	9	0	4	174	186	205	9	3	2	0	12	8	1	1	0	3	10	3	30	5	2	1	0	0	1	0	0	4	13	5	0	1	12	7	1	1	0	2	3	3	2	0	0	0	1	0	10	247	1	2	0	0	5	5	0	1	0	0	0	5	10	2	2	1	49	9	64	9	0	8	12	3	18	2	10	3	5	1	11	0	0	62	303	70	97	60	2	10	9	77	23	7	49	34	0	0	0	3	7	5	24	0	5	30	1	25	14	0	37	29	2	12	24	0	0	149	24	1	64	3	4	0	10	0	0	74	15	63	17	102	19	65	25	7	168	6	31	0	2	3	10	0	89	82	283	103	0	92	102	118	17	71	2	7	3	11	4	2	9	155	21	11	0	1	0	0	137	0	0	0	0	0	2	15	3	35	85	21	53	26	2	39	20	57	33	14	69	10	28	127	18	111	0	6	6	7	0	4	1	2	22	70	12	19	31	4	2	12	6	1	6	4	0	0	5	1	1	1	10	1	1	16	381	400	5	239	277	55	8610	86	3	6	1	0	0	0	0	42	15	43	7	1	16	54	0	7	2	23	8	3	0	2	14	2	1	1	568	105	2	48	95	59	5	0	4	1	1	103	4	291	1	11	3322	2	5	4	80	3	49	1	7	0	12	2	0	1	2	1	1	5	35	0	0	2	0	0	4	0	0	2	2	3	7	4	65	0	11	13	15	4	2	8	0	7	0	5	3	54	2	351	322	3	21	14	60	11	57	13	11	0	35	2	37	5	0	1	0	1	3	0	0	1	0	0	37	0	9	4	0	4	8	0	0	4	17	2	31	12	0	0	2	9	3	1	5	0	3	2	41	2	4	75	14	3	2	0	0	2	0	0	0	5	0	9	24	7	23	1	36	67	79	8	85	4	2	2	0	1	0	3	0	39	3	272	0	1	8	48	0	98	95	0	0	4	0	9	2	3	0	4	8	2	0	0	4	4	12	5	6	0	0	0	0	1	0	3	3	0	16	4	1	7	0	0	5	2	0	1690	0	3	0	0	0	6	0	0	14	12	0	0	2	0	0	0	2	0	6	0	0	2	4	0	1	1	0	4	0	0	8	3	0	1	278	0	6	0	9	2	0	52	10	0	0	1	1	0	0	2	18	17	51	2	48	0	2	2	0	6	36	2	3	4	6	6	11	0	0	20	5	0	0	0	6	0	0	0	0	1	1	1	4	3	0	0	0	3	0	0	0	0	9	11	0	2	8	1	45	11	5	2	2	2	3	2	3	2	0	3	3	2	0	1	24	0	0	2	6	0	0	0	0	0	0	0	0	2	2	0	0	2	53	2	0	0	93	0	0	3	0	3	0	6	15	0	0	0	0	0	0	2	2	3	3	4	0	0	3	1	1	0	0	28	0	0	5	1	0	0	13	6	2	2	4	8	4	46	2	8	6	3	7	0	21	2	28	6	0	15	172	5	40	1	1	301	5	79	0	2	8	0	0	4	21	3	12	9	5	0	8	9	722	8	15	0	50	0	0	18	6	8	0	48	0	0	6	13	8	11	0	7	9	6	31	3	5	27	0	4	7	2	5	11	11	8	2	0	0	7	0	4	59	3	12	3	14	39	29	19	0	2	9	50	15	59	14	14	1	26	4	0	0	7	9	2	12	66	1	0	53	5	1	24	0	3	0	44	0	0	35	11	7	6	4	10	7	30	0	0	10	1	4	1	43	14	28	4	76	144	47	18	221	297	239	44	0	4	7	158	0	14	0	3	8	20	0	3	0	1	57	0	50	0	0	0	0	0	7	0	531	37	104	0	7	12	1	0	22	3	167	0	131	114	2	13	4	19	3	4	4	3	0	0	2	0	2	0	11	17	2	21	0	8	11	5	1	0	9	0	1	1	1	5	4	53	4	0	0	4	0	14	4	7	3	0	1	33	11	1	4	6	10	8	1	6	0	21	1	13	171	0	2	0	12	0	4	9	4	0	4	4	0	0	4	7	40	4	52	4	0	2	6	3	0	1	10	1	3	28	0	3	0	4	7	54	2	197	0	16	0	0	0	189	8	0	2	1	260	3	73	3	8	2	0	9	5	3	0	19	2	1	11	0	3	3	8	0	1	0	4	113	45	5	80	106	7	3	0	4	1	15	18	0	1450	0	19	4	67	0	1	3	33	39	92	34	0	0	12	2	98	2	0	0	4	18	30	0	213	1	71	42	22	3	3	1	3	1	1	9	7	13	0	1	0	22	8	12	2	4	13	0	5	59	32	10	8	52	1	1	7	2	7	4	17	36	73	40	71	71	6	52	43	792	1	75	25	23	79	0	47	51	23	3	15	0	2	2	15	163	47	1	3	2	0	77	59	1	1	1	84	2	0	0	0	2	5	14	0	125	40	25	1	0	102	3	2	0	2	2	3	34	2	47	20	26	7	41	13	9	4	0	4	0	21	1	3	7	7	50	7	20	1	18	0	46	62	12	23	129	18	2	7	6	7	14	146	73	4	6	1	0	0	2	1	1	17	13	1	2	1	8	2	0	28	54	8	2	17	2	11	24	9	65	0	10	5	17	4	99	11	15	12	7	4	0	9	46	45	162	64	36	4	1	3	0	2	0	2	11	8	12	15	173	67	99	0	52	1	0	24	24	17	4	5	0	0	4	18	24	23	37	25	9	49	7	75	0	12	4	7	83	1	48	45	100	106	11	7	29	124	28	24	0	2	5	0	3	0	56	3	0	183	0	12	4	4	0	9	6	157	55	33	0	0	5	3	10	0	1	8	13	10	16	22	1	2	0	17	51	14	203	6	37	4	6	1	5	1	89	4	9	1	37	3	8	0	44	10	3	97	30	13	95	0	2	0	75	122	0	0	7	5	0	100	1	6	4	1	2	0	0	6	50	13	4	20	7	43	20	0	2	0	3	2	6	0	110	3	4	0	49	5	4	2	4	17	93	6	31	10	0	7	1	10	5	89	44	0	7	4	2	3	3	2	1	13	31	11	0	4	35	211	52	4	1	8	6	2	7	0	0	0	0	8	30	8	19	5	149	15	12	118	8	62	308	20	93	30	155	101	8	148	27	45	75	19	82	54	0	2	10	13	8	12	0	7	9	14	3	7	61	3	3	4	5	1	0	3	2	2	1	0	2	72	6	25	25	24	6	3	2	0	0	0	0	0	3	0	0	2	1	0	4	0	4	0	17	0	1	0	0	2	8	2	15	38	33	6	0	0	0	0	0	0	0	0	0	0	3	0	0	0	0	0	1	1	3	0	0	4	0	18	53	3	79	11	2	4	65	1	0	1	72	51	94	13	12	7	58	3	0	7	1	19	29	0	0	0	0	2	0	5	61	210	17	92	13	58	0	13	4	48	5	40	17	2	0	3	2	4	2	1	1	0	7	18	7	5	13	10	0	44	9	80	14	53	4	34	96	113	1	119	51	23	0	4	0	0	0	1	13	68	5	3	0	5	1	1	0	31	17	40	0	0	112	32	7	110	6	106	0	2	0	0	27	4	4	3	233	12	2	11	2	10	775	0	1	4	5	32	1	48	0	0	155	0	7	20	54	0	50	35	20	0	55	92	0	2	2	27	0	10	2	18	9	5	28	9	62	114	1	6	0	38	8	52	5	0	6	33	95	57	104	27	32	6	15	12	0	46	6	5	22	20	6	0	1	44	0	3	9	34	17	1	24	7	6	10	4	4	3	30	6	10	1	8	6	3	10	7	5	7	5	0	0	1	3	90	6	0	0	0	0	5	4	8	38	2	6	1	0	0	0	0	28	41	10	28	21	0	84	1	3	407	27	462	43	71	1	10	823	195	4	32	93	2	0	0	42	62	17	27	2	59	1	57	77	14	9	6	9	0	5	26	29	24	0	0	172	136	69	12	0	0	2	1	0	0	47	2	6	9	15	4	5	3	0	9	0	3	6	463	2	163	42	34	2	142	18	32	3	0	3	0	1	16	0	12	0	8	0	103	4	10	52	37	6	125	30	681	39	14	0	0	34	44	0	364	69	63	119	31	259	3	96	90	9	0	0	0	2	7	14	51	1008	287	41	0	143	0	8	0	0	73	2	4	5	17	9	0	1	169	219	1	0	0	212	82	48	59	5	64	33	20	116	0	12	24	0	1	32	18	55	5	10	1	7	0	0	0	17	46	1	13	15	2	1	2	4	3	1	1	0	1	4	0	216	54	3	12	5	134	16	23	6	2	13	15	55	11	2	0	1	36	86	6	4	98	0	62	9	2	4	5	114	5	16	6	3	6	41	94	128	25	157	307	125	5	2	6	441	57	98	134	4	0	0	2	4	2	2	4	29	0	2	25	12	0	2	0	1	0	0	1	59	6	11	16	49	32	55	10	1	45	4	42	0	13	29	4	21	0	1	0	60	13	39	110	54	45	345	2	23	2	0	4	2	0	4	0	0	0	4	3	46	0	1	0	0	0	0	35	3	0	0	35	3	6	26	3	6	4	15	6	1	12	2	29	2	2	19	0	2	59	2	0	0	0	0	42	5	0	2	0	0	0	51	36	18	12	0	20	18	45	0	4	1	21	0	32	110	1	14	39	15	17	3	0	0	35	33	1931	153	129	99	20	144	60	56	42	78	26	31	0	40	79	0	0	1	9	3	8	2	101	4	15	0	7	2	20	4	4	7	18	16	0	0	0	1	9	4	2	5	2	1	3	3	4	0	2	0	3	0	13	7	1	0	4	0	2	1	9	17	3	96	12	0	129	2	61	98	18	70	1	0	0	40	0	8	28	1	15	27	0	0	113	64	4	1	4	8	7	36	7	10	12	107	2	0	4	0	14	3	23	6	1	2	9	1	5	6	10	5	10	0	83	8	24	7	8	10	0	0	12	2	5	131	23	12	3	28	13	78	0	65	5	17	7	19	1	27	0	94	12	1	3	2	0	30	0	2	3	14	8	0	3	24	8	9	27	5	8	50	3	3	6	2	0	1	0	5	0	10	117	15	11	36	134	0	5	5	5	0	2	0	0	22	0	10	9	11	4
LakWasMeta3_LOW4_2_rpkm	2	0	1	0	0	35	9	1	3	1	4	28	4	118	2	3	1	2	24	0	1	0	0	72	0	0	0	0	2	32	0	0	0	24	4	21	4	1	25	0	0	0	2	10	43	109	65	29	3	8	13	2	3	0	0	15	5	37	54	18	212	4	1	34	15	0	0	0	7	54	5	1	5	0	5	0	0	1	0	0	1	17	0	1	1	0	1	2	5	0	1	7	53	4	15	1	10	0	7	0	1	0	0	0	0	0	1	2	1	1	0	0	51	10	26	8	0	3	2	0	0	2	5	13	0	0	12	0	2	1	8	66	11	1	0	3	0	4	13	0	0	2	0	24	3	5	0	1	29	4	11	30	0	1	49	0	18	27	20	0	19	4	1	23	10	18	0	12	1	52	5	3	0	2	0	1	0	0	0	1	3	6	0	0	2	216	1	1	0	7	21	2	17	10	1	1	6	4	7	1160	26	0	10	1	0	6	19	0	21	6	12	6	28	20	23	0	8	0	0	8	0	0	15	4	1	16	0	2	18	1	5	4	63	0	1	0	48	29	45	14	1	0	17	13	112	17	1	2	7	24	9	18	28	6	2273	634	1	1	1	2	6	2	169	33	6	0	10	10	8	93	59	1	35	0	0	7	1	0	46	6	12	27	48	22	42	0	2	0	73	1	5	1	1	2	6	0	3	22	23	0	1	66	99	5	37	1	55	50	36	2	33	1	61	131	0	0	0	2	9	3	2	0	0	5	25	4851	7	0	18	0	3	9	1	0	0	0	2	0	2	1	0	23	14	28	46	3	7	10	3	2	2	8	1	0	23	0	4	1	0	61	19	0	17	1	1	35	34	54	14	14	0	44	1	1	24	5	0	14	3	18	1	1	12	8	5	0	78	1	0	1	4	0	65	1	1	71	42	1	0	35	0	21	0	57	41	0	13	0	2	3	0	28	6	16	0	49	26	21	12	3	0	1	1	2	0	1	1	0	0	1	0	10	11	4	1	4	3	4	17	2	47	22	0	2	0	91	1	0	0	3	0	91	17	141	1	47	82	8	0	14	3	10	1	11	7	35	3	0	4	7	22	44	47	10	7	1	29	1	32	1	9	0	29	2	0	4	1	111	53	2	1	3	151	84	11	1	9	0	0	1	0	3	6	2	0	4	0	6	1	4	0	1	0	1	6	4	15	0	7	14	0	1	0	0	2	0	0	7	2	1	9	0	2	6	15	0	15	10	0	31	3	19	4	17	103	3	2	0	3	0	0	0	4	2	0	13	0	0	0	0	0	0	1	8	18	0	39	0	22	2	1	7	0	9	15	39	23	108	8	82	12	275	139	23	82	11	2	15	85	0	0	0	32	4	18	12	9	1	5	0	40	5	1	5	35	18	1	89	0	13	1	194	117	139	3	0	114	7	175	10	88	61	17	23	1	16	7	28	1	4	11	15	4	3	6	0	2	0	5	13	6	53	1	2	0	5	1	22	37	2	42	1	8	21	5	2	4	0	6	7	2	198	0	15	0	5	1	9	23	16	3	40	1	2	3	0	4	1	3	2	2	4	14	2	0	0	3	0	1	36	3	2	32	3	333	0	2	11	0	10	1	33	1	8	46	4	18	2	12	0	0	2	1	0	76	30	0	0	42	3	1	4	10	20	6	2	2	0	20	0	0	0	4	1	3	0	0	6	0	11	1	84	15	2	36	62	10	0	0	35	2	2	1	5	0	9	11	1	47	14	0	4	0	64	2	0	4	1	0	1	0	0	0	0	0	43	1	0	0	1	0	0	5	1	0	0	2	0	0	12	14	22	2	3	0	3	23	0	1	33	0	0	1	0	44	57	148	0	0	0	0	2	1	0	0	0	2	0	7	0	2	0	0	8	26	4	2	11	7	0	4	0	0	0	0	0	1	71	42	0	6	0	1	0	3	0	0	11	21	10	0	0	14	0	0	0	3	8	3	21	48	14	15	6	0	5	3	0	19	2	5	2	4	1	0	1	5	19	66	8	0	0	2	9	13	8	0	2	3	0	0	0	7	0	0	2	2	3	0	2	1	1	10	6	0	0	1	4	0	0	1	0	0	2	38	24	21	26	35	0	0	1	2	4	0	1	0	0	1	2	66	6	0	1	2	0	2	0	0	4	0	1	0	20	18	0	4	20	0	0	0	7	0	0	0	0	2	0	5	1	0	0	4	0	2	8	0	0	0	0	2	13	3	127	6	29	4	1	0	5	11	33	61	2	52	0	0	1	0	0	0	5	1	0	12	0	4	9	0	0	0	19	0	0	0	0	0	0	1	2	0	9	0	0	2	0	2	73	0	1	0	61	18	1	2	55	0	3	180	98	18	0	0	0	1	2	0	1	17	0	2	5	1	1	0	1	1	4	0	0	2	0	3	11	2	0	3	0	0	16	0	34	0	25	0	0	1	0	66	27	8	2	6	3	15	7	14	7	16	8	0	3	4	0	0	0	0	1	4	88	21	0	0	2	0	1	2	3	0	1	0	0	0	0	5	81	24	0	5	16	0	11	0	0	2	1	0	23	2	1	1	3	0	1	1	0	33	14	21	7	0	0	2	0	0	4	4	0	10	8	0	0	0	0	0	1	0	0	0	0	0	1	0	0	2	0	0	3	0	1	1	0	0	3	1	0	0	0	0	1	11	3	2	2	2	0	3	0	9	0	0	1	9	4	5	0	3	20	0	1	17	11	24	13	74	67	1	0	0	30	47	4	0	5	0	21	17	0	0	1	12	0	0	1	5	3	16	78	0	2	0	4	117	0	5	1	1	1	20	0	0	3	0	0	17	0	0	4	4	0	21	0	448	20	3	3	5	6	19	0	15	0	3	53	131	0	2	9	5	8	13	1	3	32	0	15	1	0	1	0	1	19	26	19	1	122	8	23	5	35	1	3	11	5	0	29	2	1	11	2	0	8	0	0	0	10	1	1	11	3	2	0	5	0	0	4	6	10	3	26	0	13	0	1	0	0	4	5	6	4	0	0	24	4	2	4	0	3	7	2	0	2	0	46	15	2	71	25	36	18	1	8	8	0	0	0	5	6	5	18	0	1	8	2	0	1	29	30	0	2	1	0	2	1	8	0	23	5	4	24	1	3	53	9	2	27	29	6	8	0	0	0	8	0	30	3	9	20	10	51	43	17	48	3	0	13	86	26	0	7	7	10	2	17	18	2	18	2	3	15	2	21	25	26	4	0	16	1	0	1	0	2	3	20	21	1	0	12	172	6	12	68	8	2	27	0	17	22	2	5	0	5	4	22	2	7	7	0	3	0	0	1	3	2559	69	31	73	2	2	7	0	11	0	0	0	48	34	11	4	44	0	2	1	30	231	86	46	34	0	10	0	95	0	0	4	0	4	0	7	0	99	69	29	54	65	34	0	12	47	14	0	1	5	0	0	0	93	12	0	0	0	21	0	5	4	1	2	3	0	18	0	3	0	0	1	3	20	0	1	7	3	4	1	4	5	22	0	0	2	1	0	2	2	3	0	4	0	0	12	7	1	0	4	0	2	2	1	0	4	21	2	13	0	55	10	0	0	0	0	0	0	0	0	2	0	24	0	4	0	4	0	5	0	0	5	0	0	200	4	0	28	2	16	5	1	117	2	7	34	2	8	139	0	68	1	0	2	3	3	2	61	0	50	2	1	2	0	0	61	2	0	3	35	1	0	0	21	9	1	4	2	0	0	0	0	1	1	24	6	106	11	8	0	3	8	6	0	0	0	14	6	0	0	4	6	8	1	6	54	3	18	14	18	27	46	0	7	12	0	0	11	33	1	15	7	15	0	0	14	0	2	0	0	3	3	0	13	0	50	32	82	92	93	6	86	23	1	0	0	13	4	23	0	5	3	5	74	1	6	1	5	2	5	4	1	42	23	2	37	15	0	16	0	11	0	54	4	0	28	3	0	2	0	3	0	12	0	106	0	3	30	17	0	3	21	0	28	112	22	1	8	10	9	0	0	16	41	85	51	132	0	0	4	16	6	1296	0	0	5	5	0	0	111	0	4	5	18	6	0	13	7	12	128	21	4	0	3	0	0	7	0	0	1	0	9	0	11	3	11	0	0	1	28	0	48	1	2	64	63	40	0	702	5	0	8	0	0	8	2	0	13	1	1	1	3	22	1	1	0	60	3	2	0	6	1	0	92	6	0	87	11	4	0	0	41	22	14	0	0	3	5	0	4	14	5	1	41	0	3	0	2	5	0	0	31	3	1	21	6	3	5	0	36	204	5	35	3	78	150	0	50	3	37	7	44	25	16	3	16	0	0	37	2	0	0	0	2	8	2	0	0	6	0	10	1	0	6	10	4	14	0	47	104	0	0	1	0	1	0	0	2	1	0	1	0	1	4	0	0	1	0	6	39	20	21	1	1	0	19	29	11	4	0	0	32	0	5	1	0	0	0	0	5	0	0	1	1	0	37	24	0	0	1	16	0	0	0	0	0	0	1	0	170	3	36	26	14	9	10	0	53	0	11	184	79	34	2	4	4	0	2	0	0	0	2	20	0	2	96	53	5	6	3	2	0	0	0	5	1	5	4	0	50	2	2	7	35	13	2	40	9	0	4	0	19	15	16	1	4	0	0	0	0	0	0	0	0	0	13	4	4	0	0	0	13	1	2	0	2	0	1	2	2	3	5	0	2	0	4	0	0	0	47	92	22	0	2	0	0	0	0	3	3	0	3	61	0	0	1	0	7	18	2	2	3	0	13	0	19	0	4	10	11	0	3	99	3	2	2	1	0	0	0	0	13	3	0	27	0	0	0	0	5	35	1	2	0	58	2	53	44	22	8	0	4	2	0	0	4	0	25	56	3	2	0	0	2	1	0	8	5	0	1	0	4	12	0	2	3	0	2	1	0	0	0	0	0	15	0	0	0	3	544	43	0	0	5	2	0	0	12	0	0	0	0	0	4	0	3	0	14	4	2	0	0	9	21	1	3	24	14	0	0	413	0	3	21	57	12	15	0	0	73	4	7	0	2	0	3	2	71	2	11	21	16	5	11	2	0	0	8	0	31	0	2	2	12	58	3	1	51	0	17	1	3	4	0	0	4	22	2	0	1	4	2	19	498	0	4	5	0	43	7	3	53	21	3	27	9	1	0	0	10	17	0	0	0	0	0	0	3	2	18	2	0	7	1	14	157	2	0	1	0	0	17	4	1	5	5	5	0	0	0	1	1	0	0	1	0	5	3	2	1	9	1	0	0	0	1	0	13	1	4	1	5	3	2	3	2	0	5	2	27	9	10	1	4	2	1	2	2	1	0	0	0	33	16	4	0	1	1	4	34	151	81	103	173	103	77	205	12	108	215	140	249	74	15	57	10	320	448	13	58	10	435	467	340	286	772	115	191	24	131	10	126	12	1	3	0	3	3	1	0	0	3	0	54	102	2	0	2	0	2	0	7	0	1	4	3	0	0	7	0	28	2	4	1	0	20	0	26	0	32	11	4	1	0	3	6	0	3	0	4	6	3	9	2	3	0	0	5	7	0	20	0	0	0	0	3	14	17	33	7	1	4	4	2	0	0	9	0	4	27	6	0	2	0	6	66	0	0	16	2	0	0	2	0	7	3	0	5	7	13	29	0	20	0	0	0	4	5	4	0	19	0	3	2	4	2	3	2	20	7	187	11	1	22	16	1	3	3	0	0	6	1	3	4	0	5	0	0	6	8	0	0	0	0	2	2	5	3	6	4	10	21	6	1	1	0	0	3	12	6	21	7	2	1	0	2	3	0	1	49	2	11	11	5	1	0	0	0	4	0	2	0	2	1	0	9	0	1	0	1	0	4	13	4	0	24	0	2	1	2	0	7	2	8	4	0	553	3	15	0	570	5	1	1	0	0	0	4	5	0	11	2	0	2	0	0	1	14	0	16	32	2	1	0	0	318	0	0	42	14	2	46	6	0	113	9	17	16	2	0	1	4	0	3	5	0	21	3	9	11	5	26	4	8	0	9	0	2	1	1	2	0	1	2	0	0	2	3	0	4	0	8	0	10	0	0	0	18	4	3	0	0	17	6	2	215	261	17	0	8	2	1	1	0	2	0	2	0	2	3	0	0	0	0	0	52	13	13	60	4	2	5	10	0	0	0	0	60	31	20	1	0	2	119	0	0	0	0	5	0	0	0	0	0	0	0	2	45	21	2	3	0	0	3	0	8	13	0	2	43	16	16	3	0	2	0	3	34	9	1	16	0	0	0	2	1	1	0	0	5	14	1	0	56	6	1	1	19	1	15	13	0	0	9	5	48	1	13	2	10	0	12	3	11	0	1	19	0	0	4	0	0	20	1	5	0	1	2	0	1	17	15	4	181	3	2	26	0	31	1	10	1	3	4	4	3	27	3	23	5	2	1	1	0	0	0	1	15	14	1	1	1	6	0	1	69	1	3	74	81	6	0	52	23	13	0	15	1	17	1	13	3	15	2	12	0	20	22	10	2	17	9	19	1	15	1	0	0	19	0	3	3	17	14	7	16	30	8	10	2	7	34	7	11	0	7	7	19	0	55	35	3	13	4	3	4	32	19	18	0	1	0	4	2	3	8	3	0	3	1	29	39	0	2	0	2	52	0	0	1	1	4	0	0	0	11	1	0	22	0	11	14	2	6	0	1	2	0	0	2	1	2	1	0	69	19	7	95	59	58	4	26	2	13	3	0	21	86	1	1	2	0	4	0	6	3	0	13	4	0	0	9	0	3	41	3	0	66	12	2	103	0	31	3	1	0	60	52	0	1	11	6	12	5	3	1	0	28	2	12	9	4	2	37	10	2	3	42	10	2	0	5	0	2	1	781	264	149	61	0	0	2	1	0	9	7	63	0	2	0	4	1	1	229	204	49	10	4	0	1	0	1	0	62	5	13	5	0	0	19	0	0	2	0	0	0	2	4	0	0	1	0	0	7	0	160	320	7	4	3	0	0	2	10	23	3	2	0	0	1	2	35	26	3	2	0	0	0	1	3	219	8	5	5	0	3	2	0	1	3	0	0	12	4	4	1	3	0	0	7	4	3	2496	2	3	9	7	6	0	8	0	1	1	1	0	0	0	0	6	0	12	0	0	0	4	0	3	0	0	0	0	0	0	3	2	0	5	3	0	0	2	0	2	0	10	2	1	1	0	0	0	0	0	2	0	2	0	6	1	1	2	1	27	0	0	0	3	1	0	79	0	14	0	2	2	1	128	3	1	0	1	5	21	20	28	21	0	33	0	2	45	4	8	104	2	0	14	0	0	0	1	0	0	0	1	8	3	0	1	0	0	1	0	0	0	0	0	0	10	7	0	0	0	0	1	0	0	3	0	2	1	1	0	6	2	1	4	2	12	0	3	0	1	0	25	2	29	0	25	57	3	13	35	0	1	0	4	0	4	0	1	10	49	1	6	4	19	1	3	1	0	1	0	1	2	0	11	3	14	1	6	20	22	4	19	2	13	2	1	0	0	8	0	0	5	3	0	6	5	0	12	9	0	60	3	180	24	0	0	9	0	0	0	0	28	13	8	0	1	0	3	0	0	47	768	0	82	0	0	0	7	0	0	0	7	0	0	0	7	12	0	6	12	31	11	0	0	2	2	10	0	4	2	37	5	12	7	0	3	0	2	0	8	11	10	0	0	0	0	24	2	0	0	21	0	4	4	119	8	0	13	0	2	0	1	108	0	0	0	35	1	8	0	3	0	3	8	320	0	1	8	3	0	0	1	4	1	2	1	10	0	4	0	1	1	0	345	10	1	1	2	0	0	0	99	0	5	0	3	0	2	9	2	0	0	2	3	3	0	1	4	2	0	0	10	14	1	1	1	36	0	0	0	1	0	0	3	1	2	0	0	7	6	18	0	0	0	8	29	0	6	1	2	3	0	1	2	0	0	0	3	0	0	12	2	10	2	1	3	3	0	3	1	1	0	1	0	3	3	4	0	5	2	2	0	3	0	0	1	12	0	1	2	73	0	3	4	0	0	0	0	0	0	0	0	0	1	0	0	0	0	9	4	4	0	1	0	7	2	8	1	0	16	2	0	0	0	60	2	0	0	17	0	1	2	0	2	7	1	0	96	2	2	0	3	0	23	0	0	0	175	40	0	5	16	2	0	0	0	0	2	2	8	0	5	0	0	26	1	0	30	0	1	0	6	13	0	1	0	698	0	2	1	0	4	5	6	1	3	0	6	0	5	95	1	4	0	0	2	3	0	0	10	4	9	0	0	1	0	0	192	1	4	2	0	0	5	6	0	0	28	1	3	0	0	0	3	0	0	0	1	0	0	6	0	0	0	0	0	2	6	0	5	0	5	0	2	0	7	3	0	8	0	18	6	0	0	4	5	0	15	0	0	0	3	0	2	0	2	0	0	69	0	0	0	0	0	0	1	2	5	0	2	0	0	0	0	0	4	0	0	0	4	0	0	0	2	0	1	0	0	0	5	0	3	0	0	0	0	0	0	0	9	37	0	2	83	8	3	0	2	0	45	0	0	3	4	0	0	2	2	0	14	3	1	1	19	0	0	0	139	109	7	6	3	9	167	0	84	6	1	4	13	0	2	1	0	5	0	0	0	0	2	0	17	1	2	0	0	3	0	4	0	0	20	34	6	0	1	0	3	0	2	0	1	0	0	0	0	2	1	0	2	2	2	0	65	0	182	4	12	5	0	5	3	3	0	0	0	85	10	0	2	2	0	2	0	4	0	0	0	0	2	0	6	0	0	11	0	0	4	0	0	3	45	0	0	4	0	6	0	0	1	0	10	4	0	0	4	24	0	6	10	4	3	0	2	0	0	2	4	3	0	110	4	0	22	0	1	25	0	5	36	0	0	3	1	2	1	1	3	0	0	1	1	0	0	4	0	4	11	0	1	94	0	54	1	2	0	0	0	0	43	0	7	2	1	0	2	4	3	0	14	8	0	0	0	0	2	5	0	0	6	0	7	1	0	0	0	24	0	0	0	5	0	0	6	4	6	0	0	0	0	2	0	0	0	1	1	2	0	5	3	23	0	10	1	10	3	23	0	6	0	0	0	0	2	0	0	1	0	3	19	25	0	392	2	35	0	1	0	6	12	0	0	4	3	0	0	0	2	3	3	24	0	19	0	0	1	0	0	0	0	1054	33	5	45	0	1	0	0	0	0	1	0	0	0	3	12	14	2	9	0	0	0	0	0	3	0	19	0	0	13	3	3	0	21	0	5	0	5	3	4	0	9	0	0	3	0	0	0	0	1	34	0	11	8	4	1	6	0	2	4	0	0	5	2	0	0	7	1	1	14	0	3	18	2	18	0	0	4	0	0	4	0	3	1	0	14	4	0	1	47	1	11	128	203	5	0	2	0	393	2	29	151	12	0	0	0	51	334	0	48	0	9	23	0	1506	0	2	1	1	2	0	0	26	34	1	26	2	6	21	0	21	12	105	0	71	27	3	11	5	22	3	2	14	2	7	0	0	0	0	2	0	26	8	8	0	2	12	10	0	4	1	0	5	3	1	0	8	0	2	1	0	7	3	0	6	40	6	0	24	44	15	0	2	21	13	16	7	0	0	7	23	0	0	1	1	8	25	86	0	0	6	0	0	5	0	13	4	2	0	1	0	3	0	33	19	0	3	0	5	2	0	2	13	7	0	19	1	1	5	0	0	1	5	31	36	8	4	4	1	22	0	4	0	1	2	19	5	5	14	1	2	0	16	0	10	5	0	35	6	8	6	0	8	2	9	27	2	0	48	0	0	0	2	73	3	1	1	85	62	239	12	24	48	52	447	2	110	51	66	12	140	377	201	2	276	47	113	72	83	12	99	26	260	6	22	2	64	0	1	0	0	0	7	3	2	0	0	0	0	35	2	0	3	0	0	0	58	1	6	4	19	1	1	3	5	0	2	61	1	9	20	2	5	0	0	1	0	81	0	2	0	5	1	0	0	461	16	0	0	4	8	3	0	49	7	12	7	109	5	15	0	0	14	0	8	327	0	21	1	18	0	3	0	4	0	0	0	3	0	0	0	0	0	0	6	20	0	0	0	0	60	0	0	0	3	69	1	0	17	5	2	0	2	0	0	11	0	2	2	191	2	4	14	0	3	3	19	14	9	52	44	4	3	0	0	1	3	3	2	0	2	24	0	13	0	9	146	0	1	9	3	1	0	0	113	1	20	6	5	4	0	0	0	0	26	0	2	72	3	11	11	3	5	5	4	0	0	16	0	0	0	2	2	0	1	0	1	0	0	0	2	0	1	44	9	1	0	12	2	0	0	0	0	5	0	13	152	1	0	2	1	61	22	9	2	35	5	1	3	66	2	21	1	0	12	0	42	6	0	0	0	18	0	0	2	6	2	1	3	5	2	38	0	4	0	70	0	0	0	0	4	0	0	3	24	3	0	19	8	0	2	0	0	3	5	75	2	14	2	0	9	2	26	1	19	5	82	8	1	13	3	9	34	26	0	9	0	0	4	1	9	0	5	35	2	3	1	24	36	2	10	6	0	0	0	0	0	12	0	10	1	1	0	0	0	1	0	5	33	0	2	3	35	54	19	10	0	49	7	4	1	0	49	3	0	5	3	4	10	26	11	18	1	0	3	18	4	8	2	0	0	0	1	2	0	8	43	0	23	3	6	0	0	0	0	5	61	8	10	0	10	0	14	1	30	9	0	1	18	1	1	0	7	5	0	0	0	0	0	10	12	0	31	1	120	4	0	0	0	2	0	0	1	0	2	4	0	8	0	21	19	1	5	0	0	87	53	24	11	1	1	3	1	0	0	0	6	10	2	1	75	17	0	4	1	1	0	13	0	31	35	7	52	11	37	45	17	2	2	6	1	4	32	13	2	12	1	11	23	0	0	0	12	17	2	38	26	9	24	22	22	25	0	0	0	0	35	0	4	0	20	0	1	4	0	0	1	0	1	3	0	0	6	1	15	2	12	0	2	0	0	0	0	126	0	0	0	4	1	6	18	5	1	0	0	1	1	0	28	3	6	0	0	3	8	23	15	93	4	0	0	180	0	2	27	0	5	0	0	0	4	0	0	6	2	0	7	32	0	0	1	2	0	59	0	9	2	0	0	0	1	15	2	2	19	2	0	4	10	9	25	0	1	216	5	0	4	25	0	5	0	0	6	2	3	12	1	7	15	8	19	9	8	4	5	5	11	23	6	50	13	0	10	0	17	1	0	0	0	0	0	18	6	11	0	0	0	5	8	0	2	3	0	39	2	11	0	3	267	0	10	0	0	2	18	11	1	11	3	0	5	16	4	34	15	0	112	5	1	13	37	0	7	4	0	2	0	65	10	9	2	12	2	0	1	211	14	0	0	0	0	11	0	49	0	0	28	5	3	3	2	0	2	6	0	4	0	0	2	0	0	0	2	0	0	47	0	0	1	0	0	0	0	0	0	0	0	0	0	0	0	0	0	0	0	0	0	0	93	0	0	3	1	0	6	4	1	48	0	0	15	0	0	7	11	3	6	0	0	2	4	0	0	2	0	3	0	3	9	6	1	0	6	13	1	0	5	2	0	43	0	0	69	1	0	16	0	20	0	1	10	4	2	2	8	5	0	0	0	1	0	5	1	8	1	0	26	1	1	95	0	1	2	0	1	9	0	0	26	0	34	0	0	0	6	0	24	2	0	0	0	133	2	0	0	0	0	1	0	0	2	0	8	2	0	0	0	5	0	44	40	0	0	1	4	0	0	0	3	4	0	0	0	0	1	0	0	4	0	0	1	4	81	0	0	0	0	20	0	0	0	0	16	0	2	12	0	0	0	0	0	0	0	4	0	0	3	10	0	2	0	5	0	0	1	140	0	0	10	0	3	2	0	0	0	4	9	0	1	0	0	6	24	27	0	0	2	0	0	15	0	16	10	2	0	1	1	6	0	22	0	43	18	26	2	0	0	0	1	1	1	4	31	1	1	12	2	0	2	0	72	38	65	10	21	3	0	0	6	4	58	12	2	0	6	32	28	18	78	2	33	47	0	82	0	3	3	61	14	0	33	4	1	1	21	20	2	0	3	91	14	10	14	6	1013	4	0	0	64	22	50	0	0	0	38	7	1	21	2	47	1	0	25	8	12	3	0	21	0	3	16	0	2	6	3	2	28	0	16	10	9	3	14	13	62	7	0	39	1	133	2	4	10	2	0	2	3	8	0	13	11	4	1	1	2	3	1	22	345	4	0	3	3	64	39	9	7	44	10	241	54	0	3	6	2	13	8	6	0	0	0	1	2	2	6	1	4	2	1	26	1	18	6	77	4	0	9	0	0	24	0	1	0	0	6	4	9	1	3	1	0	0	0	2	3	0	6	4	1	8	4	6	0	1	2	11	4	1	4	3	0	1	1	1	11	1	3	4	1	1	0	17	0	4	0	4	11	16	1	14	4	52	26	2	4	6	2	7	3	0	4	0	1	24	361	2	3	8	2	1	55	22	16	5	24	5	17	10	5	70	14	1	2	54	47	4	0	3	2	5	65	10	0	0	2	0	2	0	2	0	10	42	0	2	47	1	0	11	12	0	0	0	0	2	3	21	0	7	14	58	50	1	9	2	2	0	16	1	0	1	13	11	9	45	3	32	0	0	2	29	10	78	4	11	6	77	6	0	0	31	0	15	0	4	0	0	34	10	253	1	0	47	1	0	0	1	36	7	2	15	2	0	21	63	62	23	43	17	0	1	4	34	0	0	0	0	2	5	4	6	0	8	1	1	0	15	1	16	123	9	1	117	5	9	1	1	1	78	9	30	6	0	49	12	3	0	1	36	0	15	3	14	31	40	11	36	20	9	43	24	78	14	2	1	1	0	11	0	0	12	5	3	9	1	0	0	0	3	3	0	19	42	13	17	164	46	44	0	175	0	0	2	3	5	20	0	0	0	0	0	1	1	1	0	0	0	0	0	140	6	10	0	1	2	28	1	0	0	0	5	2	35	2	0	1	9	0	8	0	1	17	8	0	23	8	0	4	3	16	0	83	40	43	13	3	1	85	8	3	1	69	32	3	2	6	3	1	0	5	27	0	3	0	67	37	212	43	1	1	5	1	13	2	1	2	44	0	9	4	7	16	3	8	1	72	67	41	17	7	27	7	38	44	33	24	0	433	0	1	51	26	0	4	7	13	1	103	197	50	2	8	24	141	0	0	2	5	2	4	19	1	5	2	0	0	33	48	3	0	6	0	20	34	0	2	4	0	0	0	70	25	14	22	27	0	11	0	94	0	87	28	44	41	34	15	4	25	198	128	0	75	9	0	0	17	11	19	12	21	0	4	1	1	0	1	9	11	10	0	2	0	1	9	67	87	571	530	20	5	0	0	4	8	41	51	6	1	8	0	0	0	2	2	0	0	0	3	8	1	14	0	2	1	3	10	1	16	3	1	7	1	1	0	10	2	25	7	3	50	16	20	3	20	26	49	21	32	20	1	0	1	2	157	117	21	5	4	3	6	11	19	5	0	11	1	3	114	19	2	1	5	0	3	1	1	35	64	0	3	0	3	1	61	6	7	15	0	0	0	4	0	210	10	39	16	610	18	6	1	0	3	0	202	0	4932	0	15	0	9	12	50	54	0	0	0	0	0	0	0	4	30	19	20	2	0	2	0	0	3	0	0	16	0	2	188	0	0	3	0	2	14	0	8	2	5	10	0	1	0	0	0	0	0	2	0	26	4	7	4	0	7	2	1	5	1	6	0	0	0	0	4	2	26	0	29	5	1	15	0	5	4	2	4	65	4	0	4	3	7	1	1	5	59	4	0	80	8	1	3	1	3	0	13	0	160	17	3	23	226	0	1	2	2	35	0	72	29	36	6	0	11	0	3	15	5	0	41	0	0	0	2	936	1	5	13	18	5	9	0	3	1	0	0	3	3	1992	15	42	41	10	1051	3	6	63	13	25	20	412	250	256	28	175	73	53	1	0	124	52	51	43	19	5	0	2	1500	4	14	25	13	0	81	2	1	0	64	9	3	0	2	1	2	3	14	0	10	0	10	2	127	83	30	16	41	11	12	1	8	0	36	16	11	48	34	3	0	0	15	0	1	0	1	2	36	20	0	4	12	29	1	7	6	0	4	0	9	9	16	4	1	0	19	0	1	2	25	2	2	0	2	0	0	0	5	1	26	2	38	21	0	43	16	11	0	27	62	292	2	0	18	26	40	5	21	41	1	43	1	41	39	3	45	1	5	16	12	25	78	11	0	37	38	35	26	1	0	37	10	2	0	21	4	10	4	4	1	93	0	13	24	2	19	0	7	8	5	3	21	0	1	24	1	6	3	3	2	0	49	4	2	29	0	4	3	10	0	340	14	28	0	0	23	7	0	13	10	1	55	1	0	2	56	38	6	46	51	1	55	18	13	10	29	15	21	5	3	2	10	4	20	17	109	69	16	3	1	0	3	0	0	1	0	0	25	78	5	11	2	2	0	1	5	3	70	31	0	14	138	1	6	0	6	0	24	12	5	5	1	2	0	1	1	2	3	1	6	0	0	0	0	3	2	0	8	3	1	7	0	0	0	65	17	8	6	4	27	4	1	4	0	3	2	4	0	18	1	1	2	1	1	0	1	11	1	23	0	7	15	5	13	1	4	0	3	0	1	0	0	36	209	0	0	0	2	0	0	15	6	55	0	1	1	0	0	26	0	25	5	21	18	0	0	2	4	3	15	0	1	1	0	28	5	2	11	25	0	7	15	5	26	0	5	3	3	10	17	30	13	22	31	7	16	9	5	4	10	10	0	25	8	14	14	0	113	9	20	18	11	5	8	7	8	3	11	10	14	12	4	13	0	2	0	0	22	59	10	11	4	29	6	4	3	58	28	3	642	0	148	9	4	0	0	0	17	20	5	7	0	7	1	486	125	226	11	1	18	3	2	1	2	0	102	46	48	89	115	11	114	59	53	93	0	0	6	57	12	2	4	3	19	5	30	4	6	19	11	73	4	7	7	22	46	15	4	0	0	52	1	3	0	12	5	94	5	2	1	2	0	31	28	5	0	0	1	21	7	24	4	2	1	0	0	3	10	23	0	1	1	0	0	1	0	0	10	5	5	1	8	2	0	2	8	1	3	3	5	20	2	19	39	19	44	78	2	1	172	1	2	2	2	0	0	1	1	2	1	3	3	0	0	4	0	17	3	12	5	0	0	18	1	1	1	0	1	1	2	0	0	0	0	7	4	4	2	1	14	3	6	0	4	18	0	119	307	20	83	1	15	6	41	3	0	1	1	1	4	0	0	0	6	2	2	2	10	28	41	6	1	2	5	1	0	2	4	1	22	12	6	3	53	2	15	1	1	20	54	0	1	0	62	1	0	15	44	161	14	17	1	0	6	1	3	21	7	69	1	2	0	43	34	4	2	16	36	4	30	8	0	0	44	36	0	18	69	182	28	1	2	3	0	4	36	31	49	1	0	1	2	1	2	12	3	14	2	2	0	2	0	5	0	14	19	16	2	1	0	2	1	5	20	16	0	32	7	0	1	1	0	0	0	0	1	19	52	8	0	12	48	1	10	6	4	7	5	11	1	0	17	0	1	0	95	20	1	1	0	1	3	2	28	8	23	4	5	4	35	2	12	1	2	2	6	22	36	5	14	66	3	9	1	0	3	1	0	5	25	9	14	78	34	26	1	1	18	3	3	6	2	2	6	0	0	4	15	18	13	2	2	7	0	0	2	4	0	0	12	30	16	0	1	1	0	3	5	10	19	13	8	26	3	1	5	1	2	5	6	9	61	5	0	0	19	0	2	3	0	52	13	0	0	62	34	12	2	0	64	0	36	7	11	486	0	0	16	0	5	1	3	2	2	4	1	0	51	10	1	23	17	20	3	5	218	1	6	1	2	1	1	0	45	0	1	0	2	6	0	2	11	2	2	0	8	13	2	1	1	1	6	1	0	0	18	28	17	0	0	0	0	22	8	2	0	0	0	128	48	0	5	6	0	2	4	36237	0	0	1	2	1	2	1	9	0	3	0	1	0	0	2	0	13	0	1	3	0	27	11	88	27	1	6	16	12	4	2	0	1	0	1	1	4	28	66	1	77	2	1	2	0	0	0	2	3	7	0	1	17	1	61	17	28	131	126	62	46	20	0	21	11	0	51	0	2	141	18	74	38	1	12	0	9	16	20	2	323	72	31	9	324	0	0	0	0	26	3	11	10	0	83	15	1	329	15	23	2	65	71	5	0	107	28	10	7	3	1	0	4	1	3	1	4	0	78	115	34	102	132	7	206	26	2	27	29	92	88	139	18	22	48	28	61	62	0	71	50	21	12	12	0	0	8	64	38	106	131	4	1	38	1	2	69	39	6	11	0	1	1	0	0	0	3	0	0	0	6	2	2	14	4	9	1	43	2	2	0	28	0	2	1	3	44	48	19	18	5	1	3	15	3	7	23	26	1	14	0	4	3	18	20	20	44	1	9	2	0	1	23	22	1	1	12	10	2	0	0	0	1	1	0	0	1	12	3	9	2	6	18	9	19	0	4	9	4	0	0	10	9	3	38	0	17	2	0	1	71	43	0	6	23	6	113	13	0	9	21	1	3	9	0	0	2	0	2	4	0	2	5	0	2	1	4	2	1	0	1	7	0	15	2	2	1	1	27	3	0	51	0	22	5	2	12	1	0	0	1	2	2	4	0	1	0	13	0	10	1	2	24	1	20	6	1	3	3	0	40	2	2	11	4	4	30	50	2	78	1	3	15	217	3	10	31	11	3	6	7	6	32	0	4	17	5	14	19	12	14	0	3	0	8	1	0	4	4	3	0	0	4	24	14	21	0	0	0	0	4	0	4	2	7	0	0	2	1	5	8	85	22	3	59	2	41	27	5	18	8	15	2	18	22	21	33	7	55	0	3	33	4	40	2	2	2	1	1	6	2	0	32	0	4	26	43	7	0	1	0	34	11	3	6	2	8	0	0	22	0	2	0	9	0	43	5	5	0	23	4	1	7	12	9	17	16	13	23	27	2	4	0	0	0	0	5	90	350	123	22	18	14	88	22	3	2	19	19	15	13	1	0	6	2	24	0	10	2	9	0	1	5	26	5	2	11	0	12	3	13	0	18	4	46	0	31	46	17	23	20	4	12	14	2	1	9	3	7	1	11	3	131	2	19	0	4	0	3	4	4	4	9	3	2	0	0	1	0	2	0	0	3	0	8	76	0	0	15	0	9	7	45	1	2	6	19	22	13	3	0	11	0	0	3	3	0	1	0	0	2	1	1	0	0	7	2	6	0	112	0	12	29	105	30	3	42	0	0	1	1	0	0	0	0	6	0	3	0	4	0	0	1	0	64	27	1	0	0	2	6	4	0	1	1	0	1	5	3	0	0	68	0	1	4	18	0	16	5	0	31	4	6	4	40	5	4	20	13	17	277	53	16	30	36	344	74	52	353	0	0	29	18	6	10	2	29	43	0	0	0	0	0	0	291	0	7	5	0	291	3	1	0	3	12	17	2	52	3	3	11	0	3	2	1	7	2	0	0	2	17	54	0	1	4	4	277	94	0	2	0	4	1	0	0	2	40	3	0	1	2	3	11	16	40	6	9	3	0	54	28	6	0	48	8	1	59	12	8	8	14	1	4	3	37	17	24	1	8	1	6	0	0	227	11	5	10	7	19	67	0	0	13	100	15	8	337	3	2	4	3	3	1	0	145	33	12	2	0	2	1	11	2	20	1	22	1	13	1	3	16	1	4	4	17	11	12	13	3	1	20	90	1	2	5	3	0	7	54	2	3	3	0	8	0	1	13	2	5	4	7	6	0	0	0	1	19	6	5	1	0	16	12	22	0	0	12	7	4	26	0	0	64	3	2	0	0	1	5	8	12	14	33	8	46	64	20	13	80	11	89	150	186	0	0	0	1	8	1	11	1	0	254	6	0	8	27	53	44	4	9	13	0	11	7	28	2	2	38	20	1	2	6	0	6	0	0	158	159	98	7	0	0	0	0	5	6	0	6	0	14	3	22	8	2	1	0	0	0	0	0	3	3	3	1	2	5	2	2	0	0	2	2	0	1	0	0	0	0	0	4	205	1	3	0	0	2	0	0	2	0	1	0	3	10	0	0	0	16	1	28	0	0	12	15	2	15	2	8	1	4	0	5	0	1	25	18	18	44	28	7	8	5	18	2	8	33	24	0	0	0	4	6	2	12	4	4	18	1	10	6	1	29	8	4	7	17	1	1	99	22	0	33	4	0	3	8	0	0	43	9	42	9	59	12	47	13	7	97	11	19	0	6	2	5	2	34	34	124	70	0	51	29	61	5	56	0	7	5	19	2	0	3	55	7	4	1	1	3	0	61	2	2	0	0	4	0	11	5	25	34	8	15	0	4	17	4	49	41	14	32	17	14	89	19	71	0	7	2	1	1	3	1	10	9	40	5	19	13	0	0	11	2	0	0	1	0	1	6	0	1	1	4	10	3	5	141	127	4	49	111	50	2110	54	1	0	1	0	0	0	0	48	3	26	15	2	9	33	0	5	3	25	16	3	1	2	11	3	1	0	838	73	3	17	53	68	4	1	3	1	1	20	1	301	0	4	1875	0	2	1	33	0	43	1	1	0	4	2	0	0	2	1	2	3	27	0	0	0	0	0	5	0	0	2	8	0	1	6	45	0	4	1	0	7	2	5	0	1	9	2	2	20	1	107	212	1	25	14	40	34	18	33	12	0	33	1	19	4	0	2	0	1	0	1	0	3	0	2	13	2	2	3	4	2	3	0	1	7	16	4	16	0	0	0	2	10	1	0	6	0	0	4	19	1	4	26	11	0	2	1	1	1	0	0	0	4	1	8	18	12	14	1	20	43	63	14	56	3	0	0	3	0	0	1	6	22	0	198	0	11	5	26	3	55	36	0	0	2	0	5	4	0	0	0	5	2	0	0	3	0	0	0	0	0	2	6	0	0	0	0	3	3	2	4	0	2	0	0	3	2	4	1312	0	0	0	0	0	2	0	0	10	27	0	0	0	0	0	0	3	0	6	0	0	0	0	0	3	4	0	3	4	0	5	2	0	1	83	0	7	0	3	1	2	31	1	1	0	3	0	0	0	1	7	10	12	1	198	0	0	1	0	4	11	0	0	8	1	4	3	7	0	5	0	1	0	0	5	0	0	0	0	0	2	0	0	2	0	1	2	0	0	3	1	0	0	12	0	1	4	0	16	2	1	5	0	2	0	0	0	18	0	0	4	0	0	0	9	0	0	0	0	6	0	0	0	0	2	0	0	0	3	0	0	6	44	0	3	0	43	0	0	2	0	0	0	0	50	0	2	0	0	0	6	0	1	1	2	0	0	2	4	1	0	8	0	32	0	0	2	0	4	0	2	2	5	0	12	0	0	62	0	14	0	1	6	0	12	0	27	0	0	16	86	0	14	1	2	169	1	43	0	0	0	0	0	0	6	2	3	4	4	0	9	2	706	6	18	0	36	2	0	5	2	1	0	5	0	0	0	6	3	8	0	2	1	5	30	0	1	7	6	0	5	5	2	9	9	8	0	1	1	1	3	0	71	8	12	1	4	18	16	6	3	0	2	57	9	28	14	4	4	2	2	14	9	5	4	4	9	16	1	1	54	6	3	8	0	3	0	81	0	14	23	12	0	1	5	16	11	23	6	2	0	1	8	7	14	0	13	3	39	79	38	7	88	373	79	27	0	0	2	101	0	7	0	2	3	16	2	2	0	0	25	0	26	0	1	0	2	0	3	1	337	18	21	0	4	3	0	0	9	5	70	7	54	58	2	7	4	20	3	3	1	1	0	0	1	0	0	0	8	24	4	17	2	15	4	3	0	0	6	0	0	2	0	6	6	41	0	4	0	3	0	8	3	5	0	0	3	9	15	1	1	15	4	3	0	11	0	10	1	8	73	2	0	0	3	0	0	5	0	0	1	6	0	3	2	3	27	0	39	1	2	0	3	1	0	4	6	3	3	1	0	2	0	1	3	26	1	144	2	12	0	4	0	143	5	2	1	3	321	1	23	2	4	1	0	6	4	4	1	10	3	1	8	0	1	0	21	3	3	0	5	67	12	4	42	87	4	3	1	6	2	11	18	0	1013	0	10	3	37	0	1	5	8	25	96	35	0	0	0	1	97	0	7	0	1	12	20	3	225	0	40	31	13	0	1	0	2	0	0	4	7	9	0	1	2	14	5	4	0	4	6	0	1	27	22	3	0	28	4	2	2	6	3	0	16	17	32	40	43	39	4	29	27	9	0	48	13	29	60	2	39	31	11	1	13	1	0	0	7	70	16	0	0	1	0	53	49	3	1	0	46	0	1	2	0	0	9	5	0	62	14	31	7	0	110	2	0	1	21	0	3	56	8	5	0	18	4	19	2	4	4	0	1	0	14	1	1	4	5	16	3	19	0	13	0	33	60	14	26	29	13	1	2	7	14	6	121	34	1	16	0	0	0	0	0	0	2	8	0	0	0	10	3	0	12	28	10	0	9	1	13	26	13	35	1	6	0	19	5	38	2	14	4	5	2	0	6	220	27	98	62	47	4	2	0	0	2	0	4	4	3	4	9	91	38	78	2	28	1	0	21	21	14	2	2	0	0	3	19	29	19	23	47	5	15	0	387	0	15	2	22	15	1	24	23	27	43	1	4	23	80	39	11	0	0	3	3	2	4	47	1	0	159	0	6	4	3	2	19	0	101	34	8	0	0	9	1	21	1	0	5	7	12	6	57	0	2	0	38	34	4	107	2	17	3	6	0	7	1	36	0	6	1	20	2	4	0	13	3	8	55	30	15	89	0	0	0	20	80	2	0	3	6	0	53	1	1	6	0	1	0	4	6	37	7	0	23	2	17	14	1	0	0	0	1	1	0	74	4	2	0	25	0	1	0	0	17	40	4	11	0	2	2	2	5	0	68	20	0	3	1	1	8	5	0	1	12	15	9	0	2	40	73	17	4	1	18	4	0	3	1	0	0	0	2	9	0	21	4	111	12	11	75	12	39	270	25	30	44	136	158	5	82	21	60	87	45	57	43	0	3	8	10	7	6	0	3	11	4	4	6	28	1	2	0	10	0	0	2	3	3	2	2	1	14	4	13	15	16	4	0	0	0	0	0	0	0	4	0	0	0	0	2	2	1	2	0	5	0	0	0	0	2	0	0	4	16	13	1	0	1	0	0	1	0	0	0	0	0	1	0	1	0	0	2	0	1	2	0	0	2	0	13	293	2	50	10	5	1	25	2	1	2	52	16	56	13	6	5	33	2	0	9	2	3	17	0	0	0	4	0	0	2	50	221	13	61	6	50	0	6	4	25	10	20	3	1	0	0	6	2	0	2	2	3	4	7	0	2	4	9	3	29	4	51	12	21	3	34	56	42	1	38	46	19	1	4	0	0	0	1	7	52	6	2	0	4	1	0	0	16	8	21	0	1	56	50	2	44	0	66	0	1	1	0	24	4	2	0	202	0	2	11	0	5	681	0	1	4	2	12	8	20	1	4	49	0	0	5	23	2	19	20	4	0	14	77	0	2	1	7	0	9	2	4	1	1	11	8	25	112	2	1	0	9	8	16	0	3	4	21	53	10	46	19	20	3	18	13	0	16	2	7	17	14	3	0	0	23	0	6	3	53	10	0	2	4	3	2	1	0	0	11	5	8	2	3	2	0	5	2	5	7	7	1	0	1	4	38	10	2	0	0	0	0	5	6	21	0	9	1	2	0	0	2	14	29	8	12	44	0	31	0	2	235	32	245	17	30	1	8	465	120	0	37	101	4	0	0	8	51	12	4	0	23	3	41	53	10	5	4	5	2	1	17	22	13	2	1	39	51	49	7	0	0	0	0	0	3	49	0	3	6	6	0	0	0	0	4	2	4	6	350	7	104	16	6	0	68	8	10	0	0	0	0	0	19	0	4	0	4	0	28	2	18	20	18	6	62	23	575	40	11	0	0	16	27	0	206	50	51	77	17	132	0	67	81	4	0	14	0	4	9	20	21	738	194	22	0	171	0	11	0	0	48	0	4	0	7	2	0	0	158	229	1	1	0	238	70	31	44	4	10	28	18	82	1	12	14	0	0	27	14	34	5	6	1	15	0	2	1	12	19	0	0	2	1	6	7	5	3	0	2	0	0	3	0	158	14	1	9	4	70	18	17	1	2	3	13	43	7	4	0	1	17	31	11	10	66	0	40	15	0	1	15	67	2	27	5	2	1	18	35	63	33	97	131	82	4	2	4	270	10	65	77	2	0	0	3	2	0	0	0	13	0	9	9	16	0	2	0	0	0	0	0	22	2	4	21	19	38	66	2	1	10	1	20	0	2	8	0	12	0	1	3	29	8	19	68	37	24	355	6	14	1	1	0	2	0	8	0	0	0	5	4	14	1	2	1	0	0	2	23	0	0	0	9	1	7	11	0	3	8	9	7	1	12	0	39	0	0	15	1	2	15	1	0	0	0	0	23	0	1	1	2	2	1	14	20	9	23	0	16	10	25	0	10	3	23	0	19	58	0	10	9	2	10	6	0	0	20	33	1287	72	84	71	1	83	30	23	30	31	14	18	2	9	54	0	0	1	9	1	6	0	15	4	36	4	6	5	20	0	4	2	11	18	0	0	0	0	6	1	0	2	1	0	3	1	2	0	1	0	2	1	7	1	0	0	2	0	2	1	1	0	0	40	5	0	79	1	49	60	13	37	3	2	0	14	3	7	16	2	2	9	0	0	45	21	4	2	6	2	6	20	2	12	17	57	0	2	2	0	6	1	13	4	3	0	9	1	3	3	24	8	5	0	51	0	24	16	7	3	0	0	9	5	6	80	20	6	0	14	7	26	1	29	7	9	4	10	1	26	0	42	10	0	1	7	0	56	0	0	2	9	8	4	0	21	7	4	25	4	16	40	5	4	3	0	2	0	0	3	1	6	64	18	12	26	83	2	1	0	4	0	10	3	0	19	0	4	11	6	5
LakWasMeta4_LOW4_2_rpkm	0	2	1	0	0	39	16	1	0	5	4	15	5	9	3	1	4	12	29	0	2	3	4	146	0	0	0	0	0	35	0	4	0	21	1	38	8	2	59	1	0	0	0	9	60	144	124	104	0	6	9	14	0	1	0	18	0	45	96	50	124	2	1	61	19	0	0	0	14	110	7	2	2	2	9	0	3	4	1	3	0	21	2	0	4	4	2	0	11	3	1	6	48	6	39	6	10	0	7	0	0	0	1	0	0	1	0	1	0	2	6	0	92	16	66	7	2	5	0	0	0	1	0	22	0	4	7	0	0	2	0	106	22	4	0	0	10	0	20	0	0	2	0	34	0	0	0	6	64	4	13	162	5	9	254	0	28	30	33	0	24	8	4	93	11	18	0	18	2	46	3	1	0	0	5	0	0	0	0	1	2	4	0	2	0	190	0	0	0	4	37	3	44	4	4	1	4	10	14	967	71	4	18	2	0	5	43	0	29	7	7	3	48	13	50	0	11	4	0	16	6	8	27	13	8	6	0	10	12	0	2	3	484	1	1	1	68	22	38	3	1	2	42	10	145	9	0	0	12	76	16	34	39	11	3139	514	0	4	1	3	12	9	12	75	3	0	8	12	9	155	54	0	76	0	0	7	0	2	83	12	10	65	49	29	81	3	0	0	133	2	8	4	0	2	36	0	2	8	26	0	0	90	140	4	38	4	61	57	64	2	40	0	108	217	0	2	0	0	134	0	2	0	0	20	183	2473	0	3	8	0	14	5	3	0	1	8	12	5	8	0	0	19	7	47	39	5	69	10	1	2	2	6	2	0	16	1	0	0	0	127	10	1	20	0	1	50	25	110	15	22	2	42	0	0	61	0	3	16	7	11	5	1	12	16	15	0	226	1	0	0	2	0	55	1	0	25	27	0	0	46	2	16	6	22	99	0	16	0	0	11	0	49	87	13	0	50	62	42	11	1	0	2	1	2	0	0	0	2	7	4	0	0	17	2	3	7	3	4	33	2	134	20	0	3	11	109	1	0	0	6	0	211	30	620	4	46	102	10	2	10	4	14	0	21	4	97	6	0	1	5	22	67	41	13	4	0	35	7	37	3	12	0	36	7	1	3	0	100	71	16	3	4	166	138	11	0	12	1	4	0	2	6	14	2	0	0	1	7	2	4	0	2	3	3	6	4	56	0	16	14	0	0	0	3	0	0	0	0	0	0	5	0	0	5	18	2	38	3	0	59	1	16	15	30	164	0	0	0	3	0	0	3	0	0	0	12	2	0	3	0	0	2	3	6	10	0	74	2	36	2	3	4	0	33	17	19	49	168	10	85	31	384	117	8	164	17	8	14	100	1	0	1	1809	3	22	20	6	1	1	0	93	2	0	3	45	37	1	160	1	0	0	439	100	206	11	1	256	6	421	18	149	72	23	26	2	31	5	27	2	5	24	27	1	2	6	1	0	1	6	13	3	71	0	2	0	8	1	17	38	1	36	1	18	17	11	1	9	0	5	12	2	340	3	5	0	0	0	2	45	36	0	59	4	1	0	0	4	4	3	1	9	3	24	3	3	3	4	2	3	64	7	4	19	0	379	0	1	11	3	28	0	65	0	12	51	0	23	0	76	0	7	0	0	0	91	43	0	6	62	8	1	4	22	22	6	1	0	3	44	0	0	1	4	0	2	1	0	3	0	19	1	103	40	4	71	84	10	0	0	58	3	0	0	0	0	7	11	0	46	26	0	5	0	298	2	2	4	0	5	6	0	0	0	0	0	85	1	1	0	1	0	0	11	2	0	4	3	0	0	32	8	32	2	1	0	2	37	8	2	60	2	2	1	0	37	15	315	1	0	0	3	1	4	0	5	0	0	0	7	0	3	0	0	8	4	0	4	26	8	0	10	2	1	1	0	0	10	75	64	1	0	2	0	0	2	0	0	2	69	17	0	0	12	0	0	0	7	10	2	35	103	51	48	9	0	18	2	0	16	3	0	3	4	2	0	1	6	7	56	14	0	0	3	20	12	14	5	1	6	0	0	0	0	0	5	0	1	4	0	0	2	0	8	7	5	3	3	2	0	0	2	0	2	2	97	35	55	69	42	3	0	1	1	3	1	1	0	0	0	2	40	5	0	0	3	0	1	0	0	3	0	6	0	36	31	0	6	22	2	0	4	8	0	3	7	0	1	1	7	0	0	1	4	2	4	8	0	0	2	4	2	6	13	566	22	57	3	2	0	0	31	27	71	0	102	0	0	1	1	0	3	5	0	2	12	1	2	9	0	3	2	24	2	0	0	0	2	0	2	5	0	9	0	0	2	0	1	198	0	2	0	120	19	3	13	24	0	0	777	8	10	2	2	0	2	3	4	2	17	0	0	5	3	0	0	0	0	13	0	0	3	0	2	25	13	0	2	1	0	7	1	14	0	3578	2	0	1	0	32	13	22	0	11	8	28	2	25	22	8	11	1	5	2	0	1	0	0	0	5	371	16	0	0	1	0	6	12	4	0	6	0	0	2	1	12	56	29	3	2	25	0	17	0	0	9	1	3	23	2	2	4	7	3	1	0	2	3	42	72	3	0	0	0	0	0	17	3	1	1	0	2	0	2	0	2	0	0	0	0	0	2	1	0	0	3	0	0	4	0	5	0	0	4	0	0	0	0	2	0	0	13	22	0	0	6	3	3	0	20	0	0	3	23	3	2	2	0	20	0	1	0	22	7	8	44	180	3	0	0	35	33	3	0	6	8	33	38	17	0	0	0	1	4	0	4	0	14	52	0	3	0	0	88	4	0	0	1	0	22	7	6	2	5	0	10	0	0	56	5	0	124	6	473	11	0	4	4	4	0	1	20	0	5	124	301	0	0	0	15	4	20	0	0	46	0	9	2	0	2	0	0	32	43	16	6	142	17	23	3	28	1	4	8	6	0	25	1	0	16	1	1	8	0	0	0	22	0	1	12	3	5	0	1	0	0	5	4	9	2	21	3	17	0	1	0	0	4	0	3	2	1	0	32	4	3	0	7	9	15	0	0	2	3	23	18	3	109	23	60	19	0	8	18	1	1	10	6	6	4	31	0	0	6	1	2	1	47	46	0	2	0	0	2	6	27	0	37	8	8	54	0	4	67	16	6	26	33	4	8	0	0	0	7	0	27	1	12	23	11	69	73	30	80	4	0	13	152	75	0	7	1	9	1	25	47	7	14	2	3	13	6	40	58	34	2	2	24	3	0	0	0	0	7	28	25	1	0	2	144	6	33	123	10	0	78	0	19	19	0	9	0	6	3	19	2	0	0	0	2	0	3	1	0	4523	120	38	219	3	0	6	0	4	0	2	12	102	110	8	38	69	4	3	2	118	435	170	48	41	5	22	0	150	1	0	4	5	3	0	0	3	182	48	46	72	127	44	0	42	157	21	3	1	1	1	0	0	64	8	10	0	0	55	0	33	1	6	1	7	0	27	0	7	0	0	2	7	17	0	2	2	6	20	0	5	14	89	0	0	0	0	3	14	2	3	0	4	0	0	8	4	0	0	9	0	2	0	0	0	4	20	4	7	2	45	5	0	0	0	0	0	1	0	0	0	0	82	1	11	1	2	0	0	8	0	7	0	9	151	6	0	23	0	11	4	0	260	1	11	36	3	2	507	6	121	7	0	1	2	14	0	122	0	57	2	0	2	3	2	68	0	0	7	58	2	0	0	36	10	3	2	2	0	0	0	0	4	0	29	5	163	14	12	0	1	21	10	1	0	0	21	7	0	0	8	8	6	1	18	88	8	46	10	26	33	60	0	5	22	3	0	20	63	0	31	8	22	0	0	32	0	0	0	2	11	1	0	8	15	58	49	138	172	200	6	197	31	0	0	0	10	3	19	0	3	2	9	151	0	0	1	7	1	2	1	1	28	75	0	83	32	0	8	0	25	0	82	4	0	65	6	9	0	2	0	0	21	5	406	0	2	21	26	0	2	150	0	19	319	27	2	14	6	28	2	0	94	114	126	26	202	0	19	0	49	3	710	0	0	0	25	0	0	163	5	6	3	4	17	0	7	8	5	95	37	0	0	0	5	0	13	0	5	0	4	0	0	10	4	20	0	0	0	6	0	52	5	3	95	104	67	0	841	4	0	4	0	3	1	1	2	30	0	0	1	1	19	5	2	7	226	4	0	0	4	0	0	65	14	2	172	9	21	0	2	40	11	32	0	0	6	6	0	10	11	5	2	40	0	5	0	0	18	2	1	63	2	1	30	14	4	9	7	58	393	6	71	0	173	219	0	79	7	114	21	44	26	17	11	26	6	4	106	2	0	0	2	5	0	1	0	0	15	0	17	2	0	14	11	6	25	0	42	126	0	2	2	0	2	2	4	2	1	0	0	0	2	4	0	0	2	25	22	48	10	10	1	8	0	6	37	24	0	0	0	32	1	13	0	0	0	0	0	3	0	1	2	3	0	0	19	0	0	4	8	0	0	0	0	2	0	0	0	260	16	61	27	31	3	18	0	56	3	7	213	530	25	0	4	2	0	0	0	0	0	0	35	2	2	65	29	4	0	0	5	0	0	0	0	3	6	11	0	6	4	2	4	26	16	0	164	18	0	4	0	36	20	63	2	11	0	0	2	0	0	1	0	3	0	6	3	3	0	0	0	7	1	0	4	0	0	8	13	0	2	0	0	2	3	5	0	2	0	26	143	4	6	3	0	3	0	0	0	0	0	0	74	0	0	0	0	0	39	7	0	16	0	22	0	28	0	0	27	8	1	3	91	2	1	2	0	0	0	0	1	30	0	0	23	0	1	0	0	4	57	0	2	8	65	3	82	91	89	3	0	9	0	1	0	24	0	74	47	0	19	0	6	6	13	0	17	1	0	0	0	5	2	2	4	9	0	0	4	0	0	0	0	0	23	0	0	9	5	41	41	0	0	4	6	0	0	8	0	0	0	0	0	0	1	2	0	19	3	1	0	0	0	33	2	5	46	12	0	5	701	0	0	160	325	8	43	3	0	45	5	7	0	0	0	4	3	153	4	18	21	26	3	0	0	2	0	15	0	33	0	4	2	18	100	1	2	70	0	11	0	6	18	2	0	2	12	2	0	0	2	4	31	29	0	6	4	1	39	2	0	121	39	1	39	8	1	0	0	12	24	1	0	7	0	0	3	4	0	17	8	2	5	2	7	188	3	3	0	1	0	21	1	0	8	0	8	0	0	0	0	1	2	1	1	6	4	1	6	0	9	2	0	0	2	0	0	7	0	0	0	10	5	0	2	9	0	17	0	26	6	28	1	8	4	0	6	6	0	1	0	0	56	30	5	0	1	0	6	51	200	150	127	320	192	183	434	45	227	296	195	413	142	15	139	42	414	537	22	87	0	674	653	353	362	1387	282	292	49	234	21	218	6	0	8	3	2	0	0	6	0	3	0	53	210	14	1	7	0	0	2	3	0	2	0	0	0	0	21	0	30	0	4	6	0	39	0	64	0	275	8	1	3	7	0	8	3	0	0	9	10	1	0	2	1	0	0	5	2	0	32	2	0	0	0	2	16	24	106	8	2	5	11	0	0	0	13	0	4	18	8	2	1	2	2	96	1	0	9	1	0	0	0	1	5	4	2	5	2	19	38	0	22	0	0	2	9	6	4	2	20	0	4	0	2	1	7	3	21	3	253	8	2	25	25	0	1	3	1	1	8	2	8	4	0	8	1	0	37	27	0	0	2	0	0	0	2	3	5	0	8	20	8	0	0	4	0	3	16	0	61	0	3	0	0	0	6	0	2	92	0	22	18	5	5	0	0	0	4	0	0	3	1	2	4	0	0	2	0	0	0	0	20	2	0	23	0	2	0	0	0	7	8	6	0	1	278	0	19	0	1750	10	0	2	0	0	3	3	0	3	8	3	0	0	0	0	0	23	0	140	212	0	2	1	0	34	0	0	49	11	0	49	2	0	179	4	21	14	4	0	0	0	1	2	2	0	21	6	14	2	6	17	0	5	2	1	3	2	5	10	0	0	0	10	0	2	0	3	0	1	0	10	0	6	4	4	0	44	2	4	1	0	22	11	4	294	449	4	2	41	0	1	3	0	2	0	0	1	0	2	6	3	0	0	0	75	8	15	11	7	3	4	13	0	2	23	1	100	43	19	3	4	0	115	0	0	0	3	4	1	1	0	2	1	0	0	1	123	40	0	4	0	0	2	0	6	15	0	4	66	18	21	4	3	14	2	6	62	5	1	12	1	0	2	0	0	0	0	0	4	21	4	0	127	10	8	0	22	1	14	8	5	0	13	7	168	2	33	2	15	0	18	3	20	1	0	53	0	0	12	0	6	24	5	35	0	2	0	0	3	23	10	0	544	1	4	45	0	62	5	30	5	3	13	6	3	60	7	53	8	5	1	1	2	0	0	14	5	15	0	1	2	0	2	0	178	0	12	124	89	22	0	68	52	16	0	22	3	29	0	53	2	26	6	9	2	36	38	5	5	21	7	28	3	27	0	0	0	61	0	16	0	33	40	15	22	46	15	15	6	0	33	10	16	1	30	4	13	2	77	37	4	13	3	16	4	40	33	28	1	2	0	1	0	13	18	3	1	0	0	29	33	3	2	0	28	70	0	1	2	0	0	0	0	0	22	1	0	35	0	23	26	2	3	0	0	2	0	0	0	4	5	6	0	250	8	6	133	89	98	0	45	2	13	0	3	3	389	0	0	3	0	2	5	0	12	0	18	2	1	0	5	0	0	87	2	0	68	12	0	490	0	94	0	3	0	93	94	0	2	2	6	10	7	1	5	0	16	1	29	9	4	5	85	8	0	2	75	15	1	0	20	5	0	2	1766	287	348	65	0	0	0	3	0	3	3	237	0	3	0	5	3	1	120	782	85	6	2	0	1	0	3	0	84	6	7	0	1	0	7	0	3	3	0	0	8	0	0	3	1	0	0	0	10	0	292	882	8	7	1	0	0	0	3	21	3	5	0	0	0	0	84	22	0	3	3	0	0	4	2	230	20	5	8	0	12	5	3	4	19	3	0	16	5	2	2	0	0	0	4	4	0	2356	6	2	8	5	19	0	14	0	0	1	0	0	0	0	0	0	1	49	0	0	0	3	0	15	0	1	0	0	0	1	4	0	2	0	0	0	0	1	2	1	0	0	0	0	5	0	0	0	1	0	0	0	1	0	5	0	2	2	1	30	2	0	0	10	2	0	288	0	0	0	1	3	0	1134	6	0	0	4	12	14	15	102	31	6	12	2	0	73	3	2	173	0	1	19	0	2	3	0	6	0	0	3	22	1	0	0	1	1	1	0	0	0	0	0	0	0	9	0	0	0	2	0	1	0	9	3	1	4	2	7	2	0	0	5	3	14	0	0	0	0	0	30	7	14	0	18	101	16	20	70	0	0	0	0	1	10	2	2	27	94	1	8	3	39	2	2	0	0	0	2	0	1	0	4	4	16	0	8	89	21	3	50	1	23	0	0	0	0	5	0	1	4	7	0	0	8	9	7	6	3	40	0	242	60	0	1	2	4	0	1	0	35	14	11	4	1	0	0	0	1	194	1767	0	76	0	1	4	7	0	0	0	8	0	3	0	13	12	0	4	10	42	36	0	0	7	0	7	6	5	2	87	6	36	2	0	4	5	0	0	6	4	9	0	0	0	0	23	2	0	0	23	0	6	2	5	6	0	28	0	13	2	2	173	14	0	0	61	1	0	1	6	0	0	3	619	0	1	10	13	4	0	6	0	0	0	6	16	0	0	0	3	0	0	491	12	0	0	0	0	0	0	143	3	0	0	0	4	6	12	0	0	0	7	2	11	0	2	9	3	0	0	2	6	0	0	0	13	0	2	2	13	5	3	2	1	0	5	0	17	9	10	4	4	0	4	36	0	16	1	0	4	0	0	7	0	0	2	2	0	2	3	0	9	3	0	3	6	0	32	0	0	0	0	1	5	4	4	3	10	0	0	0	0	4	0	6	24	3	0	4	100	4	1	7	2	0	0	5	4	0	0	0	0	2	0	0	0	0	25	22	0	0	1	0	3	0	0	0	2	0	0	3	10	0	41	3	0	0	24	7	1	9	0	5	2	5	0	46	3	2	0	7	0	71	0	0	0	185	77	0	7	26	8	1	2	0	0	0	0	2	0	4	0	1	42	0	2	38	0	0	2	7	9	0	0	4	1921	2	0	0	0	9	0	6	2	5	2	0	0	0	191	0	36	0	0	0	9	0	2	10	2	40	0	11	2	0	0	98	4	0	0	0	0	13	6	0	0	30	0	4	0	0	0	3	0	0	0	6	0	3	0	0	0	0	1	2	0	0	0	14	0	0	0	0	0	2	5	0	4	0	6	8	0	0	5	0	0	10	3	0	0	2	7	1	9	0	0	2	4	0	0	0	0	0	11	0	0	0	0	2	0	0	0	6	4	0	0	0	0	0	0	0	0	0	0	0	0	0	0	7	0	4	4	0	2	4	0	0	0	7	164	0	10	293	0	4	12	3	0	23	3	0	19	6	6	0	6	0	14	17	9	0	4	9	0	0	0	224	181	5	6	1	20	241	0	40	0	0	7	11	12	0	3	0	0	2	0	0	4	5	0	115	0	0	0	7	4	4	0	11	0	6	19	2	0	3	0	0	0	2	0	3	0	0	0	13	0	0	0	5	0	7	2	170	0	412	2	9	0	4	3	4	0	0	0	0	358	4	0	0	0	2	4	0	3	0	0	0	0	6	0	0	0	0	9	0	0	6	2	0	6	89	0	5	0	9	16	0	0	0	0	0	5	0	0	9	525	0	3	13	5	0	0	13	0	8	0	6	10	0	167	417	3	7	0	2	72	0	5	207	0	0	13	0	16	4	1	4	3	0	0	2	0	0	28	0	20	8	0	2	53	0	6	1	0	4	0	0	0	187	0	5	0	5	0	0	6	5	1	12	14	2	0	0	2	0	0	0	0	0	1	9	0	0	0	2	74	4	0	0	2	0	0	3	6	2	0	4	0	0	2	2	0	0	1	2	4	0	7	0	15	0	11	1	0	0	60	0	3	0	0	0	3	2	2	0	3	0	0	24	30	0	52	6	22	3	0	0	2	24	7	2	4	2	0	0	0	4	0	4	154	0	17	2	7	2	0	4	0	1	4	25	6	119	0	0	0	0	0	2	0	0	1	0	0	25	13	0	11	0	0	2	0	0	1	0	42	2	2	3	9	4	0	10	0	5	0	7	6	0	0	19	0	0	0	0	8	0	0	0	69	0	4	0	6	1	2	3	0	2	0	0	5	0	0	0	0	0	2	17	0	0	20	16	18	11	0	11	0	0	3	2	12	2	0	36	17	3	0	54	4	9	103	313	80	0	2	0	715	5	32	173	23	2	0	0	55	540	0	98	0	15	39	0	1794	0	0	0	0	1	0	0	35	54	4	30	0	18	34	3	47	11	176	3	42	19	7	10	0	21	2	0	75	0	20	0	0	0	3	0	1	52	6	2	0	3	8	36	0	3	6	0	6	3	1	0	4	0	0	0	2	2	2	0	4	30	4	3	19	51	9	0	3	19	21	34	5	0	0	5	376	1	3	1	1	0	42	160	0	6	17	3	0	7	0	13	15	0	0	0	0	0	0	44	30	0	8	0	7	1	0	6	4	10	2	24	0	0	12	0	0	0	16	9	74	0	9	3	1	31	0	7	0	3	4	38	5	9	14	2	0	0	45	0	0	8	1	98	9	6	5	0	25	3	34	37	2	2	251	0	0	0	3	109	7	0	1	231	674	495	8	36	73	34	677	24	156	100	111	23	365	750	288	0	196	71	202	102	174	10	238	38	295	5	40	0	89	3	0	0	0	5	5	4	2	0	5	3	4	40	6	0	2	3	0	2	305	3	6	16	26	6	4	4	9	0	0	11	0	13	39	1	2	0	0	4	6	138	2	2	0	1	4	0	8	286	30	0	0	2	6	0	2	56	5	18	5	177	6	0	0	0	16	0	16	548	2	49	2	32	0	3	0	8	0	0	9	7	0	0	2	0	0	0	4	25	0	0	2	0	51	2	0	0	4	61	4	0	13	3	0	0	7	0	0	25	6	3	2	7	0	13	14	0	3	5	21	9	24	333	39	1	7	0	1	2	12	2	0	0	3	23	0	15	1	28	136	3	1	8	6	1	1	0	86	3	53	3	4	3	0	0	1	0	64	0	0	90	12	0	20	6	4	4	6	0	0	31	0	0	11	0	0	0	0	0	1	1	0	0	0	0	37	43	2	14	0	20	3	0	0	3	0	0	0	30	404	0	0	0	3	79	5	13	9	47	8	1	2	172	3	108	0	0	5	0	41	11	0	0	0	20	0	2	2	0	7	0	0	7	5	43	2	2	0	134	0	0	0	0	6	0	0	18	46	2	5	22	2	2	0	0	0	2	11	59	0	41	24	0	9	7	37	2	8	8	22	0	0	10	4	7	70	33	0	10	0	0	9	2	16	0	10	58	0	6	7	13	49	1	8	12	3	0	6	0	0	4	0	9	0	0	0	0	0	3	0	0	26	0	3	4	97	21	26	12	0	71	12	3	0	0	209	2	0	0	0	2	20	43	7	26	0	0	6	6	9	12	1	0	0	2	6	3	0	47	60	0	20	0	2	0	0	0	0	5	240	7	16	0	9	2	0	0	19	9	0	0	24	0	0	0	12	10	0	0	3	0	0	15	42	1	33	1	0	0	0	0	0	0	0	2	0	0	4	2	1	16	0	30	29	6	6	0	0	270	63	51	6	0	0	8	3	0	0	0	3	7	2	1	94	7	0	9	3	3	1	15	1	14	40	6	58	20	39	62	13	4	1	2	0	2	57	7	5	32	14	52	24	0	0	4	9	44	10	82	63	8	57	24	31	74	2	1	0	0	59	0	17	0	11	0	2	17	6	5	2	0	2	0	0	0	8	0	33	12	8	0	2	0	2	0	0	221	35	0	0	0	0	28	37	18	4	23	9	0	2	1	25	0	0	0	0	0	4	96	14	356	0	0	0	95	0	0	35	4	2	2	0	0	4	0	1	1	7	0	0	72	0	4	2	0	0	50	13	10	3	0	0	0	0	21	14	3	15	0	0	2	8	45	79	0	2	246	8	7	9	48	2	3	0	0	5	3	0	18	2	3	44	19	15	2	12	1	6	3	0	226	2	101	16	0	8	3	21	4	4	4	0	2	1	20	0	10	6	0	0	3	27	0	0	4	13	44	0	43	0	2	439	2	14	1	2	4	44	10	2	15	4	0	6	11	3	150	27	1	156	3	1	4	31	1	19	2	0	2	0	93	0	8	2	3	3	0	1	278	31	8	0	2	0	18	0	85	2	4	18	4	3	0	0	0	3	23	0	1	0	0	9	0	3	0	0	0	0	111	0	0	6	0	0	0	0	0	0	0	0	0	0	0	0	0	0	0	0	0	0	2	82	0	6	0	0	0	2	6	1	106	4	1	15	0	0	9	3	3	3	2	5	0	8	0	0	3	1	5	4	0	6	0	2	25	6	5	4	0	4	6	0	138	0	0	99	0	4	33	0	36	5	4	5	13	10	0	3	61	4	0	0	0	0	2	0	2	2	4	23	2	1	383	1	5	3	0	1	44	0	0	28	0	36	0	0	0	3	0	11	0	15	0	0	349	2	0	0	0	0	0	4	0	5	0	2	0	0	0	0	0	0	73	60	0	0	1	0	0	0	0	5	3	0	0	0	0	1	5	3	9	0	0	0	3	46	0	0	0	4	46	0	2	0	0	24	0	1	11	0	4	0	0	4	0	0	0	0	0	0	98	0	7	11	0	0	0	2	63	0	3	6	0	1	2	0	0	3	7	30	1	2	0	1	7	62	24	0	3	1	2	5	20	0	38	27	4	2	1	0	16	0	25	0	16	14	247	0	0	0	0	1	1	2	2	51	6	0	15	0	0	0	0	100	56	54	6	24	0	2	3	5	0	61	14	7	3	7	51	38	17	131	0	43	77	0	118	1	7	10	91	1	0	76	7	0	0	28	67	4	3	4	140	21	14	12	7	1526	0	0	2	103	60	151	0	0	8	55	15	2	58	4	57	0	2	21	2	5	3	0	15	0	5	25	0	2	6	1	2	43	0	17	9	7	4	16	13	72	11	2	53	1	94	3	4	7	22	0	1	1	2	0	9	11	11	2	1	0	3	5	20	348	4	0	1	8	91	63	10	12	45	18	400	77	1	1	5	1	14	8	7	0	0	0	0	2	3	5	1	2	1	1	32	0	24	10	44	8	2	13	2	0	26	0	0	2	0	4	0	7	1	11	2	0	1	2	1	8	3	15	0	2	4	0	0	2	6	2	1	1	4	13	6	1	2	1	3	17	1	1	1	0	1	2	26	0	4	5	8	8	16	1	11	9	111	29	1	4	4	6	6	16	0	5	0	2	45	454	1	3	18	0	0	51	34	38	2	33	20	37	19	4	99	11	2	5	69	70	0	2	4	1	2	0	14	0	4	0	0	0	0	0	0	6	39	1	0	82	2	0	20	6	0	1	0	0	1	0	22	2	6	9	63	81	0	18	1	0	0	19	0	0	1	14	39	15	126	1	80	1	0	0	34	12	294	7	0	0	62	5	0	0	29	0	18	12	6	0	0	52	13	275	1	0	91	0	1	2	5	45	3	0	64	1	0	16	146	104	22	70	9	1	0	1	60	2	4	9	0	1	16	1	4	2	4	1	1	0	15	0	7	436	9	3	73	4	14	2	3	1	71	2	70	11	2	91	18	2	0	1	92	0	17	2	10	55	70	14	17	42	7	66	17	122	0	8	3	0	1	35	1	0	18	1	2	14	2	3	0	0	0	1	0	34	67	16	24	223	71	72	0	439	0	0	1	4	7	34	3	0	0	0	1	3	2	1	0	0	1	0	0	101	5	12	0	5	5	24	0	0	1	2	7	0	46	1	1	1	17	0	31	3	1	16	13	0	52	4	2	6	3	39	1	92	112	21	18	8	3	120	7	2	1	136	42	2	2	10	2	5	0	4	62	0	1	0	106	60	136	51	0	0	5	0	9	13	1	5	69	0	6	4	7	10	6	11	2	114	105	61	6	3	39	28	32	32	31	20	0	233	0	0	68	29	0	12	16	23	0	166	349	72	8	12	18	246	0	0	1	4	3	4	16	3	2	2	0	0	69	37	1	4	11	0	134	22	2	2	4	1	1	0	137	32	16	36	62	0	14	0	97	0	104	23	75	63	38	26	2	30	421	125	0	52	11	0	0	14	21	45	7	24	0	5	2	3	1	2	7	6	2	0	4	9	2	25	79	122	794	792	60	8	2	12	3	10	23	76	2	1	17	0	7	0	1	0	5	0	0	4	11	0	18	2	1	2	1	9	0	22	5	0	8	4	0	1	18	0	43	0	7	80	11	30	12	7	42	34	32	51	35	2	0	3	1	728	170	30	5	1	3	11	15	30	0	7	13	0	3	84	31	4	0	8	0	0	0	5	47	52	0	0	4	4	0	20	4	5	14	0	1	0	1	2	103	7	34	27	584	5	3	1	0	0	0	273	0	10121	1	33	0	17	26	82	80	0	0	0	0	0	0	0	1	41	23	28	2	0	2	0	0	5	0	3	19	2	6	285	2	0	11	7	4	3	3	57	2	17	42	0	2	0	0	0	0	3	2	2	38	4	3	12	0	0	1	4	5	0	0	0	0	0	0	8	6	42	0	78	10	3	8	1	0	0	6	9	128	7	2	8	3	10	0	0	2	135	7	0	10	6	1	7	1	1	0	14	0	305	88	2	24	345	0	3	3	2	39	1	131	38	51	13	4	9	0	7	19	0	0	25	0	2	0	3	338	1	2	39	13	16	7	1	1	0	2	0	4	0	7624	31	75	24	6	825	1	12	77	3	63	28	553	396	411	32	342	101	96	2	2	129	73	52	36	16	8	0	7	2905	6	11	29	15	2	124	10	1	0	58	30	1	0	1	2	7	2	39	1	6	2	19	16	85	111	34	18	39	13	26	0	14	3	68	30	11	78	27	3	0	0	10	0	2	4	4	2	16	7	0	1	7	68	2	8	11	0	13	0	7	10	6	7	6	2	18	0	2	12	67	5	0	3	0	0	0	0	8	0	21	2	43	33	0	93	4	8	0	43	36	354	3	3	12	24	77	5	23	51	3	35	0	73	49	2	107	0	3	39	27	46	142	12	0	54	65	36	60	0	0	50	9	1	0	33	2	10	5	11	0	110	2	0	31	0	35	8	12	5	2	3	23	0	0	25	9	6	4	0	3	0	62	2	0	28	0	5	6	14	0	1179	9	75	0	0	64	9	1	27	22	5	80	0	0	2	54	50	8	72	100	0	99	23	26	16	125	43	29	14	4	5	11	7	9	57	148	114	27	1	0	0	0	2	0	6	2	2	7	65	3	8	0	0	0	2	5	17	113	25	0	13	73	1	18	0	0	0	34	7	7	4	1	0	0	0	2	0	2	1	5	0	0	2	0	6	0	0	14	2	1	2	0	0	0	94	25	7	3	0	33	12	0	10	0	2	0	0	1	24	5	3	2	2	0	0	1	26	13	24	3	17	12	0	22	1	3	1	2	1	3	0	0	43	442	5	1	0	0	0	2	49	4	105	1	2	0	0	0	30	0	44	6	70	31	1	0	5	0	5	23	0	1	1	1	40	18	6	10	5	6	6	21	0	12	0	10	2	0	15	29	90	18	38	45	4	23	10	2	0	21	7	3	21	49	6	3	4	68	14	23	21	5	13	11	9	16	2	11	18	19	15	7	30	4	10	0	4	8	39	11	26	0	9	9	1	7	38	12	5	266	0	197	15	8	0	0	0	8	22	2	6	3	7	0	2303	163	449	17	0	31	1	2	2	6	5	265	48	37	222	168	15	430	64	77	125	0	5	20	125	23	0	0	2	21	0	44	4	6	36	9	45	4	16	6	35	86	12	0	0	0	59	0	4	0	15	0	330	1	1	0	0	0	56	13	10	2	0	3	46	12	16	7	0	0	0	0	3	12	27	0	2	0	0	0	1	0	0	24	0	2	4	8	2	0	1	11	0	4	0	13	24	1	41	53	6	36	69	11	0	165	0	0	2	2	0	0	0	2	3	3	6	1	0	0	5	0	40	0	10	3	0	1	34	5	0	1	0	9	1	0	0	0	2	1	3	6	1	4	2	18	4	4	2	0	14	1	240	215	31	120	6	23	2	82	3	1	0	3	3	0	0	0	1	4	0	0	0	12	39	62	11	4	3	3	2	0	4	3	1	28	32	5	4	94	3	20	2	1	24	67	1	3	3	81	3	0	21	91	246	28	33	2	0	8	0	4	38	6	86	2	2	4	86	53	11	0	13	52	13	44	13	0	6	57	37	0	12	202	397	42	4	2	5	0	4	19	38	91	0	0	8	1	2	1	24	1	9	2	2	4	1	3	16	4	14	28	8	0	0	0	0	0	13	20	14	0	109	9	0	0	4	1	0	0	0	1	42	62	12	2	17	95	1	11	9	8	10	4	14	2	0	19	0	0	1	117	10	2	4	1	0	6	1	45	13	25	4	2	3	26	2	0	4	8	2	8	54	22	0	15	172	2	2	0	0	0	7	0	23	33	7	13	119	72	21	4	0	13	2	4	7	1	1	5	2	0	3	12	26	6	0	2	2	0	0	4	6	3	0	0	57	13	2	6	1	0	11	11	6	11	14	12	11	3	5	5	0	4	1	7	3	41	5	1	0	27	0	1	8	0	47	31	2	1	44	63	19	4	2	83	2	54	8	3	541	0	0	32	0	0	1	0	4	1	6	2	1	106	18	0	58	34	45	0	0	454	0	9	0	2	3	2	0	24	1	2	1	1	4	0	0	15	3	3	0	2	15	9	4	0	1	8	1	2	1	18	41	19	0	0	0	1	76	16	3	3	0	2	154	90	0	10	0	2	9	2	78433	0	0	3	0	3	0	2	7	0	0	0	2	0	0	6	0	29	3	6	2	5	89	18	235	21	6	2	40	9	4	1	1	1	0	0	17	4	62	113	6	116	9	2	0	0	0	10	4	4	14	4	0	24	2	120	42	44	205	104	80	31	30	0	49	13	0	16	0	0	222	19	90	68	0	6	1	18	25	30	4	192	176	73	1	200	3	0	0	2	15	0	5	19	3	159	27	0	365	9	26	6	124	130	1	0	131	29	0	6	2	10	0	0	1	2	0	4	0	80	247	67	141	222	3	257	26	0	70	113	183	212	368	17	16	90	24	164	55	5	59	60	22	18	16	0	0	0	77	58	120	342	35	0	37	5	4	77	62	11	8	19	2	0	1	0	0	3	0	0	0	8	1	2	14	14	25	4	9	6	0	7	49	0	6	4	2	63	77	73	51	3	2	6	11	0	19	46	29	0	16	0	10	5	66	41	58	67	1	30	7	0	0	31	12	1	2	12	15	3	0	0	0	7	2	0	0	1	8	11	25	6	5	27	4	11	0	0	14	0	0	0	11	2	10	58	0	37	2	1	4	152	42	0	5	29	5	307	14	1	21	24	0	8	11	0	0	3	0	0	4	1	5	2	2	4	2	5	0	6	0	0	17	1	9	4	3	1	1	20	0	0	4	0	7	11	1	13	2	3	0	2	2	11	11	0	1	1	12	0	13	0	3	44	1	48	18	3	3	0	0	40	17	1	12	5	6	57	37	2	81	2	8	6	360	9	9	32	18	0	8	7	4	48	0	6	38	3	21	42	18	28	0	0	0	12	0	0	4	0	23	0	2	2	32	10	53	0	0	0	6	0	11	1	2	0	0	2	0	3	9	31	114	28	15	164	0	87	54	11	1545	4	0	1	12	20	29	56	6	48	0	3	29	4	41	2	4	6	1	0	0	0	0	18	0	3	50	46	19	2	4	4	171	17	11	4	4	4	0	0	24	1	3	4	15	0	93	3	23	0	17	2	2	2	14	8	23	16	18	31	67	4	1	2	0	0	4	10	107	454	127	31	17	45	106	59	5	6	15	68	43	20	2	10	13	0	40	2	5	10	10	2	2	0	42	3	24	6	3	3	5	15	0	8	5	16	5	57	23	57	6	17	8	7	34	0	4	11	4	16	0	4	3	223	6	25	0	3	0	1	10	4	1	0	2	0	0	4	4	0	3	9	0	0	1	5	86	0	0	2032	1	9	4	27	2	0	6	12	11	43	5	0	3	0	0	0	3	0	3	3	0	3	5	3	0	3	22	4	0	0	250	0	37	24	151	21	26	32	1	0	0	0	0	0	1	0	19	0	0	0	0	0	0	1	0	94	8	2	2	3	2	4	6	7	2	0	0	1	7	12	0	0	111	0	1	5	22	2	41	2	0	58	6	4	7	57	14	2	31	23	18	137	144	34	79	102	955	360	64	1385	0	4	62	19	4	8	6	37	54	1	2	0	3	0	0	466	4	0	9	2	382	2	1	0	9	6	21	7	111	2	3	0	2	8	1	1	2	1	0	0	3	24	49	0	1	5	20	327	90	4	0	0	10	1	0	3	0	88	0	0	0	0	0	10	14	107	7	9	3	0	90	29	8	1	94	0	0	61	12	11	7	2	0	0	6	58	9	38	6	4	2	8	1	0	352	6	2	15	4	23	86	2	0	32	395	38	2	852	2	1	2	16	5	2	1	643	26	40	1	1	5	1	50	13	37	2	36	0	32	0	2	12	0	9	4	11	11	18	9	1	2	36	257	0	0	5	0	0	56	134	4	2	14	0	33	1	0	29	2	7	2	10	6	1	3	0	0	187	14	5	1	0	54	11	28	1	0	7	3	3	39	0	2	46	4	1	0	0	1	0	17	15	19	52	13	111	129	17	27	78	7	125	245	236	0	0	0	2	7	0	2	1	0	438	6	0	36	103	109	64	5	25	23	4	8	9	40	5	6	115	22	2	0	1	0	6	1	2	94	274	355	3	0	1	0	0	9	0	1	5	0	8	8	30	6	5	0	4	13	2	0	0	1	0	3	1	0	14	0	2	0	0	2	3	0	2	0	0	0	0	3	10	355	0	2	0	0	1	6	0	3	4	0	6	7	16	0	1	0	35	7	41	9	0	16	4	7	16	2	3	8	11	0	10	0	3	45	452	32	46	31	6	16	9	32	15	3	51	36	0	0	1	6	10	3	15	0	10	30	0	7	16	0	33	37	4	8	42	1	0	221	36	0	41	1	7	0	7	0	0	93	15	53	16	108	16	82	39	3	131	10	24	8	5	2	5	0	44	55	235	199	0	79	52	57	10	37	0	9	0	8	4	0	13	46	10	12	1	1	0	0	117	0	1	0	0	0	0	14	7	33	74	16	62	4	0	38	9	86	37	16	60	7	8	190	24	99	2	4	2	6	0	5	0	6	22	84	8	11	46	0	0	11	6	0	0	0	0	2	4	0	0	0	6	5	2	11	623	648	4	409	451	93	13018	131	2	19	2	0	5	0	0	57	6	26	9	0	12	34	0	0	4	32	22	5	0	1	12	1	0	0	617	173	1	70	73	29	8	1	4	2	0	13	0	465	1	16	4079	1	2	1	43	2	94	5	2	0	5	0	0	0	0	3	1	1	18	2	0	0	0	0	2	0	0	0	3	0	0	8	64	4	14	2	8	9	3	2	4	6	0	2	4	33	7	692	266	4	36	21	31	4	27	19	4	0	29	1	39	4	0	7	0	1	2	0	0	2	0	0	13	2	0	0	0	0	4	0	0	22	5	2	28	0	0	0	3	17	1	0	3	0	1	14	27	0	7	43	12	12	4	0	1	2	0	0	0	6	1	3	14	12	19	2	17	78	57	31	92	0	0	4	2	0	0	0	4	41	1	268	2	25	8	52	0	246	91	0	0	0	0	0	0	0	0	2	7	2	0	0	0	6	0	0	3	0	4	0	0	0	0	0	2	0	30	2	0	6	0	0	19	0	0	1500	0	0	0	2	0	3	0	1	18	4	3	0	1	0	0	0	4	0	7	0	0	4	0	0	4	0	0	1	3	0	4	2	3	2	222	2	1	0	5	4	0	43	0	0	0	10	0	6	4	2	27	6	6	0	389	0	1	3	0	0	45	6	0	0	2	3	15	0	0	14	0	1	0	0	0	0	0	1	0	0	0	1	2	0	0	0	0	3	0	0	0	3	11	22	0	0	5	3	14	4	0	2	8	1	0	0	0	21	0	0	0	2	0	3	17	0	0	2	8	0	0	0	0	0	0	1	0	5	11	0	0	5	35	0	0	0	115	0	0	3	0	2	0	0	13	0	0	0	0	0	13	0	0	1	0	0	0	0	4	3	0	0	4	50	1	0	1	3	26	0	3	6	3	0	9	4	10	43	0	13	0	2	9	0	6	0	46	6	0	5	148	3	9	1	2	237	2	70	0	0	0	0	0	0	8	5	5	3	0	0	9	3	1089	8	23	0	28	2	0	24	3	0	0	13	0	0	0	10	5	10	16	13	2	0	31	0	9	6	0	0	18	7	6	0	13	2	0	1	3	4	4	0	53	0	2	1	16	21	30	12	0	0	0	43	14	32	10	5	2	11	2	12	4	9	24	5	6	29	1	0	50	14	1	4	2	4	2	47	8	19	58	10	0	6	9	12	12	49	0	2	5	0	8	7	46	13	18	0	55	140	76	5	133	419	196	39	0	3	5	240	0	11	0	3	5	11	0	2	0	0	34	0	36	0	0	0	10	0	8	5	589	63	90	0	3	15	0	0	12	8	185	4	116	82	8	9	4	14	4	8	2	0	0	0	1	0	0	0	11	16	3	32	10	8	5	6	0	0	7	0	0	1	1	8	2	79	5	0	6	0	0	13	1	9	0	0	2	8	0	0	2	0	4	4	1	11	0	21	1	7	215	1	0	0	14	0	0	5	0	0	0	1	0	0	1	4	52	4	55	0	3	2	11	0	0	5	4	6	5	8	0	3	1	3	0	66	0	284	0	6	0	0	4	223	1	3	2	1	160	2	34	1	0	0	4	2	6	1	0	8	4	1	6	0	0	0	4	0	1	0	2	82	10	6	57	64	2	1	0	12	3	13	10	2	1993	3	6	0	50	0	2	0	46	32	106	32	0	0	4	0	96	3	3	0	4	43	21	4	247	3	61	39	13	0	3	0	3	0	0	7	15	6	0	1	0	18	16	5	0	13	4	3	2	36	17	6	2	34	0	3	6	2	2	0	16	27	40	20	42	72	5	57	57	1359	2	87	16	34	79	2	76	77	12	0	19	0	1	0	24	217	34	0	1	1	0	82	38	3	1	0	66	3	0	2	0	2	8	5	2	88	30	43	2	0	147	8	0	0	2	0	0	65	13	10	6	21	2	22	13	9	10	0	6	0	29	1	1	4	3	33	4	24	0	26	0	52	70	14	28	59	14	1	8	10	11	6	188	76	3	13	0	4	0	0	0	1	5	15	0	0	2	5	0	0	19	55	7	0	25	0	13	23	8	53	0	5	0	36	7	82	4	17	6	17	12	1	16	50	55	255	52	45	0	4	2	0	2	0	0	12	11	15	11	192	46	111	0	62	2	0	39	14	12	9	0	0	0	2	14	31	15	30	31	11	28	4	206	0	29	6	35	102	2	35	38	49	84	4	1	8	148	32	23	0	1	7	0	4	0	69	1	0	281	0	6	4	15	3	19	15	126	26	29	0	0	6	1	26	0	0	5	9	4	5	23	0	0	0	41	55	14	272	5	10	2	9	1	18	0	192	0	4	0	38	1	20	0	57	6	10	146	27	13	136	0	1	0	43	113	2	0	3	6	0	56	1	4	3	1	3	0	5	57	48	17	0	31	7	44	26	1	1	9	2	1	8	0	74	6	5	0	47	0	1	9	1	20	33	0	41	6	0	0	2	10	0	108	31	0	10	3	1	4	4	3	0	10	9	13	0	1	51	150	50	6	2	5	1	1	7	1	0	0	0	4	22	18	38	6	179	35	12	225	28	42	500	59	103	21	186	234	0	208	25	54	115	55	48	65	0	9	14	16	4	6	1	4	12	11	2	3	53	2	1	1	1	2	0	0	0	4	2	0	1	34	1	11	26	21	24	1	0	0	0	0	0	0	2	0	0	1	2	0	2	2	2	0	5	0	0	0	0	3	0	0	0	29	18	2	0	0	0	3	0	0	0	0	0	0	0	0	0	0	0	0	0	0	2	0	0	12	0	26	51	4	94	18	0	2	52	0	1	1	166	34	163	25	4	14	219	14	0	17	4	9	21	2	0	2	0	0	0	4	61	255	11	109	14	88	0	5	3	55	9	26	8	1	2	4	11	5	1	1	2	2	4	17	0	4	5	4	1	34	11	74	16	32	6	41	48	39	1	59	62	10	0	2	0	5	1	0	11	75	4	1	1	3	2	0	0	40	12	23	3	0	116	38	6	42	0	87	0	0	0	0	18	0	3	9	291	9	3	2	0	5	905	0	0	9	2	18	1	38	0	3	52	0	0	4	28	0	37	14	0	3	28	119	0	1	0	17	0	8	0	9	6	4	13	7	31	66	0	8	2	19	6	27	16	0	10	28	73	30	101	60	23	5	22	26	0	40	0	11	13	21	8	0	0	27	1	5	5	38	14	0	22	2	5	2	0	2	3	34	6	2	3	5	0	0	5	8	6	6	1	2	0	2	1	66	5	0	0	0	1	2	8	15	16	1	21	0	0	0	0	3	9	27	7	17	16	0	46	0	0	496	27	463	41	47	0	8	746	209	5	31	173	14	2	0	54	87	14	21	3	54	6	47	67	18	9	22	7	0	0	16	39	34	0	0	234	165	65	10	0	1	4	0	0	6	55	0	5	7	6	4	0	0	10	6	0	8	22	378	10	140	48	24	0	91	12	18	0	0	0	0	0	20	0	0	0	24	2	59	1	19	36	19	3	131	19	1295	30	23	0	0	30	20	0	382	44	69	99	30	217	0	80	119	12	0	0	0	0	5	24	8	963	264	78	2	166	0	8	0	0	87	2	3	16	14	0	0	1	178	231	2	0	0	301	91	43	40	5	41	18	31	150	1	16	11	0	0	37	13	31	4	6	0	2	0	4	1	13	38	0	0	4	13	4	0	9	2	1	3	0	0	5	0	216	24	1	9	2	122	16	11	1	0	4	24	41	5	0	4	3	18	39	17	9	111	0	48	18	2	6	2	137	5	20	4	3	3	46	88	112	26	122	325	181	0	4	7	392	32	75	96	2	0	0	4	0	0	0	5	6	0	4	30	17	0	0	0	1	0	5	0	61	1	8	19	48	30	46	5	3	42	1	25	1	6	13	1	23	0	0	0	17	3	15	140	59	29	632	0	19	0	4	2	2	2	4	0	0	0	8	2	32	0	4	0	1	0	2	17	2	0	0	19	0	7	8	2	13	9	16	5	1	8	2	72	0	0	21	3	2	53	7	0	0	0	4	30	6	0	4	4	3	2	30	13	14	9	5	23	8	37	1	11	1	23	2	13	139	0	13	8	3	4	4	0	1	42	28	1574	164	117	84	21	155	59	67	60	66	19	19	0	31	114	0	0	6	11	1	5	0	7	3	14	0	10	6	9	0	2	5	6	27	1	1	0	0	0	1	5	8	2	0	3	2	4	0	2	0	1	1	3	0	1	1	1	0	1	1	0	4	0	39	8	0	96	2	63	112	18	76	2	0	0	17	0	0	40	0	4	3	0	0	104	49	0	0	9	26	3	37	0	8	12	54	1	0	5	0	10	5	25	1	0	0	4	3	9	0	10	13	5	0	76	2	19	9	10	6	0	0	14	2	3	153	18	15	4	20	20	44	0	56	7	4	0	14	0	15	0	60	9	1	4	4	5	37	2	2	8	14	6	0	5	23	31	5	35	6	10	84	4	5	2	1	3	0	0	3	0	10	107	12	11	47	132	3	2	2	7	4	7	0	0	18	1	4	19	15	17
LakWasMet10_HOW4_2_rpkm	0	0	0	0	2	29	12	2	0	0	45	0	6	3	3	1	0	12	11	0	0	0	9	69	0	2	0	0	0	18	0	2	0	29	2	19	3	1	14	3	0	0	0	2	48	72	56	29	2	5	9	9	0	0	0	9	0	27	211	25	136	2	0	32	59	0	0	0	4	59	3	0	2	0	4	0	0	0	0	2	0	72	0	1	0	0	0	2	2	0	0	0	35	4	28	0	8	2	1	4	0	0	1	0	4	0	0	0	0	4	0	0	61	8	33	14	0	2	0	0	0	1	6	16	0	0	6	0	2	2	4	118	6	2	0	3	0	0	29	0	0	0	0	16	2	2	0	0	19	3	4	30	5	0	71	0	10	21	26	0	22	4	0	30	7	0	0	9	2	24	1	4	0	0	0	0	0	1	1	0	0	0	0	2	0	44	0	1	0	22	43	2	25	0	6	0	4	13	4	203	72	2	3	0	0	2	36	0	25	4	0	0	48	7	17	0	3	0	0	16	4	2	15	10	2	9	0	0	5	0	8	6	351	0	0	0	39	4	55	4	0	0	39	3	85	9	2	0	0	25	0	27	37	0	1937	263	2	1	0	2	8	0	8	32	4	0	4	0	2	65	32	0	50	0	0	9	0	4	50	9	0	47	22	23	72	0	1	0	56	2	2	0	1	4	329	2	0	3	28	0	3	57	86	5	12	4	18	44	72	4	37	1	42	58	0	0	0	0	266	0	2	0	10	8	44	1491	1	3	5	0	1	2	0	0	0	0	17	0	0	0	0	7	3	23	75	3	26	6	1	1	0	3	2	0	10	0	4	1	0	340	6	0	21	0	2	24	11	48	10	12	0	54	1	0	49	2	0	5	4	16	0	2	12	8	5	0	107	4	0	0	1	0	35	3	1	14	29	0	0	5	0	6	1	16	80	0	11	0	0	2	2	80	11	10	0	83	66	24	12	7	0	4	0	1	0	0	13	0	6	1	0	3	5	2	1	11	0	0	26	1	99	12	0	0	13	111	2	0	2	0	2	129	12	1014	2	53	104	3	2	8	4	0	0	29	3	61	6	0	2	4	20	26	33	4	1	0	27	0	34	0	10	4	17	2	0	0	0	69	33	2	0	0	129	90	13	0	8	0	0	2	0	2	10	1	0	2	2	6	0	5	0	0	0	9	2	4	0	2	0	15	0	0	0	1	2	0	1	0	0	0	1	0	0	1	52	0	63	6	0	38	0	19	6	15	56	0	0	0	5	0	0	0	2	0	0	14	0	0	3	0	0	8	0	4	12	5	59	3	52	2	0	4	0	0	2	12	40	230	12	143	94	441	105	19	251	8	9	1	58	0	0	1	2689	1	14	17	1	1	1	0	59	0	0	4	32	24	0	47	0	7	1	211	49	94	12	0	159	1	218	3	150	27	12	16	1	27	2	17	1	4	19	31	1	2	3	0	1	1	2	23	0	43	0	4	0	6	1	41	38	4	20	1	8	18	19	1	1	3	3	6	2	178	1	15	0	0	4	4	33	9	0	35	0	0	0	0	0	3	5	1	2	2	15	2	0	0	2	0	0	97	1	0	8	0	49	0	0	12	0	18	0	30	0	0	43	0	7	0	108	0	0	0	2	0	28	46	0	0	28	1	3	0	11	229	7	0	0	1	24	0	0	2	3	0	1	1	0	7	1	53	0	24	6	1	51	45	1	0	0	52	0	0	0	2	0	6	6	0	50	38	0	4	0	145	2	2	17	0	0	0	0	0	0	0	0	39	0	1	0	2	0	0	7	21	0	0	0	0	0	3	3	8	0	3	0	1	13	1	2	60	0	2	0	0	38	7	59	1	2	0	0	0	0	0	0	0	0	0	0	0	0	0	0	5	14	2	3	32	0	7	11	0	2	4	0	0	0	45	74	0	0	0	0	0	0	0	0	0	24	11	0	0	0	0	0	0	3	2	1	31	47	19	59	3	0	4	1	0	16	3	0	0	10	0	0	0	20	0	8	11	0	0	0	10	0	5	4	0	0	1	0	0	6	0	6	0	2	0	0	0	0	0	7	4	0	0	2	0	0	0	1	0	0	6	40	59	39	63	32	0	0	1	1	4	0	0	0	2	0	0	0	0	1	1	1	0	1	0	0	4	0	0	0	31	36	0	28	28	2	0	0	11	0	0	6	0	0	1	1	0	0	0	6	0	3	0	4	0	3	0	2	4	2	427	4	45	2	0	0	0	8	9	42	0	57	2	3	10	1	0	0	3	0	2	2	0	0	3	4	0	2	7	0	1	0	0	0	0	1	2	0	11	0	0	0	0	1	121	0	6	0	68	4	2	2	17	0	0	551	4	8	0	0	1	0	0	0	0	42	2	0	19	0	0	1	0	1	6	0	0	0	0	4	13	5	4	0	0	0	12	5	14	0	8542	0	0	0	0	39	8	7	0	2	1	3	3	5	0	9	9	0	0	1	0	0	0	0	0	4	238	43	0	0	0	0	2	0	0	0	2	0	0	0	0	3	19	9	0	3	17	0	10	0	0	1	1	0	23	2	2	0	0	1	1	3	0	4	10	52	0	13	0	0	1	0	26	8	0	3	0	0	0	0	0	0	0	0	0	0	0	0	0	0	0	4	0	6	0	3	2	0	0	0	0	0	0	0	0	4	0	3	3	3	0	6	0	37	6	16	0	0	0	28	0	0	0	0	14	0	0	0	0	0	8	16	1183	2	4	0	23	24	0	0	0	0	22	9	0	0	0	0	1	0	0	0	0	11	17	0	5	0	4	33	0	0	0	0	0	14	0	0	0	0	4	10	0	0	7	1	0	25	0	469	8	0	0	13	7	0	1	3	0	0	115	132	0	0	12	0	2	4	2	0	26	0	7	0	0	0	0	0	4	22	12	1	81	12	15	16	4	2	4	0	1	2	15	0	0	12	0	0	9	5	0	0	17	2	0	4	4	5	0	0	0	0	4	8	2	0	16	0	18	0	0	0	2	2	0	1	3	2	0	66	1	0	0	0	0	2	0	0	0	0	2	12	1	62	12	38	10	3	6	16	0	2	0	9	10	0	43	1	0	3	4	0	2	27	38	0	0	1	0	6	6	28	0	21	5	6	34	1	0	45	30	0	24	26	6	0	0	0	0	4	1	51	0	19	10	4	40	42	28	57	0	2	6	63	29	0	20	6	7	2	23	16	0	11	0	0	8	6	29	52	24	0	3	17	0	0	0	0	0	5	19	5	0	0	1	109	4	17	65	3	0	45	0	4	34	10	5	0	9	0	28	0	3	0	2	0	0	0	6	0	1141	40	32	133	0	3	4	0	0	0	0	0	127	55	10	7	33	0	0	0	20	230	143	43	19	3	2	0	185	1	0	0	0	2	0	2	0	262	42	31	89	93	30	0	12	85	9	0	0	1	0	0	0	70	2	13	0	0	20	4	33	2	5	1	2	2	6	0	3	0	0	5	14	37	0	0	2	2	0	0	12	4	60	0	0	0	2	0	3	0	3	0	3	0	1	3	2	4	0	12	0	0	0	0	3	5	22	0	7	0	58	0	0	0	0	0	0	0	0	4	0	0	11	1	0	1	0	0	0	2	0	12	4	0	153	0	0	14	0	0	0	0	221	0	2	23	0	11	400	0	34	9	0	2	0	0	0	60	0	31	0	0	2	0	0	34	0	0	2	25	0	0	2	41	3	2	7	6	0	0	0	0	2	0	23	0	58	19	15	0	0	5	0	0	0	0	44	7	0	0	2	5	7	0	4	40	0	9	0	22	36	30	0	2	11	0	0	0	21	1	27	4	33	0	0	9	0	2	2	0	1	0	3	5	0	153	17	127	126	197	16	291	18	2	0	0	4	2	13	0	2	0	1	91	0	0	0	4	1	0	0	0	20	15	0	34	34	0	12	0	6	0	25	6	0	34	11	0	0	0	0	6	17	0	154	0	4	40	7	0	1	66	0	4	159	17	0	3	42	14	1	2	20	149	105	23	176	0	0	9	10	9	1523	0	0	3	13	0	0	113	4	4	4	2	9	0	8	5	2	17	15	0	0	0	6	0	7	2	6	0	0	3	0	0	0	54	0	0	0	12	0	47	8	0	65	93	340	0	2174	5	0	5	0	0	3	2	0	0	0	0	3	3	18	1	0	0	118	4	0	0	2	0	0	37	6	0	122	0	10	0	1	13	9	11	0	0	0	8	0	4	8	0	3	20	0	6	0	0	0	0	1	27	5	1	48	5	1	4	0	21	270	3	52	0	72	220	1	55	6	92	4	37	27	19	4	15	2	0	29	2	0	0	5	3	4	0	0	0	0	0	2	0	0	6	0	2	14	0	13	51	0	0	1	0	0	1	0	0	4	0	0	0	2	0	0	0	0	30	27	6	1	4	0	3	0	27	9	7	0	0	3	25	0	7	3	0	0	0	0	5	0	1	2	2	0	2	13	0	0	3	7	0	0	3	0	0	0	0	0	220	0	34	15	27	8	4	0	31	5	17	181	96	3	2	5	5	0	0	0	0	0	0	19	0	0	14	18	0	0	4	2	0	1	0	0	2	3	4	5	0	6	6	8	42	14	0	101	8	0	2	0	28	14	262	2	4	0	0	5	0	0	0	0	0	0	8	7	4	0	0	4	0	0	0	0	0	0	11	1649	0	0	0	0	2	0	4	0	0	0	25	128	0	0	0	3	1	0	0	0	0	0	6	69	0	0	0	0	2	14	3	0	0	0	0	0	9	0	0	13	3	0	2	52	2	4	0	2	0	0	0	2	8	4	0	195	0	0	0	0	20	30	0	2	10	68	0	37	57	73	3	0	0	0	2	0	12	0	78	19	0	0	0	4	7	4	0	5	0	0	1	3	0	5	2	2	2	0	0	5	0	0	0	0	0	20	0	0	0	2	40	26	0	0	1	2	1	1	7	0	0	4	0	0	0	0	0	0	3	2	0	0	0	6	5	0	0	124	9	0	3	362	0	0	66	191	7	11	3	0	33	4	2	0	0	0	1	31	90	0	4	9	12	0	0	0	1	2	25	0	42	0	6	6	3	73	2	0	19	0	9	0	1	0	0	6	9	13	3	0	0	2	2	23	15	0	4	2	1	46	4	0	139	0	1	22	0	1	0	0	9	7	1	0	0	2	3	0	0	0	53	2	0	6	5	2	192	2	0	0	0	0	16	4	0	16	5	1	6	0	0	0	0	6	0	0	7	2	5	0	0	0	0	0	0	0	3	0	6	0	0	0	3	2	0	2	4	0	6	2	2	1	4	3	2	3	0	2	3	0	0	0	1	17	21	3	0	0	0	0	65	376	145	79	458	328	251	766	5	222	409	104	326	367	52	212	23	589	422	9	93	9	560	532	227	442	850	80	279	84	326	37	692	6	0	14	0	1	0	0	1	0	0	0	19	60	9	0	9	0	0	0	3	0	1	3	0	0	2	6	0	10	0	2	9	0	34	0	43	0	1157	11	0	0	0	3	0	0	0	0	0	0	2	5	0	0	0	0	4	0	0	13	0	0	0	0	2	12	6	42	0	2	0	14	0	0	0	4	0	0	11	3	2	2	0	2	59	2	0	6	1	0	0	0	0	4	0	1	1	4	4	22	0	19	0	3	0	3	3	0	0	6	0	0	0	1	1	6	0	4	3	105	6	0	7	19	0	0	0	1	0	6	1	2	2	1	0	1	1	5	30	0	0	0	3	0	3	0	2	1	0	3	0	1	0	2	0	0	1	3	0	0	0	0	0	8	4	1	0	0	55	3	9	27	5	0	0	0	0	4	1	0	0	1	0	0	16	4	2	0	0	17	0	47	1	0	9	0	4	3	0	0	7	0	2	7	0	51	3	5	0	1813	11	0	0	0	0	1	0	0	0	13	0	0	0	0	0	0	12	0	89	378	2	0	2	0	8	0	0	25	19	0	12	6	0	105	2	11	9	4	6	0	3	2	8	3	0	31	5	19	3	5	4	0	2	1	4	0	0	2	6	0	0	0	1	0	0	0	17	0	2	0	8	0	2	0	4	7	46	3	2	0	0	6	6	0	136	380	5	0	0	0	1	1	0	2	0	2	0	0	1	0	0	0	0	4	27	4	25	11	0	0	0	12	0	0	0	0	117	34	20	0	1	0	108	0	0	4	0	6	0	0	0	0	2	0	0	3	155	10	0	0	0	0	0	0	2	3	0	4	39	10	14	2	15	0	2	8	30	3	0	8	1	0	0	0	1	0	0	8	3	7	0	3	106	4	10	0	0	37	13	1	0	6	12	1	27	0	24	2	17	0	23	0	20	0	0	5	0	0	2	0	0	6	1	1	0	2	0	0	0	13	8	0	170	2	2	33	0	16	2	2	2	3	3	1	2	25	10	20	10	0	0	0	0	0	0	0	0	14	0	0	4	0	0	0	126	0	10	51	74	4	0	61	67	5	1	31	0	31	1	41	4	40	4	22	0	28	12	0	4	28	1	19	0	23	0	0	3	13	0	0	0	9	15	11	17	16	2	4	9	0	11	1	5	1	20	8	1	0	66	63	3	6	0	13	3	33	22	18	0	0	0	0	2	12	3	2	0	0	1	13	20	0	0	0	5	25	0	0	1	0	0	0	0	0	30	1	0	23	0	4	26	1	2	0	2	6	2	0	0	1	4	4	0	193	3	0	87	53	48	4	42	8	4	0	0	12	260	0	0	0	0	6	6	0	8	0	3	2	0	0	6	0	5	64	1	0	69	2	0	328	0	37	3	0	0	76	63	0	1	2	11	4	3	2	4	0	10	1	19	13	1	2	75	2	2	1	78	9	1	0	15	0	0	0	882	172	517	54	0	0	0	2	2	0	2	69	0	0	0	11	0	0	58	483	53	10	0	0	1	0	0	0	107	4	0	0	0	0	2	0	0	4	0	0	2	0	0	0	1	0	0	0	0	0	174	1123	2	3	8	0	0	1	2	20	2	0	0	0	0	0	50	18	6	1	0	0	0	0	0	121	14	2	4	0	6	4	0	0	0	6	0	8	0	4	0	3	0	3	0	6	5	1714	2	1	7	0	11	0	0	1	0	1	0	4	0	0	0	0	3	34	1	0	1	0	0	5	5	2	0	0	0	0	0	4	0	0	0	0	0	0	0	1	0	0	0	1	2	12	0	0	0	0	3	0	1	0	7	1	2	5	0	20	5	0	0	0	0	0	104	0	5	0	0	0	0	638	21	0	0	1	3	3	2	114	22	0	12	0	0	20	2	3	141	0	0	4	3	0	0	0	0	0	0	0	11	1	10	0	0	0	0	0	0	0	0	0	0	0	3	0	0	0	1	0	0	0	0	0	2	0	4	0	1	1	0	3	0	0	0	2	0	0	0	41	9	18	0	6	33	0	29	24	2	0	0	0	0	0	0	1	10	11	0	4	0	19	2	0	0	0	0	0	0	2	0	4	4	3	0	12	37	4	1	43	0	23	0	0	0	0	7	0	0	5	3	0	0	14	0	11	3	3	25	4	58	37	0	0	2	0	0	0	0	18	8	14	0	3	0	0	0	1	51	773	0	41	0	3	4	6	5	0	0	3	0	0	0	2	0	0	5	6	23	14	0	0	0	0	1	0	1	1	32	1	21	8	0	0	0	0	0	0	0	5	5	0	0	0	41	0	3	3	35	0	4	0	6	0	0	25	4	0	1	0	107	0	2	0	83	0	0	0	0	0	3	3	1157	0	0	0	6	0	2	3	4	2	2	2	1	0	2	0	0	2	0	415	7	0	0	0	2	1	0	78	0	2	0	0	0	0	4	0	0	0	12	0	4	0	1	7	1	0	0	0	1	0	2	0	0	0	0	1	14	0	0	3	0	0	6	0	11	8	18	0	11	0	2	10	0	23	2	0	0	0	0	3	0	0	0	0	0	0	4	0	0	0	0	0	4	0	0	0	2	0	0	0	1	6	2	0	0	0	0	0	0	0	0	0	24	0	0	0	95	2	0	13	0	0	0	0	0	0	6	0	0	0	0	1	0	0	16	54	0	0	6	0	0	5	0	3	0	4	6	27	0	0	24	4	0	0	0	0	0	2	0	0	1	1	0	30	0	0	0	0	0	49	0	0	4	305	49	2	2	2	6	1	6	0	2	0	0	0	0	0	0	0	26	0	0	47	0	0	0	0	8	0	2	0	440	0	0	0	0	2	0	7	0	0	0	10	0	9	194	0	7	0	0	0	2	0	4	18	0	19	0	0	0	7	4	20	0	0	3	0	0	2	0	0	0	3	1	3	0	0	0	2	0	0	0	0	0	0	0	0	0	0	1	0	0	0	0	8	0	0	0	0	0	3	0	0	1	0	7	5	0	0	0	0	0	0	3	0	0	0	0	0	4	0	0	0	0	0	0	0	0	0	0	1	0	0	0	0	0	0	0	0	0	11	0	0	0	0	0	0	0	2	12	0	0	0	0	0	0	0	0	0	6	0	0	0	0	0	103	0	0	49	8	3	0	0	0	50	0	0	6	0	0	0	0	5	5	8	0	0	6	4	0	0	2	113	98	4	0	0	0	84	0	10	4	0	0	0	5	4	0	0	0	4	0	0	0	0	0	91	0	3	0	17	0	0	0	2	2	0	23	0	0	0	0	0	0	3	0	1	0	0	0	0	8	0	0	2	0	0	0	257	0	87	0	0	5	0	2	0	0	0	0	0	1208	0	0	0	0	0	8	0	4	0	0	0	0	3	0	0	0	0	64	0	0	8	3	0	2	12	0	0	0	0	10	0	0	0	5	0	1	0	0	8	2217	0	27	0	0	0	0	3	0	0	0	8	0	0	91	0	0	10	0	3	106	0	6	182	0	0	5	0	0	0	0	0	0	0	0	2	0	0	7	0	0	0	0	0	242	0	124	1	0	0	0	0	9	82	0	0	0	0	0	0	0	0	1	3533	4	5	7	0	0	2	0	9	0	1	0	13	0	0	2	0	30	5	0	0	0	4	0	0	0	0	0	0	0	0	0	2	0	0	0	0	0	7	6	5	11	0	9	1	0	0	63	0	0	0	0	0	0	0	0	0	3	0	0	13	18	0	42	0	4	0	1	0	9	2	5	0	1	6	0	0	3	0	0	0	134	2	36	1	0	0	0	0	0	0	0	35	1	61	0	0	4	0	0	0	0	0	2	5	5	29	29	0	20	0	0	0	0	9	3	0	23	0	11	2	4	0	2	5	0	1	0	2	0	3	0	15	0	0	0	0	0	0	0	0	111	0	17	0	1	0	10	0	0	0	0	0	8	0	0	0	0	0	0	6	0	0	0	7	35	5	1	4	0	0	1	2	2	0	0	18	7	8	0	33	0	1	31	117	64	0	5	0	456	0	26	173	18	0	0	0	36	265	0	81	0	13	64	0	520	0	2	0	0	1	0	0	62	28	3	39	0	3	25	1	42	10	106	0	91	31	3	9	0	10	1	0	62	7	12	0	0	5	0	1	0	16	10	3	0	0	7	14	0	0	5	0	12	0	0	0	15	0	0	0	0	0	0	0	0	45	15	0	14	56	132	0	0	14	0	39	4	0	3	3	25	0	0	0	0	0	34	152	2	0	9	0	0	0	0	4	10	0	0	0	0	0	0	21	0	0	39	0	0	0	0	24	11	11	5	6	2	0	0	0	0	0	0	22	11	0	6	0	2	21	0	2	0	1	5	35	0	7	19	0	0	0	17	0	0	27	0	55	11	3	2	0	34	4	2	39	0	0	22	5	0	0	4	68	0	0	2	164	341	439	16	56	40	160	456	17	375	154	211	14	444	495	449	0	154	36	458	202	123	6	314	23	556	0	29	0	38	0	2	0	0	0	0	5	0	0	0	0	0	43	3	0	4	0	0	0	193	3	2	4	24	0	0	4	3	0	0	3	1	5	35	0	6	0	0	0	5	117	0	0	0	2	0	0	0	159	19	1	0	0	8	5	0	65	1	32	0	87	2	0	0	0	23	0	5	237	0	44	3	14	0	0	0	0	2	0	11	0	2	0	0	0	0	0	4	14	0	0	3	0	32	0	0	2	8	80	3	0	4	3	2	2	2	0	6	0	0	0	0	2	3	2	8	0	4	0	16	7	6	21	24	1	4	0	1	1	1	5	0	0	0	14	0	24	1	3	528	0	0	10	1	0	0	0	31	0	25	4	0	4	0	0	5	0	21	0	3	59	3	0	10	0	4	0	6	3	4	58	0	0	0	7	0	0	0	0	0	0	0	0	0	0	12	0	2	0	0	5	0	0	0	0	0	0	0	29	280	0	1	0	5	24	13	4	12	35	6	0	0	109	18	66	0	0	8	2	62	0	0	0	5	19	0	0	11	1	0	1	1	2	1	26	0	2	0	89	0	0	0	0	2	0	0	29	27	3	0	24	2	0	0	0	0	2	11	49	0	7	5	0	0	0	15	0	14	14	19	0	0	6	4	0	92	39	0	4	0	0	3	0	7	1	3	30	0	0	0	14	46	2	3	0	0	0	0	0	5	4	0	4	0	0	0	5	0	0	0	5	14	0	0	4	77	3	20	0	0	25	7	8	0	0	136	2	8	0	0	2	7	10	6	10	0	0	0	2	2	3	4	1	1	0	0	0	0	14	24	0	30	1	1	0	0	0	3	6	120	4	8	0	4	2	0	0	23	3	3	0	14	0	0	0	0	6	1	2	9	0	0	6	29	0	55	0	4	0	1	0	0	0	0	0	0	0	3	3	0	0	0	44	29	0	0	0	0	123	22	31	2	0	0	5	2	0	0	0	0	3	0	3	88	11	0	7	2	2	1	4	0	3	38	2	42	15	22	35	4	2	0	5	2	0	31	3	0	10	16	32	17	0	0	1	8	16	0	36	38	4	26	23	28	14	0	0	0	0	45	0	11	0	6	0	2	4	7	0	5	7	0	0	0	0	10	0	7	0	15	6	0	0	6	0	0	127	26	4	0	4	0	21	26	15	3	6	0	0	2	0	26	5	0	0	0	0	14	20	3	134	6	0	0	12	1	0	35	0	7	0	0	0	0	0	0	7	0	3	0	26	0	0	3	0	0	8	0	5	0	0	0	0	0	12	0	2	11	13	0	1	5	30	78	0	2	49	4	0	2	15	0	8	0	6	3238	2	0	9	0	3	27	0	19	6	5	0	0	1	0	21	2	117	5	2	9	0	15	4	0	0	0	0	0	5	7	3	4	0	2	4	8	0	1	0	0	40	0	3	0	3	269	0	3	0	0	0	31	0	5	8	0	4	7	14	6	94	35	0	34	4	0	10	11	0	3	2	0	0	0	87	0	0	2	0	0	0	0	350	23	0	0	0	0	14	0	17	2	2	4	6	0	0	0	5	0	11	0	3	0	0	5	2	0	0	0	2	0	61	0	0	0	0	0	0	0	0	0	0	0	0	0	0	0	0	0	0	0	0	0	0	36	0	0	0	5	0	6	4	0	35	5	0	6	0	0	3	4	0	0	0	0	8	10	0	0	0	0	0	0	9	0	0	3	9	4	0	0	0	2	1	1	56	0	0	38	0	0	25	0	18	0	3	5	6	6	0	3	158	6	0	2	0	0	0	0	6	0	0	16	5	2	30	0	1	0	0	0	26	0	0	30	0	46	0	0	0	0	0	0	0	0	0	0	171	0	2	0	0	0	0	0	0	0	0	0	0	0	0	0	0	0	23	26	0	0	1	0	0	0	0	0	1	0	0	0	0	0	0	0	0	6	0	0	0	70	0	0	0	5	3	0	0	0	0	3	0	5	7	0	0	0	0	0	0	5	0	0	1	0	84	0	0	0	0	0	0	3	9	0	0	2	0	0	0	0	0	0	6	15	0	0	0	0	0	41	8	0	0	0	0	0	37	2	42	16	0	0	0	0	8	0	10	0	26	0	12	0	0	0	2	0	0	0	7	34	2	0	4	0	0	3	0	92	18	69	11	6	5	4	7	0	2	30	5	9	0	0	2712	2	12	88	0	28	30	0	35	0	3	3	52	5	0	48	3	2	1	20	74	2	0	0	80	8	11	9	0	714	0	0	0	233	58	101	0	4	0	17	16	2	43	0	56	0	0	19	2	0	1	0	19	0	2	0	3	0	3	2	2	65	0	29	0	6	4	10	6	94	28	0	23	0	65	3	4	3	30	0	0	1	13	0	19	2	0	0	0	0	2	2	14	11	3	3	0	13	43	33	8	8	45	2	388	32	0	0	1	1	20	0	2	0	0	0	0	6	0	4	0	2	0	0	9	2	50	2	59	6	3	0	0	0	11	4	0	0	0	0	7	3	2	6	2	0	1	0	3	0	0	8	0	1	0	0	3	0	2	0	0	3	1	4	0	0	2	0	2	3	1	0	0	1	6	0	41	1	10	0	0	0	9	1	19	0	65	17	0	0	0	2	5	3	0	0	3	33	16	200	1	2	13	1	0	26	17	24	2	20	8	13	16	0	37	8	0	4	68	27	0	0	0	2	2	2	13	0	2	0	0	0	0	0	0	6	50	0	0	78	0	0	8	3	0	0	0	1	0	2	19	0	5	8	78	77	0	9	2	2	0	33	0	0	0	4	32	16	86	0	54	1	6	0	3	2	136	3	0	5	104	0	0	0	12	0	11	0	0	0	0	24	10	152	0	0	65	1	1	1	4	40	3	0	24	3	0	16	126	50	3	32	5	0	0	10	22	0	0	5	0	0	3	0	3	2	1	0	1	0	9	2	0	201	0	0	33	0	9	0	0	1	44	6	41	2	2	69	4	0	0	2	62	1	4	3	38	46	57	11	24	43	14	42	5	41	18	0	1	0	3	34	2	0	5	13	0	4	1	0	0	0	0	0	7	20	17	10	26	219	60	38	0	177	8	0	0	1	4	9	5	0	0	0	0	2	6	1	0	0	1	0	0	424	8	16	0	0	3	6	0	0	0	2	2	0	28	4	2	1	13	0	22	0	2	14	0	2	25	0	0	1	2	13	0	57	55	33	11	2	2	48	7	1	0	50	25	3	0	0	0	2	0	6	171	0	0	1	31	56	32	38	0	0	2	0	0	0	0	0	55	0	0	10	3	5	0	4	0	100	80	37	3	0	20	6	32	6	22	12	0	14	0	0	33	9	0	12	4	24	0	147	261	29	5	7	4	122	0	0	1	1	0	0	12	0	0	0	0	0	558	16	2	0	11	0	27	42	3	0	1	0	0	1	36	28	3	34	37	0	3	0	44	5	75	20	47	19	32	8	1	34	201	97	0	55	12	0	0	3	15	25	10	14	0	1	0	2	2	2	2	4	2	0	3	0	0	8	50	19	366	300	24	6	0	3	16	3	2	20	1	0	8	0	0	0	0	0	0	0	0	2	2	3	6	2	1	0	3	9	2	9	1	0	50	2	0	0	4	3	26	0	13	30	8	15	5	7	29	29	19	41	46	1	0	1	1	152	103	19	0	0	2	6	0	12	0	33	6	0	0	27	14	2	2	0	2	5	1	2	32	99	0	0	0	3	4	8	2	8	7	0	0	0	0	2	176	2	46	20	380	6	8	0	0	2	0	141	0	5422	0	17	0	4	30	36	53	0	1	0	0	0	3	0	2	32	26	20	1	0	0	0	0	1	6	0	14	0	0	177	0	0	5	2	5	0	0	9	1	202	16	4	0	0	0	0	0	0	1	1	50	0	4	6	0	0	2	5	2	1	5	0	0	0	0	0	7	34	0	23	0	0	14	0	5	2	0	0	79	3	5	0	2	2	0	0	0	36	0	0	52	2	0	4	0	0	0	12	0	113	29	1	20	145	0	0	0	0	34	0	85	20	61	1	7	8	0	0	14	3	0	33	0	0	0	0	164	0	0	5	9	0	4	0	0	0	0	0	4	0	5304	31	49	46	5	706	1	1	93	9	28	13	455	319	246	13	100	56	38	1	0	106	47	28	15	10	5	0	8	1623	2	4	10	11	0	41	5	3	0	135	11	2	0	1	12	6	2	39	0	0	0	22	8	60	50	26	9	22	3	10	0	2	2	24	7	15	36	56	4	0	0	0	0	0	0	0	2	2	93	0	8	0	65	0	11	8	0	17	0	4	12	5	15	8	0	6	2	0	5	43	0	3	0	0	0	0	0	2	0	11	0	17	33	0	62	4	0	2	16	43	268	2	0	6	22	69	4	8	40	2	10	0	54	18	2	96	0	5	14	23	14	79	8	4	37	60	34	31	0	0	35	8	3	0	12	3	22	2	6	5	74	3	2	15	0	20	0	6	2	0	7	17	0	4	8	1	0	0	2	2	0	15	0	2	31	0	8	2	5	0	581	0	63	0	0	28	0	2	46	10	4	25	0	0	0	49	38	2	46	54	0	49	21	16	13	67	20	3	3	4	0	16	6	15	37	204	94	32	5	0	2	0	0	0	0	1	0	27	14	0	20	1	0	0	0	3	6	53	21	0	28	24	1	7	0	0	0	20	2	3	2	3	0	0	2	0	0	3	0	1	0	0	0	0	1	3	0	10	0	2	9	0	0	0	70	13	1	5	0	11	1	0	3	0	0	2	0	1	19	0	0	4	0	1	0	0	11	3	7	0	8	19	0	30	0	0	0	3	0	0	0	0	12	160	0	0	0	4	2	1	17	0	31	0	0	0	0	2	25	0	28	2	16	21	1	0	2	0	1	12	0	1	1	0	30	16	12	4	9	5	4	8	5	9	0	11	0	6	0	49	157	8	8	29	5	26	2	0	0	8	4	0	9	0	6	0	5	13	10	9	10	2	0	10	0	10	0	10	2	14	6	0	23	0	0	0	0	5	53	0	11	4	12	0	1	2	51	32	0	144	0	138	5	0	0	0	0	3	29	0	2	0	10	0	1680	223	190	3	0	6	2	0	0	2	6	89	23	22	73	115	8	178	23	19	169	0	0	19	88	9	0	0	1	14	0	23	1	5	27	4	23	0	16	10	26	46	6	3	0	0	155	0	11	2	12	2	42	2	0	0	2	0	53	13	10	0	0	1	39	4	9	6	1	0	16	0	3	3	10	1	2	0	0	0	0	0	0	10	7	1	0	6	4	0	3	7	0	4	4	15	8	0	17	18	3	14	11	0	0	57	5	0	0	0	0	0	0	0	0	2	0	3	0	0	0	0	33	0	7	0	0	0	57	4	0	0	0	8	0	0	0	0	0	0	9	0	3	4	0	9	2	0	0	0	13	0	80	101	29	78	0	26	4	93	3	0	0	0	0	0	0	2	0	0	1	0	0	10	79	40	8	0	1	1	1	0	0	1	0	89	19	2	2	88	1	16	1	0	13	86	0	0	0	30	0	0	9	193	89	8	19	0	0	6	0	5	15	3	66	0	0	2	39	37	6	2	20	33	15	76	10	0	7	39	24	0	20	120	131	29	4	2	0	0	4	9	12	65	0	2	0	0	0	4	19	0	5	1	0	0	0	0	15	0	5	2	0	0	0	1	0	0	8	7	6	0	77	7	1	0	2	1	0	0	0	0	12	35	13	0	12	44	5	6	2	1	6	0	2	4	0	6	0	1	0	10	9	2	0	1	1	0	0	52	8	22	6	4	17	2	6	0	0	2	1	0	15	15	0	16	88	0	0	0	0	0	2	0	19	4	4	11	60	35	19	0	0	10	4	1	2	2	4	0	0	0	1	11	50	11	3	3	2	0	0	0	4	0	4	0	29	11	0	0	2	0	0	6	14	6	12	2	19	1	1	1	0	13	0	58	0	9	4	0	3	13	0	0	3	1	21	25	1	2	26	46	35	0	0	41	0	26	4	2	165	0	0	5	5	5	0	0	1	0	5	0	1	69	24	0	21	12	23	2	12	181	0	2	0	0	0	5	0	0	0	4	0	2	0	0	4	7	3	5	11	2	9	0	0	0	2	5	0	2	3	21	34	19	0	0	0	0	80	4	4	2	0	0	74	80	0	12	2	0	4	5	73490	0	0	2	0	0	4	0	0	0	0	0	0	0	0	8	0	19	0	0	0	0	65	17	169	40	1	4	19	2	2	3	0	0	0	0	11	2	51	104	0	124	16	1561	0	0	0	0	2	0	10	0	1	6	0	46	28	28	117	275	31	38	14	0	26	10	0	14	7	0	166	18	67	18	0	6	0	18	15	3	3	49	90	39	8	101	0	0	0	0	3	0	2	9	2	60	13	1	77	8	13	3	114	84	2	0	99	23	2	4	2	6	0	2	0	0	0	4	1	28	86	17	73	692	4	426	27	9	41	128	329	326	518	4	5	121	29	154	54	0	233	122	18	0	0	0	0	0	171	28	267	925	11	0	6	0	0	910	30	8	11	3	0	15	0	0	8	0	0	0	0	3	2	0	6	2	28	2	19	2	0	0	37	0	0	2	0	29	91	60	28	0	0	4	3	1	19	33	8	2	20	0	3	0	8	25	24	24	0	30	4	0	0	17	12	0	0	0	16	0	0	0	0	2	0	0	0	0	20	8	2	1	1	37	7	18	0	12	60	0	0	0	3	0	0	27	0	14	4	0	0	134	31	0	0	6	3	69	10	0	21	5	0	12	20	2	0	2	0	0	2	0	6	0	0	0	4	0	2	2	0	2	5	0	18	3	3	0	2	23	0	0	3	0	3	4	0	3	0	0	0	2	0	4	6	0	5	0	2	0	9	0	0	51	0	12	12	3	16	2	2	8	12	0	4	1	1	31	26	6	111	1	2	12	258	0	13	41	17	0	7	8	5	76	0	3	30	0	14	41	10	25	0	1	0	3	0	0	2	0	5	0	1	0	23	7	24	0	0	0	0	9	13	1	0	0	0	0	4	2	0	26	103	11	2	159	0	33	30	1	3221	5	0	2	6	14	31	45	32	34	0	3	28	2	26	0	4	0	1	0	0	0	0	24	0	0	14	32	24	0	5	5	33	14	7	2	0	4	0	0	2	0	1	11	10	0	45	0	12	0	17	0	4	5	6	2	9	6	8	23	41	0	1	0	0	0	4	4	119	148	34	48	27	36	47	8	0	3	18	34	41	21	0	0	7	6	36	0	3	0	6	0	2	0	72	0	9	8	3	5	0	8	0	6	6	4	0	7	8	8	7	16	9	4	20	0	1	9	3	4	0	2	6	229	4	9	0	0	0	0	10	2	1	5	2	0	0	5	0	0	0	0	6	0	1	2	115	0	0	3123	0	3	3	23	1	0	3	5	8	24	0	0	0	0	0	0	0	0	3	0	0	4	0	2	0	0	19	0	5	2	204	0	21	17	77	8	9	47	1	5	0	0	0	1	0	0	6	0	0	0	0	0	0	4	0	92	4	0	0	1	4	0	3	0	0	0	0	0	6	0	0	0	116	4	0	2	30	0	34	2	0	34	5	2	4	30	14	3	18	13	8	76	34	22	18	32	295	115	5	383	0	0	14	3	0	3	2	15	17	0	0	0	1	0	0	190	0	0	0	1	260	1	0	0	0	5	26	1	18	1	1	0	0	0	0	0	2	1	0	0	0	11	27	0	0	2	8	159	53	0	3	0	8	2	0	0	0	170	0	0	0	1	1	3	9	52	2	1	1	0	49	22	6	0	34	2	2	56	8	10	2	9	1	5	0	39	22	31	3	6	2	2	1	0	70	0	5	8	2	9	44	0	1	12	324	9	6	859	0	0	5	2	0	0	1	483	37	236	0	0	0	0	9	4	16	4	18	0	4	0	0	4	0	1	6	16	8	2	43	2	4	24	215	2	8	4	0	0	42	79	9	6	2	2	52	0	0	21	0	4	3	6	5	1	3	0	0	31	6	2	1	0	32	8	30	0	0	20	19	0	9	0	3	27	3	0	0	5	1	0	4	6	6	42	5	74	112	0	4	76	1	49	143	127	0	0	0	1	6	0	4	0	0	272	7	0	22	62	70	85	6	3	4	6	3	15	15	12	2	72	24	2	0	0	0	2	0	2	117	175	191	4	0	0	0	9	2	7	0	0	0	8	0	11	2	3	1	0	0	0	0	0	0	2	0	0	2	2	3	0	0	0	0	0	0	4	0	0	0	0	2	4	11	0	1	0	0	0	0	7	2	0	0	0	0	5	0	0	0	34	5	70	2	0	0	4	2	7	2	4	2	4	0	4	0	0	12	677	22	134	32	2	8	4	38	0	1	53	28	0	0	0	2	0	0	40	0	1	44	0	16	4	0	24	7	3	4	24	1	0	113	18	0	25	1	0	3	4	0	0	53	4	39	7	89	11	49	19	1	167	6	61	3	3	1	7	0	9	129	155	105	0	89	52	36	10	31	0	1	0	11	0	0	2	271	7	6	1	0	0	0	166	0	0	0	0	0	0	14	2	37	70	5	36	16	0	14	22	35	14	27	58	9	3	145	19	88	3	0	14	5	0	0	0	13	8	53	2	9	30	0	0	6	4	2	0	0	2	2	5	0	0	0	1	4	8	10	347	435	0	340	311	71	6497	45	0	14	1	0	0	0	0	28	2	29	9	0	2	39	2	2	0	9	3	2	0	0	0	0	0	0	400	116	4	33	83	9	0	1	0	2	0	250	0	449	0	1	1657	1	0	0	35	0	41	1	3	1	2	3	2	0	0	1	0	2	28	0	2	0	0	0	0	0	0	0	6	0	0	12	21	6	9	2	5	4	0	0	0	5	0	0	4	39	0	330	157	0	17	16	31	5	30	5	16	0	37	1	37	1	0	0	0	1	0	0	0	2	2	0	7	2	0	0	2	0	1	0	0	3	12	0	16	0	0	0	0	12	2	0	4	0	0	0	25	1	4	18	1	0	5	0	0	4	0	0	0	5	0	6	6	9	3	1	15	31	82	18	54	1	0	1	0	0	0	0	3	45	0	188	0	0	2	17	0	117	115	0	0	0	0	6	0	0	0	0	0	0	0	0	6	0	0	0	0	3	4	0	0	0	0	0	0	0	8	2	0	15	0	0	0	0	0	681	0	4	0	0	0	0	0	0	9	0	2	0	2	0	0	0	0	0	4	4	0	0	0	0	2	0	1	3	1	0	0	0	0	1	92	0	6	1	2	0	0	29	0	0	0	6	0	0	0	3	4	0	7	0	80	0	0	2	0	3	54	0	0	0	0	2	0	0	0	15	0	0	0	0	0	0	0	0	0	0	0	0	6	0	0	0	0	0	0	0	0	0	0	0	0	0	6	0	12	8	2	0	0	0	0	0	2	0	1	0	0	0	6	0	9	0	0	0	0	0	0	0	0	0	0	0	0	2	0	4	0	0	10	0	0	0	56	0	0	0	0	0	4	0	0	0	0	0	0	0	0	0	0	0	0	0	0	0	1	0	0	5	0	32	0	0	0	2	4	0	0	8	0	2	11	2	5	58	0	19	0	7	0	0	17	3	0	0	0	7	87	0	19	2	1	168	5	10	0	0	0	0	0	0	0	3	2	6	0	0	3	2	142	1	8	3	8	0	0	14	0	2	0	9	0	9	0	2	6	0	0	28	0	0	12	0	2	4	0	0	7	2	0	8	6	8	0	2	4	11	0	0	34	0	0	2	8	0	37	4	0	0	2	24	3	16	6	4	0	0	1	5	11	2	14	0	3	18	1	0	72	1	3	18	0	10	0	16	3	18	13	12	11	4	4	11	0	42	6	3	0	0	0	0	11	6	15	0	49	54	116	15	105	463	147	89	0	0	0	313	0	6	0	5	0	11	3	8	3	0	18	0	26	0	0	0	0	0	6	0	211	24	58	0	0	4	0	0	4	2	114	2	52	65	0	4	2	14	1	7	3	2	0	0	0	0	0	0	5	14	3	38	0	6	4	0	0	0	5	0	0	0	0	7	1	72	0	0	0	0	0	0	1	4	0	1	0	13	5	4	2	0	1	1	1	2	0	13	0	1	163	5	4	0	12	0	0	6	0	0	0	9	0	0	0	3	3	0	30	2	2	5	54	0	0	2	0	0	1	15	0	1	1	0	2	24	0	239	0	3	0	0	0	207	0	0	0	0	109	0	46	4	0	0	2	0	4	0	4	3	0	0	5	0	0	0	55	0	0	0	3	67	10	8	12	74	2	2	0	3	2	10	12	0	677	0	6	10	96	0	0	1	7	25	119	22	0	0	4	3	69	4	0	0	0	21	7	0	254	0	15	24	8	0	6	0	3	0	1	6	6	15	0	0	4	6	11	0	5	0	7	2	0	52	8	4	0	10	0	0	0	3	6	0	2	17	10	12	38	53	4	41	36	2483	0	54	2	25	65	0	64	49	11	0	7	1	0	0	12	153	18	0	1	0	0	49	18	0	0	0	41	0	0	0	0	0	15	3	0	47	14	21	0	2	138	2	0	0	0	0	0	11	0	19	4	11	8	16	4	1	6	0	0	0	16	0	0	5	8	20	0	13	0	12	3	29	65	4	5	41	5	0	3	4	2	2	106	100	0	0	0	2	0	0	2	0	3	14	0	2	1	4	5	0	14	29	15	3	10	2	5	15	10	20	0	4	0	15	5	68	0	4	4	6	0	0	3	77	68	152	46	2	0	0	6	6	4	0	0	0	2	12	2	103	30	99	0	39	0	0	19	7	0	0	4	0	0	0	38	28	71	14	33	5	28	10	118	0	18	5	16	1418	2	24	23	46	28	0	1	17	121	14	16	0	0	2	0	0	3	44	0	4	124	0	15	6	2	4	5	2	88	14	4	0	0	3	0	19	0	0	3	9	3	6	163	0	1	0	32	45	9	81	2	3	1	3	0	0	0	121	0	4	0	20	2	2	0	27	0	10	171	31	5	63	0	0	0	40	64	0	0	6	1	0	50	1	2	3	1	0	0	0	21	22	11	0	18	5	39	7	0	2	6	0	0	4	0	49	1	4	0	55	0	2	4	2	6	56	2	26	8	3	0	4	5	3	56	30	0	4	5	1	3	0	0	0	2	10	9	0	0	20	85	25	1	5	0	0	1	3	0	0	0	0	11	16	12	37	8	232	14	0	189	0	20	676	15	34	27	100	75	0	381	15	48	175	31	243	82	0	2	1192	10	3	6	0	1	4	17	2	10	45	0	1	3	4	0	0	0	3	6	0	2	1	10	2	8	25	10	7	1	0	0	0	0	0	3	0	0	0	1	2	8	0	5	0	0	2	0	0	0	0	0	0	0	0	20	16	3	0	0	1	0	2	0	0	0	0	7	0	0	2	0	0	0	0	0	0	0	0	2	0	9	43	4	81	11	4	0	29	1	2	2	37	48	42	4	0	0	55	5	0	0	2	3	10	0	2	2	2	0	0	0	36	226	5	64	4	46	1	0	4	46	9	28	11	1	0	2	3	6	1	7	0	0	8	3	0	0	2	2	1	36	3	19	22	21	0	35	45	23	0	38	19	13	1	0	0	0	2	0	6	103	2	8	0	3	2	0	0	12	8	24	0	0	104	42	2	27	0	62	0	4	0	0	7	7	3	0	169	0	1	0	3	7	366	1	0	0	0	14	2	27	2	0	194	0	0	8	16	0	47	5	5	0	14	117	0	1	0	11	0	6	0	15	5	6	31	12	80	22	0	2	0	22	2	50	8	2	0	18	41	30	53	15	22	0	8	13	0	63	0	4	116	18	5	0	0	47	0	0	4	15	3	0	16	2	7	6	0	0	0	18	5	2	0	3	1	0	4	2	7	2	1	0	0	0	0	25	3	3	0	0	0	0	5	0	14	0	0	0	0	0	0	0	92	28	4	15	7	0	41	0	0	244	8	250	25	34	0	0	421	89	0	12	73	0	0	0	39	12	16	6	5	35	0	32	45	13	4	5	1	3	0	75	6	25	0	0	156	122	73	0	0	0	5	0	0	0	30	0	7	4	18	0	7	0	0	0	0	10	2	358	2	202	23	18	0	152	10	14	0	0	0	0	0	6	0	0	0	9	0	16	1	12	32	27	0	109	16	665	22	10	0	0	22	12	8	133	63	89	65	27	135	0	81	132	3	0	1	0	6	6	9	47	601	193	55	0	122	0	16	0	0	24	3	3	7	7	3	0	0	153	250	0	0	0	310	41	13	47	14	45	8	23	57	0	3	22	0	0	4	3	16	4	5	2	7	0	2	1	7	25	0	0	7	3	2	2	4	0	1	2	0	0	6	1	127	10	2	5	3	78	16	4	3	1	0	6	15	0	6	2	5	1	51	2	1	58	0	26	11	0	3	4	58	0	5	0	0	0	16	31	40	9	49	201	45	0	0	0	212	21	42	86	0	0	0	1	6	0	0	2	5	0	5	12	3	0	0	0	2	0	2	0	20	0	5	9	40	8	23	6	1	15	0	6	0	4	13	2	8	0	2	3	5	5	18	70	40	24	149	6	10	0	0	0	0	0	0	0	0	0	2	0	13	0	2	0	0	0	5	8	1	0	0	75	0	8	5	5	0	0	5	6	0	10	0	45	0	1	14	3	0	32	0	0	0	0	0	28	4	0	0	4	0	1	16	6	7	6	0	12	2	33	0	7	0	35	0	13	184	0	5	4	6	5	2	0	0	29	26	671	99	89	67	2	72	48	57	41	66	79	23	0	42	48	0	0	0	10	0	2	0	5	5	5	0	4	0	6	0	0	4	12	9	1	0	0	0	3	3	0	0	4	3	1	2	3	0	2	0	1	2	1	0	1	0	1	2	1	0	0	4	0	34	3	0	82	0	50	79	20	86	0	0	0	0	0	0	8	0	4	0	0	0	57	88	0	0	12	13	0	36	0	6	8	35	0	0	1	0	6	0	8	1	3	0	0	1	0	4	11	2	7	2	74	0	5	23	12	3	0	0	4	2	8	56	5	7	0	24	2	16	0	51	2	5	3	9	0	22	2	64	8	0	0	0	0	3	0	0	8	5	8	2	0	13	10	2	20	0	18	43	1	6	2	0	0	1	1	1	0	10	77	14	5	36	77	0	2	2	0	0	0	0	0	19	1	11	8	8	4
LakWasMeta7_HOW4_2_rpkm	2	0	0	0	0	13	12	1	0	0	14	23	0	4	0	0	0	4	33	0	0	0	0	41	0	0	0	2	0	23	0	0	0	15	2	20	2	2	4	0	0	0	22	2	34	32	64	35	0	6	7	4	0	0	1	4	0	18	168	17	239	6	0	20	40	0	0	0	8	35	5	5	0	0	3	5	0	0	0	2	0	26	0	1	0	2	0	0	3	1	0	2	21	3	17	24	2	0	4	6	0	0	1	0	0	3	1	1	0	0	1	0	33	5	31	6	0	3	0	0	0	1	4	16	0	0	6	7	0	0	4	79	13	0	0	0	0	0	8	1	7	1	0	23	0	1	0	2	21	2	3	16	2	2	20	0	9	20	21	0	12	7	0	16	10	10	0	6	1	24	0	1	0	0	2	0	2	2	0	0	1	0	0	2	0	24	0	0	0	6	14	1	5	0	0	0	1	4	2	175	43	0	4	0	0	2	29	2	28	11	1	2	35	6	10	0	2	25	0	11	4	10	13	2	0	9	0	4	7	0	4	11	312	1	0	0	38	9	32	5	1	3	26	2	49	14	0	3	2	33	13	23	21	0	1387	192	0	4	1	0	9	1	4	21	6	0	7	0	2	92	28	0	38	2	0	4	0	1	42	6	0	21	13	27	33	0	0	0	33	0	4	1	1	1	888	0	0	6	13	0	0	49	65	6	9	0	22	24	22	1	22	0	39	33	0	0	2	0	2	0	0	0	11	2	56	1114	0	3	10	0	4	5	0	0	0	0	4	0	1	0	1	4	10	27	61	2	14	0	1	3	3	5	2	2	7	1	2	0	0	212	6	0	3	1	0	20	5	44	8	10	2	8	0	0	48	3	0	8	2	9	1	1	4	7	3	0	33	0	0	0	1	0	47	5	0	11	40	1	0	0	0	4	0	8	42	0	4	0	4	3	0	42	13	10	0	75	59	38	3	0	0	0	1	1	0	0	15	2	0	2	3	0	7	0	1	43	2	2	18	0	54	6	1	0	5	86	1	0	0	0	2	90	6	175	11	27	95	0	0	0	6	4	2	31	2	15	16	0	1	3	6	15	44	8	2	0	14	0	52	2	7	0	18	1	0	1	0	51	41	2	0	0	118	102	0	0	3	1	0	0	0	0	6	4	0	2	1	3	0	1	0	1	1	1	2	0	7	0	6	14	0	0	0	0	2	0	0	0	0	0	2	0	1	0	15	1	26	7	0	28	0	9	3	5	30	0	6	0	2	0	0	2	3	0	0	8	0	0	0	0	0	2	2	4	11	4	31	0	24	0	0	5	0	18	6	31	10	236	18	85	53	351	80	11	89	4	8	5	57	0	0	0	23	0	16	7	2	0	1	0	28	1	0	1	19	19	1	52	0	3	4	148	54	67	4	1	99	1	189	10	86	26	8	13	1	14	1	18	1	3	11	22	2	1	5	1	0	1	0	12	4	32	3	2	0	3	0	30	19	0	20	1	9	16	9	3	6	1	0	7	0	108	6	27	0	9	2	4	33	31	2	26	1	1	3	2	0	0	3	0	0	0	10	1	1	0	2	0	0	42	1	0	28	3	38	0	1	7	0	3	0	11	2	0	9	3	9	0	89	0	0	0	0	0	16	41	0	9	15	1	1	0	7	6	4	0	2	0	18	0	0	1	2	0	0	0	0	1	0	35	2	15	4	8	30	28	4	0	0	7	0	0	2	1	0	21	4	0	26	12	0	8	0	53	1	1	2	0	0	0	0	0	0	0	0	28	1	0	0	0	1	0	6	2	0	0	0	0	0	15	12	6	2	0	3	4	5	2	1	33	0	1	0	0	65	35	65	1	1	0	0	0	2	0	0	0	24	0	3	0	1	0	0	10	21	5	1	13	3	2	4	0	0	0	0	0	2	53	61	0	0	0	0	0	0	0	0	4	34	19	0	0	0	3	0	0	2	3	0	10	22	12	10	6	0	6	1	0	20	3	3	3	5	1	0	0	19	0	12	5	0	4	0	6	3	6	3	1	5	1	0	0	0	0	4	0	5	0	0	0	0	0	2	2	0	4	4	1	0	0	0	0	0	4	37	38	39	31	24	0	0	0	1	1	0	0	0	0	0	0	5	1	0	1	1	0	1	0	0	9	0	0	1	47	24	0	0	15	1	0	0	4	0	0	7	0	1	0	11	0	7	0	1	0	1	5	0	0	0	2	1	8	6	286	4	30	0	1	0	0	7	17	19	0	76	2	0	2	0	0	0	0	0	0	3	0	21	4	0	0	0	1	0	0	0	0	0	0	0	1	0	0	0	0	1	0	0	53	0	2	0	43	7	2	4	24	0	0	458	7	5	0	0	0	1	2	0	5	75	2	0	5	0	1	0	0	0	2	0	0	0	0	3	5	12	0	2	0	0	6	4	22	0	44	0	0	0	0	19	12	7	0	2	1	5	6	2	12	14	3	0	2	1	0	0	2	0	0	6	42	167	0	0	0	0	0	3	0	0	13	0	0	0	1	8	18	10	0	13	20	1	18	0	0	6	2	0	10	0	3	7	0	2	1	0	2	14	18	27	33	6	0	0	3	0	24	6	0	1	3	0	0	0	0	0	0	0	0	0	0	0	0	0	1	5	0	4	1	2	1	0	0	0	0	0	0	0	0	0	0	4	6	0	0	7	0	27	0	0	0	0	1	31	0	3	0	0	7	0	0	6	13	3	4	8	742	6	0	0	24	27	3	0	3	0	9	9	0	0	0	0	0	0	1	0	0	7	8	0	2	0	3	6	0	6	0	0	0	8	6	0	1	0	0	10	0	0	10	2	0	14	0	236	3	6	7	0	1	0	0	10	0	15	73	132	7	4	0	4	1	15	3	0	25	0	8	1	1	0	0	0	2	14	8	6	32	4	10	4	10	0	1	5	4	0	20	2	0	5	0	1	4	2	0	0	15	0	0	10	1	7	1	3	0	0	2	0	19	2	14	1	20	0	1	0	9	2	3	3	1	0	0	58	0	5	2	1	2	5	0	0	0	0	42	13	0	36	22	35	11	0	2	8	1	2	0	4	1	4	25	2	2	1	0	3	3	23	17	1	1	0	0	8	3	22	0	14	3	6	16	0	1	33	19	0	20	18	2	3	0	0	0	5	0	12	1	4	115	12	40	34	12	45	0	0	8	53	16	0	4	1	23	2	15	14	0	4	2	1	6	6	78	38	35	0	1	10	0	0	0	0	0	2	12	8	1	0	0	633	5	6	44	3	3	39	0	7	16	0	0	2	6	0	12	0	2	0	0	3	4	0	0	0	753	60	34	91	2	4	2	0	0	0	2	3	60	24	10	18	50	0	0	1	63	213	174	14	20	2	3	5	123	0	2	0	0	2	0	0	0	221	17	22	62	67	18	2	16	12	10	0	0	0	0	0	4	95	1	5	0	0	35	0	21	0	4	4	3	0	8	0	4	0	1	1	8	8	0	0	0	0	0	0	1816	9	41	0	0	0	0	0	0	2	1	0	2	0	0	8	0	0	0	8	0	0	5	2	5	6	10	0	2	0	46	5	0	0	0	0	0	0	0	0	0	1	35	0	0	0	0	0	0	0	0	0	3	0	193	0	0	18	3	0	4	1	87	0	2	47	0	0	185	0	100	4	0	0	0	4	0	45	0	51	0	2	1	0	1	5	0	0	3	23	0	1	0	27	8	0	4	1	0	1	1	2	0	0	12	0	63	12	11	0	0	0	11	1	0	0	13	3	0	0	4	9	20	1	2	26	0	3	18	17	22	24	0	4	6	3	0	1	255	0	12	2	11	15	0	2	2	0	0	6	0	0	0	7	0	107	5	94	121	110	5	181	7	1	2	0	5	3	25	0	1	2	0	178	1	0	1	6	1	20	1	4	34	20	0	73	8	0	8	0	4	1	27	4	7	14	5	0	0	1	2	4	5	2	101	1	2	15	4	0	1	56	6	17	78	15	2	2	45	8	0	0	24	62	134	20	109	1	0	2	7	2	222	0	0	0	11	0	0	124	1	0	4	1	8	0	10	5	4	32	0	0	0	0	2	0	1	0	9	0	0	0	0	3	8	4	0	0	2	6	0	86	0	0	43	53	85	0	3800	2	0	2	0	0	1	1	0	0	0	0	1	5	10	1	2	0	28	0	105	2	4	0	0	8	1	0	49	3	3	0	1	18	7	12	0	0	0	6	0	10	11	1	4	17	2	5	0	0	0	0	0	42	1	1	18	3	1	3	0	9	177	7	34	0	59	199	0	52	1	43	1	36	10	10	8	8	0	2	26	10	0	0	0	2	0	0	0	0	5	0	3	2	0	7	2	0	11	0	5	26	0	0	0	0	0	2	0	2	2	0	0	0	0	0	0	0	0	17	13	16	0	1	0	6	0	14	10	12	5	0	13	18	0	2	4	1	2	0	0	3	0	0	1	0	0	0	9	0	0	7	5	0	0	0	0	0	0	0	0	142	5	45	35	10	3	17	0	21	0	6	67	62	10	0	0	4	4	0	0	0	0	0	36	0	0	8	3	0	0	9	4	0	2	0	0	1	5	2	0	4	2	85	2	45	17	0	39	7	0	23	2	19	13	114	3	0	0	0	0	0	0	0	0	0	0	20	0	0	0	0	0	3	1	0	1	10	0	117	628	3	0	0	0	0	0	8	0	0	3	10	125	11	0	0	0	1	0	0	0	4	2	0	37	0	0	0	0	0	8	0	0	4	0	0	0	0	0	6	5	13	0	1	85	3	1	1	0	0	0	0	2	7	0	0	1195	0	0	0	0	46	32	0	1	3	31	0	24	23	25	2	3	0	0	0	0	25	0	37	12	0	0	4	3	4	1	0	2	0	0	1	0	0	0	1	2	5	0	2	15	0	0	0	0	0	35	0	0	0	2	22	14	0	0	172	0	0	1	4	0	0	0	0	0	0	0	0	0	10	2	0	0	0	7	14	1	2	63	0	0	0	247	0	0	58	155	5	4	0	0	16	2	4	0	0	0	2	2	62	3	8	13	26	3	0	0	0	0	7	0	18	0	3	2	5	59	1	0	17	0	4	2	3	80	0	0	0	10	2	0	0	2	1	23	6	0	8	5	0	15	2	0	57	7	0	26	5	0	2	0	6	11	0	0	0	2	1	0	0	0	20	0	0	4	0	18	102	1	3	1	1	0	6	10	0	3	6	4	0	0	1	0	0	0	0	0	1	1	2	0	2	0	0	0	0	0	1	1	13	0	0	1	4	1	0	2	3	3	3	3	7	7	6	0	0	1	0	2	2	0	0	0	0	18	20	2	0	0	0	5	38	190	80	48	413	205	128	729	19	183	326	114	249	207	34	113	19	251	174	7	45	7	324	236	68	187	497	47	208	46	261	14	361	7	0	14	1	1	0	0	2	0	0	0	38	48	9	0	1	0	0	0	0	3	1	0	0	1	0	12	0	0	0	1	7	0	18	0	19	0	157	3	1	1	4	1	3	0	0	0	0	6	0	0	0	0	0	2	6	2	0	20	0	0	0	0	0	8	11	35	2	1	0	19	0	0	0	4	0	1	13	2	0	3	1	9	48	0	0	10	0	0	0	2	1	6	0	0	6	1	8	16	0	11	0	0	0	1	1	0	2	15	0	3	0	1	0	1	0	9	0	73	3	0	11	19	0	1	0	0	1	1	1	5	0	0	3	1	0	6	12	2	0	0	0	0	0	0	3	5	0	0	3	12	0	0	0	0	0	10	3	0	0	0	0	0	0	1	0	3	23	1	12	31	7	1	0	0	0	8	0	0	0	0	0	0	0	0	2	0	0	0	0	47	2	1	14	0	6	0	0	4	5	0	4	0	4	84	26	4	0	1051	3	9	2	0	0	1	3	0	0	3	9	0	0	3	0	0	9	0	13	314	5	2	1	0	21	0	2	19	4	0	17	0	0	104	3	7	3	0	0	0	4	1	3	10	0	14	0	13	0	1	6	0	5	0	3	0	0	0	0	0	1	1	25	3	0	0	2	0	3	0	0	0	3	0	0	5	17	0	3	0	0	2	10	4	86	155	4	7	4	2	0	0	0	0	0	1	0	0	1	0	0	0	0	3	15	8	10	4	4	2	0	0	0	0	112	0	55	130	24	0	1	0	117	0	0	1	0	3	0	0	0	0	0	0	1	1	86	16	0	1	0	1	1	0	1	1	0	1	18	4	19	2	10	0	0	0	38	2	1	5	0	0	0	1	0	0	3	0	0	4	0	0	50	0	6	0	4	2	7	6	5	0	5	0	26	2	7	0	12	0	13	0	10	0	0	6	0	0	3	0	0	4	2	2	0	0	0	0	0	15	14	0	92	0	1	23	0	224	2	7	11	1	1	1	4	27	2	16	4	0	0	0	0	0	0	2	0	18	0	0	1	0	0	0	66	1	22	70	60	14	0	28	41	8	5	17	6	24	9	25	4	18	8	30	2	24	17	0	4	32	2	10	1	18	0	0	0	25	0	8	7	2	16	18	7	14	4	5	9	4	5	4	4	1	10	3	4	0	33	38	4	8	0	1	8	20	13	16	0	2	0	4	1	4	7	0	2	4	0	16	12	0	0	0	0	56	0	0	2	1	0	0	0	0	30	3	0	23	0	25	26	2	0	0	2	12	0	0	0	0	0	0	0	93	15	3	50	52	49	0	29	2	3	0	3	54	116	0	1	1	0	0	6	0	10	0	6	2	0	0	5	1	3	71	4	0	42	3	2	246	0	19	0	3	0	73	60	0	0	2	2	3	7	0	1	0	5	1	10	3	0	3	50	4	0	0	49	15	5	2	2	0	0	0	546	128	414	40	0	0	3	4	0	3	3	36	0	3	4	5	0	1	43	354	47	12	1	0	2	0	1	0	72	13	1	0	0	2	3	0	0	3	0	1	0	0	0	5	1	0	0	0	5	0	95	38965	2	2	1	0	0	1	1	37	0	1	0	0	0	0	45	32	0	3	0	1	0	2	3	116	4	1	0	0	0	3	0	1	0	0	0	12	2	4	0	0	0	3	0	4	13	1306	3	0	0	0	0	0	8	1	0	0	0	8	0	0	0	10	3	16	0	0	0	0	0	10	0	0	0	0	1	1	3	0	1	3	0	0	2	0	2	1	26	0	2	2	0	4	0	0	1	0	2	0	0	0	0	0	0	0	0	18	0	0	0	2	0	0	91	0	0	0	1	0	0	284	6	0	0	0	25	8	8	62	4	3	5	0	0	29	6	0	70	0	0	13	6	0	2	1	0	0	0	0	3	2	0	4	0	0	0	0	0	4	0	0	3	0	4	0	0	0	1	1	2	3	0	0	1	1	13	0	0	0	2	2	0	0	0	0	0	0	0	20	0	23	0	11	16	5	12	12	0	0	0	2	0	5	2	1	5	14	1	7	2	25	1	6	0	0	0	0	0	0	0	4	0	2	0	13	18	5	1	19	0	28	0	2	2	0	0	0	0	2	3	0	0	4	0	4	2	2	18	1	150	46	0	1	0	7	0	0	0	0	5	12	0	1	1	0	0	0	51	582	0	83	0	2	0	6	0	0	0	0	1	2	2	2	3	0	6	8	19	14	0	0	0	0	3	0	2	1	17	3	15	1	0	0	0	0	3	10	0	14	0	0	0	0	20	0	3	0	35	0	18	4	2	0	0	17	0	1	1	0	59	7	4	0	64	0	0	0	0	0	8	5	691	0	0	0	2	0	0	0	3	0	0	1	6	0	2	2	2	1	2	355	5	1	0	0	0	0	0	50	0	1	0	0	0	0	0	1	0	0	0	12	11	0	1	0	1	0	7	5	1	0	0	0	3	1	2	1	14	0	0	1	1	0	0	0	7	0	6	0	7	0	0	13	0	12	0	0	2	0	0	3	0	0	0	0	0	0	0	0	0	2	0	1	2	0	4	0	1	0	0	0	0	2	0	0	0	1	10	0	0	0	0	0	17	0	0	0	40	0	0	7	2	0	0	1	0	0	0	1	0	0	0	2	0	0	9	0	1	0	0	0	2	0	0	4	0	0	2	2	24	0	21	8	0	0	0	0	0	1	3	2	0	0	0	17	0	0	0	0	3	40	0	0	7	78	33	1	3	8	0	3	0	0	0	0	0	2	0	0	0	0	30	0	1	48	0	0	0	1	5	0	0	0	344	1	1	0	0	2	0	0	0	0	0	3	0	0	84	0	15	0	0	0	2	11	0	4	4	11	0	0	1	6	0	23	0	5	0	0	0	0	5	0	0	0	1	2	0	0	0	3	0	0	0	2	0	0	0	0	0	0	0	0	0	4	0	19	0	0	0	0	0	4	0	0	4	0	13	0	0	6	5	0	0	0	0	0	0	0	2	0	0	0	0	0	0	0	0	0	0	0	0	0	0	0	0	0	0	0	0	0	0	7	0	0	0	6	0	0	0	0	0	0	0	0	0	6	0	0	0	7	0	0	0	0	0	1	27	0	2	54	0	4	0	0	0	17	0	0	17	3	12	0	0	0	0	5	8	1	3	3	0	3	0	68	39	11	3	0	0	70	0	3	3	0	0	4	4	0	0	0	0	0	0	0	5	0	0	37	0	0	0	0	0	0	0	5	0	0	14	0	0	2	0	7	0	0	0	0	0	0	0	0	0	0	0	4	0	3	2	184	0	78	0	0	0	0	0	4	0	0	0	0	645	0	1	0	0	4	0	0	0	0	0	0	0	0	0	4	0	0	0	0	0	0	2	0	2	17	0	0	0	0	18	0	0	0	0	0	1	0	0	0	400	0	3	0	0	10	0	0	0	0	3	0	0	0	58	0	0	0	0	1	25	0	3	116	0	0	11	0	4	6	1	0	0	0	2	0	0	0	0	0	5	0	0	0	21	1	35	1	0	4	0	0	0	68	0	0	0	3	0	6	0	0	1	246	7	2	0	0	0	1	2	0	0	4	1	45	0	0	0	1	26	2	0	0	0	0	5	0	5	0	0	0	0	0	1	0	7	0	0	0	0	0	0	4	14	0	13	1	0	0	9	0	0	0	0	0	0	0	0	0	0	0	0	20	4	2	21	0	6	0	0	0	1	9	0	0	1	2	0	0	0	0	0	0	54	0	17	0	2	3	0	0	0	0	0	34	5	55	0	5	0	0	1	0	0	1	0	0	0	35	38	2	5	0	0	2	0	0	0	0	32	0	0	8	0	0	2	0	0	2	0	4	3	4	0	0	2	0	0	2	0	0	0	0	86	0	10	0	5	0	10	0	0	2	0	0	5	0	2	0	0	2	0	5	2	0	39	9	49	4	0	9	0	0	1	0	0	1	0	9	7	3	0	26	2	7	32	173	40	0	6	0	402	0	52	108	6	0	2	0	26	222	0	46	0	7	30	0	498	0	0	0	0	2	0	0	55	24	0	29	0	2	18	0	31	12	72	0	18	27	2	2	0	18	1	0	33	0	3	0	0	0	0	0	0	9	18	0	0	0	10	15	0	1	5	0	4	1	0	0	9	0	0	0	2	1	0	0	0	55	6	0	3	12	392	0	0	22	5	10	15	0	1	9	22	0	0	1	0	0	29	62	0	0	0	0	0	1	0	14	6	0	0	0	0	0	0	16	6	0	8	2	1	0	6	13	27	3	2	14	0	2	0	0	0	0	0	8	4	0	1	0	2	8	0	1	0	3	5	38	0	2	9	0	0	0	19	0	3	13	0	31	19	0	3	0	10	0	5	30	2	0	2	4	0	0	0	33	4	0	0	134	152	311	18	32	37	191	380	9	199	104	107	6	231	377	436	0	353	41	323	194	92	9	188	3	304	1	16	0	34	0	4	1	0	0	1	2	0	0	0	0	4	22	2	0	6	1	1	0	141	4	0	8	21	1	0	1	0	0	22	0	2	1	13	1	1	0	0	0	4	56	0	0	0	0	2	0	0	136	8	1	0	0	23	0	0	57	2	20	7	77	1	0	0	0	12	0	8	129	0	28	12	19	0	0	0	2	0	0	0	0	0	0	0	0	0	12	8	14	0	0	0	0	43	0	0	0	1	57	2	0	10	2	2	0	2	0	8	0	0	3	0	5	3	0	6	1	1	0	5	209	2	22	21	1	6	0	0	0	1	2	0	0	3	15	0	32	0	4	394	2	1	6	2	0	0	0	32	0	32	1	3	6	0	0	0	0	14	0	0	19	4	4	9	0	0	0	12	2	0	14	0	0	0	1	0	0	0	0	1	0	0	0	0	0	2	5	3	0	0	5	0	0	2	0	0	0	0	16	208	0	0	0	4	14	16	6	8	20	2	0	0	73	6	51	0	0	5	1	29	0	0	0	0	10	0	0	0	1	0	0	1	2	1	22	0	8	0	63	0	0	0	0	5	0	0	7	18	2	5	22	2	0	0	0	0	2	2	21	0	21	2	0	2	0	4	1	4	7	5	0	0	2	5	3	48	14	0	3	0	0	2	2	12	0	4	35	4	0	3	8	25	2	12	2	3	1	0	0	0	9	0	0	0	5	4	0	0	0	0	0	6	6	0	0	52	2	6	10	0	25	6	0	0	0	79	2	0	0	1	3	0	39	2	7	0	0	4	1	4	0	2	0	0	1	0	0	0	8	29	0	16	0	3	0	0	0	0	4	77	1	4	0	14	2	0	2	6	4	6	0	11	0	0	0	2	0	1	0	3	0	0	1	25	0	59	0	0	0	0	0	0	0	0	0	0	0	0	2	2	2	0	6	19	4	4	0	0	101	26	20	4	1	0	0	1	0	0	0	0	5	0	0	52	5	0	1	0	0	0	8	0	2	14	1	24	7	12	36	1	0	1	3	0	1	19	3	0	5	6	18	7	0	0	0	0	23	0	33	29	44	13	19	23	8	4	1	0	0	38	0	10	0	10	0	2	6	0	0	0	0	0	2	0	0	4	0	5	2	11	0	0	0	2	0	0	65	4	0	2	0	0	16	26	3	0	13	0	0	1	0	9	3	2	0	0	0	3	42	1	106	0	1	0	6	0	0	25	0	2	3	0	0	4	0	4	3	0	0	0	14	0	12	0	0	0	4	0	5	0	0	0	0	0	5	5	0	5	2	0	0	7	12	21	0	2	5	7	0	1	31	0	0	0	0	79	1	0	6	0	4	28	4	7	0	3	1	2	0	0	18	0	54	0	0	0	0	9	1	4	0	0	0	0	6	11	1	3	0	0	9	11	0	2	0	4	13	0	109	0	2	184	0	2	1	0	0	16	0	0	13	2	0	2	5	3	23	19	0	9	2	0	3	11	1	0	1	0	1	0	41	4	12	0	0	0	0	2	230	21	8	0	0	0	16	0	4	3	0	7	0	1	2	0	0	0	3	1	0	0	0	2	0	0	0	0	0	0	47	0	0	3	0	0	0	0	0	0	0	0	0	0	0	0	0	0	0	0	0	0	0	124	3	0	0	1	0	1	7	0	25	0	1	6	0	0	3	6	1	3	0	1	0	6	0	2	0	0	0	0	0	0	0	4	0	0	1	0	1	2	3	0	62	0	0	0	0	2	18	0	12	0	3	9	2	3	0	0	8	0	0	0	0	0	0	1	8	2	5	45	0	1	18	0	0	0	0	0	10	3	0	31	0	28	0	0	0	0	0	3	2	0	0	0	47142	1	0	0	0	9	2	0	0	0	0	1	0	0	0	0	0	0	27	26	0	0	1	0	0	0	0	0	2	0	0	0	0	0	0	0	4	0	0	0	0	143	0	0	0	3	23	0	2	0	0	5	0	0	3	0	4	0	0	0	0	0	0	0	0	0	48	3	0	0	0	0	0	0	2	0	0	29	0	0	0	0	0	0	4	7	0	3	2	0	2	7	12	0	0	0	2	0	24	1	17	10	3	0	1	1	6	0	11	0	16	20	182238	0	0	0	0	0	0	0	19	11	0	0	2	0	0	0	0	78	9	48	3	16	7	3	6	0	0	39	2	24	1	11	20	6	10	65	0	18	31	0	23	1	2	0	27	3	0	56	2	0	2	6	40	3	0	2	56	11	6	1	3	386	0	0	0	52	40	71	0	0	3	30	4	2	27	36	21	0	0	0	4	7	1	0	20	5	1	14	6	1	4	3	3	34	0	8	6	1	2	10	9	124	12	4	19	1	54	2	2	9	13	0	1	0	7	0	16	5	1	2	2	0	3	6	13	3	6	0	1	1	33	32	4	6	21	4	144	25	0	0	3	2	19	1	4	2	1	0	0	2	0	1	1	1	0	0	13	0	48	4	76	4	1	5	0	0	4	0	1	0	0	2	7	2	2	1	1	1	0	1	0	3	3	5	1	2	9	0	2	2	0	0	0	2	0	3	2	1	1	0	0	5	1	0	0	0	3	0	39	1	10	0	5	4	1	0	12	2	46	9	0	5	14	0	6	11	0	0	1	6	38	224	0	0	7	5	0	28	10	12	7	22	14	19	5	1	21	5	2	1	67	49	3	0	0	1	0	2	2	0	0	0	0	0	0	0	0	24	28	1	0	41	0	0	10	18	0	0	0	0	0	1	21	5	8	2	48	53	3	5	0	0	0	6	0	0	0	6	17	9	72	2	31	1	0	0	21	3	83	0	0	0	104	0	0	0	8	6	11	0	12	5	7	12	3	116	3	1	59	0	0	0	0	21	1	0	20	1	0	16	81	41	13	34	4	0	0	0	12	0	0	0	0	1	6	0	3	0	4	1	1	3	12	1	0	49	0	0	21	1	2	1	0	1	28	3	29	0	0	36	6	6	0	0	27	2	8	0	30	27	45	4	13	24	8	37	4	29	8	0	0	0	4	23	3	0	4	16	1	3	1	6	0	0	0	0	0	26	9	8	17	175	66	47	0	126	0	0	0	4	1	2	0	1	0	1	0	2	0	0	0	0	0	0	0	169	5	5	0	1	2	7	0	0	0	1	3	0	34	0	2	0	8	1	16	4	0	8	2	0	21	5	2	7	0	16	0	48	28	8	6	1	6	21	1	4	0	21	28	0	0	6	2	4	0	4	16	0	0	0	31	33	46	15	0	0	3	0	1	4	0	0	34	0	17	23	5	4	0	5	0	65	62	35	6	1	21	5	5	16	17	25	0	9	0	0	37	9	0	2	4	17	0	73	147	30	2	8	10	74	0	1	5	3	0	2	7	1	0	0	1	0	38	18	2	0	18	0	21	39	13	5	3	1	1	0	23	12	4	30	33	2	0	0	32	0	34	4	27	8	21	6	4	18	127	53	0	34	4	0	0	4	14	14	2	15	3	3	0	11	1	0	0	3	3	0	0	0	0	10	36	19	236	199	12	6	4	10	6	4	10	16	0	0	6	0	0	0	1	0	0	2	2	7	4	4	1	7	2	0	0	2	1	14	1	2	98	1	0	0	5	0	17	0	1	43	14	13	9	8	30	15	13	22	31	1	0	1	3	73	66	13	1	0	2	10	4	9	0	11	4	0	5	31	7	0	0	0	1	0	1	1	19	65	0	0	0	1	2	5	3	5	5	6	0	3	0	0	109	2	14	23	379	5	12	3	0	1	0	73	0	2487	0	12	1	10	39	14	27	0	0	0	0	0	0	0	0	11	12	7	4	4	1	1	0	2	3	0	4	4	0	156	0	0	6	1	0	0	3	7	0	433	17	3	0	0	0	0	0	3	3	3	15	6	1	6	0	0	0	2	1	0	0	0	0	0	0	0	0	24	0	25	6	2	10	0	0	0	0	3	48	4	0	2	1	0	2	0	0	30	0	0	39	1	0	2	0	19	1	8	0	82	33	5	17	92	0	2	3	1	27	0	54	20	64	3	0	0	0	3	14	8	3	50	0	2	2	0	83	0	0	4	8	2	4	1	1	0	0	0	0	0	4661	15	39	47	6	1160	1	11	49	2	9	13	274	240	146	28	57	29	36	1	0	352	50	22	23	6	1	4	0	1250	7	0	11	3	1	36	8	0	0	213	13	5	0	5	1	10	2	16	0	3	1	5	37	50	16	24	8	17	2	14	0	0	0	38	4	8	24	14	3	0	0	0	2	8	0	0	4	6	4	0	2	2	32	0	2	6	0	5	0	6	3	6	11	4	0	16	0	0	6	13	0	2	3	0	1	1	0	3	0	10	2	16	16	1	46	5	1	1	25	32	190	2	0	6	41	41	6	14	34	1	10	5	17	11	3	80	0	1	12	11	24	59	6	6	16	38	21	21	0	0	25	8	1	0	16	3	23	2	2	0	66	2	3	10	0	8	0	4	2	0	0	24	0	0	4	4	0	0	0	3	1	10	1	1	9	0	4	6	12	1	183	9	11	0	0	30	2	1	21	5	0	37	0	0	0	36	23	1	36	39	0	27	7	12	11	47	16	13	2	4	1	4	0	15	24	160	59	13	2	1	0	0	1	0	0	1	0	40	3	2	14	0	0	0	1	2	10	39	23	0	22	7	7	2	0	0	0	17	1	1	1	0	0	2	0	0	0	2	0	0	0	0	0	0	0	1	0	7	4	0	3	0	0	0	38	23	7	1	2	26	1	1	3	0	5	0	0	2	13	1	0	0	1	0	2	1	13	0	8	1	5	13	5	8	0	0	0	0	0	0	0	0	16	85	8	0	0	2	0	2	40	0	18	1	1	2	0	2	6	0	32	4	17	16	1	0	2	0	2	10	0	1	2	3	36	6	3	0	19	5	13	8	2	8	0	4	0	13	8	10	23	16	14	20	5	15	0	2	0	7	2	6	12	54	12	3	4	14	15	4	12	3	7	15	37	7	2	5	8	15	2	0	34	0	0	0	4	6	56	3	2	3	14	0	1	0	29	23	8	153	2	89	7	0	0	0	3	0	25	0	8	0	12	0	2030	465	156	29	0	13	1	0	0	2	8	78	16	40	69	36	13	140	39	20	107	0	5	8	44	10	0	2	1	57	0	16	2	6	27	7	15	8	8	4	20	34	8	0	0	0	38	0	3	0	4	0	19	5	0	0	0	0	55	9	6	3	0	3	22	4	11	4	12	0	0	4	1	6	10	1	1	0	0	0	0	0	2	6	3	4	0	9	1	0	0	4	0	2	4	5	2	2	19	24	1	37	39	6	2	26	0	2	0	1	0	0	0	0	0	1	2	3	0	0	0	0	28	2	6	1	0	0	17	0	1	2	0	6	0	1	0	3	0	0	7	0	1	1	2	11	6	3	0	0	6	0	56	64	26	81	0	34	4	46	3	0	0	1	1	3	0	0	1	0	0	0	4	13	48	19	4	11	1	2	1	0	2	2	0	52	23	2	4	68	1	15	1	0	9	68	0	0	0	23	3	0	11	126	51	10	29	3	0	3	1	9	8	2	42	0	2	0	38	28	9	9	10	37	4	41	9	0	0	19	9	0	11	78	132	11	0	1	1	0	11	14	19	55	0	3	3	0	2	0	17	0	7	1	0	0	0	0	4	0	4	3	1	3	0	0	0	0	5	10	11	0	65	3	1	0	0	0	0	1	0	3	24	28	7	0	9	33	1	6	4	2	4	4	3	0	0	6	0	2	3	9	6	6	9	0	2	1	1	29	0	23	3	1	0	5	2	0	0	4	2	2	11	17	0	6	48	2	8	0	1	0	3	0	3	0	3	12	41	56	12	0	1	10	2	0	5	4	0	4	4	0	1	38	34	7	6	2	4	0	0	2	23	3	0	8	33	10	0	4	2	0	3	2	3	10	7	1	77	2	7	1	0	1	0	16	3	13	3	0	2	15	0	1	6	0	39	11	0	0	27	42	26	0	0	45	3	26	2	9	215	0	0	21	0	3	1	0	3	0	5	1	7	48	14	0	23	5	18	4	2	104	1	0	0	5	0	2	0	10	0	3	0	0	0	1	2	4	2	5	0	0	2	0	2	0	0	2	0	2	0	9	16	17	0	0	0	1	44	12	2	0	0	0	63	61	0	6	1	3	3	6	30858	0	0	0	0	0	3	0	6	0	0	0	0	0	0	3	0	14	0	2	2	0	41	3	69	27	3	3	17	10	8	1	1	0	0	1	12	0	34	75	0	116	11	1	1	0	0	4	4	3	6	0	2	13	0	126	423	26	72	104	18	33	34	0	16	4	0	35	0	2	139	36	59	15	0	2	0	7	5	3	0	54	33	12	9	23	0	0	0	0	18	0	1	10	0	47	12	1	64	1	11	0	44	57	4	0	71	10	2	2	0	1	0	1	0	0	0	6	1	12	102	19	49	501	6	279	9	6	36	105	143	221	166	0	0	107	8	163	75	0	67	84	34	6	0	0	7	0	99	6	205	487	17	0	15	0	1	26	24	6	19	2	2	2	0	0	0	0	1	0	0	0	2	0	7	3	4	4	14	1	3	2	20	2	1	0	4	18	76	18	21	0	0	0	2	0	10	23	12	0	11	0	0	1	18	0	18	19	0	18	2	0	2	18	81	1	0	0	3	0	0	0	0	1	2	0	0	0	18	0	2	0	3	28	5	4	0	0	0	5	0	0	3	6	3	14	0	15	1	0	1	95	40	0	0	3	5	32	1	0	7	10	1	1	5	0	0	1	0	0	0	0	0	2	0	2	5	0	0	4	0	0	8	0	3	3	3	2	0	13	1	1	54	0	7	12	0	7	0	0	0	0	0	0	7	0	4	0	4	0	2	3	4	36	0	9	7	2	5	0	0	6	9	0	1	2	0	20	24	4	57	1	4	18	200	27	7	25	3	0	0	5	7	54	0	1	8	1	12	18	20	15	0	1	0	2	0	0	12	0	4	0	0	0	14	9	16	0	0	3	1	0	20	2	0	4	0	0	0	2	3	17	63	12	8	82	0	31	23	7	20	2	6	9	19	5	24	21	5	23	0	1	24	2	27	1	3	0	0	4	0	0	0	7	0	5	20	25	12	0	3	17	26	3	3	11	4	0	0	0	15	0	2	4	4	0	29	7	8	0	7	0	67	5	7	1	8	9	5	39	19	0	0	0	0	0	0	15	60	160	38	35	15	38	24	3	0	4	8	25	37	6	0	2	15	2	19	0	15	2	10	2	0	19	42	5	5	7	0	4	1	12	0	4	4	12	0	20	6	15	0	11	2	4	14	0	1	2	0	1	0	2	3	126	0	12	0	1	0	1	3	1	2	0	5	0	0	21	3	4	1	0	0	0	3	3	58	2	0	0	0	4	2	48	0	0	4	14	6	50	0	0	2	0	0	0	0	4	3	0	0	3	1	0	0	0	0	0	0	0	174	0	10	19	36	8	10	29	0	2	0	0	0	0	0	0	4	15	0	4	0	0	0	0	2	58	0	6	0	2	2	0	3	0	0	0	0	0	6	0	0	0	101	0	1	3	18	2	22	3	0	11	6	2	9	15	4	5	13	11	8	358	20	12	28	13	128	16	11	152	0	0	15	0	4	3	7	21	4	0	0	0	2	6	0	93	0	0	0	0	214	2	0	0	0	6	52	3	14	0	1	0	0	0	0	2	1	1	0	0	0	11	16	0	0	2	4	84	42	0	1	0	8	1	0	0	2	123	0	0	0	1	0	4	7	36	2	1	0	0	33	7	5	0	37	2	0	35	13	1	1	7	1	0	13	30	6	19	2	0	2	6	0	0	135	6	3	4	1	9	27	0	0	18	347	14	2	687	1	0	1	0	1	0	0	318	37	99	1	0	0	0	15	6	6	0	19	1	11	0	3	5	0	4	1	19	5	9	49	3	1	29	145	2	12	1	0	0	12	35	2	0	6	1	5	1	1	11	0	0	1	4	4	1	3	0	0	37	4	2	0	0	24	6	11	0	0	17	35	11	7	0	4	44	0	0	0	0	2	0	4	8	2	49	9	71	74	4	12	56	1	63	132	89	0	0	1	0	9	0	2	1	0	171	5	0	28	34	45	78	2	7	6	0	15	6	16	4	1	40	20	0	0	0	0	7	1	0	106	82	151	3	0	0	0	0	3	4	0	4	4	16	0	9	9	0	0	0	4	3	0	0	1	7	0	0	0	0	6	0	0	0	0	0	0	1	0	0	0	0	1	11	6	2	0	0	0	0	0	0	1	0	1	0	2	6	0	0	0	28	4	28	3	0	9	5	3	2	2	9	4	1	0	2	0	0	9	13	25	88	40	9	2	4	48	3	6	37	14	0	0	0	1	5	0	27	0	2	21	0	13	4	2	16	10	2	7	23	1	0	73	12	0	17	0	2	2	1	0	2	37	2	35	4	49	4	35	19	3	80	2	11	0	3	1	1	0	24	59	118	55	0	51	39	30	8	9	1	9	0	5	0	0	1	19	4	2	0	1	0	0	113	0	0	0	0	0	2	15	2	31	48	3	19	4	2	34	7	25	14	5	42	13	12	85	35	44	0	2	2	1	0	4	0	0	7	139	6	20	16	0	1	4	6	1	4	0	0	0	1	0	0	0	2	7	1	9	196	236	2	266	133	35	3984	24	0	0	1	0	0	1	0	29	12	19	1	0	5	27	0	3	0	15	4	1	1	0	8	0	0	2	271	92	0	29	62	5	5	2	3	2	0	169	0	417	0	4	1158	1	1	1	23	0	30	0	5	0	4	6	0	1	0	0	0	0	15	0	0	0	1	0	2	0	0	2	5	2	0	5	4	0	16	19	5	4	0	0	0	0	4	1	1	11	0	274	117	2	7	20	26	16	12	13	4	0	16	0	33	19	0	0	0	1	2	0	0	0	0	0	16	0	1	5	3	0	2	0	0	0	14	0	20	0	0	7	0	3	1	0	0	0	1	0	49	1	3	24	9	0	1	1	1	1	0	0	0	5	0	3	8	7	7	1	10	43	33	2	34	1	0	0	2	2	2	0	1	39	2	99	0	3	7	6	2	55	26	0	0	0	0	1	0	0	0	0	0	9	0	0	9	0	0	0	0	0	0	0	0	0	0	0	2	0	6	2	0	0	0	0	3	2	0	428	0	0	0	0	0	0	0	1	4	0	0	2	0	0	0	3	0	0	0	0	0	0	0	0	0	0	0	1	3	0	0	0	0	2	95	0	2	1	2	0	0	21	4	1	7	0	0	0	0	2	8	14	5	0	2384	0	1	1	0	1	7	0	0	14	0	2	0	2	0	4	0	0	0	0	0	0	0	0	0	1	0	0	0	0	0	0	0	0	0	4	0	0	3	4	0	0	0	1	19	0	0	1	0	2	0	0	0	0	0	0	0	0	0	0	11	0	0	2	0	0	0	0	0	0	1	0	2	1	0	0	0	0	12	0	0	0	48	0	0	0	0	0	0	2	0	0	0	0	0	0	0	0	0	0	0	0	0	1	0	1	3	2	2	34	0	0	3	0	3	0	6	6	2	0	0	13	0	34	0	68	7	2	0	0	13	2	6	0	0	5	139	0	8	1	0	143	0	31	0	0	0	0	0	0	2	4	4	1	0	0	2	3	95	0	10	0	16	0	0	8	0	4	0	6	3	19	0	2	5	6	15	48	2	6	13	0	0	14	4	0	7	2	0	6	40	5	0	0	7	4	0	0	39	0	2	0	3	6	22	0	0	0	0	21	4	27	6	7	0	6	0	14	0	0	7	3	7	61	1	3	302	3	4	3	0	4	0	39	4	14	15	0	0	5	0	14	23	7	4	2	0	2	2	3	25	0	11	4	38	31	160	8	142	300	95	74	0	11	2	144	0	477	0	1	0	2	0	2	0	0	11	0	22	0	0	0	12	32	4	0	149	22	50	4	1	4	0	0	0	0	56	5	28	48	10	2	1	7	2	1	6	1	0	0	1	3	0	0	14	7	2	7	0	4	8	3	1	2	7	0	0	6	1	5	1	24	0	0	0	0	0	8	0	5	0	1	1	4	12	0	0	0	4	11	0	4	3	7	1	5	62	1	1	0	9	0	4	5	0	0	2	6	0	0	1	3	17	1	25	0	1	0	57	1	0	0	0	0	5	12	0	2	0	0	5	13	0	145	0	58	0	0	0	78	2	1	1	1	60	1	21	2	0	0	3	4	0	1	0	4	0	0	0	2	0	3	11	0	0	0	2	59	17	0	40	66	0	1	1	3	0	4	16	2	512	1	7	3	90	0	0	1	15	17	149	7	0	0	6	0	39	0	0	0	2	16	12	7	294	2	22	21	4	3	0	0	0	0	0	2	12	5	0	1	0	6	0	4	2	0	8	0	17	47	13	6	0	19	1	0	1	6	2	0	11	17	18	18	40	44	2	27	26	3	1	37	14	11	39	0	29	42	14	2	8	0	0	0	23	87	8	1	1	2	0	49	21	1	0	0	24	3	0	2	0	0	4	2	0	28	26	25	2	4	100	0	0	0	0	0	0	15	4	21	0	12	4	6	9	5	5	0	4	0	7	0	0	3	9	14	4	8	0	21	0	16	32	7	8	53	7	1	2	13	5	4	155	111	2	7	0	0	0	0	1	0	1	17	0	0	1	1	0	0	2	14	10	0	18	0	5	12	4	17	0	4	0	15	3	50	4	7	6	3	0	0	8	51	28	81	29	1	1	1	2	0	7	0	0	6	2	5	5	80	38	60	0	18	0	0	15	7	8	0	0	0	0	2	17	13	13	3	24	6	13	0	67	0	3	6	15	4264	1	22	31	32	25	3	3	20	55	49	8	0	1	0	0	0	0	30	0	0	86	0	2	0	1	0	0	1	67	28	10	0	0	4	1	3	0	0	0	12	6	4	299	0	0	0	13	21	7	82	2	4	6	3	0	2	0	70	0	2	0	19	1	1	1	79	0	3	74	39	6	43	0	0	1	13	79	0	0	2	0	0	27	1	0	1	0	0	0	0	13	24	11	0	10	4	14	6	0	0	0	0	0	4	0	73	2	2	0	43	0	1	8	2	6	60	0	23	12	0	0	1	8	0	46	19	0	4	2	4	2	6	1	0	9	5	7	0	0	17	62	20	2	1	1	3	1	1	0	0	0	0	2	8	8	8	0	177	10	4	96	4	15	548	11	24	15	58	81	0	196	6	7	109	9	97	37	0	3	1	6	1	8	0	3	4	6	1	3	34	0	0	0	13	2	0	2	2	2	0	3	0	20	4	14	10	6	0	0	0	0	0	0	0	0	0	0	0	0	0	4	3	0	1	0	9	0	1	0	0	0	0	0	0	24	19	3	0	7	0	0	0	0	0	0	0	0	0	0	0	2	0	0	0	0	0	0	0	4	0	6	26	2	46	6	0	0	40	1	0	0	48	4	39	7	4	0	59	0	0	0	1	5	11	0	0	0	1	0	0	1	20	99	17	62	7	21	1	3	1	21	6	13	9	3	4	2	7	0	0	0	2	6	3	6	4	2	2	9	0	22	6	23	1	21	2	36	28	46	0	31	12	7	0	4	0	0	1	0	4	80	3	4	0	1	0	0	0	5	5	24	0	0	65	22	3	66	0	29	0	0	0	0	12	2	4	0	122	0	1	4	3	7	181	1	0	1	5	23	0	18	0	4	164	0	0	4	15	0	32	8	8	0	9	75	0	2	2	13	0	4	0	5	0	9	8	4	47	15	0	2	1	14	9	30	11	0	6	21	19	3	50	37	19	0	0	13	0	13	0	1	266	5	4	0	0	20	0	4	10	9	3	0	27	12	2	3	0	0	0	7	4	6	1	5	0	0	1	2	0	2	1	1	0	0	3	20	0	0	0	0	0	7	3	8	6	0	13	3	0	0	0	0	86	37	0	4	4	0	38	0	0	161	11	207	38	24	0	4	190	90	0	12	41	5	0	0	9	18	15	11	3	30	0	26	35	8	4	2	3	0	2	16	18	7	0	0	100	45	40	10	0	0	4	1	0	0	43	0	4	2	8	0	0	0	0	0	0	10	6	266	3	143	20	11	0	102	7	10	0	0	0	0	0	7	0	0	0	11	0	37	1	11	33	4	2	153	15	442	26	8	0	0	13	13	0	170	34	36	70	29	130	0	75	66	18	1	0	0	2	0	7	15	689	129	40	0	78	0	14	0	0	30	4	5	0	8	0	2	1	69	124	0	0	0	172	37	11	68	3	47	11	10	64	2	4	19	0	0	10	7	12	12	1	1	2	0	2	0	3	9	0	0	2	1	0	0	2	2	0	1	2	0	0	0	104	26	2	2	0	42	31	25	5	2	2	9	20	5	0	2	0	6	27	4	2	55	0	22	10	0	2	4	0	2	4	3	0	0	17	21	15	9	34	69	21	0	2	2	157	8	62	60	0	0	0	2	0	0	0	1	4	0	2	8	0	0	0	0	0	0	2	0	17	1	2	4	27	14	20	2	0	10	0	17	0	5	7	5	12	0	0	2	8	35	30	43	14	21	122	2	8	0	2	0	0	4	2	0	0	0	1	2	11	0	1	0	0	0	1	6	0	0	0	10	2	8	0	2	0	4	5	5	2	0	0	38	1	1	9	0	0	11	0	0	0	0	0	17	1	0	0	2	3	3	20	9	20	2	0	11	12	37	0	5	1	52	0	19	74	0	0	6	0	5	1	0	0	32	45	361	73	119	42	12	45	20	27	13	34	15	19	0	25	25	0	0	3	4	1	5	4	4	0	4	5	8	0	1	0	2	2	2	10	0	0	0	0	0	0	0	0	0	0	2	1	2	0	0	0	0	0	5	1	0	0	0	1	0	1	2	4	3	33	5	0	67	0	28	62	16	48	0	0	2	21	0	0	3	0	1	17	0	0	51	69	0	0	2	5	2	29	1	10	58	26	0	0	1	0	2	0	14	1	1	0	2	0	0	5	18	2	3	0	50	0	11	8	4	2	0	0	2	4	2	38	26	2	0	16	2	15	0	25	0	10	3	5	0	13	0	36	7	1	5	0	4	2	0	2	4	9	9	0	2	14	9	9	14	3	0	65	5	4	1	3	13	0	0	1	0	3	30	15	9	29	50	0	0	3	0	0	2	0	0	7	0	4	7	8	7
LakWasMeta8_HOW4_2_rpkm	0	0	0	1	0	3	2	1	0	0	2	0	0	0	0	0	0	0	2	0	0	0	0	12	0	0	0	0	0	8	0	1	1	5	1	6	1	1	0	0	0	0	0	1	15	13	13	14	1	0	2	3	0	0	0	4	0	13	40	6	30	0	0	14	5	0	0	0	0	10	0	0	1	0	2	0	1	0	0	0	0	9	0	0	0	0	3	0	0	1	0	0	3	0	2	64	1	0	0	0	0	0	0	0	0	0	0	0	0	0	0	2	9	4	7	1	0	4	0	0	0	0	4	5	0	0	4	0	0	0	0	16	3	0	0	0	0	0	0	0	0	0	0	5	0	0	0	1	6	0	2	1	0	0	12	0	5	5	11	0	6	4	1	4	1	0	0	1	0	8	0	0	0	0	0	0	0	1	0	0	0	0	2	1	5	12	0	0	0	2	2	1	6	0	0	0	0	5	2	116	12	0	4	0	0	0	10	0	6	0	0	0	10	4	4	0	5	1	0	1	3	0	5	0	0	1	0	0	1	0	2	4	76	0	0	0	18	0	25	0	0	0	14	1	17	1	0	0	0	16	0	9	5	0	479	27	0	0	0	0	2	0	0	2	0	0	1	0	1	15	0	0	8	0	0	0	0	0	15	0	0	10	8	13	7	0	1	0	18	1	1	1	0	0	209	0	0	0	6	0	0	8	14	2	0	0	5	7	8	0	1	1	10	13	0	0	0	0	140	0	4	0	6	1	27	413	1	0	0	3	0	3	0	0	0	0	8	0	0	0	0	0	0	6	13	0	4	1	1	0	0	0	0	0	0	0	0	0	1	93	0	0	1	0	0	10	0	12	2	2	0	5	0	0	14	0	0	6	1	0	0	0	3	4	0	1	18	1	0	0	0	0	9	0	0	4	7	0	0	8	0	1	0	4	9	0	0	0	0	0	0	15	0	0	0	9	11	27	3	1	0	0	0	0	0	0	0	0	0	0	0	0	6	1	0	0	0	0	7	0	19	2	0	0	0	16	1	1	0	0	1	25	5	428	2	3	34	0	0	0	0	4	0	7	5	4	0	0	2	1	6	8	6	5	1	0	3	0	9	2	3	0	1	1	0	0	0	13	5	1	0	1	21	21	2	0	1	0	0	0	0	1	4	1	0	0	0	1	0	0	0	0	0	3	3	0	0	0	1	1	1	0	0	3	3	0	0	0	2	0	1	0	0	0	6	0	7	5	0	11	0	1	3	4	24	0	0	0	0	2	0	0	2	0	0	3	0	0	0	2	0	3	0	0	3	0	12	0	5	0	0	0	0	0	0	7	12	30	2	10	0	243	25	0	44	1	0	3	14	0	0	0	1726	0	3	2	1	0	2	0	13	0	0	0	12	6	0	7	0	0	1	49	9	31	4	0	16	0	32	0	26	14	6	8	0	4	0	18	0	2	4	3	1	2	0	0	0	0	0	3	0	4	0	0	0	2	0	8	6	0	7	1	6	4	1	0	1	0	1	1	1	50	0	3	0	2	1	0	12	2	0	12	0	0	0	0	0	0	1	0	0	2	1	0	0	0	1	0	0	9	0	0	1	0	21	0	0	0	0	0	0	5	0	2	13	0	2	0	17	0	0	0	0	0	6	31	0	0	9	5	0	0	3	2	2	0	0	0	4	0	0	0	1	0	0	0	0	1	1	6	0	12	4	1	15	15	2	0	0	2	0	0	0	0	0	4	1	0	2	6	0	4	0	15	1	0	2	0	0	0	0	0	0	0	0	9	0	0	0	0	0	0	1	0	0	2	0	0	0	3	0	2	0	0	0	0	4	0	0	10	1	0	0	0	8	0	51	0	0	0	0	0	0	0	0	0	2	0	0	0	0	0	0	0	3	0	0	6	1	0	1	0	0	0	0	1	2	17	11	0	0	0	0	0	0	0	0	1	2	0	0	0	0	0	0	0	0	0	0	5	6	5	8	2	0	0	0	0	4	0	0	0	2	2	0	0	0	0	8	0	0	0	0	5	0	0	5	0	0	0	0	0	0	0	0	0	1	0	0	0	0	0	0	1	0	0	0	1	2	0	0	0	0	2	9	3	11	17	5	0	0	0	0	0	0	0	0	0	0	0	7	0	0	0	0	0	0	0	0	0	0	0	0	6	8	0	4	4	0	0	0	0	0	0	0	0	0	0	0	0	0	1	0	0	0	1	0	0	0	0	1	1	0	67	0	10	0	0	0	0	0	9	15	0	17	0	0	0	0	0	2	3	0	0	1	0	19	0	0	0	1	0	0	0	0	0	0	0	0	0	0	3	0	0	0	0	0	24	0	2	0	16	3	0	1	5	0	0	115	0	2	0	0	0	0	0	0	0	4	0	0	1	0	0	0	0	0	1	0	0	0	0	1	2	0	0	0	0	0	1	0	0	0	2883	0	0	0	0	0	0	0	1	0	1	0	0	3	0	6	0	0	0	1	0	0	0	0	0	0	5	24	0	0	0	0	0	2	0	0	0	0	0	0	0	3	0	2	2	2	2	0	3	4	0	1	0	0	8	0	0	2	0	0	0	0	0	2	4	9	0	3	0	5	1	0	8	1	1	0	0	0	0	0	0	0	0	0	0	0	0	0	0	0	0	0	0	0	1	0	2	0	0	0	0	0	0	0	0	0	0	0	0	0	0	4	0	10	0	0	0	0	0	9	0	0	0	0	5	0	0	5	6	0	2	3	42	0	0	0	6	6	0	0	0	0	0	2	0	0	0	3	0	0	0	0	0	3	11	1	1	0	0	4	0	0	0	0	1	1	0	0	0	0	3	2	0	0	4	2	0	8	2	91	1	0	0	0	1	0	0	4	0	0	23	28	0	0	0	2	2	1	0	0	15	0	2	1	0	0	0	0	3	5	1	1	19	1	4	1	0	0	0	0	0	1	7	2	0	5	0	0	1	0	0	0	2	0	0	0	0	0	0	0	0	0	0	0	0	0	6	1	31	1	0	0	0	0	3	0	0	0	0	13	1	0	0	0	1	3	0	0	0	0	22	5	0	9	2	6	0	0	0	1	0	0	0	1	1	1	6	1	0	1	0	0	0	12	8	0	0	0	1	2	1	3	0	3	0	0	5	0	2	12	5	0	5	6	0	0	0	0	0	0	1	4	0	1	7	5	22	10	7	13	1	0	3	25	11	0	3	1	3	1	4	6	0	2	0	0	0	2	4	3	7	0	0	1	0	0	0	0	0	0	0	3	0	0	0	80	3	2	7	1	0	8	0	3	6	0	0	0	0	0	3	0	0	1	0	1	0	0	0	0	254	13	9	41	1	0	1	0	0	0	0	0	7	12	5	0	20	1	0	0	7	60	28	16	4	0	2	0	26	0	0	0	0	2	0	0	2	38	5	4	12	13	5	0	4	10	2	2	0	1	0	2	0	2	0	2	0	0	3	0	12	1	0	0	1	0	2	0	0	0	0	1	2	5	0	0	0	0	0	0	32	0	8	0	0	0	0	0	0	0	3	0	1	0	0	0	0	0	0	2	0	0	0	0	0	0	2	0	0	1	53	0	0	3	0	0	0	0	0	0	0	0	5	0	2	0	0	0	0	0	0	0	0	0	15	0	0	17	0	0	0	0	34	0	5	6	0	1	49	0	9	2	3	0	0	0	0	17	0	4	0	0	0	0	0	2	3	0	1	3	0	0	0	8	2	0	0	0	0	0	0	0	0	0	3	0	18	13	0	0	1	2	3	0	0	0	5	1	0	0	0	0	10	0	0	21	0	0	0	3	6	18	0	0	2	0	0	2	108	0	7	1	0	0	0	0	0	0	0	2	0	0	3	0	0	25	7	18	16	29	0	31	1	0	1	0	1	0	2	0	4	2	0	27	0	0	0	0	0	1	0	0	0	0	0	9	49	0	2	0	2	0	12	1	0	10	2	0	0	0	0	0	3	0	46	0	0	8	1	0	0	23	0	2	56	7	0	2	0	2	0	0	12	23	17	3	53	0	0	0	3	1	21	0	0	0	0	1	0	14	0	0	0	0	5	0	1	0	0	8	0	0	3	0	2	0	0	0	0	0	0	1	0	1	1	20	0	0	0	2	0	2	1	0	14	12	56	0	151	0	0	1	0	0	2	0	0	4	0	0	0	2	6	0	0	0	9	0	0	0	1	0	0	5	0	0	13	0	2	0	0	6	6	4	0	0	0	1	0	0	4	2	0	6	0	0	0	1	0	0	0	7	0	1	18	0	0	3	2	4	53	2	13	1	15	49	0	8	1	13	0	8	4	1	1	3	0	0	37	0	0	0	0	4	0	1	0	0	0	0	1	0	0	1	1	0	0	0	4	17	0	0	0	0	0	0	0	0	0	0	0	0	1	0	5	0	0	13	0	3	0	1	0	0	0	1	5	0	0	0	4	8	0	1	2	0	0	1	0	0	0	0	0	0	0	14	6	0	0	0	6	0	0	0	0	0	0	0	0	59	1	17	4	5	3	7	0	6	3	0	23	22	2	0	0	3	0	0	0	2	0	0	2	0	0	8	5	0	0	0	1	0	0	0	0	0	5	1	0	1	0	5	4	13	0	0	14	4	0	0	0	4	1	10	0	0	0	0	0	0	0	1	0	0	0	1	2	0	0	0	0	0	0	0	0	30	0	10	125	0	0	0	0	0	0	2	0	0	2	6	30	0	3	0	0	0	0	0	0	9	0	0	27	0	0	0	0	0	7	0	0	0	0	2	0	10	2	2	4	2	0	0	8	2	0	0	0	0	0	0	0	2	0	0	6	0	0	1	0	7	9	0	0	1	16	0	6	11	18	0	0	0	0	0	0	3	0	10	7	0	0	0	0	0	0	0	1	0	0	0	0	0	0	0	0	0	0	0	0	0	0	0	0	0	0	0	0	0	0	4	16	0	0	0	0	0	0	1	0	0	0	0	0	0	0	2	0	4	2	0	0	0	2	4	0	3	25	7	0	0	105	0	0	20	60	4	0	0	0	8	2	0	0	0	0	1	0	21	0	0	7	3	3	0	1	1	0	6	0	11	0	0	4	3	26	0	0	23	0	0	0	0	4	0	0	2	0	0	0	0	3	3	7	5	0	0	0	0	6	2	0	17	0	0	6	0	0	0	0	0	3	0	0	0	0	2	0	0	0	4	1	0	0	0	0	23	0	0	0	0	0	0	4	2	1	2	0	0	0	0	0	0	0	0	0	1	0	1	0	0	0	1	0	0	0	1	0	0	0	0	0	1	1	1	1	0	0	1	0	3	1	3	2	4	1	0	0	0	0	0	0	0	6	2	0	0	0	0	0	4	42	6	10	47	26	21	79	0	25	36	15	41	36	3	40	1	72	99	0	4	0	96	73	48	65	210	48	48	27	44	4	106	2	0	6	0	0	0	0	0	0	0	0	6	13	5	0	0	0	0	0	0	0	0	0	0	0	1	2	1	6	0	0	0	0	5	0	8	0	540	3	0	0	0	0	1	0	0	0	0	0	1	0	0	0	0	0	2	0	0	6	1	0	0	0	0	2	1	8	2	0	1	4	0	0	0	0	0	1	8	2	0	0	0	4	15	0	0	2	0	0	0	0	0	1	2	0	0	0	3	6	3	3	0	0	0	0	4	0	0	7	0	0	0	2	1	2	0	7	0	33	3	0	8	8	0	0	0	0	0	0	0	0	2	0	0	0	0	10	7	0	0	0	0	0	0	0	0	5	0	4	2	2	0	1	0	0	0	0	0	0	0	0	1	0	0	0	0	0	14	0	1	5	1	0	0	0	0	1	0	0	2	0	0	1	0	0	0	0	0	0	0	5	0	0	5	0	2	0	0	0	0	2	0	0	0	44	0	2	0	317	4	0	1	0	0	0	1	0	0	0	0	0	0	0	0	0	1	0	27	50	0	0	0	0	9	0	0	18	0	0	8	0	0	37	0	1	6	0	0	0	0	0	0	0	0	12	0	2	0	0	6	0	2	0	2	0	0	1	0	0	1	0	203	0	0	0	0	0	0	0	0	0	3	0	0	0	10	0	1	0	0	0	0	0	31	97	1	0	0	0	0	0	0	0	0	0	0	0	0	0	0	2	0	0	11	2	3	1	1	0	0	2	0	0	277	0	25	12	19	1	0	0	14	0	0	0	0	0	0	1	0	0	0	0	0	1	29	3	0	1	0	0	0	0	0	0	0	1	8	0	7	0	2	0	0	1	7	0	0	1	0	0	0	0	0	0	0	0	0	3	1	0	53	0	1	0	4	2	1	1	0	0	2	0	13	0	11	0	4	0	2	1	2	0	1	4	0	0	0	0	0	0	0	419	0	0	0	0	0	11	2	0	3232	2	0	2	0	101	1	1	2	1	1	0	2	6	2	4	0	0	0	0	0	0	0	0	0	1	0	0	0	0	0	0	21	0	0	37	10	2	0	5	15	4	0	4	1	6	0	5	2	3	2	7	0	5	7	7	0	6	0	6	0	4	1	0	0	6	0	0	0	6	3	13	2	2	1	0	0	0	2	3	2	0	4	0	4	0	13	5	2	1	0	0	2	7	7	2	0	0	0	0	0	3	0	0	0	0	0	5	3	0	2	0	2	11	0	0	0	0	0	0	0	0	5	1	0	9	0	183	6	0	0	0	0	0	0	0	0	0	0	2	0	68	1	2	27	24	16	0	8	0	2	0	0	5	66	0	0	0	0	5	2	0	0	0	4	0	0	0	1	0	0	5	0	0	11	1	0	73	0	10	0	0	1	18	17	0	1	0	0	2	0	1	0	0	2	0	7	1	0	0	15	0	2	0	18	0	0	3	1	0	0	0	193	28	46	4	0	0	0	0	0	0	0	12	0	2	0	0	0	0	10	118	14	1	1	0	0	0	0	0	23	0	0	0	1	0	0	0	0	2	0	0	0	0	0	0	0	0	0	0	2	0	38	1211	1	0	0	0	0	0	1	3	1	1	0	0	0	0	14	0	0	0	0	0	0	0	0	16	3	0	0	0	2	1	0	0	0	0	0	3	0	1	0	0	0	0	0	1	0	271	0	1	0	0	0	0	0	0	0	1	0	0	0	0	0	0	0	8	0	0	0	0	0	1	0	1	0	0	1	0	0	0	0	0	0	0	0	0	0	0	0	0	0	0	0	1	0	0	0	0	0	0	0	0	1	0	0	0	0	5	0	1	0	0	1	0	30	0	4	0	0	0	0	192	2	0	0	1	1	4	0	62	4	0	0	0	0	9	3	0	25	0	0	0	5	0	0	0	0	0	0	0	2	1	3	0	0	0	0	0	4	0	0	0	0	0	0	0	0	0	0	0	0	0	0	0	1	0	0	1	0	0	0	0	0	0	0	0	0	0	0	8	0	6	0	1	5	2	9	2	0	0	0	0	0	0	0	0	1	35	0	0	0	5	1	0	0	0	1	0	0	0	0	2	1	0	0	0	6	4	0	12	0	4	0	0	0	0	0	0	0	1	0	0	0	2	0	0	0	0	0	1	18	13	0	0	0	0	0	0	0	0	0	2	0	0	0	0	0	0	8	185	0	10	0	0	0	1	0	0	0	0	0	0	0	0	0	0	1	4	10	9	0	0	0	0	0	0	0	0	15	0	10	0	2	0	0	0	0	0	0	2	0	0	0	0	10	0	0	0	7	0	8	0	0	0	4	10	0	4	0	1	30	0	0	0	26	0	0	0	0	0	0	1	155	0	0	0	0	0	2	0	0	0	0	1	2	0	1	0	0	0	0	156	4	1	0	0	0	0	0	20	0	0	0	0	0	0	1	0	0	0	0	2	0	0	0	3	0	0	0	1	2	0	0	0	4	0	0	0	2	0	0	0	0	0	0	0	5	0	10	0	0	0	0	8	0	4	0	0	0	0	0	0	0	0	0	0	0	0	3	0	0	0	0	0	0	0	1	0	0	0	0	0	0	2	0	1	0	0	0	0	0	0	0	0	3	0	0	0	18	0	0	0	0	0	0	0	0	0	0	0	0	0	0	0	0	0	6	0	0	0	1	0	0	0	0	0	0	3	0	6	0	0	2	0	6	0	0	0	0	0	0	0	0	0	0	6	0	0	0	0	0	0	0	0	0	13	5	0	1	2	3	2	0	0	0	0	0	0	0	2	0	0	3	0	0	9	0	0	0	0	2	0	0	0	32	0	0	0	1	1	0	2	0	0	0	0	0	5	24	0	8	0	0	0	2	0	0	0	3	2	0	0	0	3	0	24	0	0	0	0	0	1	0	0	0	6	0	0	0	0	0	0	0	0	0	0	0	0	2	0	0	0	0	0	0	0	0	6	0	0	0	0	0	0	0	0	2	0	4	0	0	0	8	0	0	0	0	0	0	0	1	0	0	0	0	0	3	0	2	0	0	0	0	0	0	0	0	0	0	0	0	0	0	2	0	0	0	0	0	0	0	0	0	1	0	0	0	0	0	0	0	0	0	0	0	0	0	0	19	0	0	39	0	1	0	0	1	14	0	0	11	0	0	0	2	0	0	3	4	0	0	0	0	0	0	12	11	0	6	0	0	12	0	0	0	0	15	0	0	0	0	0	0	0	0	0	0	0	0	12	0	0	0	0	0	0	0	1	0	4	5	0	0	0	0	0	0	0	0	1	0	0	0	3	0	0	0	1	0	0	0	32	0	20	0	0	0	0	0	0	0	0	0	0	83	0	0	0	0	2	0	0	0	0	0	0	0	6	0	0	0	0	0	0	0	0	1	0	0	7	0	0	0	0	6	0	0	0	0	0	0	0	1	0	1417	0	0	0	0	0	0	0	0	0	0	0	4	0	18	4679	0	0	3	6	12	0	0	46	0	1	3	0	0	0	1	0	0	0	0	0	0	0	6	0	0	0	0	2	0	0	10	0	0	3	0	0	0	21	0	0	0	0	0	0	0	0	0	179	0	5	0	0	0	0	0	6	0	0	0	6	0	0	0	0	8	0	0	0	0	0	0	0	0	0	0	0	0	0	0	0	0	0	1	0	0	0	0	0	7	0	0	0	0	0	3	0	0	0	0	0	0	0	0	6	0	0	0	5	0	0	19	0	2	0	0	0	0	3	0	0	0	2	0	0	0	0	0	0	15	0	2	0	1	0	0	0	0	0	1	25	0	27	0	1	0	0	0	0	0	0	0	0	0	13	4	0	3	0	0	0	0	0	0	0	16	0	0	0	0	1	1	2	0	1	0	1	0	0	0	0	0	0	0	0	0	0	0	0	9	0	0	0	0	0	4	0	0	0	0	0	0	0	0	0	0	0	0	1	0	0	0	4	13	0	0	0	0	0	1	0	3	0	0	11	0	4	0	13	0	1	4	32	14	0	0	0	69	0	8	28	1	0	0	0	8	66	0	9	0	1	22	0	152	0	0	0	1	0	1	0	9	8	0	2	0	3	7	0	4	8	29	0	2	3	0	1	0	1	0	0	13	0	1	0	0	0	0	0	1	6	0	0	0	0	2	1	0	0	1	0	1	0	0	0	1	0	0	0	0	1	0	0	3	101	2	0	1	10	44	0	0	2	0	7	0	0	0	2	7	0	1	0	0	0	9	14	0	0	0	0	0	0	0	0	1	0	0	0	0	0	0	0	0	0	3	0	0	0	0	5	3	1	0	2	0	0	0	0	0	0	0	7	0	0	0	0	0	2	0	0	0	2	1	5	0	0	2	0	0	0	6	0	0	3	0	18	2	0	1	0	2	0	0	1	0	0	0	0	0	0	0	12	0	0	0	41	5668	99	1	6	0	36	77	3	48	22	20	2	99	128	81	0	20	6	45	34	35	2	19	0	58	0	4	0	0	0	0	0	0	0	1	0	0	0	2	0	0	2	0	0	0	0	0	0	37	1	0	0	1	1	0	0	1	0	0	0	0	0	13	0	0	0	0	0	0	20	0	0	0	1	0	0	0	52	5	0	0	0	5	0	0	17	2	6	0	22	2	0	0	0	7	0	2	51	0	17	2	4	0	2	0	0	0	0	0	0	0	0	0	0	0	0	0	0	0	0	0	0	2	0	0	0	0	12	0	0	2	1	0	0	1	0	4	0	0	0	0	0	8	2	0	0	0	1	10	247	1	4	3	1	1	0	0	0	0	0	0	0	0	2	0	2	2	2	57	1	1	1	0	0	0	0	8	2	8	2	1	0	1	0	0	0	15	0	0	4	1	0	5	0	0	0	1	0	0	6	0	0	0	0	0	0	0	0	0	1	0	0	0	0	0	0	1	0	0	6	0	0	0	0	0	0	1	1	40	0	0	0	1	9	4	1	5	3	4	0	0	30	2	11	0	0	2	0	17	0	2	0	3	0	0	0	0	0	0	0	0	0	0	5	0	0	0	18	0	0	0	0	1	0	0	2	7	2	0	2	0	0	0	0	0	0	0	8	0	0	0	0	2	0	0	1	6	0	2	0	0	1	0	4	18	4	0	2	0	0	0	1	0	0	1	8	0	3	0	0	7	1	1	5	0	0	0	0	0	0	0	4	2	0	4	0	5	0	0	0	3	0	1	0	11	0	0	0	0	5	1	0	1	0	39	0	0	0	0	0	1	6	2	4	0	0	0	2	1	2	0	1	0	0	0	0	0	4	2	0	6	0	0	0	0	0	0	0	37	0	1	0	4	0	0	0	0	0	0	0	4	0	0	0	0	1	0	0	0	0	0	1	6	0	7	0	0	0	0	0	0	0	0	0	1	0	1	1	0	0	0	1	4	0	2	0	0	43	6	1	2	0	0	0	0	0	0	0	0	1	0	0	16	1	0	0	0	0	0	2	0	5	5	0	12	8	16	20	3	0	0	0	0	0	11	0	0	6	7	10	7	0	2	0	0	5	0	9	12	0	18	3	5	11	0	0	0	0	12	0	4	0	2	2	0	6	0	0	1	0	0	0	0	0	0	0	0	2	7	0	2	0	0	0	0	27	3	0	0	0	0	2	15	0	0	0	0	0	0	0	2	0	0	0	0	0	0	12	0	34	0	0	0	0	0	0	5	0	1	0	0	0	0	0	1	0	2	0	2	10	0	0	0	0	0	0	0	0	0	0	0	0	0	4	0	5	1	2	0	2	0	10	17	0	0	0	0	0	0	2	0	0	0	0	10	0	0	11	0	0	11	3	6	0	0	0	0	3	0	4	1	14	0	0	0	2	6	0	0	0	0	3	0	2	0	2	2	0	0	0	2	0	0	0	0	8	0	630	0	0	86	0	2	0	0	2	7	2	0	1	2	0	8	0	0	14	4	0	7	0	0	0	4	0	2	1	0	2	0	11	0	4	0	0	0	0	0	61	2	0	0	0	0	5	0	4	0	0	3	3	0	0	0	0	0	2	0	0	0	0	2	0	0	0	0	0	0	15	0	0	1	0	0	0	0	0	0	0	0	0	0	0	0	0	0	0	0	0	0	0	4	0	0	0	1	0	2	0	0	3	0	0	3	0	0	2	0	1	0	0	0	0	3	0	0	0	0	0	0	0	1	0	1	0	1	1	0	0	1	2	0	17	0	0	0	0	0	8	0	6	0	0	1	0	0	0	0	78	0	0	0	0	0	0	0	4	1	0	2	0	1	9	0	0	0	0	1	4	0	0	3	3	21	0	0	0	0	0	0	3	0	0	0	914	0	0	4	0	0	0	0	0	0	0	0	0	0	0	0	0	0	7	8	0	0	0	0	0	0	0	4	0	0	0	0	0	0	0	0	0	0	2	0	0	39	0	0	0	0	6	0	0	0	0	6	0	0	1	0	0	0	0	0	0	0	0	0	0	0	7	0	0	0	0	0	0	2	2	1	0	8	0	0	0	0	0	0	0	3	0	0	0	0	4	5	3	0	0	0	0	0	5	0	6	4	2	0	0	0	5	0	2	1	4	3	2559	0	0	0	1	1	0	0	1	4	0	0	1	0	0	0	0	25	6	2	0	5	0	1	0	1	0	4	0	0	0	5	5	2	0	25	0	3	8	0	11	0	1	1	12	0	0	10	0	0	0	2	8	0	0	0	14	4	1	3	0	165	0	0	0	24	7	13	0	0	0	8	2	0	10	2	9	0	0	0	0	2	1	0	4	0	1	0	0	0	1	2	0	3	0	10	0	0	2	2	0	22	1	0	7	0	7	0	1	3	7	0	1	0	1	0	5	2	0	0	0	0	0	3	1	0	2	0	0	2	9	10	1	2	12	2	51	5	0	0	1	0	3	1	4	0	1	0	0	1	0	2	0	1	0	0	6	0	8	0	8	0	0	3	0	0	3	0	0	0	1	0	2	2	0	0	1	0	0	1	1	2	1	1	0	0	1	0	2	0	0	0	1	0	0	1	0	0	0	0	0	4	0	0	0	0	0	0	0	1	0	0	2	0	3	0	3	0	10	3	0	2	3	2	0	1	1	0	0	4	3	72	0	0	2	2	0	8	2	1	0	5	0	9	14	0	5	4	0	0	13	14	0	0	0	1	0	1	0	0	0	0	1	0	0	0	0	10	5	0	0	13	0	0	1	3	0	0	0	0	0	1	4	0	0	2	23	16	1	1	0	0	0	4	0	0	0	4	6	3	15	1	8	0	0	0	0	0	30	0	0	0	13	0	0	0	4	4	4	0	5	9	0	4	3	36	0	0	13	0	0	0	0	6	0	0	6	1	0	4	20	13	3	11	2	0	0	1	10	0	0	0	0	0	0	0	1	0	0	0	0	0	4	1	1	25	1	0	14	0	2	0	0	0	10	1	7	0	0	5	2	0	0	0	14	0	0	2	2	14	4	0	6	5	3	13	2	28	0	0	0	0	1	1	0	0	0	7	0	2	0	0	0	0	0	0	0	4	9	4	6	25	10	1	0	35	0	0	0	2	0	1	2	0	0	0	1	1	0	1	0	0	0	0	0	30	3	0	0	0	0	6	1	0	1	0	0	1	5	0	0	0	0	0	6	1	0	6	0	0	6	0	0	2	0	3	0	17	3	5	0	2	1	4	4	0	0	4	2	0	4	0	0	0	0	0	85	0	0	0	18	6	5	5	0	0	0	0	1	0	0	4	9	0	5	0	1	0	0	2	0	18	14	17	3	0	4	2	7	4	11	5	0	3	0	0	14	3	0	1	197	2	0	21	62	5	1	1	8	20	0	0	0	0	0	0	1	0	0	0	0	0	14	6	0	0	0	0	956	7	0	0	1	0	0	1	8	4	2	5	11	0	0	0	16	0	17	3	9	3	6	2	0	6	42	18	0	4	1	0	0	2	10	8	1	1	0	1	0	0	0	1	3	1	1	0	0	0	0	3	15	8	87	89	6	0	0	0	2	0	2	4	2	0	4	0	0	0	0	0	0	0	0	3	0	0	1	0	0	0	0	0	0	1	0	0	5	0	0	0	4	0	5	0	0	12	1	9	4	6	11	10	5	9	5	0	0	1	0	41	14	3	1	0	0	3	4	4	0	0	2	0	0	15	2	0	0	0	0	0	1	0	2	21	0	0	0	0	0	1	1	0	2	0	0	0	0	0	0	0	1	6	90	0	0	1	0	1	0	32	0	1524	0	4	0	3	1	3	13	0	0	0	0	0	0	0	0	11	2	6	0	0	1	0	0	0	0	0	1	0	0	39	1	0	2	1	1	0	0	9	1	80	5	0	0	0	0	0	0	0	1	1	5	0	0	7	0	0	0	0	0	0	3	0	0	0	0	0	0	7	0	13	3	0	1	0	1	1	2	0	18	0	0	0	1	1	0	0	0	12	1	0	9	2	0	0	0	1	0	3	0	37	8	0	4	31	0	0	0	0	6	0	17	0	10	3	1	0	0	0	10	0	0	2	0	0	0	0	40	0	0	2	3	1	1	0	0	0	0	0	0	0	1137	1	18	8	2	112	0	3	13	2	6	3	96	45	44	8	27	12	9	0	0	14	0	8	3	2	1	0	2	312	1	0	6	2	1	13	0	0	0	9	1	2	0	0	0	0	1	0	0	2	0	4	19	6	9	6	3	10	0	2	0	2	0	11	6	15	21	8	0	0	0	2	0	0	0	0	2	6	0	0	2	0	12	1	2	0	0	1	0	0	0	4	0	0	0	2	0	0	3	5	0	0	0	0	0	0	0	0	0	2	1	6	8	0	12	1	0	0	3	8	56	1	0	4	11	16	1	2	8	0	5	1	8	5	0	25	0	0	9	2	8	16	3	0	4	29	5	8	0	0	5	3	0	0	4	0	1	0	0	0	23	0	1	2	0	2	0	0	1	0	0	5	0	1	4	0	0	0	0	0	0	4	0	0	12	0	0	2	4	0	58	0	15	0	0	8	0	0	3	1	0	8	0	0	0	4	6	0	14	10	0	20	7	6	7	21	7	2	0	1	0	2	2	2	6	29	26	7	0	0	0	1	0	0	0	0	0	5	50	1	3	0	0	0	1	0	0	9	1	0	21	0	1	1	0	0	0	6	2	1	0	0	0	0	0	0	0	3	0	1	0	0	0	0	1	0	3	1	0	0	1	0	0	1	18	3	1	0	0	3	1	0	1	0	0	0	0	0	3	0	0	0	0	0	0	0	0	0	2	1	2	4	0	2	0	0	0	0	0	0	0	0	7	56	0	0	0	1	0	0	12	3	15	0	0	0	1	1	0	0	9	0	10	4	0	0	1	0	0	2	0	1	1	0	2	1	2	0	0	0	3	3	0	5	0	2	1	0	0	0	54	0	5	2	0	5	1	1	0	4	4	0	0	0	2	0	2	26	2	5	2	0	2	1	0	3	1	3	4	2	2	5	9	0	0	0	0	0	3	0	3	0	2	0	3	0	0	2	0	10	1	8	1	0	0	0	2	4	2	2	0	0	1	0	336	27	48	0	0	3	0	0	2	0	0	21	3	9	23	20	1	46	0	1	14	0	5	4	15	2	0	0	0	1	0	8	0	1	9	3	11	0	1	1	8	16	1	0	0	0	2	0	0	0	4	0	5	1	1	0	0	0	7	2	0	0	0	1	9	1	4	1	1	0	13	0	0	3	4	0	0	0	0	1	0	0	0	4	0	2	2	0	0	1	1	1	0	1	2	1	5	2	4	5	0	8	6	0	0	13	1	0	0	0	0	0	0	0	1	0	0	0	0	0	0	0	0	0	0	2	0	0	4	0	0	0	0	0	0	0	0	0	0	0	3	0	1	0	1	4	0	1	0	0	2	0	16	20	7	41	0	3	1	8	0	0	0	0	0	1	0	0	0	0	0	0	0	1	8	10	1	1	0	0	0	0	1	2	0	7	11	1	0	14	2	4	0	1	1	16	0	0	0	10	0	0	1	28	38	2	9	0	0	0	0	1	4	0	16	0	0	0	10	14	0	0	7	198	2	11	1	0	0	4	4	0	2	11	50	6	1	3	1	0	1	3	4	23	0	0	1	1	0	2	6	0	1	0	0	0	0	0	0	0	2	3	1	0	0	0	0	0	1	0	4	0	23	2	0	0	0	0	0	0	0	0	4	8	5	1	1	18	0	2	3	0	0	0	1	0	1	4	0	0	0	10	3	0	0	0	0	0	0	3	1	15	1	0	0	2	0	0	0	1	0	2	11	2	1	0	31	0	2	0	0	0	4	0	3	0	2	0	9	13	10	0	0	2	2	0	1	0	0	3	0	0	0	2	2	2	0	0	1	0	0	0	0	0	0	0	3	3	0	0	0	0	0	0	0	2	2	0	25	1	0	0	0	1	0	21	0	14	3	0	0	3	0	1	0	0	6	0	0	0	14	12	9	0	0	9	0	13	3	0	28	0	0	9	0	0	0	1	0	0	1	1	0	11	2	0	12	5	7	0	0	61	0	0	0	0	0	0	0	0	0	2	0	0	0	0	1	0	0	0	6	0	0	0	1	0	0	1	1	1	0	2	6	3	0	0	0	0	15	0	0	0	0	0	23	11	0	1	2	0	0	3	43928	0	0	3	0	3	0	0	0	0	0	0	0	0	0	0	0	8	0	0	0	0	19	2	25	17	0	0	7	3	5	0	0	0	0	1	0	2	7	16	0	16	1	1	1	0	0	0	2	0	7	0	0	3	0	18	8	3	22	27	0	0	4	0	10	2	0	3	0	2	164	7	9	9	0	1	0	2	4	3	0	6	7	3	0	12	0	0	0	0	0	0	3	0	0	24	1	0	39	2	3	0	9	21	0	0	14	6	0	1	0	0	0	0	0	0	0	2	0	3	26	11	16	120	0	72	2	0	9	9	31	42	131	3	0	35	3	21	8	0	17	25	6	0	0	0	5	0	16	10	31	65	5	0	2	0	0	5	9	0	7	2	0	2	0	0	0	0	0	0	0	1	0	0	7	0	2	0	2	0	0	0	2	0	0	0	0	6	14	10	6	0	0	0	2	0	7	9	0	1	9	0	0	0	0	0	9	7	0	4	0	0	0	4	4	0	1	0	3	0	0	0	0	1	0	0	0	0	8	0	4	0	2	10	2	3	0	0	0	4	0	0	1	4	1	9	0	4	0	0	0	13	11	0	6	4	3	14	2	0	5	3	0	1	0	0	0	1	0	0	1	0	0	0	0	0	0	0	0	0	0	0	1	0	1	0	0	0	1	7	1	0	0	0	0	0	1	5	0	0	0	0	0	0	0	0	1	0	0	0	4	1	1	22	0	3	2	0	2	0	0	16	0	1	2	0	1	13	2	2	22	0	0	10	74	1	4	4	4	0	0	5	0	13	0	0	8	0	5	10	7	1	0	0	0	3	0	0	1	0	16	0	1	0	5	1	6	0	0	2	2	219	4	1	0	0	0	0	0	0	0	4	20	2	3	24	0	17	10	1	1428	0	0	7	5	7	11	8	2	2	0	0	3	0	8	0	1	3	0	1	0	0	0	0	0	0	7	5	1	4	3	0	8	0	0	1	1	0	0	0	4	0	0	0	1	0	7	1	1	0	2	0	5	2	8	1	2	3	1	7	9	0	0	1	0	0	0	1	15	38	22	4	2	7	13	21	0	0	0	8	9	5	0	0	4	0	11	0	0	0	1	0	0	0	7	0	0	0	0	0	0	3	0	2	0	2	0	4	9	0	0	12	0	1	6	0	0	0	2	0	0	0	0	31	0	3	0	0	0	1	0	0	1	0	1	0	0	9	3	0	0	0	0	0	0	3	11	0	0	2143	0	2	0	40	0	0	0	4	2	411	0	0	0	0	0	0	0	0	0	0	0	2	0	0	0	0	4	0	0	0	21	1	3	2	13	0	4	11	0	1	0	0	0	0	0	0	0	0	0	7	4	0	0	0	0	22	0	0	0	0	0	2	2	0	0	0	0	1	2	0	0	0	28	0	0	4	13	0	5	1	0	5	2	0	4	2	1	0	6	6	2	24	8	6	11	11	54	18	1	45	0	0	5	6	0	0	0	6	0	0	1	0	0	0	0	60	0	0	0	1	49	0	0	0	0	2	7	0	4	0	0	0	4	0	0	0	1	0	0	0	0	3	9	0	0	1	4	30	8	0	0	0	0	1	0	0	0	21	0	0	0	1	0	1	1	18	3	1	1	0	10	0	1	0	9	1	0	9	4	3	1	3	0	0	1	11	0	5	0	1	0	0	0	0	23	0	0	1	0	4	14	1	0	4	74	7	0	189	0	0	0	0	0	0	0	90	3	65	2	0	0	0	5	0	6	0	16	1	1	0	2	2	0	1	0	0	0	2	3	0	0	1	37	0	4	0	2	0	8	18	2	0	2	0	28	1	1	5	0	1	0	0	1	0	0	0	0	5	1	0	0	0	13	1	3	0	0	4	4	0	5	0	0	3	0	0	0	0	0	0	1	5	5	14	3	12	28	0	15	8	2	10	35	53	0	0	0	1	2	0	2	0	0	49	3	0	2	4	13	13	1	2	1	0	0	2	3	0	0	4	4	0	0	0	0	2	0	0	4	18	29	0	0	0	0	0	2	0	0	0	0	5	0	5	0	0	0	0	0	1	0	0	1	5	0	0	0	1	2	0	0	0	0	0	0	0	0	0	0	0	1	0	6	0	0	0	0	0	0	0	1	0	0	0	1	2	0	0	0	6	0	6	2	0	3	0	0	1	1	0	1	1	0	1	0	0	4	412	6	16	11	0	0	1	11	0	1	6	3	0	0	0	0	0	0	4	9	0	5	0	0	5	0	5	4	0	3	3	0	0	15	3	0	3	0	0	0	2	0	2	15	3	7	0	24	0	10	5	2	26	2	5	0	0	0	2	0	4	15	32	17	0	19	11	11	2	4	0	2	0	2	0	0	0	17	0	0	0	0	0	0	32	0	0	0	0	0	0	2	0	4	24	0	3	3	0	8	0	7	2	3	9	2	0	33	2	18	0	3	0	0	0	0	1	0	0	211	1	1	11	1	0	1	1	0	0	0	0	1	1	0	0	0	0	1	0	2	43	42	3	66	34	10	941	5	0	0	0	0	0	0	1	6	0	2	0	0	3	14	0	1	2	1	0	2	0	0	0	0	0	0	125	17	0	7	10	0	0	0	1	0	0	102	0	278	0	2	382	0	1	0	8	0	9	1	1	0	2	2	0	0	0	1	1	0	7	0	0	0	0	0	0	0	0	0	0	0	0	3	4	0	4	6	1	0	0	1	0	0	0	0	0	4	0	67	33	0	3	2	7	6	4	2	0	0	10	1	7	1	0	0	0	0	0	0	0	0	1	0	4	0	1	0	0	0	1	0	1	1	6	0	12	0	0	0	0	2	0	0	0	0	0	2	20	0	0	5	2	0	1	0	0	0	0	0	0	3	0	1	4	0	3	1	1	14	9	4	28	1	0	0	0	0	0	0	0	8	0	29	0	0	0	5	0	21	53	0	0	0	0	0	2	0	0	0	0	0	0	0	0	0	0	0	3	0	0	0	0	0	0	0	0	0	10	0	0	2	0	0	0	0	0	170	0	0	0	2	0	0	0	0	4	0	0	0	1	0	0	0	0	0	0	0	0	0	0	0	0	0	0	1	0	0	0	0	0	1	21	0	2	0	1	0	2	10	0	0	2	0	0	4	0	0	0	5	0	0	1202	0	0	0	0	0	3	0	0	0	1	3	0	0	0	5	0	1	0	0	0	0	0	0	0	0	0	0	0	0	0	0	0	0	0	0	1	0	0	0	0	0	0	0	7	0	2	1	0	0	0	0	0	0	0	0	0	0	0	0	0	0	0	0	0	0	0	0	0	2	0	0	0	0	0	0	0	0	12	0	0	0	12	0	0	0	0	0	0	0	0	0	0	0	0	0	0	0	0	0	0	0	0	1	2	0	0	0	0	6	0	0	0	0	0	1	0	0	0	0	0	2	0	7	0	0	0	0	0	0	1	0	11	0	0	0	26	0	0	0	0	23	0	8	0	0	0	0	0	0	0	0	0	0	0	0	2	0	70	0	5	0	1	0	0	0	0	1	0	0	0	0	0	3	4	0	0	0	0	5	0	0	0	1	0	0	0	0	2	0	2	2	0	0	0	0	0	0	0	0	2	1	2	4	4	0	0	0	0	6	0	2	0	0	0	0	0	0	0	0	0	0	3	4	0	0	6	0	0	0	0	3	0	3	0	0	9	0	0	0	0	4	3	8	0	0	0	0	2	0	6	4	3	0	7	5	9	0	29	100	24	11	0	0	0	48	0	3	0	0	0	7	0	0	0	0	8	0	1	0	0	2	0	0	0	0	47	8	15	0	0	4	0	0	0	1	25	0	8	10	2	0	1	2	0	1	1	0	0	0	0	0	7	0	6	2	0	1	0	0	2	0	0	0	0	0	1	3	1	2	0	10	0	0	0	0	0	0	0	1	0	0	0	4	0	0	0	4	1	1	0	1	0	1	0	1	41	1	0	0	4	0	0	3	0	0	0	1	0	0	0	0	0	0	5	1	0	0	0	0	0	0	0	0	2	0	0	1	0	0	1	1	0	64	0	2	0	0	0	62	1	0	0	0	23	0	7	0	0	2	0	0	0	0	0	2	0	0	2	0	3	0	4	0	0	2	0	15	7	0	14	24	0	0	0	0	0	0	5	0	120	0	1	0	5	0	1	1	4	5	11	1	0	0	0	3	8	0	0	0	0	7	2	0	22	0	12	11	0	0	2	0	0	0	0	0	2	1	0	0	0	0	1	0	0	0	0	0	0	20	3	1	3	12	0	0	0	2	0	0	1	11	12	8	8	12	3	6	7	1279	0	11	2	2	13	0	4	11	7	0	0	0	1	0	2	24	9	0	1	0	0	10	5	0	0	0	6	0	0	0	0	0	3	0	0	12	0	6	0	0	16	0	0	0	0	0	0	0	0	3	0	4	0	7	0	1	0	0	3	0	1	0	0	0	1	7	0	5	0	0	0	3	6	0	2	4	2	0	0	2	2	2	11	30	0	2	0	0	0	0	0	0	1	1	0	3	0	0	0	0	1	9	7	0	3	0	0	5	1	7	0	1	0	8	0	22	0	1	2	0	0	0	0	16	4	35	9	1	0	0	1	4	0	0	2	0	1	0	1	28	10	9	0	13	0	0	4	4	0	0	0	0	0	0	4	2	4	3	6	2	4	3	7	0	0	0	0	706	0	3	7	11	4	0	0	3	18	9	2	0	0	0	0	0	0	7	0	0	22	0	0	0	0	0	2	2	22	11	0	0	0	4	1	4	0	0	0	0	1	0	86	0	0	0	6	3	1	11	0	0	0	2	0	1	0	31	0	0	0	6	0	1	0	6	1	0	30	7	4	13	0	1	0	8	14	0	0	0	2	0	21	0	1	1	0	0	0	0	4	7	1	0	1	3	8	4	1	0	0	0	0	0	0	3	0	0	0	10	2	0	0	0	3	22	0	7	0	0	1	0	2	0	19	4	0	1	1	1	2	0	1	0	3	1	1	0	0	2	22	5	0	0	3	0	0	0	0	0	0	0	1	0	3	3	0	46	0	3	30	0	4	137	0	8	0	33	8	8	44	2	12	18	4	47	16	0	0	1	2	1	0	0	0	1	2	1	0	10	0	0	0	3	0	0	0	1	0	1	0	0	12	0	5	9	2	6	0	0	0	0	0	0	0	0	5	0	0	0	0	0	1	0	0	3	1	0	0	0	0	0	0	4	5	1	1	0	0	0	0	0	2	0	0	0	0	0	0	0	0	0	0	0	0	0	0	0	1	0	3	5	1	12	1	0	0	3	0	0	0	15	9	13	2	0	1	8	3	0	3	1	3	2	0	1	0	1	0	0	0	5	22	3	14	3	3	0	1	0	3	1	6	0	2	0	0	0	0	0	0	0	0	0	1	0	0	2	0	0	14	2	4	2	3	1	6	7	10	0	14	5	0	0	1	0	0	0	0	2	33	0	1	0	1	0	0	0	2	3	4	4	0	14	5	1	5	0	24	0	0	0	0	1	0	1	0	37	0	0	0	0	2	82	0	0	1	0	1	0	5	0	1	31	0	0	0	9	0	9	13	3	0	2	85	0	0	0	2	0	0	0	6	0	1	0	0	10	6	0	1	0	4	3	7	1	0	2	5	13	0	20	11	5	1	0	3	0	5	0	1	49	0	3	0	0	10	0	0	4	8	0	0	28	1	0	1	1	0	0	3	1	1	0	0	0	0	1	1	0	0	0	0	0	0	0	11	0	0	0	0	0	0	0	2	2	0	0	0	0	0	0	0	9	5	2	0	3	0	7	0	0	91	0	63	59	15	0	2	81	20	3	4	15	4	0	0	9	10	0	0	0	12	0	8	10	3	1	0	0	0	0	4	1	7	0	0	13	8	9	0	0	0	0	0	0	0	4	0	0	2	1	4	0	2	3	0	0	1	2	60	1	18	2	2	0	21	2	5	0	0	0	2	0	5	0	0	0	0	0	6	1	6	9	3	4	19	2	162	8	3	0	0	5	6	0	39	10	20	9	0	23	0	8	16	4	1	0	0	0	4	6	13	122	45	23	0	67	0	0	0	0	2	0	2	0	1	0	0	0	22	21	0	0	0	38	13	6	10	0	17	0	2	25	1	2	0	0	0	11	0	13	0	1	0	2	0	0	0	1	0	0	0	1	0	0	0	2	1	0	1	1	0	0	0	30	5	0	0	3	14	1	3	0	2	0	4	5	1	2	0	0	2	4	1	0	14	0	15	6	0	0	0	6	1	0	0	0	1	5	11	10	1	19	28	12	0	0	4	61	6	9	17	2	0	0	0	0	0	0	0	3	1	0	2	0	0	0	0	0	0	0	0	9	0	3	2	8	9	15	1	0	2	0	3	0	0	3	0	3	0	0	0	2	0	5	6	8	5	66	0	2	0	0	0	0	0	0	0	0	0	0	0	2	1	0	0	0	0	0	3	0	0	0	7	0	4	3	0	0	1	1	0	0	4	1	3	0	0	2	0	0	6	0	0	0	0	0	0	1	0	0	0	0	0	6	6	2	1	0	4	1	5	0	1	0	6	0	5	83	0	0	3	1	2	0	0	0	11	0	86	21	18	12	1	11	8	3	6	7	4	7	0	7	6	0	0	0	1	0	0	0	1	1	0	0	0	0	1	0	0	1	2	2	0	0	0	0	0	0	0	1	0	0	0	0	0	5	1	0	0	0	1	0	0	0	0	0	0	0	0	0	0	11	3	0	13	0	13	13	2	21	0	2	0	5	0	0	0	0	0	4	0	0	15	6	0	0	0	4	2	13	0	0	1	7	0	0	1	0	0	0	4	0	0	0	0	0	0	2	7	0	1	0	17	0	3	7	0	0	0	0	1	1	0	11	2	1	0	1	1	4	0	12	1	3	0	0	0	2	0	9	1	0	1	0	0	3	0	0	0	3	3	0	0	1	3	0	2	0	0	8	3	1	0	0	0	0	0	1	0	8	18	14	2	18	18	0	0	1	3	0	2	0	0	1	0	1	1	3	1
LakWasMeta9_HOW4_2_rpkm	0	0	0	0	1	16	4	1	0	0	16	10	2	2	3	2	0	0	17	0	1	0	2	22	0	3	0	2	2	7	0	2	0	20	3	15	2	2	2	11	0	0	0	3	20	22	36	16	0	2	33	2	2	0	0	5	5	20	84	7	126	1	1	6	12	0	0	1	7	25	7	0	1	0	3	0	1	0	0	0	1	22	1	0	0	0	2	1	4	0	2	3	10	8	19	1	5	0	4	0	0	0	0	0	2	1	1	0	0	0	1	0	24	2	8	2	0	1	0	0	0	0	1	18	0	1	27	0	0	1	0	288	5	0	0	2	0	0	5	0	0	1	0	14	6	0	0	0	13	2	17	8	0	3	16	0	6	8	16	0	10	2	1	16	6	5	0	7	3	23	1	5	4	2	0	0	0	0	2	0	0	3	0	1	8	37	0	0	0	4	8	1	12	2	4	0	2	2	5	413	26	0	10	0	0	3	15	0	16	1	5	0	28	5	14	0	5	4	0	6	0	0	8	3	1	8	0	0	10	0	1	2	132	0	0	0	15	5	32	2	0	0	14	6	49	11	0	0	0	17	0	14	22	2	848	116	0	0	0	0	6	0	7	6	4	0	4	2	5	26	10	1	31	0	0	2	1	3	33	2	4	7	18	10	32	0	0	1	24	1	3	0	0	3	702	1	0	3	14	0	2	38	37	1	11	0	12	45	19	3	14	0	20	30	0	2	0	2	1	0	0	0	0	6	12	1889	0	0	10	0	4	3	1	1	0	0	3	0	5	0	0	1	6	16	30	4	5	2	2	2	2	6	1	0	5	1	1	10	0	185	6	0	1	0	0	18	7	23	4	13	2	46	1	0	25	1	0	1	1	9	2	0	1	10	3	0	37	0	0	0	0	0	10	0	1	13	19	0	0	27	0	4	1	10	28	0	3	0	2	5	0	9	7	13	0	33	12	15	7	1	0	1	1	0	0	1	13	2	6	0	181	8	8	0	0	2	0	3	9	0	51	12	0	0	8	27	1	0	0	0	0	54	6	97	1	23	31	0	0	0	0	3	1	2	10	20	6	0	0	6	15	13	9	2	1	0	8	0	40	1	7	8	10	3	1	1	0	39	50	0	1	1	57	42	3	0	1	0	0	0	0	1	2	1	2	0	1	4	0	0	1	0	0	6	2	0	4	0	1	11	0	0	0	0	0	0	0	1	0	0	2	1	0	2	8	2	13	2	0	25	1	11	3	14	35	0	0	2	3	0	0	0	0	0	0	5	0	0	0	0	0	1	2	2	37	1	18	0	12	0	0	1	0	23	9	2	30	101	7	51	8	235	72	17	85	5	6	11	41	0	0	0	11	24	8	6	2	1	2	0	15	1	0	2	14	17	0	34	0	6	0	118	38	62	3	1	56	1	228	6	62	18	14	7	0	15	0	10	0	2	4	7	0	1	4	6	1	0	0	8	8	25	0	0	0	1	3	17	14	3	19	1	5	5	14	1	3	2	7	1	1	92	0	4	0	1	2	0	13	11	1	23	3	2	0	0	2	0	2	2	1	1	17	4	0	0	1	0	0	23	2	1	40	1	32	0	1	3	0	5	0	8	1	2	17	0	6	0	73	0	0	0	0	4	18	23	4	4	40	3	0	0	14	18	2	0	2	0	8	0	4	12	1	0	1	0	0	3	0	15	1	30	13	2	15	21	2	0	0	13	4	0	0	1	0	4	7	0	25	18	0	6	0	46	1	0	6	1	0	0	0	0	0	0	0	18	0	0	0	0	1	0	5	0	0	0	0	0	0	4	6	24	1	0	0	10	17	1	0	16	1	0	0	0	21	232	35	1	2	5	0	1	35	0	0	0	4	0	0	0	0	0	0	3	8	1	0	7	3	0	3	0	1	2	0	0	0	36	75	1	0	0	0	0	0	0	0	6	15	0	0	0	3	1	0	1	0	3	0	7	24	13	7	3	0	9	0	0	21	0	0	0	0	0	1	0	3	0	7	11	0	0	5	1	3	4	0	2	1	0	0	0	0	0	0	0	1	3	0	0	0	0	6	1	0	0	1	3	0	0	0	0	0	2	10	12	18	20	15	0	0	1	0	1	0	0	1	0	1	1	34	0	0	2	1	0	1	0	0	0	0	3	0	9	12	0	4	3	0	0	0	3	0	0	3	0	1	0	3	0	0	0	3	0	0	0	0	0	1	3	1	4	2	154	0	16	0	0	3	0	3	14	27	0	28	0	0	2	0	1	2	3	0	0	2	0	18	2	2	2	0	4	0	0	0	0	0	0	0	1	0	0	2	0	0	0	0	84	0	1	3	47	3	0	0	15	0	0	289	1	5	0	0	0	0	0	1	2	20	3	0	4	1	1	0	1	0	4	0	0	2	1	2	14	1	1	3	0	0	8	0	17	0	20	0	0	0	0	22	4	3	0	3	3	3	0	0	4	10	5	2	3	2	0	0	0	0	1	8	168	129	0	0	0	0	0	1	0	0	1	0	0	1	1	25	7	8	0	0	10	0	3	0	0	2	1	0	14	0	1	3	0	0	1	0	2	10	9	16	4	3	0	49	0	0	14	8	0	2	0	0	1	0	0	1	0	0	1	0	0	2	1	0	1	2	0	3	2	0	1	0	0	0	0	0	0	0	0	0	0	0	3	0	0	2	0	5	4	12	1	0	0	16	0	0	1	0	13	0	0	0	12	0	7	0	38	0	1	0	16	24	6	0	4	0	161	1	0	0	0	3	0	3	0	1	0	9	11	0	0	0	0	12	0	2	0	0	2	13	2	0	0	0	2	3	0	0	0	1	0	24	0	509	3	1	0	0	3	0	1	6	0	20	33	65	0	0	4	2	3	1	0	0	14	0	13	0	0	0	0	0	2	5	22	2	40	1	7	3	4	0	1	6	1	0	16	3	0	6	0	0	6	2	0	0	4	0	0	5	2	8	2	2	0	0	3	5	0	0	7	3	7	0	1	0	1	8	5	3	2	1	0	27	0	0	0	1	1	9	0	0	1	2	9	5	1	31	13	19	20	0	0	4	1	0	0	18	3	1	6	0	0	1	1	0	2	17	14	0	2	0	0	1	2	31	0	8	2	8	12	0	0	16	4	0	13	14	1	2	0	0	1	5	0	17	0	4	863	7	57	23	17	19	3	0	5	25	10	0	10	2	5	0	17	11	0	5	0	3	9	2	18	11	18	0	0	6	0	0	0	0	2	1	12	7	0	0	1	425	0	4	48	1	0	20	1	7	9	6	0	2	3	0	16	0	2	0	1	0	6	0	1	6	550	39	44	55	1	0	10	0	0	0	0	8	77	14	7	15	30	1	0	3	27	168	375	19	26	2	2	0	71	1	0	5	0	6	0	1	0	98	23	19	30	36	15	16	20	24	5	0	0	0	0	0	0	79	11	0	0	0	3	0	23	1	2	0	1	1	7	0	1	0	0	2	10	23	0	0	1	3	10	0	18	3	24	0	0	0	0	0	4	0	3	1	1	0	0	2	7	9	0	9	12	1	2	0	0	6	13	0	5	3	68	0	0	0	0	0	0	0	0	0	1	0	12	0	0	0	0	0	0	0	0	0	8	0	141	2	1	47	0	2	3	0	75	1	4	31	2	1	143	0	40	0	0	1	0	3	0	18	0	24	1	1	0	0	1	7	0	0	4	15	0	7	0	16	0	1	2	0	0	0	0	0	0	3	12	2	51	5	0	1	2	1	5	2	0	0	35	2	0	0	4	7	6	1	5	12	3	5	0	6	13	25	0	1	3	0	1	2	60432	0	11	2	18	4	0	5	0	1	0	0	2	0	2	3	0	35	10	37	92	47	9	106	6	0	0	1	6	3	9	0	7	2	4	839	0	0	2	3	1	4	4	3	5	21	2	25	9	0	2	0	0	0	49	2	1	9	1	0	0	0	2	0	9	0	92	0	0	26	7	0	0	30	2	7	135	6	0	1	14	4	0	0	11	31	28	5	109	0	4	0	10	3	517	0	0	0	3	0	0	67	0	6	0	0	3	0	5	2	0	41	4	0	0	0	0	0	9	1	0	0	0	3	0	1	0	3	0	0	0	10	0	28	0	0	32	21	105	0	1369	2	0	1	0	0	1	3	0	4	2	0	1	1	6	1	0	2	38	0	2	0	2	0	0	19	16	0	30	2	0	0	0	78	0	2	0	0	1	4	0	0	24	1	2	7	0	1	0	1	10	1	0	32	3	1	16	3	1	1	1	10	140	0	20	1	32	84	0	28	2	36	2	24	9	5	4	7	2	0	36	11	0	0	0	18	2	0	0	0	1	0	1	1	0	3	0	3	1	0	13	29	0	0	0	1	0	2	0	1	0	0	0	0	1	0	0	0	0	8	6	15	1	0	0	0	0	10	5	6	0	0	3	17	1	5	2	0	0	0	0	2	0	0	0	1	2	0	11	0	0	2	15	1	0	0	0	0	0	0	0	130	0	79	41	6	1	8	0	15	2	13	89	47	11	7	4	0	1	0	0	0	2	0	12	0	0	14	8	0	0	10	1	0	0	0	0	0	4	2	0	0	4	7	3	15	10	0	49	6	0	1	1	13	6	50	0	2	2	0	0	0	0	2	0	0	1	8	0	0	1	0	0	2	1	1	0	3	0	8	677	1	2	0	0	0	0	1	0	0	3	9	48	8	9	0	0	1	0	0	0	0	0	3	24	0	0	2	0	2	7	2	0	3	0	15	0	5	0	0	11	6	0	0	24	3	0	0	0	0	0	0	0	7	0	0	1196	3	0	0	0	61	14	2	1	3	28	2	11	30	13	4	0	0	0	0	1	8	0	29	5	0	3	0	2	2	1	0	5	3	0	0	0	0	4	0	1	2	3	0	1	0	0	0	2	0	21	0	4	3	1	9	12	0	0	1	0	1	0	4	2	0	0	0	0	0	0	0	4	2	2	0	0	0	3	13	2	2	65	2	2	0	106	0	0	24	96	10	9	0	0	12	4	2	0	0	0	0	0	50	0	10	10	15	0	11	1	1	0	9	0	19	2	2	2	11	42	0	0	8	0	3	0	6	4	0	0	3	2	3	0	0	3	1	10	11	0	12	1	0	26	8	1	62	10	0	8	3	1	0	0	1	9	0	0	0	0	0	0	0	0	11	1	2	1	1	7	57	8	0	0	1	0	1	8	0	3	2	10	4	1	0	1	1	0	1	1	3	2	1	2	0	0	1	0	0	0	0	1	7	0	0	0	2	1	0	2	2	1	4	0	9	4	5	0	5	1	0	3	3	0	1	1	1	12	7	4	0	0	0	1	14	75	52	50	239	104	64	325	0	78	146	88	131	103	25	78	21	192	294	0	28	5	198	169	138	220	349	133	132	31	128	45	277	5	0	7	0	0	0	0	0	0	2	0	13	27	5	0	1	0	0	0	0	0	0	0	0	1	1	4	0	12	0	0	5	0	17	0	10	0	13333	2	2	0	0	3	0	4	0	0	0	2	2	0	2	0	0	0	2	0	0	9	0	1	2	0	3	6	6	30	1	1	5	8	0	0	0	6	0	1	13	0	0	10	0	0	59	0	0	6	0	0	0	0	0	5	1	0	3	4	7	10	0	12	0	0	0	1	4	0	0	3	0	4	0	3	1	3	0	12	1	74	3	1	10	8	0	2	4	1	0	4	1	1	4	0	2	0	0	13	10	0	0	0	0	0	0	0	1	1	0	3	2	2	2	1	1	0	1	4	0	0	0	0	0	0	0	1	0	0	28	1	11	22	2	1	0	0	0	10	0	0	0	3	1	0	0	0	0	0	0	4	1	14	0	1	2	0	2	2	1	0	7	0	1	4	0	199	3	2	0	795	22	0	0	0	0	0	3	0	0	15	2	0	0	0	0	0	7	0	12	185	1	19	2	0	16	0	2	108	7	0	9	2	0	72	2	5	4	2	1	0	0	2	6	4	0	8	2	2	0	0	13	0	5	1	0	1	0	0	2	1	0	2	75	1	0	1	3	0	5	0	2	0	1	0	0	4	6	0	3	1	0	2	3	2	114	147	5	0	12	1	1	1	0	5	0	9	1	0	2	4	0	0	1	2	15	4	6	224	0	0	0	2	0	2	1	1	42	24	21	0	0	1	78	0	0	0	0	1	0	0	0	0	0	0	0	2	27	10	1	2	0	0	0	0	1	3	0	3	12	4	8	2	0	0	0	1	21	0	0	8	0	0	0	0	1	0	6	0	3	5	0	4	60	2	12	0	2	0	10	7	8	4	4	1	2	0	3	1	4	0	5	2	12	0	1	10	0	0	2	0	4	5	0	1	0	1	0	0	0	15	5	0	109	2	3	11	0	35232	4	3	2	0	11	1	1	10	9	10	1	0	0	0	0	0	0	0	0	5	0	0	1	0	0	0	55	1	6	41	28	2	2	27	15	7	9	2	4	10	0	12	1	17	8	8	2	6	3	3	2	12	1	6	1	9	3	0	0	27	0	3	0	6	9	4	18	6	4	2	5	0	8	6	6	0	9	3	7	0	45	19	16	5	4	0	3	23	19	9	0	0	0	1	0	9	4	1	1	0	0	22	14	0	0	0	2	22	0	0	0	0	0	0	0	0	11	0	0	7	0	73	7	0	3	0	0	0	1	1	2	2	3	0	0	98	3	2	67	65	36	0	22	1	8	0	0	43	118	0	1	1	0	5	1	0	9	2	3	1	0	0	5	1	4	39	4	0	26	1	0	187	0	13	0	1	0	34	24	0	2	2	0	3	2	3	1	1	0	1	6	9	0	1	39	5	0	1	23	10	1	0	0	1	2	0	319	72	239	13	1	0	0	0	0	0	1	40	0	2	0	4	0	0	25	216	19	1	0	0	0	0	8	1	52	2	1	0	0	0	15	0	0	2	0	0	4	0	0	0	1	0	2	0	3	0	86	64535	1	3	3	0	0	0	1	10	1	1	0	0	0	0	23	21	0	2	2	0	0	0	0	88	3	2	1	0	1	1	3	0	5	2	1	2	1	1	1	3	1	0	0	1	3	884	1	1	3	0	6	0	3	0	0	0	0	0	0	0	1	0	1	12	0	0	0	0	0	4	0	1	0	0	0	0	7	4	0	0	0	0	0	0	0	1	0	0	0	1	1	1	0	0	0	0	0	0	0	0	5	1	0	0	1	11	0	0	0	7	0	0	55	0	4	0	0	0	0	382	8	1	0	0	7	6	3	33	8	2	16	0	0	25	1	0	67	2	1	6	2	1	2	0	0	0	0	0	5	0	0	3	0	0	0	0	0	3	0	0	0	3	1	0	0	0	0	0	1	0	3	0	2	0	4	1	0	0	0	3	2	3	0	2	0	2	0	5	0	20	0	5	16	0	8	6	0	0	0	0	0	4	0	1	5	24	0	1	0	13	3	0	0	0	0	2	0	0	0	0	2	2	0	8	16	4	0	10	0	5	0	2	0	0	0	0	0	4	3	2	0	4	0	4	0	9	16	0	121	21	0	0	2	1	0	1	0	3	7	7	3	1	0	0	0	0	28	377	0	91	0	0	1	3	0	0	0	2	1	1	0	14	4	0	5	3	14	9	0	0	0	0	3	0	3	2	29	2	2	5	0	15	0	1	0	5	4	9	0	0	0	0	23	1	2	0	5	2	5	0	3	0	0	16	1	0	0	1	57	0	1	0	9	0	2	0	0	0	0	2	791	0	1	3	1	0	1	2	2	0	1	1	4	0	1	0	1	0	0	216	12	0	0	1	0	0	0	75	2	0	0	0	0	14	1	0	0	0	0	18	10	0	0	2	1	4	0	5	6	0	1	0	21	0	0	0	11	0	0	1	0	0	0	0	10	0	6	2	8	0	1	12	0	3	1	0	0	1	0	0	0	0	0	0	0	1	0	1	0	0	2	2	5	1	0	2	0	0	6	0	1	5	5	0	0	1	1	2	0	0	0	1	14	0	0	0	57	0	2	18	0	1	0	0	0	3	0	0	0	0	0	0	1	0	7	0	2	1	2	0	3	0	1	0	0	1	0	17	4	0	24	0	10	0	0	0	0	2	0	1	0	0	0	12	0	0	0	1	8	34	0	1	8	147	14	0	3	3	3	0	0	0	0	0	2	2	0	2	0	0	17	0	1	8	0	0	0	1	7	0	1	0	273	2	1	0	0	1	0	2	0	0	3	8	0	0	52	0	33	0	1	0	3	0	0	3	5	13	0	0	1	0	0	266	0	0	0	0	0	1	6	0	0	4	2	0	0	0	0	1	0	0	0	1	0	2	0	0	0	0	0	0	0	3	0	0	0	0	1	0	0	0	0	0	1	0	6	0	0	0	0	0	0	0	0	0	0	0	13	0	2	2	0	2	3	0	0	0	0	0	0	0	2	2	0	3	0	2	0	0	4	2	0	0	0	6	0	0	0	2	0	0	0	0	0	6	0	0	0	0	1	0	0	0	0	3	32	0	0	55	0	3	0	2	0	13	0	0	3	0	5	0	2	0	0	6	6	0	9	6	0	0	1	62	40	3	6	1	0	51	0	16	0	0	5	0	8	2	0	0	0	0	0	0	0	4	0	40	0	2	0	28	0	0	1	1	1	0	23	1	0	3	0	7	0	4	0	1	4	0	0	0	0	1	0	0	0	1	1	88	0	40	0	0	10	3	0	0	0	0	0	0	525	0	0	0	0	0	4	0	0	1	0	0	0	2	0	3	0	0	8	0	0	4	0	0	0	0	3	4	0	2	8	0	0	0	3	0	1	0	0	10	31060	0	11	2	29	0	1	0	4	0	10	4	0	0	41	0	1	0	0	3	31	0	0	94	0	0	6	0	1	0	2	0	0	0	0	0	2	0	6	0	0	0	4	0	155	0	54	0	0	0	1	0	5	37	0	0	0	1	2	0	0	3	1	96	4	0	0	0	0	0	0	0	0	0	2	5	0	0	6	0	7	2	0	0	2	0	0	0	2	2	0	0	0	0	1	0	0	0	0	1	0	4	2	0	4	0	8	0	5	0	16	2	0	0	0	0	0	15	0	5	0	0	0	13	17	0	20	0	3	0	0	0	2	26	3	0	0	1	0	0	2	1	0	0	39	0	4	7	10	0	0	2	0	0	1	18	2	28	0	2	0	0	0	0	0	0	0	1	0	15	13	0	10	0	0	0	0	10	3	0	7	2	0	8	1	0	0	4	0	2	0	0	0	1	0	5	0	0	0	2	0	0	0	0	56	0	6	0	1	0	9	0	0	1	0	0	3	0	0	0	0	0	13	3	1	0	10	6	17	0	0	0	0	0	0	0	2	3	2	37	11	4	0	24	1	2	16	114	13	0	1	0	219	0	18	58	10	0	0	0	35	129	0	35	0	8	36	0	343	0	3	0	0	2	0	1	26	14	0	14	0	3	10	0	15	11	56	2	29	11	0	6	0	7	3	0	37	2	7	0	0	0	0	0	0	7	8	0	0	0	2	7	0	1	4	0	2	0	0	0	3	1	0	0	0	2	0	0	0	64	25	0	21	10	211	0	0	5	7	8	3	0	0	1	23	1	1	0	0	0	30	60	2	4	0	0	0	20	0	0	4	0	0	0	0	0	0	18	2	0	3	0	0	1	0	4	6	4	0	25	0	0	0	0	0	0	0	0	13	0	1	2	1	5	2	3	0	0	3	30	0	71	11	0	0	0	16	0	0	8	0	23	10	3	0	0	8	2	6	9	0	0	0	0	0	0	0	17	0	0	0	71	53	187	23	13	28	91	296	5	66	31	62	15	220	305	189	0	141	27	170	57	57	6	122	11	177	2	10	0	27	1	0	0	1	0	5	1	0	0	0	0	0	16	3	0	0	0	2	0	110	1	1	7	15	1	1	2	5	0	0	5	0	8	10	0	0	0	0	3	3	87	0	1	0	1	1	0	0	168	13	0	3	0	0	0	0	37	1	6	5	49	2	5	0	0	7	0	5	103	2	16	1	15	0	2	0	4	1	0	0	3	0	0	0	0	0	0	3	7	0	0	1	0	148	0	0	0	2	22	5	0	3	2	1	0	0	0	0	0	8	0	0	5	4	2	11	0	1	2	14	8	11	22	22	3	3	0	0	0	2	0	1	0	0	5	1	15	0	1	177	2	0	6	1	0	0	0	34	0	5	18	1	0	0	0	5	0	5	0	2	17	0	3	6	6	2	3	6	1	0	0	0	0	0	2	2	0	2	0	0	0	0	0	2	0	1	0	2	1	0	3	4	0	2	0	0	0	0	10	95	1	0	0	0	31	2	11	6	25	6	0	1	57	9	47	1	0	2	0	17	0	0	0	3	17	2	0	0	6	0	1	1	3	1	19	1	5	1	36	0	3	0	0	3	0	0	9	15	1	0	6	1	0	0	0	0	2	1	20	2	8	1	0	2	5	3	1	18	5	23	0	0	5	3	5	25	28	0	6	0	1	2	4	4	0	11	14	0	1	1	5	19	1	1	6	1	1	0	0	1	3	0	4	0	0	0	0	0	0	0	1	14	0	0	1	31	2	8	0	0	43	7	0	1	0	71	3	0	3	0	0	6	17	2	3	0	0	0	0	0	2	1	2	0	0	1	0	0	2	26	4	5	1	0	0	0	1	0	2	42	4	3	0	681	2	0	0	4	4	2	0	9	0	0	0	0	1	0	0	2	0	4	8	11	0	15	0	2	0	1	0	0	0	0	0	0	0	1	1	1	1	0	9	9	0	0	0	0	69	17	13	1	0	0	0	0	0	0	0	4	3	0	1	34	7	0	1	0	0	0	9	1	4	11	2	15	5	19	37	4	1	0	4	0	1	20	2	2	10	2	9	4	0	0	0	3	3	1	18	7	13	24	189	16	7	0	0	0	0	40	0	5	0	16	0	2	0	4	0	4	0	1	0	0	0	3	1	5	4	7	0	3	0	2	0	0	96	6	0	0	4	0	8	17	4	3	13	0	2	3	0	10	4	0	0	0	3	5	16	3	83	4	0	0	6	1	3	12	3	4	6	0	0	0	0	19	3	2	0	0	10	0	14	3	0	1	125	0	1	2	0	0	0	0	2	0	0	7	8	0	2	5	14	33	0	3	8	4	0	5	17	2	2	0	7	327	0	0	7	1	0	2	9	9	2	0	0	2	0	4	97	0	56	3	0	10	0	9	0	0	0	1	0	0	5	2	13	4	6	0	2	0	0	0	3	0	17	3	245	0	0	217	0	9	1	0	0	18	7	0	11	0	2	4	11	3	24	4	1	12	0	0	0	23	1	3	2	0	1	0	15	6	9	2	2	0	0	0	179	17	0	0	0	0	19	0	3	2	0	12	0	2	0	0	4	0	5	0	1	0	0	3	0	0	0	0	0	0	40	0	0	0	0	0	0	0	0	0	0	0	0	0	0	0	0	0	0	0	0	0	0	32	0	0	3	0	3	285	8	1	26	1	0	5	0	0	3	2	2	5	0	0	0	4	4	0	0	1	6	0	0	4	0	1	0	2	5	3	0	1	3	0	42	0	0	0	0	1	11	1	7	0	0	5	5	2	0	4	9	3	0	1	0	0	0	0	7	0	4	16	0	1	25	0	1	0	0	0	9	0	0	17	0	17	1	0	0	6	0	3	1	0	0	0	73	2	0	0	0	3	2	0	0	0	0	2	5	0	0	0	0	0	17	14	0	0	0	0	0	0	0	0	1	0	0	0	0	2	0	0	6	0	0	0	0	78	0	0	0	0	14	0	1	0	0	7	0	1	9	0	0	0	0	0	0	0	0	2	0	0	44	0	0	0	0	0	0	2	10	1	1	2	0	0	0	0	0	0	2	9	2	0	1	1	3	10	10	0	0	0	1	1	9	1	9	5	2	0	0	0	0	2	5	0	13	1	0	0	0	0	0	1	0	0	0	12	4	0	5	0	0	0	0	44	14	31	0	10	0	0	4	2	2	33	2	3	0	7	309	5	6	41	1	7	24	2	33	1	1	2	31	6	0	21	3	0	0	5	27	2	0	1	39	9	4	7	0	525	0	0	0	52	43	105	2	33	5	17	4	0	14	52	33	0	0	0	2	45	2	0	10	3	0	58	2	1	1	1	1	13	3	15	2	5	4	9	3	154	10	0	14	1	62	0	4	0	10	0	3	0	12	0	5	11	3	3	0	0	6	4	13	9	3	0	0	0	52	14	3	19	24	3	209	29	0	0	0	1	11	1	1	0	2	0	2	3	0	2	1	4	1	0	11	0	9	3	27	7	0	9	0	0	3	0	0	3	1	1	0	15	1	2	0	0	0	0	0	4	1	5	0	1	3	0	17	3	0	2	0	2	2	1	6	0	5	0	5	13	1	0	2	0	0	0	10	0	5	5	4	5	9	1	8	2	29	7	1	6	0	4	2	0	0	1	1	0	40	137	0	3	11	2	0	64	21	76	4	29	4	15	23	1	33	5	0	2	37	17	0	1	0	2	1	1	3	0	1	0	0	0	0	0	0	4	13	0	0	25	1	0	2	6	0	1	0	0	0	0	12	1	3	4	29	27	1	2	0	0	0	11	0	0	0	2	11	10	31	3	19	0	0	0	4	0	60	0	3	0	83	0	0	0	6	0	16	0	0	0	0	16	4	100	0	0	33	1	0	0	0	11	0	0	15	1	0	12	72	20	2	47	4	0	1	2	22	1	0	3	0	0	2	0	4	1	1	0	1	0	5	1	0	108	2	3	25	9	6	0	1	0	20	6	20	1	1	17	4	2	0	0	16	2	6	3	8	27	21	4	13	33	7	16	3	39	3	8	1	0	0	15	1	0	0	2	0	4	0	0	0	0	0	1	0	37	18	11	7	108	27	16	0	65	0	1	0	1	3	4	1	0	0	0	1	0	2	1	0	0	2	1	0	506	3	6	0	2	2	20	0	0	1	1	1	2	13	1	0	0	4	0	7	0	1	19	0	0	20	4	2	1	0	14	0	12	23	19	4	1	0	35	9	3	0	29	10	1	7	0	4	0	0	1	11	0	0	0	87	39	40	27	0	0	1	0	4	0	0	2	20	0	11	5	2	2	3	12	0	71	29	22	4	1	24	6	16	13	20	22	0	23	1	0	17	5	0	3	1	6	0	60	107	19	5	3	1	69	0	0	0	1	0	0	27	1	0	0	3	0	3485	12	0	0	8	0	6	34	5	2	0	0	0	0	15	16	4	15	11	0	6	0	30	3	34	0	25	15	12	13	0	8	120	20	0	21	1	0	0	2	11	17	4	3	0	1	0	6	0	0	2	0	5	0	2	0	0	2	30	11	253	212	5	8	0	2	2	4	22	11	2	1	0	0	0	0	0	1	0	0	0	2	8	4	12	0	1	9	1	0	1	13	2	1	38	3	0	0	0	2	7	0	1	25	7	10	2	9	27	22	11	7	13	2	0	7	1	61	62	6	1	0	0	4	0	22	0	12	7	1	0	35	5	0	2	0	0	8	0	1	5	25	0	0	3	2	1	2	5	2	3	0	1	0	0	0	56	5	18	10	327	0	11	1	0	3	0	131	0	3067	0	16	0	3	10	22	22	0	0	0	0	0	2	0	4	14	4	12	0	0	0	0	0	1	0	4	4	0	0	93	0	0	2	0	2	3	2	17	0	346	32	0	0	0	0	3	0	4	16	1	16	0	4	7	1	0	0	1	3	1	3	0	0	0	2	1	6	12	0	16	0	3	8	0	2	0	0	4	28	4	0	2	3	5	1	0	0	18	4	0	32	0	0	2	1	4	0	7	0	53	13	2	14	45	0	2	0	0	18	0	40	9	24	7	4	1	1	0	13	3	0	59	0	0	1	0	77	0	0	3	11	2	1	0	1	0	0	0	0	0	3204	9	25	26	1	858	1	7	32	0	10	5	206	219	113	0	69	23	43	0	0	79	22	14	26	3	23	0	0	726	6	8	9	19	0	36	3	0	3	81	9	6	0	2	5	0	1	7	0	7	0	9	4	73	26	12	18	12	0	6	0	4	1	31	8	3	11	14	3	0	0	1	0	2	3	1	0	11	43	0	7	5	18	1	4	4	0	12	0	4	0	6	0	8	0	0	0	1	0	24	2	0	0	0	0	1	0	4	0	9	0	15	12	0	33	6	2	0	7	29	204	0	2	10	19	26	1	9	12	0	17	0	24	29	1	48	0	4	22	19	15	48	6	0	12	40	21	8	2	0	27	1	0	0	11	0	10	0	2	3	63	1	0	1	0	5	0	6	4	1	4	22	0	2	5	0	0	2	0	7	0	6	3	2	9	3	0	3	5	2	152	2	25	0	0	21	2	1	20	4	1	69	0	0	1	44	18	3	28	35	0	28	4	6	1	24	9	7	4	2	2	3	0	5	15	76	31	6	1	2	0	7	0	0	0	0	0	15	4	8	17	4	0	0	1	0	0	57	6	0	16	7	2	2	0	0	0	7	4	0	3	1	1	0	0	0	0	4	0	2	0	0	0	0	3	1	0	4	1	0	1	0	0	0	26	7	2	3	1	15	0	0	3	0	0	2	0	0	11	0	1	1	0	0	0	0	13	0	4	2	2	8	0	4	0	1	1	4	1	0	0	0	14	66	0	0	0	0	2	1	3	3	28	0	0	0	0	0	14	0	12	1	9	12	0	0	2	0	1	9	0	1	1	0	15	4	4	2	9	6	10	12	1	18	0	3	4	3	8	14	7	9	7	12	0	7	2	0	0	7	1	0	13	12	14	2	5	34	6	9	51	0	2	4	0	3	0	7	6	13	10	0	8	0	0	0	9	27	36	2	7	4	2	3	2	1	26	5	3	70	0	126	9	4	0	0	2	2	13	5	1	2	7	0	1088	136	100	5	0	7	0	2	4	1	0	45	9	18	53	42	12	103	23	8	73	5	3	3	20	6	0	2	0	12	4	5	3	4	16	2	71	1	10	0	6	16	5	0	0	0	35	1	3	0	10	2	27	3	0	0	0	0	28	6	5	1	0	1	15	2	25	3	3	5	0	3	3	18	10	0	0	0	0	0	1	0	0	11	7	4	0	4	0	0	2	8	1	3	0	10	11	2	10	16	6	15	18	0	0	32	0	0	0	9	0	1	1	0	2	0	1	2	0	0	0	0	19	0	6	1	0	0	13	1	4	0	0	0	0	0	0	0	0	0	3	4	3	3	3	8	6	5	0	1	5	2	42	183	7	64	2	12	0	74	1	0	1	0	3	1	0	0	0	1	1	0	1	8	17	23	5	3	0	2	3	0	0	3	2	27	9	4	1	33	2	10	0	1	13	47	0	0	0	18	0	1	12	69	53	7	13	0	0	3	0	4	10	1	30	0	0	0	18	17	5	2	16	49	3	15	4	0	4	7	13	0	13	53	123	4	1	1	0	0	4	52	34	27	1	3	2	3	0	5	7	1	41	0	0	2	0	1	9	0	9	27	5	0	0	1	0	0	7	5	6	2	36	5	2	1	1	0	1	3	0	0	13	15	3	0	2	26	0	2	6	2	10	5	4	1	0	6	0	0	3	27	8	0	0	0	0	3	2	15	3	48	1	2	0	4	0	0	0	3	0	1	5	15	0	17	52	1	2	0	1	3	2	0	3	4	2	3	24	27	8	0	0	4	3	2	2	2	1	3	4	0	0	9	32	8	3	0	0	0	7	2	4	0	0	0	16	10	0	0	0	0	8	4	5	2	3	2	10509	0	2	2	0	2	0	9	1	33	4	0	0	9	0	1	2	0	15	5	0	0	56	20	4	0	0	28	0	3	3	1	164	0	3	15	0	0	0	0	2	0	10	1	6	31	6	1	26	13	5	2	4	203	0	3	0	2	2	1	1	0	0	0	1	0	0	1	0	4	0	2	0	0	8	0	1	1	1	2	2	0	1	18	10	10	0	0	0	0	27	4	0	1	0	0	47	38	0	8	3	0	0	5	31455	0	0	1	2	0	0	0	0	3	0	0	1	0	0	4	0	2	0	1	0	0	21	4	58	18	1	2	15	1	1	1	0	0	0	0	2	1	17	41	1	50	3	97	1	0	0	4	2	0	12	0	0	11	0	37	13	12	24	97	3	25	13	0	15	0	0	0	0	5	183	15	39	20	0	0	0	8	11	9	0	39	31	6	3	49	0	0	0	0	10	0	3	3	0	51	6	1	102	6	6	0	19	32	2	0	38	5	0	2	3	4	0	1	1	2	0	3	1	20	56	9	39	230	5	150	21	10	14	69	133	112	229	2	11	51	9	61	71	0	101	36	0	5	0	0	0	0	58	13	114	364	10	0	13	0	0	46	13	4	9	0	0	7	0	5	0	3	0	1	0	1	1	0	4	1	6	1	8	0	1	0	11	2	0	1	5	19	34	14	7	0	0	0	1	1	6	11	5	0	6	0	3	3	18	0	10	17	0	9	2	0	0	18	16	2	4	0	16	0	0	7	1	2	0	0	0	0	5	2	1	2	4	14	5	9	0	0	9	0	0	0	3	5	7	7	1	14	2	1	0	44	35	0	2	9	3	26	3	1	10	18	0	4	13	1	0	1	0	0	0	0	2	7	0	0	0	3	0	8	0	0	2	1	1	2	1	0	2	11	0	0	229	1	0	4	1	4	0	0	1	1	6	4	4	0	0	0	2	1	136	3	1	26	0	13	26	2	2	2	2	47	0	2	4	3	6	10	53	1	34	5	2	6	165	4	3	37	4	0	6	4	0	14	0	1	36	0	9	12	5	9	0	0	0	3	0	0	1	0	3	6	2	5	13	9	6	0	0	4	0	5	22	4	2	13	0	2	0	1	4	1	112	12	4	81	0	33	17	3	9	1	0	4	9	4	17	13	11	25	0	0	11	0	18	2	1	0	0	0	0	0	0	6	0	4	16	20	2	2	27	0	15	3	5	4	1	3	0	71	14	0	0	1	4	0	30	2	6	0	10	0	88	1	4	3	2	5	6	20	11	0	0	0	0	0	0	1	41	147	47	13	8	12	30	10	0	0	7	14	32	6	0	0	7	0	8	0	0	0	7	0	0	0	14	0	1	7	0	7	3	6	0	8	5	2	0	8	9	9	4	7	2	4	11	0	0	3	1	4	0	2	17	94	0	6	0	1	0	0	4	1	1	22	1	2	0	3	0	8	1	0	0	0	1	4	34	0	0	3	1	4	0	14	0	1	0	8	14	123	0	0	0	0	0	0	0	0	2	0	0	0	0	1	0	0	0	2	3	1	72	0	9	11	33	6	8	15	0	1	0	0	0	0	0	0	1	0	0	0	4	1	1	0	0	44	2	0	0	1	0	14	8	0	0	0	0	2	2	2	0	0	41	4	1	12	5	0	10	5	0	11	2	2	2	11	12	1	13	3	7	280	29	6	8	21	98	24	8	156	0	0	10	2	0	3	1	11	6	0	0	1	1	2	0	46	0	0	1	0	81	2	1	0	0	10	18	3	8	1	3	0	2	0	0	0	3	0	0	0	0	10	42	0	0	4	7	83	34	0	0	0	4	2	0	0	0	42	0	0	2	2	0	11	4	24	0	0	0	0	27	8	5	0	11	4	2	23	8	4	0	9	0	0	7	14	7	14	1	5	0	4	0	0	87	7	2	10	0	6	51	0	0	0	175	8	0	359	0	1	1	4	2	0	0	192	20	90	0	0	2	0	4	2	18	0	7	0	7	1	1	3	0	5	0	5	0	2	32	1	1	28	104	0	0	0	2	0	15	34	4	3	1	0	4	2	0	6	0	4	0	3	0	1	2	0	0	14	2	1	0	0	19	2	34	0	0	12	9	6	7	0	1	32	4	0	0	4	0	2	1	8	3	15	6	48	68	2	25	43	2	50	84	120	0	0	0	1	4	0	5	0	0	147	1	0	15	18	27	30	1	2	6	0	5	6	27	6	0	26	13	2	0	1	0	3	0	0	71	56	100	0	0	0	0	0	4	4	0	3	3	14	2	9	6	0	0	0	0	0	0	0	1	2	4	0	0	4	0	0	0	0	0	2	2	0	0	0	0	0	0	7	23	2	2	0	0	0	0	0	3	0	3	0	3	14	0	1	0	11	0	24	1	0	3	0	0	4	2	0	4	5	0	18	1	1	11	2	14	37	10	1	10	6	12	2	4	29	9	0	0	0	0	4	4	10	4	5	13	0	5	13	1	5	15	1	6	20	1	0	42	11	0	7	2	1	3	3	0	0	22	2	25	4	52	7	35	20	6	61	4	6	6	0	1	2	1	13	38	74	42	0	31	11	29	1	11	0	4	1	5	0	0	0	6	7	7	1	0	0	0	33	0	0	1	0	0	0	6	1	5	14	3	10	3	21	7	3	23	13	8	16	2	5	89	14	47	1	2	1	4	0	3	0	6	2	801	0	2	16	0	0	1	0	2	0	1	0	0	1	0	0	0	3	6	2	4	184	147	6	201	116	21	2830	17	0	1	0	0	0	0	0	22	22	7	0	0	1	17	0	1	2	16	6	6	0	0	2	2	0	1	445	82	2	21	24	12	2	2	0	1	0	134	0	261	0	3	593	0	1	2	16	1	23	2	2	0	2	0	0	13	0	0	0	0	11	0	0	0	0	0	1	1	0	0	1	0	1	1	8	1	8	2	7	6	1	0	0	1	6	1	7	14	0	149	69	0	10	6	14	5	15	3	9	0	12	1	13	104	0	1	5	0	0	0	1	6	1	0	6	0	2	0	0	2	1	0	3	0	2	0	2	0	0	5	0	5	1	0	6	0	2	0	12	2	2	17	9	0	0	0	0	1	0	0	0	6	1	10	12	12	7	1	4	10	20	31	69	1	0	3	6	0	1	0	2	11	0	86	0	2	2	7	1	78	21	2	0	1	0	2	0	2	5	0	9	3	0	0	0	1	10	0	0	0	2	0	0	2	2	0	0	0	2	5	0	0	0	0	0	0	4	238	0	0	0	0	1	0	0	0	3	0	0	0	1	0	0	0	2	0	0	0	0	1	0	0	0	0	0	0	1	0	4	2	9	0	62	0	1	0	2	2	0	19	2	0	0	4	1	0	0	7	10	5	4	0	460395	5	0	0	0	1	3	0	0	2	1	1	0	0	0	5	4	0	0	0	0	0	0	0	0	0	0	1	2	0	0	0	2	0	0	0	0	0	0	0	0	0	2	1	11	0	3	2	0	0	0	0	0	8	1	0	0	0	0	0	9	0	0	0	0	0	0	0	0	0	0	0	0	1	4	0	0	0	4	0	0	0	29	0	0	0	13	0	0	0	0	0	0	0	0	0	0	0	0	0	0	0	0	2	2	0	1	5	0	31	0	0	4	0	4	0	0	2	0	0	0	3	2	23	0	37	0	1	6	0	4	0	17	1	0	2	68	0	4	1	0	124	1	21	0	0	0	0	0	4	0	7	0	4	0	0	3	3	92	2	11	1	6	1	0	10	2	2	0	0	0	5	2	7	11	7	0	18	0	5	4	0	0	4	0	0	4	2	2	0	0	4	0	0	2	6	0	0	17	8	2	0	4	2	12	6	0	0	2	19	1	3	0	4	1	0	0	3	6	3	3	0	5	14	0	0	47	1	5	0	0	8	0	23	0	23	14	2	0	1	1	6	3	6	0	0	0	0	4	1	30	2	6	0	18	9	41	1	98	202	49	22	0	0	3	140	0	4147	0	1	1	8	0	2	0	0	10	0	12	2	0	0	0	0	5	1	109	7	26	0	3	5	0	0	24	4	74	0	22	35	1	4	2	27	4	3	3	2	0	0	2	2	0	0	7	7	0	8	0	5	3	2	0	5	0	2	2	3	0	1	2	41	0	0	0	0	1	1	0	0	0	1	0	1	9	0	2	2	2	5	0	5	0	3	0	10	52	0	0	0	3	0	0	4	1	0	2	1	0	1	3	7	2	1	17	0	2	0	23	1	0	1	0	0	3	4	0	0	0	0	1	12	0	96	0	2	0	0	1	122	4	1	2	0	43	2	25	2	2	0	3	0	4	1	1	9	0	1	0	0	0	0	50	0	0	2	5	32	2	2	59	30	3	1	0	2	1	6	30	0	390	1	3	2	59	0	0	0	4	29	69	10	0	0	7	0	32	0	0	0	1	11	9	8	200	1	11	15	6	0	1	0	1	0	1	1	9	19	0	0	0	2	5	2	0	2	3	0	1	15	6	4	2	18	0	0	2	0	2	0	3	10	14	25	29	40	3	19	16	3	0	25	9	39	32	0	25	20	6	1	9	0	0	0	16	71	6	0	0	0	0	43	12	0	1	1	12	0	0	3	0	1	3	4	0	10	5	9	1	3	67	2	0	0	0	0	0	10	3	6	0	8	2	4	6	4	4	1	5	0	12	0	0	4	63	9	0	9	0	19	2	20	26	3	3	24	6	1	2	5	5	5	94	74	1	20	0	0	6	0	1	0	1	0	0	1	0	2	0	0	11	22	2	0	11	0	6	10	6	13	0	2	0	19	6	15	3	4	4	9	19	1	2	34	32	76	23	4	2	0	1	6	8	0	2	0	6	5	4	50	28	44	0	14	1	0	13	6	1	1	2	0	0	0	25	8	30	5	24	2	8	0	37	0	3	2	33	3249	0	19	27	18	23	1	0	16	45	28	6	0	0	3	3	0	0	35	1	0	66	0	2	0	0	0	2	5	47	25	2	0	0	3	1	11	0	0	1	6	5	4	267	0	0	0	9	6	1	40	0	0	1	2	0	4	2	32	0	3	0	5	1	2	0	29	2	3	49	9	11	39	0	0	0	16	33	0	0	1	1	0	27	0	0	1	0	0	0	0	3	13	5	0	8	1	4	12	0	3	0	0	0	6	0	42	3	24	0	24	0	2	6	2	6	32	1	10	11	0	0	0	1	0	31	23	0	2	0	1	1	2	1	0	9	11	10	0	0	10	40	12	1	0	2	0	1	1	0	0	0	0	5	0	3	6	4	101	3	16	97	3	0	247	15	15	7	80	61	11	138	8	20	50	6	70	22	0	3	109	10	2	2	0	6	1	2	1	3	17	1	0	1	1	0	0	0	0	0	0	2	0	19	1	11	25	10	0	0	0	0	2	0	0	0	4	0	0	0	0	0	0	0	0	0	3	0	0	0	0	2	0	0	0	3	8	2	0	1	0	0	0	1	0	0	0	0	0	0	0	0	0	0	0	2	0	0	0	2	0	4	15	0	30	2	0	2	12	0	1	0	47	36	54	10	19	3	9	0	0	3	2	3	17	0	0	0	1	0	0	0	34	78	10	23	2	26	0	1	1	12	2	10	0	0	2	0	4	0	0	4	3	1	1	6	4	0	0	1	0	13	1	9	2	14	1	16	20	13	0	14	16	2	2	0	0	0	0	0	20	34	2	6	0	0	0	0	0	8	5	21	0	0	46	5	2	25	0	28	0	0	3	0	13	9	0	0	65	0	2	1	0	2	243	0	1	0	4	4	1	4	0	2	51	0	0	1	19	2	12	8	5	0	7	39	0	0	0	7	0	5	0	1	1	3	9	8	11	17	0	0	2	5	5	11	1	0	0	11	117	8	26	40	9	0	2	3	1	64	0	2	310	2	6	0	1	10	2	1	4	26	0	1	39	5	4	2	0	0	1	5	2	10	0	1	0	0	1	4	2	3	1	2	2	0	1	9	3	0	0	0	0	1	0	8	7	0	5	1	0	1	0	3	61	11	10	49	6	0	17	0	0	107	4	162	15	20	0	2	246	52	3	10	41	0	5	0	11	7	8	1	2	18	1	16	22	3	6	3	3	2	1	7	7	12	0	0	70	33	26	0	0	1	3	0	0	0	39	0	6	1	2	14	0	0	14	0	3	20	9	117	1	68	10	6	0	39	10	11	0	0	0	0	0	17	0	17	0	12	0	3	1	3	10	10	4	110	5	316	16	11	0	0	13	29	0	140	27	22	43	7	96	0	67	55	14	0	1	0	3	5	17	6	393	69	42	0	99	4	11	0	0	24	2	2	2	4	0	0	0	55	80	0	1	0	110	28	8	20	3	32	4	14	36	0	3	17	3	0	7	8	20	0	2	1	12	1	0	0	2	17	0	0	2	1	0	1	6	1	0	2	1	0	1	1	134	8	1	4	2	24	7	4	0	1	1	3	3	4	0	1	3	12	15	0	5	30	0	29	4	0	0	3	19	3	0	2	0	0	14	20	5	6	28	83	14	0	2	4	116	4	23	29	0	0	1	1	0	0	1	1	9	0	4	5	7	0	0	0	0	0	2	0	21	1	3	5	62	7	41	1	0	7	1	5	0	1	7	2	7	0	1	1	3	0	6	52	21	10	243	0	6	3	0	1	0	1	0	0	0	1	2	1	10	0	0	0	1	0	2	1	1	0	0	12	2	1	5	1	6	3	10	2	0	10	0	47	2	0	5	6	0	19	0	0	0	0	1	10	1	0	1	3	2	1	9	4	6	0	0	7	5	15	0	7	0	23	0	13	20	1	1	5	1	1	1	0	0	22	19	198	38	32	31	5	40	19	15	14	16	19	14	0	14	13	0	0	0	5	0	1	0	14	1	0	3	1	0	0	0	0	2	3	6	0	0	0	0	2	36	0	1	0	1	2	2	0	0	0	4	0	2	1	2	0	0	1	0	0	0	2	1	0	21	1	0	34	1	13	44	3	46	0	0	1	2	0	0	4	1	2	8	0	0	23	40	0	0	2	5	1	14	0	9	1	51	0	0	1	0	6	0	2	4	2	0	0	1	0	3	6	7	1	0	38	0	18	3	14	9	0	0	3	0	5	20	8	9	0	8	13	14	0	29	2	7	2	6	0	2	0	26	4	0	1	1	0	3	0	0	0	6	4	0	0	9	10	4	4	8	4	25	3	7	0	2	6	0	0	0	0	6	39	7	7	19	33	0	1	0	3	0	1	4	0	10	0	0	4	8	3
LakWasMet13_LOW5_2_rpkm	0	0	0	0	0	28	16	4	2	0	3	7	3	1	2	1	0	3	18	0	1	1	5	46	0	2	0	0	0	32	0	0	0	10	0	17	2	0	5	0	0	0	2	2	27	71	50	36	3	6	7	7	0	0	0	6	4	38	81	27	155	0	1	16	14	0	0	0	18	70	2	2	1	0	4	0	0	0	0	1	0	7	1	0	0	0	1	0	2	0	0	7	27	3	14	3	1	0	1	0	0	1	1	0	0	0	0	0	0	1	1	0	57	8	31	2	1	1	0	1	1	0	5	10	2	0	2	1	0	0	1	53	13	3	0	0	0	1	19	1	0	2	0	18	2	0	1	2	59	0	19	113	3	6	65	0	11	15	24	0	13	1	0	21	10	4	0	8	1	22	0	1	0	0	1	0	0	0	0	0	2	0	1	0	4	80	1	0	1	3	16	1	14	2	8	1	2	10	6	546	39	2	10	0	0	2	30	0	14	8	8	1	41	4	17	0	5	0	0	6	2	4	13	8	5	16	1	2	11	0	3	3	121	0	1	0	46	24	22	9	0	0	30	7	69	11	0	1	9	32	8	8	19	0	1502	331	0	1	0	1	4	0	5	25	7	0	11	3	2	70	27	0	15	0	0	2	0	2	61	6	3	37	28	18	44	0	0	0	21	1	3	1	0	1	3	0	0	20	25	0	0	40	73	4	12	0	35	17	30	3	21	0	57	20	0	0	0	0	6	1	4	1	0	4	57	2374	3	7	13	0	1	2	0	0	1	0	3	0	2	0	0	0	13	29	22	0	17	4	1	0	2	5	2	0	3	0	0	0	0	151	9	0	8	0	0	18	6	37	11	11	2	23	1	0	33	3	0	3	0	5	0	0	2	4	3	0	192	0	0	0	1	2	36	0	1	39	57	0	0	53	0	37	6	10	56	0	11	6	0	6	0	16	76	12	2	29	40	8	6	2	0	1	0	2	0	0	1	1	0	1	2	2	2	0	0	2	1	0	14	0	79	28	0	0	4	66	0	0	0	0	0	105	22	144	0	39	37	2	1	7	0	2	1	16	11	37	10	0	2	5	18	43	30	4	1	0	12	3	142	1	15	1	4	2	0	1	0	76	43	3	0	3	85	85	8	0	4	1	0	1	1	4	4	0	0	1	0	5	1	4	0	0	1	0	4	0	2	0	6	2	1	0	0	1	1	0	0	0	1	0	0	0	0	3	20	2	30	0	1	33	1	10	4	20	78	1	0	0	0	0	0	0	2	0	0	18	0	0	0	1	0	0	0	3	12	2	43	0	12	0	0	4	1	0	15	13	57	114	5	41	31	141	79	26	104	1	12	5	35	0	0	1	6	0	6	10	4	8	2	0	46	1	0	1	13	10	0	47	15	20	0	211	88	78	3	0	103	3	201	8	115	43	20	13	1	12	4	13	1	2	8	18	2	3	2	0	0	0	1	4	2	41	0	0	0	1	0	12	19	0	34	1	5	14	7	0	1	0	0	7	2	175	0	25	0	1	1	0	24	14	4	41	1	1	5	0	1	0	1	1	5	2	7	0	0	26	2	1	2	29	1	3	15	2	37	0	0	17	0	10	0	3	1	6	8	0	3	0	62	1	0	0	2	0	17	11	1	0	19	5	0	3	11	10	12	0	1	0	14	1	0	0	3	0	0	0	0	1	1	17	0	35	16	1	31	36	7	0	0	29	1	0	1	2	0	7	1	0	52	7	0	16	0	96	0	0	3	0	0	0	0	0	0	1	0	48	0	0	0	0	0	0	5	2	0	0	0	0	0	10	15	8	3	0	1	1	7	0	1	24	0	0	1	0	75	24	102	0	0	0	0	0	3	1	0	0	6	0	6	0	1	0	0	11	22	0	1	12	3	0	4	0	2	0	0	0	1	32	34	0	3	0	0	0	0	0	0	10	34	6	0	0	4	5	0	0	3	4	0	20	56	24	16	20	0	6	4	0	15	1	0	1	2	0	0	1	1	11	30	20	1	0	0	3	4	2	3	0	0	0	0	0	0	0	2	0	2	0	0	0	0	0	6	18	0	0	0	5	0	0	0	0	0	6	45	29	36	37	24	0	0	0	0	0	0	1	0	0	0	0	14	1	0	1	0	0	2	0	0	12	0	1	0	19	15	0	19	15	1	0	0	6	0	0	4	0	0	0	1	0	0	0	6	0	5	2	0	0	1	1	0	10	4	272	0	24	0	0	0	1	15	15	50	0	49	0	0	0	1	0	0	1	2	0	2	0	4	6	10	0	1	6	0	0	1	0	1	0	0	1	0	1	0	0	0	3	1	127	1	0	0	66	8	2	6	22	1	0	316	4	2	1	0	0	0	1	0	5	74	0	1	1	0	0	0	0	1	4	0	0	0	0	3	7	4	0	1	0	0	2	2	5	1	10	1	0	1	0	57	12	14	0	8	3	8	2	11	3	11	5	1	6	1	1	0	0	0	0	3	36	8	0	0	0	1	16	2	2	0	1	0	1	0	2	3	20	23	0	5	16	0	3	0	1	4	2	0	5	1	0	3	0	1	1	0	0	10	24	17	1	2	0	1	1	0	7	5	0	4	0	0	0	1	2	2	0	0	0	0	0	1	5	0	0	6	0	2	1	0	6	0	0	1	0	0	0	0	0	0	0	5	9	1	0	1	0	0	5	12	0	0	1	2	5	1	0	0	4	0	0	60	12	7	20	99	103	7	3	0	14	13	0	1	2	1	7	9	0	0	1	0	1	1	2	0	0	9	57	0	0	0	2	58	0	0	0	0	0	22	8	0	0	0	0	8	0	0	17	5	0	24	0	1105	3	0	1	1	4	0	1	11	0	1	89	128	3	0	5	9	4	38	0	0	22	1	7	0	0	0	0	1	34	22	10	3	20	8	14	2	17	1	1	4	4	0	20	0	0	12	1	1	2	0	0	5	22	0	1	12	2	4	0	3	0	0	3	2	6	1	27	0	5	0	1	0	0	2	0	0	1	1	0	33	1	0	3	2	1	6	0	0	0	1	4	13	1	65	24	38	16	0	1	7	0	0	0	1	3	2	12	0	1	3	1	0	0	25	14	0	1	0	1	3	4	14	0	14	2	3	28	0	1	37	12	4	11	14	6	6	1	0	0	18	0	28	4	5	12	6	39	25	14	33	0	0	6	61	28	0	6	1	1	4	14	10	0	1	0	1	3	2	27	25	21	1	0	11	0	0	0	0	0	1	19	17	0	0	10	85	2	23	69	3	1	44	0	16	10	2	2	5	36	2	19	2	4	1	0	1	0	0	0	2	1951	54	25	103	0	4	5	0	0	0	0	3	67	25	6	3	34	1	1	0	7	191	86	21	10	0	3	0	123	0	1	0	0	3	0	3	13	129	27	25	48	87	27	0	14	73	11	0	0	1	0	1	0	75	7	2	0	1	32	0	16	7	1	0	3	0	11	1	4	0	0	0	4	19	4	0	1	7	3	0	7	11	48	2	0	0	0	0	13	1	0	0	1	0	0	2	2	0	0	4	0	0	3	1	0	3	11	0	2	0	24	2	0	0	0	0	0	0	0	0	0	0	16	0	0	1	1	0	0	0	0	3	0	0	285	1	0	33	0	2	1	0	176	0	7	17	7	0	199	0	114	4	1	0	0	4	0	35	1	27	2	1	1	0	3	11	0	1	3	15	1	1	0	22	3	1	2	1	0	1	0	4	1	1	33	3	75	11	18	0	1	2	14	0	1	1	5	4	0	0	1	11	12	0	7	69	0	67	8	11	20	20	0	7	7	0	0	13	19	0	11	3	15	4	0	20	0	1	0	0	0	0	0	5	0	54	34	70	97	124	12	97	25	0	0	0	7	6	21	0	0	1	7	87	0	0	0	4	0	2	0	0	6	40	0	45	14	0	4	0	19	0	41	3	0	39	5	0	0	0	2	0	41	1	226	0	1	53	8	0	0	47	4	14	207	16	0	5	4	12	0	0	32	67	124	24	183	0	4	1	7	4	79	0	1	1	10	1	0	153	3	5	0	6	2	0	9	8	5	65	0	1	0	0	2	0	6	0	6	0	0	15	1	1	5	2	0	0	1	18	0	162	20	1	43	81	131	0	6242	10	0	7	0	0	1	2	1	0	0	0	0	2	6	1	0	3	84	0	1	1	2	0	1	12	2	0	96	1	6	0	3	16	12	14	0	1	1	4	0	5	19	4	2	17	0	2	0	2	1	0	0	26	1	0	15	7	0	0	1	32	174	6	48	0	93	131	0	45	3	38	3	18	15	8	5	29	7	1	36	31	0	0	1	6	2	1	0	0	3	1	4	0	0	5	1	2	9	0	22	78	0	0	1	1	1	1	0	2	0	0	0	0	1	0	2	0	0	8	11	30	2	0	1	1	0	2	3	5	0	0	6	12	0	1	0	0	0	1	2	1	0	0	0	0	0	1	14	0	0	0	17	1	0	1	0	0	0	1	0	107	7	11	8	19	6	10	0	37	0	9	45	214	16	2	3	1	0	1	0	0	0	0	20	0	0	32	39	1	0	0	3	0	0	0	0	2	4	2	0	2	8	7	4	24	15	0	57	5	0	2	0	16	8	47	2	2	2	0	0	0	0	0	0	0	0	8	2	4	0	0	6	3	0	0	1	1	1	2	1	1	0	2	0	0	0	1	0	0	1	13	122	44	5	1	0	1	0	0	0	5	0	0	32	4	0	0	0	2	17	0	0	10	1	9	2	18	0	0	3	7	2	9	94	2	1	1	0	0	0	0	1	4	0	0	7	0	0	1	0	0	18	0	0	3	33	0	40	47	34	8	0	5	0	1	0	30	0	42	23	0	2	4	0	0	6	0	5	0	1	0	0	0	4	0	0	3	0	0	6	0	1	0	2	0	6	0	0	0	1	19	28	0	0	0	1	0	0	6	0	0	0	1	0	0	0	0	0	21	0	0	0	2	8	16	2	1	76	31	0	0	413	0	0	54	138	9	27	4	1	22	4	1	0	0	0	0	4	73	1	3	18	9	2	0	0	0	1	15	0	19	0	1	0	7	54	0	0	29	0	11	0	4	6	0	0	2	13	0	0	0	2	3	20	5	0	1	0	1	6	6	0	42	10	0	15	3	0	0	0	3	21	0	0	3	0	0	0	0	1	18	4	3	3	3	8	112	5	0	0	0	0	3	3	0	3	0	0	1	0	0	0	0	2	0	0	0	1	2	2	0	0	0	1	1	0	1	0	3	0	0	0	0	2	0	3	3	0	6	1	19	2	9	0	1	0	4	4	2	0	0	0	0	27	16	0	0	1	0	0	59	173	98	79	268	121	179	334	31	153	130	172	229	128	16	102	13	309	388	0	49	21	418	433	461	438	670	136	189	32	197	18	183	11	1	5	0	0	0	0	11	0	2	0	46	85	8	0	2	0	0	2	3	0	2	0	0	0	0	11	0	18	0	0	5	0	10	0	16	0	16	5	0	0	0	1	5	1	0	0	4	14	0	0	0	0	3	1	0	1	0	14	0	0	0	1	5	5	7	43	12	0	4	5	0	0	0	6	0	1	11	6	0	1	0	4	79	0	0	13	2	2	2	0	0	5	0	2	0	1	5	17	0	3	0	0	0	0	5	3	0	10	1	0	1	0	3	2	2	13	0	258	3	0	10	5	1	1	1	1	0	7	0	7	0	0	1	1	1	14	9	2	0	0	0	0	2	0	3	2	6	3	2	2	1	1	0	0	3	9	0	2	0	4	0	0	0	1	0	0	77	0	21	12	5	1	0	0	0	4	1	3	2	1	2	1	3	1	1	0	1	52	3	15	1	0	8	0	2	0	0	0	5	2	5	0	0	247	1	16	1	1190	3	1	0	0	0	0	0	0	0	4	2	0	1	1	0	0	13	0	69	136	0	1	0	0	11	0	0	80	13	0	21	7	0	79	2	6	9	4	1	1	0	0	3	10	0	11	6	5	2	1	7	0	5	0	3	0	1	2	2	1	0	0	1	0	0	0	4	0	5	0	3	0	2	0	0	0	20	0	2	0	0	14	32	4	110	273	7	1	21	0	0	0	0	1	0	0	0	1	0	1	0	0	1	0	36	1	7	8	4	0	0	5	0	0	0	0	55	21	8	0	1	0	126	0	0	0	0	0	0	0	0	0	2	0	0	1	87	14	0	1	1	0	1	0	0	3	0	1	37	15	9	2	0	6	1	3	18	7	1	7	0	0	0	1	0	0	1	2	2	3	7	0	59	4	6	0	2	0	4	1	3	0	4	2	3	0	20	1	12	0	8	1	4	0	0	10	0	0	1	0	0	5	4	21	0	0	0	1	1	7	6	0	279	1	1	27	1	93	2	13	2	0	7	0	1	20	3	25	7	7	0	0	0	0	0	4	4	20	0	1	0	0	0	0	67	1	10	44	45	21	0	47	33	13	2	9	1	27	1	33	2	18	4	19	1	24	9	0	2	20	2	16	0	25	1	0	0	17	0	6	2	28	13	14	12	18	6	5	6	0	15	4	4	0	11	1	2	0	35	26	0	5	1	8	2	22	44	15	0	0	0	1	0	0	13	1	1	0	0	11	45	1	2	0	4	81	0	0	0	0	2	0	0	0	17	1	0	12	0	7	13	1	1	0	2	0	1	1	0	0	3	0	0	265	6	4	74	50	54	1	31	1	11	0	6	1	194	0	0	0	0	3	6	0	22	0	7	2	1	0	4	1	0	58	8	0	45	6	0	229	1	28	1	3	0	63	65	2	1	0	2	3	2	3	0	0	3	1	8	10	2	1	69	2	0	6	53	11	1	2	6	0	1	0	1000	276	387	22	0	0	3	2	0	7	5	54	0	1	2	0	0	1	86	301	46	7	2	0	0	0	0	0	78	6	1	2	0	0	2	0	0	3	0	0	1	0	0	0	0	0	0	0	5	0	129	252	6	2	0	0	0	0	1	19	3	0	0	0	1	2	26	10	2	1	3	0	0	0	2	83	4	1	3	0	0	4	0	0	5	2	0	8	1	4	0	1	0	1	0	2	0	2043	2	1	7	0	5	0	7	0	0	0	0	0	0	0	0	6	0	31	1	0	0	0	0	2	0	1	0	0	0	1	0	0	0	0	1	0	0	0	0	0	0	3	3	0	15	1	0	0	0	0	1	0	2	0	1	1	0	0	1	41	1	0	2	1	1	0	99	3	7	0	0	0	0	236	5	0	0	1	9	16	22	33	2	0	22	0	0	23	0	2	70	1	0	12	3	1	0	0	0	0	0	1	11	0	0	2	0	0	0	0	1	0	0	0	0	19	3	0	0	0	0	0	1	0	0	1	1	1	1	2	0	0	2	1	1	4	0	0	0	0	1	14	1	14	0	12	37	6	14	20	0	0	2	1	1	4	0	1	7	48	0	2	0	10	1	1	0	6	0	0	0	1	2	0	1	28	0	9	43	9	0	23	0	14	0	0	0	0	5	0	0	1	1	1	0	25	0	13	17	1	127	2	67	72	0	0	1	0	0	0	0	16	10	8	0	0	0	1	0	1	52	598	0	64	0	0	38	5	1	4	0	3	0	1	0	5	0	0	2	6	29	11	0	2	0	0	1	1	0	1	22	3	18	1	0	0	2	1	0	1	4	23	1	0	0	0	25	0	0	0	9	0	7	1	361	2	1	15	2	1	1	0	74	0	0	0	33	0	0	0	1	1	0	0	417	0	0	3	3	18	0	0	0	0	2	0	10	0	4	0	1	0	0	184	4	0	2	0	0	0	0	182	0	0	0	2	0	2	5	1	0	1	2	1	1	0	0	4	0	0	0	5	3	3	1	0	4	5	2	1	5	0	0	3	2	0	14	2	3	4	12	1	0	1	1	20	0	10	1	0	0	0	0	3	0	0	0	0	0	2	4	1	6	1	0	0	1	1	3	0	1	0	1	0	1	6	2	1	3	1	0	1	0	1	0	3	8	0	1	1	30	1	0	9	5	1	1	1	0	1	0	0	1	0	0	0	0	0	4	20	3	1	0	0	3	0	0	3	1	3	1	1	6	0	50	0	0	0	12	2	0	0	0	0	3	0	0	22	0	1	0	2	4	33	0	1	0	31	34	0	2	8	4	0	0	0	0	0	0	4	0	2	1	0	20	0	0	26	0	0	1	15	10	0	0	0	1165	2	0	0	0	1	0	8	0	0	3	1	0	0	95	0	9	1	0	0	18	0	0	10	2	26	0	0	0	1	0	25	0	0	1	0	0	2	3	0	0	3	1	0	0	0	0	2	0	0	0	2	0	0	1	0	0	0	0	0	0	2	0	2	0	0	1	4	0	1	2	0	0	0	6	0	0	0	2	0	0	0	3	2	0	0	3	0	1	0	0	0	4	0	1	0	0	0	0	0	0	0	0	0	0	1	0	0	0	1	0	0	0	0	0	0	0	0	0	0	0	0	0	2	0	1	0	0	0	0	0	0	0	2	79	0	3	108	16	1	0	0	0	19	0	0	8	0	0	1	1	1	11	2	12	0	10	1	0	2	0	181	124	1	10	1	4	124	0	16	0	0	4	9	9	1	0	0	0	3	5	0	2	0	0	41	0	5	0	2	1	1	0	3	1	2	4	3	0	2	2	0	0	2	0	0	0	2	1	0	0	0	0	3	0	2	0	162	2	55	1	0	9	0	0	0	0	0	0	0	417	0	0	0	2	0	5	0	1	0	0	0	0	0	0	3	2	0	2	0	0	4	1	0	1	14	0	6	1	2	7	6	0	1	0	10	1	3	0	0	15	0	2	0	5	0	1	0	1	0	0	0	3	0	55	211	4	3	17	0	37	0	6	94	0	0	6	0	1	2	0	2	1	0	1	0	0	1	1	1	0	0	0	0	40	0	8	0	0	3	0	0	0	74	0	2	0	0	1	0	0	2	1	28	4	1	0	0	0	1	0	10	0	2	0	4	0	0	1	0	18	1	0	0	2	0	4	2	4	2	0	0	0	0	1	3	3	0	0	1	0	2	12	5	16	0	22	1	0	0	21	0	1	0	0	0	0	0	0	0	0	1	2	25	27	2	21	0	3	1	0	0	5	2	1	0	2	0	0	0	0	2	0	0	85	0	4	0	6	1	2	4	1	1	0	10	0	58	0	0	0	0	0	0	0	1	0	0	0	13	11	0	5	0	0	1	2	18	2	0	17	0	1	2	4	4	0	1	0	3	0	0	7	0	0	4	0	0	0	0	0	0	0	0	22	0	9	0	0	0	2	0	2	0	0	0	10	0	0	0	3	1	5	4	0	0	3	2	24	1	1	4	0	0	2	0	3	0	1	15	4	3	1	41	2	2	45	214	31	0	1	1	300	0	31	121	12	0	0	0	36	289	0	68	1	13	57	0	818	0	4	0	2	3	1	0	27	27	1	26	0	10	23	1	31	12	104	0	9	16	0	4	0	16	1	0	33	3	7	1	10	1	0	1	0	25	7	2	1	1	7	19	0	7	15	0	3	0	0	0	4	0	2	0	0	6	1	0	1	23	1	3	13	31	11	1	0	16	4	15	7	0	0	0	1	1	1	0	0	0	59	88	2	0	7	1	2	4	0	7	3	0	0	3	0	0	0	15	8	0	3	1	0	0	0	9	4	0	2	17	1	0	5	0	0	0	4	15	48	0	2	0	1	20	1	4	0	0	1	9	3	3	11	0	0	0	24	0	0	8	1	35	8	5	6	0	12	8	11	28	0	0	16	1	1	1	0	47	11	0	0	139	355	335	4	20	75	77	341	3	132	59	83	15	345	506	205	0	352	39	164	111	94	5	203	25	245	0	26	0	21	1	4	0	0	2	2	1	1	0	1	1	1	27	2	0	6	0	0	0	115	3	2	13	21	0	1	0	1	0	0	4	1	6	22	2	3	0	0	1	2	74	0	2	0	1	1	0	0	116	21	0	1	2	30	2	1	28	4	9	0	112	0	0	0	0	4	0	6	204	4	31	5	24	0	1	1	1	2	1	3	3	0	0	0	0	0	0	3	15	0	1	0	0	34	1	0	3	2	37	1	0	7	0	3	2	1	0	3	3	0	4	5	3	3	2	6	0	1	1	9	4	9	252	16	3	4	0	2	2	3	1	2	0	0	15	0	31	1	1	124	0	1	2	1	0	0	0	61	2	16	2	1	3	0	0	2	0	15	0	0	37	2	8	12	0	1	3	5	1	9	16	0	1	6	2	1	0	0	0	0	0	0	0	0	0	0	29	2	0	0	5	5	0	0	0	0	0	0	17	218	0	0	0	0	21	3	4	2	15	15	0	1	88	34	69	0	0	1	0	39	1	0	1	1	10	0	0	1	0	1	0	0	1	1	35	1	2	0	50	0	0	0	0	1	0	0	5	21	2	0	11	5	0	0	0	1	1	6	32	2	18	5	0	1	2	16	0	6	11	7	0	1	4	4	4	33	21	0	8	0	0	6	3	16	0	3	37	1	0	3	4	34	2	6	1	1	0	0	0	1	6	0	18	1	1	0	0	4	3	0	1	16	2	0	21	25	6	4	2	0	18	5	37	0	0	131	0	0	0	0	4	5	23	2	4	1	0	2	10	1	7	0	1	0	0	2	1	0	15	17	0	6	0	2	0	0	1	0	1	80	15	2	0	1	2	0	0	15	3	0	0	8	0	0	0	0	1	0	0	1	1	1	7	21	0	18	0	0	0	0	0	0	0	0	0	0	0	3	0	2	3	0	19	18	2	2	0	1	158	50	29	8	0	0	3	0	0	0	0	0	2	1	0	69	15	0	1	1	0	0	16	1	10	25	15	42	10	22	48	9	1	0	1	0	2	32	1	14	12	2	7	15	0	0	0	3	9	0	52	25	1	8	23	16	15	2	0	1	0	63	0	2	0	5	0	0	3	8	6	0	0	0	0	0	0	1	0	4	4	4	0	0	0	0	0	0	103	14	1	0	2	1	11	17	13	2	12	0	1	0	0	12	1	1	0	0	0	2	78	2	88	2	0	0	23	0	0	16	6	2	1	0	1	3	0	0	1	1	0	3	12	0	0	1	1	0	20	1	2	4	0	0	0	1	12	1	6	4	4	0	5	2	7	20	0	3	21	1	0	2	24	1	1	0	2	6	1	2	6	2	2	31	3	12	0	2	0	2	1	1	10	5	67	12	0	14	0	13	1	2	19	0	1	0	1	1	3	2	16	0	0	5	2	2	5	1	17	0	3	0	1	354	0	18	1	4	3	43	0	0	3	0	2	5	8	2	80	12	0	9	1	0	1	44	0	6	2	0	3	0	52	1	2	2	0	0	0	0	207	2	0	0	0	0	8	1	27	1	0	6	5	2	2	0	0	0	9	0	0	0	0	1	0	0	0	1	1	0	30	0	0	0	0	0	0	0	0	0	0	0	0	0	0	0	0	0	0	0	2	0	1	40	1	0	2	0	0	0	2	0	20	0	0	15	0	0	1	1	1	1	0	1	3	7	3	0	0	0	2	0	3	3	0	1	14	2	2	1	0	1	2	0	113	0	0	8	1	0	24	2	14	0	1	0	12	0	1	1	6	6	0	4	0	0	0	0	9	1	0	27	0	2	1401	1	5	2	0	0	10	0	0	16	0	38	0	0	0	1	0	1	0	3	0	0	132	1	0	0	0	2	0	0	0	2	3	1	0	0	0	0	3	0	34	26	0	0	0	0	0	0	2	3	2	3	1	0	0	0	0	0	3	0	1	1	0	65	0	0	0	5	22	1	0	0	0	9	0	0	8	1	0	0	0	0	1	0	2	0	0	4	49	1	2	4	1	0	0	2	27	0	0	3	0	0	0	0	0	1	6	21	0	0	0	0	4	27	17	0	0	0	0	0	15	0	18	7	32	1	0	0	9	0	24	2	15	1	2	1	0	0	0	0	0	0	5	25	0	0	0	0	0	0	0	55	24	37	6	5	5	8	1	7	4	35	4	2	0	1	21	13	10	86	1	21	27	0	43	0	2	3	55	5	0	39	4	0	0	16	28	0	0	1	80	18	6	9	59	1219	0	4	0	34	28	87	0	1	1	22	1	2	18	1	37	0	0	5	2	0	0	1	13	4	0	8	2	1	5	1	5	30	1	24	10	4	0	8	10	39	12	0	38	0	10	10	10	6	12	0	0	1	5	0	6	9	2	0	0	0	5	2	21	252	3	0	0	1	34	27	6	1	27	2	220	16	0	0	3	3	2	5	1	0	2	0	0	0	0	3	0	1	1	0	10	0	15	6	65	3	0	3	1	0	17	0	0	0	0	4	1	4	2	17	1	0	0	0	0	3	0	2	1	0	6	0	2	0	1	3	3	2	1	3	0	0	3	0	1	8	2	0	0	3	0	0	18	1	4	2	2	0	2	0	10	2	47	27	2	5	4	7	6	2	1	3	0	0	18	252	0	8	5	3	0	32	21	15	2	18	9	17	4	1	35	6	0	3	39	29	0	1	0	0	1	1	6	0	0	0	0	0	0	0	0	11	9	0	0	57	2	0	12	8	1	0	1	0	0	0	30	0	9	3	41	47	0	4	0	0	0	6	1	1	1	3	20	11	64	2	53	0	1	0	9	5	147	1	6	0	99	0	0	0	15	0	4	2	6	2	0	29	3	114	10	0	55	0	1	0	4	20	1	0	21	0	0	14	93	61	10	29	5	0	1	1	22	1	6	1	0	0	10	0	3	0	0	0	0	1	14	1	0	178	0	2	26	1	5	0	0	1	38	3	32	4	3	33	12	1	0	0	47	0	7	3	7	18	35	5	4	29	8	33	11	51	11	4	1	1	0	16	0	0	5	5	0	5	1	4	0	1	0	0	0	169	17	6	10	136	39	39	0	181	0	3	1	1	1	15	0	0	0	0	1	0	3	2	0	0	3	0	1	31	12	3	0	1	3	7	1	0	0	0	2	2	48	2	1	0	8	0	17	4	0	7	2	0	48	2	0	1	2	23	0	54	21	26	8	9	3	48	3	0	0	51	36	2	3	2	2	4	0	3	24	0	2	0	52	26	41	17	0	0	10	0	1	1	0	4	39	0	3	9	3	1	0	1	0	89	59	57	2	0	16	10	21	19	7	8	0	84	0	1	32	18	0	3	2	14	0	86	173	46	6	10	20	110	0	0	0	6	0	3	5	0	2	1	0	0	28	19	1	0	10	0	77	32	7	1	1	1	0	0	41	18	4	24	28	1	7	0	65	0	54	20	39	34	26	21	0	9	252	80	0	24	5	0	0	4	6	19	4	12	0	1	0	1	0	0	2	1	2	0	1	3	0	6	55	39	304	331	33	12	0	8	0	3	17	17	0	0	8	1	0	0	0	0	0	0	0	3	9	0	9	0	2	1	3	8	1	6	2	0	8	0	0	0	9	2	21	5	3	35	8	16	4	8	50	17	28	20	29	0	0	0	0	193	94	20	0	1	1	6	5	17	0	3	9	0	1	54	15	1	2	0	0	1	0	3	25	27	0	1	1	3	0	3	4	3	5	1	1	0	0	0	156	4	9	15	564	4	2	1	0	5	0	114	0	8069	0	14	0	5	15	55	19	0	0	0	0	0	0	0	1	26	12	14	3	0	1	0	0	2	0	0	5	2	0	117	0	0	5	2	0	2	4	19	0	5	86	1	1	0	0	2	0	0	6	1	17	4	1	15	0	0	0	1	1	0	0	1	0	1	0	0	3	27	0	33	5	1	12	0	0	5	0	4	64	0	0	2	1	10	1	0	1	56	2	0	4	0	0	4	1	1	0	6	0	121	23	0	13	158	0	3	2	3	21	0	77	17	30	4	2	0	0	1	18	2	2	51	2	0	0	2	149	0	34	15	10	5	2	0	0	0	0	0	0	0	4078	9	41	33	7	1197	2	14	60	21	74	12	395	282	254	32	186	58	53	0	2	144	62	64	29	12	5	0	3	1585	8	3	17	7	1	65	9	1	0	213	6	1	0	0	1	1	3	42	0	2	0	11	5	107	34	17	15	18	3	8	0	6	1	19	34	8	28	13	1	0	1	2	0	1	1	0	2	10	6	0	6	3	25	1	1	12	0	10	0	4	7	31	5	0	1	5	0	0	4	26	1	0	0	0	0	8	0	1	0	6	0	21	22	0	54	16	0	0	27	72	175	1	2	14	38	46	2	17	51	1	15	0	44	14	1	125	1	1	8	18	13	73	10	1	36	49	29	45	0	0	20	13	1	0	28	2	7	3	2	2	56	1	3	13	2	7	0	9	3	1	2	23	0	1	15	2	0	1	1	2	0	7	1	0	20	0	2	3	6	1	483	4	28	0	0	31	7	0	18	7	3	17	0	0	2	42	35	2	43	69	0	38	21	14	8	34	13	13	5	9	3	15	4	13	19	118	88	11	1	0	0	1	2	0	0	1	0	10	30	0	14	1	0	0	0	0	5	51	21	0	22	16	1	4	0	0	0	10	1	4	4	0	0	0	0	1	1	2	0	1	0	0	1	0	1	1	1	7	1	0	4	0	0	1	41	8	3	2	0	17	6	0	2	1	1	2	2	0	11	2	0	2	1	0	0	0	21	2	12	3	6	14	2	13	0	2	0	1	0	0	0	0	58	307	3	0	0	0	2	0	26	4	29	0	0	0	1	2	22	0	16	4	13	26	1	0	1	0	3	9	0	1	1	0	22	12	4	6	21	8	8	15	6	6	0	27	3	10	13	8	40	23	11	39	1	9	27	4	1	5	4	2	22	10	13	6	5	15	45	6	22	8	10	14	5	46	7	22	16	14	15	8	10	0	0	3	1	38	55	4	6	2	14	8	3	4	85	51	17	181	0	98	5	0	1	1	0	7	20	5	28	0	7	1	1449	412	178	1	0	17	0	0	1	3	2	136	34	35	95	106	18	175	47	25	31	0	0	8	74	9	0	2	1	15	0	31	6	5	15	12	20	3	8	7	17	33	12	0	0	1	11	0	0	1	6	2	3	1	0	0	0	0	26	11	7	1	0	2	26	6	7	4	0	0	0	0	1	7	13	0	0	0	0	0	0	0	0	4	9	1	1	4	1	1	0	12	1	0	5	7	4	1	12	26	1	12	55	2	1	27	0	1	0	1	0	0	0	0	0	0	0	1	0	0	0	0	21	0	4	1	8	0	18	4	2	0	2	5	0	0	0	0	0	1	4	1	2	3	1	7	5	3	0	0	9	0	92	167	24	48	0	24	4	54	0	0	0	0	0	1	1	0	0	0	0	2	0	4	42	23	5	2	1	1	0	0	2	0	0	19	18	2	3	63	3	18	1	1	13	40	0	0	1	23	1	0	6	67	97	24	11	0	1	5	0	1	14	2	46	3	0	1	29	29	9	2	6	15	6	25	13	0	2	33	17	0	1	70	219	21	4	3	0	0	13	12	16	44	0	2	1	0	1	0	14	0	3	0	1	2	0	0	4	0	2	6	2	0	0	0	0	1	11	3	7	0	75	4	0	0	3	1	0	0	1	0	19	27	4	0	3	41	0	8	2	2	3	6	15	0	0	18	0	1	0	49	10	0	0	0	0	5	0	25	7	18	4	6	2	8	4	2	0	3	0	0	22	28	0	9	158	0	0	1	1	1	2	0	6	17	3	8	47	30	16	0	0	22	0	2	4	1	0	1	6	0	0	7	7	2	2	1	2	6	0	0	9	0	1	0	39	3	0	6	0	0	1	3	12	14	6	6	23	0	2	2	0	1	0	11	11	13	2	0	1	19	0	0	5	0	20	44	0	0	31	40	17	0	2	28	1	21	6	10	562	0	0	26	0	3	0	0	0	0	2	0	0	55	11	0	33	6	22	2	4	618	0	5	2	0	1	0	0	20	0	0	0	1	2	2	0	6	2	0	0	0	2	3	1	0	0	7	0	4	0	5	9	36	0	0	0	0	47	8	4	0	1	0	77	69	0	7	0	0	6	2	34860	0	0	0	0	2	0	0	0	0	0	0	0	0	0	3	0	7	1	2	0	0	69	6	117	45	2	11	18	7	3	2	0	0	0	0	6	1	23	76	3	76	12	1	2	0	0	6	8	1	10	0	0	19	0	57	15	16	70	121	44	24	10	0	29	13	0	14	1	0	74	16	34	34	2	2	1	1	6	7	0	128	41	37	3	108	18	0	1	0	19	3	2	9	0	88	15	1	176	10	2	1	79	70	0	0	59	18	1	10	0	3	0	1	0	0	1	2	0	65	144	75	103	188	3	212	17	5	20	54	94	152	261	13	2	70	19	79	31	0	30	57	12	8	8	3	0	3	68	38	138	213	13	0	26	0	0	19	30	8	15	2	0	3	0	5	0	0	0	0	1	2	1	2	9	4	4	0	8	3	0	2	18	0	3	0	1	22	34	91	24	3	1	2	5	0	4	18	20	0	5	0	4	3	22	4	25	23	1	15	1	0	0	26	10	0	0	4	3	2	0	0	0	1	2	0	1	0	5	30	2	0	3	16	8	10	0	2	17	0	0	1	3	6	3	25	2	18	0	1	1	58	44	0	5	11	3	82	16	0	11	12	1	3	4	2	0	2	0	1	2	0	1	3	0	1	1	0	0	2	0	0	6	1	6	4	1	1	0	25	1	0	21	0	4	9	2	2	0	1	1	1	1	2	4	0	2	0	1	0	10	2	5	34	0	5	15	2	1	1	0	14	11	0	2	1	5	25	16	2	68	3	5	8	251	4	6	19	10	0	1	3	4	40	0	3	13	1	20	32	7	12	1	0	0	3	0	0	0	0	5	2	12	4	11	16	18	0	0	0	0	3	30	0	0	0	0	2	0	5	5	22	58	16	5	100	0	38	31	3	5	5	2	0	15	15	23	17	5	30	0	1	25	1	28	2	1	3	1	3	0	1	0	15	0	7	45	32	4	2	0	1	35	8	5	1	1	2	0	4	21	0	1	2	4	0	42	5	12	0	12	0	2	5	7	1	3	4	7	25	27	0	0	0	0	0	2	4	39	130	45	18	12	22	38	13	34	1	12	31	31	22	0	1	12	3	21	0	10	6	4	1	0	1	17	1	6	8	0	1	0	13	0	3	5	7	6	29	3	22	4	15	6	2	27	0	0	3	1	10	0	3	2	139	0	13	0	0	0	3	6	2	1	0	3	1	0	0	0	0	0	0	4	3	1	3	48	0	0	8	0	4	3	18	0	1	0	6	6	15	0	0	1	7	2	0	1	0	0	1	0	5	3	0	1	0	2	2	3	0	178	0	17	14	64	25	22	23	0	0	0	0	0	0	0	0	5	0	1	2	2	2	0	1	0	155	0	0	0	0	0	2	2	0	1	0	0	0	4	1	0	0	58	0	0	3	16	3	20	4	0	15	8	6	5	44	6	2	8	17	5	24	18	30	32	86	458	88	32	542	0	0	21	18	1	5	2	14	14	1	0	0	0	1	0	237	0	0	1	0	210	0	0	0	0	7	49	5	66	1	1	2	4	3	0	0	1	0	0	0	0	4	15	2	0	0	11	201	54	0	2	1	4	0	0	0	0	64	1	0	0	0	1	3	8	47	2	0	1	0	53	6	13	1	46	1	1	36	10	13	1	2	0	1	3	30	11	17	4	5	4	5	0	0	169	3	2	4	3	33	43	0	0	17	204	17	7	766	1	1	2	5	1	0	0	400	9	14	0	2	1	1	45	10	17	4	17	0	7	0	1	10	0	2	1	11	8	7	27	3	2	26	157	1	3	7	0	0	29	19	2	1	27	0	5	1	0	16	1	13	1	4	4	0	1	0	0	18	5	1	4	0	28	3	6	0	2	7	12	8	18	0	3	51	4	0	0	8	1	0	4	10	4	24	7	42	111	11	10	44	1	59	74	94	0	0	0	0	4	0	8	4	0	262	2	0	12	36	52	36	3	9	18	0	8	13	14	3	3	107	13	3	1	1	0	6	0	0	60	149	202	5	0	1	0	8	2	6	0	3	0	6	4	5	6	1	0	0	2	0	0	0	0	7	1	1	0	2	4	1	0	1	1	0	1	0	0	0	0	0	0	2	141	2	1	0	0	2	0	0	1	0	1	0	1	2	0	0	0	14	4	18	5	0	10	5	5	3	2	4	1	6	0	5	1	1	17	13	15	50	15	9	13	5	14	9	2	27	14	1	0	0	0	5	3	10	0	0	14	0	2	9	0	28	18	1	6	15	0	1	97	17	0	23	0	1	2	1	0	0	52	10	24	7	62	6	48	22	4	86	11	15	2	0	0	3	0	22	44	122	93	0	56	21	22	6	7	2	10	1	7	4	0	2	14	7	5	0	0	0	1	42	0	0	0	0	2	0	3	3	14	35	12	26	22	6	12	2	37	25	3	32	5	12	89	31	55	0	2	2	2	0	1	0	12	7	45	10	36	25	0	0	4	1	1	4	0	0	2	1	0	1	0	1	5	1	9	354	317	0	255	274	48	11722	49	1	3	0	0	0	0	0	16	11	10	4	1	11	24	0	1	1	13	5	0	0	0	10	1	0	0	635	105	2	23	59	16	2	3	2	2	0	11	0	109	0	3	2098	0	1	0	22	0	47	0	1	0	2	2	0	3	0	2	0	3	18	0	0	0	0	1	0	0	0	2	0	0	0	2	3	0	4	5	3	2	2	1	0	1	2	6	1	25	1	422	117	0	17	17	26	11	23	10	10	0	30	0	27	3	0	1	0	0	0	1	0	1	0	0	13	1	0	0	2	8	4	1	0	2	7	1	14	0	0	5	0	13	1	0	2	0	0	1	11	0	1	13	7	5	3	0	0	0	0	0	0	2	1	0	8	3	15	2	17	37	44	23	52	0	0	0	2	0	0	0	1	51	0	131	0	5	2	23	1	69	29	0	0	0	0	1	0	0	0	0	5	1	0	0	2	0	0	0	0	0	0	0	1	1	0	1	0	0	2	4	0	3	0	0	0	0	0	564	0	0	0	0	0	0	1	1	5	8	0	0	0	0	0	0	0	1	1	1	2	0	0	0	1	0	0	5	2	0	5	0	0	0	76	0	2	2	1	2	0	22	1	0	0	1	1	6	4	0	4	168	11	0	150	0	0	0	0	0	87	0	0	3	0	6	2	2	1	12	2	1	0	0	0	0	0	0	0	0	0	0	1	0	4	0	1	1	0	0	0	0	0	1	0	0	6	0	17	0	0	0	3	0	0	0	0	0	0	3	4	1	0	0	9	0	0	3	0	1	0	1	0	6	0	0	2	0	5	0	1	1	4	0	0	0	28	0	0	1	0	0	0	2	7	1	0	0	0	0	1	0	1	0	0	2	0	0	2	1	1	2	0	73	0	0	2	1	3	0	4	10	2	1	0	3	3	72	0	42	25	3	0	0	6	1	8	1	0	5	164	0	7	0	0	180	1	58	0	1	1	0	0	5	4	1	4	3	0	0	7	3	53	4	10	0	11	1	0	14	1	10	3	14	0	0	0	13	5	5	5	26	1	7	4	0	0	6	3	3	18	4	4	7	7	8	4	0	2	6	0	2	54	5	3	3	4	14	12	3	3	0	3	42	16	20	11	1	0	3	1	5	15	8	8	0	7	26	0	0	178	4	1	7	1	7	0	93	2	27	15	3	1	1	2	3	13	22	0	5	0	0	1	3	23	4	14	0	41	74	50	5	105	253	100	26	1	2	7	120	0	19	0	0	0	7	2	2	0	0	20	0	12	4	0	0	7	0	3	1	315	24	60	0	0	1	0	2	5	0	108	0	53	84	1	5	0	6	4	4	0	2	0	1	0	6	0	0	33	9	0	15	1	1	5	1	0	0	4	0	0	0	0	0	1	35	0	0	0	2	0	5	1	4	0	1	0	8	15	0	0	1	4	2	0	1	2	7	1	2	70	0	2	0	5	0	6	0	3	0	3	2	0	0	0	2	33	2	23	0	1	1	2	1	1	1	1	1	4	8	0	2	0	0	1	15	1	121	0	5	0	1	0	3	1	0	0	1	77	1	25	2	0	0	2	3	0	3	0	1	0	1	2	0	1	4	4	0	0	1	1	60	14	1	36	53	4	4	1	1	0	2	5	0	1146	0	5	7	58	0	1	2	15	19	70	12	0	0	8	3	21	0	2	3	1	18	9	14	323	0	20	28	7	2	2	0	2	0	0	2	7	1	0	0	1	12	0	3	0	7	4	1	0	29	16	4	1	16	0	0	1	5	0	0	10	15	24	25	34	41	3	30	27	32	0	44	9	10	46	1	34	17	9	0	19	0	1	0	3	134	10	1	1	0	0	61	27	1	0	0	22	0	0	2	0	0	1	1	1	23	27	21	0	1	72	1	0	0	2	0	0	27	2	11	2	15	3	19	5	2	12	0	12	2	31	0	1	2	2	10	5	14	0	17	0	62	63	17	41	22	3	1	7	10	4	6	149	50	0	7	0	1	0	0	1	0	3	6	0	1	0	3	1	0	6	65	8	0	8	0	6	15	3	31	0	5	0	6	2	31	3	20	9	1	1	0	5	35	41	108	23	19	2	1	4	0	7	0	3	4	2	7	1	105	28	65	0	34	0	0	9	12	7	4	0	0	0	0	18	35	16	21	23	4	7	3	71	0	6	4	24	9	2	17	16	14	46	3	2	3	90	32	6	0	0	1	1	0	0	26	0	0	88	0	1	0	2	0	12	5	76	10	1	0	0	1	0	8	0	0	3	2	2	1	5	0	0	0	9	5	4	172	2	32	3	2	0	2	0	71	12	2	0	11	0	2	0	24	2	6	50	19	10	63	0	1	0	18	48	0	1	0	2	0	29	0	1	3	0	0	0	0	1	29	11	1	17	2	28	6	0	0	0	1	0	1	0	54	2	3	2	44	0	0	10	0	10	27	2	24	7	0	0	1	4	0	67	25	0	1	2	1	5	1	0	0	5	11	15	0	0	10	85	14	3	0	3	2	1	4	0	0	0	0	4	7	12	19	0	125	21	8	122	23	27	290	30	46	12	120	119	0	143	15	46	79	33	80	66	0	3	0	8	0	11	0	3	6	5	2	1	29	0	1	0	0	0	0	1	3	5	0	3	0	13	5	5	6	20	2	0	0	0	0	0	0	0	0	0	0	0	0	0	1	1	0	1	2	0	0	0	6	0	2	1	1	16	11	0	0	1	0	2	1	0	0	0	0	0	0	0	1	0	0	0	0	0	0	0	1	0	1	8	25	0	55	10	0	0	18	0	0	0	46	51	63	12	5	15	84	11	0	7	1	9	15	0	0	2	4	0	0	0	44	126	7	59	7	43	0	3	0	21	3	12	6	1	1	3	4	1	0	0	0	0	0	7	3	3	1	4	3	20	8	31	8	23	0	14	28	26	0	29	29	2	1	1	0	0	0	0	4	46	1	2	0	2	3	0	0	20	9	18	0	0	72	9	1	33	0	70	0	0	0	0	15	1	2	0	120	12	2	6	0	3	389	0	0	0	3	6	0	21	0	0	66	0	0	1	13	0	39	10	8	0	16	58	0	1	0	8	0	3	0	1	2	3	15	2	11	27	0	3	1	5	1	24	13	0	1	16	57	14	46	22	12	5	13	23	1	12	1	0	9	5	1	0	0	18	0	0	8	24	7	0	7	3	1	1	1	0	1	13	1	1	2	2	0	0	0	1	1	4	0	1	0	2	1	24	5	0	0	0	0	1	8	5	8	0	11	0	8	2	0	3	14	46	2	13	7	0	53	0	0	214	8	118	18	27	0	5	414	128	2	21	66	3	0	0	12	50	10	105	1	22	0	23	25	16	1	1	4	0	0	20	7	24	0	0	138	102	54	8	0	0	1	0	0	1	78	0	2	5	6	2	0	0	10	6	0	3	30	234	4	74	14	4	0	56	5	4	1	0	0	0	2	6	0	0	0	8	0	23	1	2	10	39	2	79	15	510	30	16	0	0	54	15	0	153	25	29	56	14	132	2	49	79	7	1	1	0	2	12	16	20	587	134	9	0	129	10	38	2	0	43	1	1	3	12	1	0	0	85	131	1	0	0	177	60	19	40	2	25	62	12	83	0	5	35	0	1	10	12	6	1	1	1	1	0	1	1	8	18	0	5	4	1	1	2	3	0	0	0	0	0	1	0	113	23	0	3	1	62	20	15	0	0	3	14	3	7	0	4	0	9	40	5	1	71	0	35	4	0	1	6	24	3	8	3	0	1	30	51	60	15	50	178	88	1	5	1	232	9	53	67	1	0	0	1	0	0	0	1	3	0	2	13	2	0	0	0	0	0	0	0	16	0	4	11	16	11	24	2	1	21	0	9	0	0	3	1	11	0	1	3	42	9	7	58	17	7	72	0	3	0	2	1	2	4	4	0	0	0	4	1	39	0	0	0	0	0	0	7	0	0	0	3	1	0	0	5	3	3	10	2	0	2	1	22	0	0	11	1	0	15	1	0	1	1	0	11	0	0	0	1	0	1	12	14	16	3	0	19	9	24	0	10	0	102	2	52	75	2	3	18	2	12	0	4	0	33	47	789	75	53	37	14	96	46	37	30	51	29	19	0	33	39	1	0	4	14	0	0	1	2	3	5	4	1	1	7	0	2	2	4	18	0	0	0	0	7	5	1	0	1	0	2	0	0	2	2	1	1	1	2	1	0	0	1	0	1	0	3	6	0	31	5	0	61	3	47	40	18	53	0	0	1	3	0	0	7	1	2	35	2	3	43	33	0	0	4	9	2	22	1	8	5	41	0	0	3	0	5	1	17	1	3	0	2	0	0	1	9	5	5	1	55	6	4	6	0	3	0	0	5	1	4	62	13	4	0	9	5	21	0	29	1	3	2	10	0	15	0	32	8	2	5	0	2	15	0	0	0	2	0	0	15	43	11	3	9	3	4	36	2	2	3	1	2	0	0	0	0	6	43	15	3	20	74	12	0	2	5	0	3	2	0	6	0	9	9	5	5
LakWasMet14_LOW5_2_rpkm	0	2	0	0	0	16	33	2	0	0	3	2	13	3	3	0	3	2	36	0	0	0	2	76	0	0	0	0	0	29	0	0	1	7	9	21	6	0	7	0	0	1	0	4	30	63	70	16	0	2	11	6	0	0	0	16	3	45	109	30	387	0	0	14	11	0	0	0	22	107	0	3	0	0	12	0	0	0	0	0	1	7	1	0	0	0	0	4	0	0	0	4	14	3	15	0	1	0	1	0	0	0	1	0	0	0	0	0	0	3	5	0	127	16	47	1	0	0	0	3	0	0	2	5	0	0	0	0	0	0	8	45	22	0	0	0	0	0	24	0	0	0	0	10	2	3	2	0	33	3	11	44	3	6	50	0	27	14	28	0	5	1	0	31	22	0	0	15	2	20	0	0	0	0	0	0	0	0	1	0	2	0	2	0	0	40	0	0	0	8	6	5	15	4	4	0	5	23	14	325	30	0	21	0	0	3	36	0	35	12	5	0	77	6	24	0	13	0	0	13	0	0	33	1	19	33	0	2	12	0	0	3	159	0	2	0	39	63	24	10	1	0	24	20	41	26	3	0	15	33	22	14	30	0	1720	580	0	2	1	0	6	2	12	15	19	0	6	3	6	108	47	0	13	0	0	0	0	0	80	34	4	31	36	21	40	0	0	0	28	1	2	0	0	2	8	2	0	6	9	0	0	41	96	2	28	0	45	40	46	3	23	0	80	32	2	0	2	4	115	0	2	0	0	2	46	1145	6	0	15	0	3	2	0	0	1	0	2	0	2	0	0	1	7	36	16	2	15	3	1	1	5	3	6	0	25	1	1	0	0	156	31	0	8	0	0	16	8	49	42	8	0	28	0	0	30	3	0	5	0	4	0	2	6	6	2	2	121	0	0	0	1	0	42	7	0	21	141	1	0	66	4	30	2	92	54	0	28	0	0	4	0	31	128	14	0	53	45	10	8	1	0	0	1	2	0	3	0	2	3	2	7	0	5	2	1	4	0	0	22	1	119	67	0	0	11	78	0	0	1	1	0	127	38	501	0	59	60	4	1	34	0	10	2	5	4	43	4	0	1	9	20	42	32	2	1	0	29	6	435	3	14	0	12	4	1	1	0	141	61	8	0	0	108	81	6	0	3	1	0	0	0	0	1	0	0	1	0	3	0	2	0	0	2	0	3	0	4	0	2	4	0	0	0	1	0	0	0	0	0	0	1	0	0	6	14	2	39	10	0	45	0	30	4	11	118	0	0	0	4	0	0	1	5	0	0	37	0	0	0	0	0	0	1	2	16	4	47	0	27	1	0	0	0	7	18	41	90	126	1	64	43	204	84	22	105	6	36	10	44	1	0	0	1985	1	12	8	0	7	1	0	48	1	0	4	13	21	0	69	4	18	0	275	208	113	2	0	117	4	404	14	203	79	22	16	0	8	3	9	2	2	8	32	0	3	2	0	0	0	2	4	16	41	0	2	0	10	1	15	13	3	62	1	7	19	2	0	3	0	1	3	7	225	1	144	0	0	1	2	36	48	9	40	0	2	0	1	8	1	0	0	4	0	16	0	2	0	3	0	0	37	0	2	3	0	36	0	0	5	0	5	0	10	0	2	13	3	11	0	48	0	0	0	1	6	27	19	0	6	25	2	0	2	17	8	6	1	3	1	17	0	0	0	2	0	0	0	0	0	2	19	0	41	14	0	49	62	16	0	0	68	0	0	0	4	3	18	4	0	113	20	0	27	0	150	0	4	0	0	0	0	0	0	0	0	2	51	0	0	0	0	0	0	8	2	0	0	0	0	0	19	5	11	5	0	0	1	13	0	2	67	0	4	1	0	204	3	131	0	2	0	0	0	0	0	0	0	24	0	0	0	0	11	0	16	24	1	4	6	3	1	4	0	0	0	1	0	0	52	34	1	0	0	0	0	2	0	0	18	49	34	0	0	12	2	0	0	5	4	1	32	80	14	38	9	0	4	1	0	16	7	0	5	2	0	0	1	5	33	33	81	5	0	0	3	0	7	5	0	0	0	0	0	0	0	0	0	2	4	0	0	0	0	5	5	0	0	0	8	0	0	0	0	0	14	52	29	63	54	25	0	0	1	1	1	0	7	0	0	0	0	31	0	0	0	1	0	1	1	0	33	0	4	0	25	11	0	47	0	0	0	0	9	0	0	0	0	2	0	2	0	0	1	1	0	11	7	0	4	0	0	1	24	5	494	3	35	0	0	2	2	17	13	53	0	73	0	0	7	1	0	0	3	5	0	2	0	0	14	12	0	4	7	0	0	3	0	0	0	0	0	2	0	0	0	0	0	2	188	0	0	0	112	30	2	0	19	0	0	332	21	12	0	0	0	1	1	0	2	237	1	0	7	0	0	2	0	0	11	0	0	0	0	1	7	9	3	2	0	0	7	9	10	0	3648	0	0	0	0	152	23	30	0	2	1	11	4	6	3	11	4	1	0	1	0	0	0	0	1	2	324	12	0	0	0	0	3	2	4	0	0	0	0	0	0	0	36	44	0	7	46	0	11	0	0	10	0	0	11	12	2	0	0	1	1	0	0	46	46	34	2	0	0	0	0	0	7	11	0	2	0	0	0	0	0	0	0	0	0	0	0	0	0	0	0	6	0	0	5	0	7	0	0	0	0	0	0	0	0	0	0	18	22	0	0	2	0	0	0	6	2	0	3	19	3	0	0	0	8	0	2	13	16	22	19	155	204	2	2	0	13	8	0	0	11	0	27	13	0	0	0	4	0	9	0	0	0	7	41	0	5	0	0	36	0	4	0	0	1	68	0	0	2	0	0	3	0	0	0	3	0	11	0	2429	16	0	0	0	2	0	1	5	0	0	80	146	0	0	10	2	4	40	1	0	33	0	7	0	0	0	0	2	21	41	17	5	17	9	32	4	58	1	4	8	5	0	38	1	0	11	0	0	10	0	0	7	14	0	1	15	3	1	0	6	0	0	4	0	0	0	19	0	5	1	1	0	0	4	3	2	0	3	0	59	1	0	0	2	2	5	0	0	0	0	0	12	1	90	56	51	25	1	0	12	0	0	0	4	1	2	18	1	2	4	1	1	0	30	20	0	4	0	2	25	7	11	1	16	7	5	41	0	0	56	29	11	5	8	16	22	0	0	0	14	0	53	1	7	22	9	41	28	16	51	0	0	3	90	30	0	8	0	3	2	7	22	0	3	0	3	9	4	19	32	37	2	0	15	0	0	0	0	0	5	25	19	0	0	9	118	10	27	80	5	0	50	0	8	10	4	2	0	3	3	12	7	11	0	0	3	0	0	0	0	2435	99	19	134	1	0	5	0	0	0	0	6	58	34	12	5	31	0	0	0	7	181	117	45	23	0	5	0	129	0	0	0	0	12	0	0	2	175	56	21	76	92	45	0	25	98	19	0	0	2	0	0	0	178	6	3	0	3	4	0	23	1	2	2	7	0	4	0	6	0	0	0	0	17	4	0	0	2	6	0	3	16	60	0	0	2	5	0	11	0	0	2	2	0	1	3	7	0	0	18	2	0	0	1	0	2	8	0	6	0	21	0	0	0	0	0	0	0	0	0	2	0	9	0	6	0	0	0	0	0	0	10	0	0	694	0	0	129	0	4	0	0	215	0	22	45	3	4	200	0	171	10	0	0	0	0	0	55	0	37	0	0	0	0	0	12	0	0	16	41	1	3	0	16	5	0	4	3	0	0	0	0	0	0	12	15	68	24	47	0	1	0	46	1	0	1	16	3	0	0	0	10	19	0	15	94	4	102	17	13	24	48	0	2	8	2	0	11	31	1	12	10	27	11	0	29	2	0	1	7	0	0	0	27	0	58	21	73	78	157	14	132	16	0	0	0	14	3	58	0	0	4	5	79	0	0	0	29	1	6	2	1	19	57	0	97	27	0	0	0	0	6	19	1	2	51	13	0	2	0	0	0	17	0	240	0	2	88	2	0	2	35	14	22	292	12	2	7	2	15	2	0	23	93	327	53	164	0	0	0	16	10	107	0	0	0	13	0	0	452	0	0	1	0	4	0	21	4	5	50	6	0	0	0	5	0	1	0	25	0	0	2	0	3	2	13	0	0	1	51	0	620	25	0	34	194	300	0	25336	13	0	10	0	0	0	1	0	6	0	0	0	1	6	2	0	0	101	2	3	0	1	0	0	12	4	0	137	0	12	0	6	10	11	30	0	0	1	11	0	7	13	4	2	15	0	1	0	6	0	0	1	25	0	0	18	15	0	0	2	32	300	2	53	1	109	118	0	80	5	74	3	35	27	18	6	75	19	0	20	14	0	0	0	9	0	1	0	0	2	0	5	0	0	8	2	2	14	0	34	121	0	0	3	0	2	0	0	0	1	0	7	1	3	0	12	0	0	12	7	62	12	0	1	4	0	0	6	13	0	0	12	19	0	4	0	0	0	0	0	1	0	0	0	1	0	2	7	0	1	5	10	0	2	0	0	0	0	0	2	150	6	17	13	16	3	3	0	46	0	35	50	115	10	0	2	4	0	4	0	0	0	0	22	4	0	44	4	4	0	0	2	0	0	0	7	2	8	1	0	7	2	9	2	28	40	2	68	5	0	4	0	24	10	51	11	4	0	0	0	0	0	0	0	0	0	3	0	0	0	0	0	3	0	1	0	0	0	2	0	1	0	0	0	1	3	1	0	0	0	14	291	182	0	0	0	2	0	0	0	0	0	0	39	0	0	0	0	0	13	0	0	4	0	0	0	14	0	0	12	2	2	4	43	1	1	3	2	3	3	0	1	4	0	0	23	0	0	1	0	0	24	0	1	6	35	0	49	54	47	5	0	19	0	1	2	37	0	66	62	0	0	0	0	0	15	0	11	0	0	0	0	5	0	1	0	2	0	2	2	0	2	0	3	0	16	0	0	0	0	46	18	0	0	1	2	0	0	8	0	0	0	0	0	0	0	1	0	19	1	0	0	0	14	3	6	2	100	4	0	0	696	0	2	101	181	32	37	6	0	24	12	1	0	0	0	0	5	88	1	5	12	9	4	17	0	1	0	15	6	31	0	0	0	5	67	1	1	36	0	37	0	2	0	0	0	0	21	0	3	0	4	7	22	9	0	6	3	0	10	0	1	55	28	0	14	11	0	2	0	13	40	0	0	2	2	7	0	0	2	15	2	0	4	0	9	172	4	0	0	0	0	0	1	0	5	2	0	2	0	1	1	0	5	0	0	1	0	4	3	0	0	1	0	2	0	0	0	2	0	0	0	0	1	0	15	1	0	4	1	33	4	20	1	22	0	8	0	1	0	0	0	0	26	18	6	0	0	0	2	91	140	128	103	370	147	169	442	17	198	155	193	319	162	34	170	31	330	520	15	44	8	524	648	426	410	970	91	235	69	184	11	193	15	1	5	0	1	0	0	2	0	1	0	85	93	3	0	2	0	0	0	0	0	3	5	0	2	3	0	0	33	0	1	4	0	30	0	11	0	20	4	0	0	4	3	19	0	0	2	0	6	0	0	2	0	3	0	3	0	0	17	0	0	0	0	2	8	21	41	3	0	0	7	0	0	0	8	0	0	19	6	0	6	2	0	177	0	0	20	1	0	3	1	0	0	1	0	3	3	4	14	0	6	0	0	0	0	31	4	0	9	0	2	1	1	0	2	0	16	1	286	1	2	5	2	0	0	1	0	0	13	1	10	4	0	1	0	0	30	8	6	0	0	0	0	0	0	4	6	4	6	0	2	0	1	0	0	1	6	3	23	0	6	0	0	3	2	0	0	102	0	41	23	1	0	0	0	0	10	0	1	4	0	1	0	7	0	0	0	0	0	0	8	2	0	12	0	4	0	0	0	11	2	6	0	0	85	0	21	0	1273	10	0	1	0	0	0	0	0	0	1	6	0	0	4	0	0	4	0	110	144	1	0	0	0	34	0	5	69	14	0	30	2	1	80	4	21	0	12	0	0	0	5	1	10	0	12	2	7	3	2	8	3	1	1	5	2	4	5	0	3	0	0	0	0	0	0	3	0	2	0	7	0	4	0	1	0	28	2	3	0	0	14	32	16	135	405	11	2	6	0	1	0	0	1	0	0	0	0	3	0	0	0	0	0	55	11	4	80	0	0	2	13	0	0	0	0	42	22	11	1	0	2	517	3	0	0	0	3	2	0	0	0	0	0	0	0	106	48	0	0	0	0	0	0	3	5	0	5	27	24	7	2	3	2	0	4	37	30	1	3	1	0	0	1	0	1	0	0	9	10	2	0	78	2	3	0	5	0	6	1	5	0	6	2	11	2	11	2	15	0	4	1	11	0	0	20	0	0	4	0	3	9	0	2	0	0	0	0	0	8	9	0	169	0	3	24	0	33	1	8	2	2	2	0	3	26	1	25	15	0	0	1	0	0	0	6	0	47	0	0	0	0	0	0	71	0	29	46	46	15	0	75	42	28	1	16	1	32	0	42	4	20	3	21	0	15	5	10	2	20	4	12	2	26	0	0	0	26	0	12	0	12	11	16	15	24	3	18	4	0	51	11	9	0	30	0	0	0	43	21	0	6	3	8	1	14	14	9	0	0	0	4	1	14	32	0	0	0	0	15	29	0	5	0	0	198	0	0	1	2	0	0	0	0	8	0	0	12	0	4	11	4	3	0	0	3	2	0	0	1	0	0	1	342	3	10	83	29	34	0	20	1	14	0	3	0	161	0	0	0	0	0	10	0	58	0	3	9	0	0	11	0	1	62	2	0	60	7	0	327	8	36	3	2	0	80	91	0	0	2	0	3	1	0	0	0	3	0	6	7	1	3	59	1	0	2	64	36	0	2	7	3	0	0	1146	800	829	18	0	0	0	4	0	28	6	72	0	0	0	7	0	1	155	430	54	4	1	0	0	0	1	0	81	2	1	0	1	0	1	0	3	6	0	0	2	0	6	0	0	0	3	0	3	0	143	522	7	1	6	0	0	2	2	64	7	2	0	0	0	0	58	29	0	0	0	0	0	0	0	122	11	0	0	0	0	16	1	7	12	0	0	6	8	12	0	1	0	0	0	6	0	3494	7	0	8	0	0	0	11	0	1	0	0	0	0	0	0	18	0	32	0	0	0	0	5	1	0	1	0	0	0	2	0	0	1	0	0	0	0	1	0	0	0	0	0	0	5	0	0	0	1	1	0	0	0	2	1	1	3	0	1	66	0	0	0	5	0	0	125	0	0	0	1	0	0	347	7	0	0	0	9	38	25	68	12	0	18	0	0	10	2	2	73	0	1	31	0	0	3	0	0	0	0	0	10	1	0	1	0	0	0	0	0	0	0	0	7	19	12	0	0	0	3	0	1	0	5	3	3	0	2	0	1	0	0	1	3	0	0	0	0	1	0	9	0	20	0	41	42	2	9	42	0	0	0	0	1	5	0	2	8	18	0	6	0	14	1	6	0	0	1	0	0	1	0	0	2	83	0	44	45	9	2	45	0	17	0	0	0	0	12	0	0	0	2	0	3	11	0	17	43	0	24	1	60	331	0	0	0	0	0	2	0	14	15	11	2	0	1	0	0	0	50	771	0	184	0	0	7	11	4	0	0	2	1	0	0	7	4	0	11	9	70	19	0	0	0	0	6	0	1	1	34	4	16	2	0	0	0	0	0	0	0	17	0	0	0	0	26	0	0	0	7	0	10	10	368	12	0	25	0	8	1	0	72	0	2	1	26	0	7	0	0	0	0	0	409	0	0	0	0	19	0	0	0	1	0	4	6	0	2	1	4	0	0	209	9	1	0	0	0	0	0	79	0	0	0	0	0	4	2	0	0	0	0	2	3	0	2	3	3	0	3	4	3	2	0	0	0	0	2	3	4	0	0	2	0	0	5	3	4	0	5	0	4	0	0	30	2	6	0	0	2	0	0	2	0	0	0	0	0	0	0	2	9	0	0	1	5	2	9	0	1	2	0	0	1	2	0	2	0	0	0	0	0	0	0	0	18	0	2	0	38	0	0	43	0	1	2	0	0	0	0	0	0	53	0	1	0	0	8	2	0	0	1	0	19	0	0	0	4	8	0	2	6	0	94	3	0	0	12	5	0	0	0	0	1	4	0	29	0	4	0	0	2	35	0	1	0	77	18	1	9	3	12	0	0	0	0	0	0	0	0	0	0	0	31	0	0	94	0	0	0	11	8	0	0	0	938	0	0	0	0	2	4	3	0	0	2	0	0	0	98	1	0	0	0	0	7	0	1	15	0	44	0	0	0	2	0	50	0	0	0	1	0	2	0	0	0	11	1	0	0	0	0	4	0	0	0	2	0	0	0	0	2	0	0	0	0	0	0	0	0	0	0	0	0	2	0	0	3	0	12	4	0	0	0	0	0	11	0	6	0	2	3	1	3	0	0	0	5	0	0	0	0	0	0	0	0	0	0	0	0	0	0	0	0	0	0	0	0	0	4	0	6	5	0	1	0	0	0	3	0	4	0	0	0	0	0	0	0	2	110	0	0	95	6	0	0	0	0	52	0	0	19	0	0	0	6	0	0	6	18	0	4	0	0	0	0	384	154	5	3	8	27	277	0	12	0	0	14	22	16	0	0	0	0	2	0	0	2	0	0	33	0	3	0	14	0	2	0	5	0	4	20	2	0	0	4	0	0	0	0	0	5	0	0	0	0	0	0	2	0	1	0	155	0	79	0	0	0	0	5	0	0	0	0	0	523	0	1	0	4	4	0	0	3	3	0	0	8	0	0	9	5	0	16	0	0	0	0	0	1	34	0	0	3	2	16	0	0	0	0	0	2	2	0	3	13	0	3	0	5	0	0	0	0	0	0	0	5	0	70	0	1	7	0	1	34	0	0	115	0	1	0	0	0	0	0	0	0	0	0	0	0	0	0	4	0	0	0	0	14	0	26	0	1	0	0	0	0	81	0	4	0	0	0	0	0	0	5	0	4	0	0	0	0	0	0	16	0	4	1	4	0	0	0	0	33	0	0	0	0	0	0	6	0	4	0	0	0	0	2	4	0	0	2	3	0	0	10	12	41	0	27	1	1	0	25	0	0	0	0	0	0	0	0	0	0	0	7	48	31	0	40	3	3	0	1	0	0	2	0	0	3	2	0	0	0	0	0	0	90	0	6	0	18	0	5	2	3	0	49	6	1	71	0	0	0	0	0	0	0	2	1	0	0	4	8	0	9	4	0	0	0	0	3	0	26	0	2	5	0	0	1	1	0	1	0	2	1	0	0	12	2	0	0	0	0	0	0	2	14	0	25	6	0	1	4	3	3	0	0	0	25	0	0	0	0	1	1	2	0	0	10	43	18	0	0	5	0	0	4	0	7	0	0	19	6	19	0	37	0	2	111	310	32	0	8	0	572	0	32	124	4	0	0	0	62	560	0	71	0	22	30	0	1377	0	4	0	1	10	0	0	33	56	0	43	0	2	24	1	49	35	62	0	13	7	2	10	0	31	1	5	42	3	2	0	3	0	1	0	0	33	12	0	0	0	1	20	0	2	56	0	4	1	0	0	1	0	0	0	0	20	0	0	2	22	0	0	7	36	9	2	0	27	1	11	0	0	0	3	26	0	3	0	0	0	104	118	1	0	0	0	0	6	0	29	8	0	0	0	0	0	0	12	23	0	0	0	0	0	0	44	12	0	0	7	0	0	3	0	0	0	0	0	40	0	2	3	0	32	0	0	0	2	1	12	0	3	12	0	0	0	21	0	0	4	0	31	40	3	5	0	12	7	24	17	7	0	22	0	0	2	0	50	0	1	0	168	125	372	3	25	57	94	507	0	195	82	124	14	388	572	270	0	1179	76	256	73	164	8	221	15	291	0	21	0	5	0	4	0	0	0	15	4	0	0	2	10	12	24	5	0	0	1	1	0	142	3	1	40	15	4	0	3	0	0	2	69	0	12	18	1	4	0	4	0	0	80	0	2	0	3	2	0	0	146	14	0	0	5	104	0	0	35	0	12	7	174	1	14	0	0	8	0	12	288	2	17	12	18	0	0	0	0	0	0	0	4	0	3	2	7	0	0	8	31	0	0	5	0	8	2	0	0	0	80	3	0	19	2	2	0	4	0	0	5	0	18	5	854	0	5	8	0	0	1	14	9	12	30	30	0	4	0	3	1	3	0	0	0	3	24	0	64	0	1	150	2	0	1	4	1	0	0	159	0	17	2	0	25	0	0	2	0	24	0	0	33	4	7	9	0	0	0	9	3	3	40	2	0	0	3	2	0	0	0	0	0	0	0	0	0	0	71	6	0	0	7	3	0	0	0	0	0	0	8	311	0	0	0	2	13	20	3	0	18	10	0	0	145	145	96	0	0	1	0	47	6	2	0	0	8	0	0	5	4	0	0	1	0	1	172	2	14	0	86	0	0	0	0	1	0	6	16	17	2	6	13	2	0	0	0	0	0	6	27	3	15	19	0	0	0	37	0	11	8	12	8	0	0	4	2	40	10	0	5	0	0	5	2	31	0	3	39	0	5	4	2	96	1	9	2	3	0	0	0	2	25	0	9	0	0	0	0	0	0	0	0	8	0	0	9	49	5	18	0	0	32	9	3	0	0	136	0	0	0	0	1	4	20	7	4	0	0	0	4	2	4	1	0	1	0	2	3	0	15	18	0	10	0	4	0	0	0	0	3	88	7	5	0	6	0	0	5	38	0	0	0	6	1	0	0	4	2	1	0	2	0	0	15	11	1	15	2	147	0	0	0	0	0	1	0	0	0	1	2	3	1	0	84	20	4	0	0	0	160	96	14	17	0	0	4	0	0	0	0	0	4	1	1	76	11	0	1	0	0	0	29	0	12	28	19	60	36	23	45	14	5	4	1	0	0	24	5	5	5	1	16	17	0	0	0	5	13	1	33	26	2	22	16	24	3	0	1	0	0	87	0	2	0	24	0	1	3	6	0	0	0	0	0	0	0	12	0	0	3	4	3	0	0	0	0	0	124	25	0	0	0	0	16	16	18	0	19	0	0	5	0	20	5	0	0	0	0	5	278	1	118	0	0	0	38	2	0	16	0	2	0	3	0	0	0	0	5	2	0	2	32	0	0	0	4	0	5	5	2	0	0	0	0	2	15	7	2	13	0	0	3	2	7	43	0	0	41	5	0	1	17	0	0	0	0	7	0	0	7	0	0	30	0	8	4	0	0	0	1	0	26	0	99	8	0	0	0	9	1	7	18	0	0	0	2	0	3	0	0	0	0	0	0	6	6	8	14	0	5	0	0	417	0	3	0	5	0	46	3	1	4	2	3	0	23	3	49	16	0	18	2	2	0	88	0	11	1	0	1	0	69	0	0	0	0	0	0	1	334	8	0	0	0	3	9	0	30	0	0	5	0	1	2	0	0	0	11	2	1	0	0	2	0	0	0	0	0	0	41	0	0	2	0	0	0	0	0	0	0	0	0	0	0	0	0	0	0	0	0	0	0	36	0	0	0	0	0	1	2	1	31	0	1	33	0	0	2	3	2	4	0	0	0	2	0	0	0	0	0	0	0	0	0	1	11	1	3	4	0	0	2	0	78	0	0	0	0	2	22	0	29	0	1	3	4	2	0	3	71	8	0	0	4	0	0	0	17	2	0	116	1	4	654	0	1	0	0	0	9	0	0	40	0	72	0	0	0	3	0	5	0	0	0	0	171	2	0	0	0	5	0	0	0	0	0	0	0	0	1	0	11	0	22	33	0	0	1	0	0	0	0	0	0	0	0	0	0	3	0	0	11	0	0	0	0	169	0	0	0	16	0	4	0	0	0	8	0	0	10	0	0	0	0	0	0	0	0	0	1	0	91	0	0	0	0	0	0	3	64	0	0	0	0	1	0	0	0	0	10	20	3	0	0	0	0	32	14	0	0	0	0	0	26	0	15	15	2	0	0	0	26	0	29	0	25	0	10	2	0	0	2	0	0	0	3	40	0	0	5	0	0	1	0	68	26	35	21	5	8	2	0	0	5	38	4	3	0	5	46	12	26	134	0	39	43	0	58	0	2	0	63	10	0	37	6	0	1	13	31	2	0	0	108	29	15	15	76	1231	0	0	0	42	23	119	0	0	0	20	0	2	25	0	62	0	0	6	0	10	0	0	40	0	3	9	6	1	4	0	1	50	2	20	9	9	0	32	10	44	17	0	25	3	18	0	11	9	12	0	0	1	2	0	6	3	3	1	1	0	4	2	20	164	18	0	1	2	30	24	9	2	14	2	270	24	2	1	1	9	4	6	0	0	0	0	0	4	0	1	1	0	3	0	5	3	21	2	209	5	0	4	0	0	44	0	0	0	0	4	2	5	2	6	1	1	2	1	0	3	0	2	0	2	1	0	7	1	0	2	5	0	3	4	2	0	1	0	0	2	0	0	0	1	1	0	8	1	1	0	2	0	9	0	23	0	66	31	0	10	8	2	0	1	2	2	3	2	21	357	1	4	5	2	0	44	8	8	4	7	6	15	6	0	42	0	0	1	35	39	0	2	0	0	0	63	7	0	0	0	0	0	0	0	0	23	18	0	1	89	1	0	20	24	0	1	3	0	0	1	35	0	12	6	57	73	0	2	1	0	0	14	3	0	1	4	17	14	54	1	78	0	2	0	32	1	262	7	0	0	438	0	11	0	20	0	6	0	12	6	14	47	0	110	6	0	44	0	0	0	0	28	1	0	24	1	0	17	114	51	16	36	13	0	0	0	21	0	4	4	0	1	4	2	4	0	1	0	2	0	12	1	0	569	0	2	24	1	7	0	0	0	35	0	46	4	2	49	16	0	0	0	55	1	3	7	11	26	38	12	5	41	30	31	29	100	19	2	2	0	1	33	1	0	5	3	0	8	0	0	0	0	0	0	0	112	32	10	15	157	66	59	0	207	0	4	0	4	0	20	1	0	0	0	0	0	2	0	0	0	5	0	0	35	22	9	0	2	4	10	0	0	0	0	0	0	216	0	0	0	7	0	23	14	1	5	2	0	41	4	0	2	0	31	0	36	79	38	11	21	0	111	3	1	0	62	52	0	0	0	5	6	1	0	143	0	0	0	46	26	55	19	0	1	15	0	0	0	1	4	35	0	6	4	7	3	2	6	0	97	79	56	10	2	17	8	22	24	14	15	0	91	0	0	41	39	0	6	0	7	0	142	181	106	3	7	39	135	0	0	1	1	3	0	7	0	2	0	0	6	45	26	9	0	7	0	33	19	0	9	0	1	0	0	40	16	4	32	61	6	29	0	76	0	93	13	48	55	54	24	1	18	476	183	0	40	8	0	0	0	4	32	6	10	1	1	0	0	0	0	2	3	5	0	0	0	0	13	65	41	309	550	29	26	0	7	0	11	22	13	1	1	20	0	0	0	1	1	2	0	0	4	8	0	0	0	0	1	0	2	0	14	2	0	6	0	0	0	6	3	27	0	7	45	17	9	10	12	37	25	28	31	18	0	4	1	2	205	119	28	1	0	3	13	9	10	2	12	15	1	6	43	6	6	0	0	0	0	0	4	42	24	0	0	2	1	0	3	5	3	5	0	1	0	0	0	84	2	22	25	624	0	3	2	0	3	0	123	0	10590	0	5	0	8	55	102	23	2	0	0	0	0	0	0	1	29	21	12	3	0	0	0	0	0	4	3	4	0	0	134	0	0	5	1	4	3	0	20	0	4	117	6	0	0	0	9	0	1	8	0	12	0	0	4	0	0	0	0	2	0	0	0	0	0	2	0	0	35	0	38	10	1	43	0	0	5	0	24	98	2	0	2	0	5	0	0	0	92	1	0	3	0	0	4	0	1	0	4	0	127	33	2	21	166	0	4	6	0	34	0	145	12	36	16	0	0	4	0	4	0	7	74	0	0	0	5	130	0	5	6	7	1	1	0	1	0	0	0	0	0	4483	40	38	16	12	2736	1	45	84	53	55	9	571	412	439	43	137	61	61	0	2	320	163	176	80	43	21	0	0	1578	8	0	10	9	2	78	23	0	0	749	21	5	0	1	0	0	6	43	0	1	0	9	16	76	49	25	25	20	14	12	0	8	0	50	32	2	26	4	0	0	0	1	0	2	4	0	2	4	4	0	20	6	48	8	3	42	0	11	0	13	20	4	4	5	0	0	0	0	8	55	0	1	6	0	0	11	0	8	0	5	0	18	20	0	62	23	2	0	41	148	208	3	0	27	102	75	9	32	80	1	81	0	54	17	3	106	0	3	9	24	13	99	16	0	20	29	34	41	0	0	29	11	0	0	36	1	10	0	3	2	61	2	0	22	0	11	0	2	5	2	2	43	0	0	4	5	0	0	0	2	0	12	0	0	18	0	2	0	6	0	757	15	65	0	0	27	7	0	53	5	0	34	0	0	0	103	41	5	84	124	0	90	34	18	3	34	17	33	21	6	4	33	6	47	27	133	73	5	2	0	0	0	5	0	1	1	2	7	60	3	28	0	0	0	1	2	4	54	44	0	21	10	2	4	0	0	0	17	4	5	4	0	0	0	0	0	0	1	2	0	0	0	0	0	0	1	0	13	2	1	12	0	0	0	43	10	2	2	1	17	5	0	5	0	4	0	0	0	7	2	2	2	3	0	0	0	45	1	14	7	7	11	2	39	1	1	0	1	0	0	0	0	49	240	5	0	0	0	0	0	27	44	29	0	0	0	0	0	70	3	19	16	7	27	0	0	1	1	7	3	0	1	0	1	50	20	35	27	14	13	8	28	18	15	0	22	17	85	61	24	147	59	40	125	8	26	16	6	3	17	2	0	22	6	12	16	16	38	62	16	57	23	18	52	16	96	20	12	18	32	27	12	28	4	0	17	0	110	229	8	9	0	50	0	3	40	456	111	5	499	0	342	9	3	0	3	0	0	27	7	49	0	33	0	1779	1448	252	8	0	49	0	0	0	1	0	228	63	108	133	151	55	403	53	28	47	0	0	6	50	33	0	4	2	12	0	38	9	21	16	34	26	6	9	17	27	56	22	0	0	0	14	1	1	0	14	1	15	9	0	0	0	2	33	50	1	0	0	2	32	17	6	7	1	0	4	0	0	2	17	0	0	1	0	1	1	0	0	8	17	2	3	10	2	0	1	4	0	3	0	10	3	0	23	27	4	24	112	4	2	252	1	0	0	3	3	0	0	0	1	0	0	0	0	0	1	0	76	0	0	1	0	0	10	0	0	1	3	2	0	0	0	0	0	0	10	0	1	4	0	14	0	14	0	0	19	0	155	111	40	87	1	36	0	62	0	0	0	0	2	0	0	0	0	1	0	0	2	7	30	32	11	1	0	2	0	0	3	1	2	7	16	9	1	73	1	16	1	2	15	43	0	0	2	29	3	0	8	85	91	68	24	0	0	25	0	4	39	4	44	4	0	0	44	31	19	7	3	26	22	31	31	0	8	73	43	0	8	79	310	26	5	2	0	0	15	12	15	62	2	10	1	0	0	1	16	1	5	1	0	0	1	0	11	0	1	23	6	0	0	0	1	0	15	3	27	0	78	8	0	0	4	0	0	0	0	0	17	21	18	0	10	62	1	10	1	0	1	7	28	0	0	27	0	2	0	21	11	0	6	1	0	2	4	20	9	22	2	2	4	9	0	0	0	2	1	4	21	22	2	9	251	0	0	0	0	0	5	0	19	26	10	9	71	51	25	0	0	51	1	0	7	6	0	0	0	0	0	4	4	6	7	0	6	0	9	2	13	0	0	0	25	5	0	2	0	0	0	4	0	6	11	4	16	1	2	0	0	3	0	8	14	8	4	0	4	36	1	4	0	0	29	55	0	0	20	47	26	0	0	38	0	30	5	15	1285	0	0	16	0	4	0	0	0	0	4	1	1	77	45	0	20	27	23	5	5	874	0	14	0	0	1	0	0	19	0	1	0	1	0	1	0	8	6	1	0	8	7	0	2	4	0	2	0	0	0	6	8	18	0	0	0	0	65	15	2	0	0	7	134	78	0	4	4	2	2	2	69081	0	0	0	0	4	0	0	0	0	2	0	0	0	0	1	0	14	0	0	0	0	85	24	82	87	1	18	8	14	1	0	0	0	0	1	2	0	23	91	0	107	28	0	0	31	0	0	5	0	12	0	0	23	0	55	19	18	127	115	67	21	26	0	13	11	0	54	3	2	90	22	31	42	0	3	0	5	9	6	0	255	24	65	4	153	6	0	0	0	74	0	1	7	0	83	30	3	188	9	6	3	73	61	0	0	94	27	17	17	2	0	0	0	1	0	1	3	0	84	190	153	70	259	0	199	19	0	37	72	148	152	266	17	5	49	9	134	84	0	69	54	38	6	0	9	0	0	63	27	199	334	13	0	20	0	0	42	32	10	18	4	2	4	1	8	0	0	0	0	2	2	2	5	11	0	8	6	10	2	0	5	30	0	0	0	0	29	46	61	12	11	5	15	11	0	4	12	93	0	7	0	22	11	67	0	19	24	0	8	2	0	0	41	10	0	2	0	1	5	0	0	0	0	1	0	0	0	4	45	8	1	1	25	10	8	0	0	0	6	0	0	6	13	3	31	2	28	2	0	1	89	90	0	5	9	2	142	10	0	10	16	1	7	2	0	0	4	0	0	0	0	4	2	0	1	0	0	0	6	0	2	9	0	13	5	1	0	0	2	0	0	0	0	9	15	2	1	0	2	2	5	2	3	4	0	0	1	1	0	2	0	4	52	0	16	27	0	0	0	1	6	20	0	1	0	12	29	9	1	54	2	3	3	362	12	9	33	4	0	9	4	9	20	0	2	7	3	14	33	8	15	0	1	0	5	0	2	0	0	10	4	13	0	16	31	22	0	0	0	0	3	70	2	0	0	0	2	0	5	2	28	71	40	4	122	0	50	39	8	1728	14	0	0	10	18	43	29	4	33	0	0	82	2	50	2	3	0	0	0	0	5	0	19	0	11	69	32	5	5	2	0	27	20	15	3	0	0	0	15	27	1	2	0	4	0	42	3	14	2	22	4	6	19	7	4	8	8	8	42	41	0	1	0	0	0	4	3	44	212	49	13	12	22	48	3	28	4	10	29	30	13	0	2	16	3	12	0	8	5	5	0	0	0	24	8	4	14	6	24	0	13	0	5	15	9	10	29	13	29	0	8	9	2	25	0	0	2	0	5	0	4	0	286	2	14	0	0	0	3	18	2	2	0	3	0	0	0	0	4	0	3	5	0	0	5	44	0	0	2258	0	0	12	17	2	0	1	4	11	2	1	0	0	0	0	0	3	0	0	0	0	6	1	2	0	0	6	0	0	2	292	0	28	12	86	25	14	18	0	0	0	0	0	0	0	0	5	0	0	0	6	0	1	1	0	141	0	0	2	0	1	7	0	0	0	0	0	1	0	2	0	0	66	0	1	5	11	5	10	11	0	26	7	7	4	82	8	10	9	17	9	12	18	26	36	150	546	92	88	731	0	0	49	11	4	9	12	19	14	3	1	0	1	0	0	219	0	0	5	0	365	3	2	0	0	3	243	5	102	2	1	6	3	12	1	1	2	0	0	0	0	9	4	0	0	2	4	199	70	0	0	0	4	3	0	0	3	37	0	0	0	1	1	3	15	53	2	2	0	1	33	9	3	0	57	2	0	34	9	4	1	4	1	0	4	37	11	33	14	0	0	5	1	0	258	4	5	8	3	98	33	3	0	20	298	20	18	1091	2	1	5	2	0	1	0	389	16	18	1	2	4	3	40	0	18	4	14	0	14	0	2	31	0	2	0	50	15	10	130	3	1	71	187	3	2	1	2	0	46	23	5	0	9	0	39	0	2	8	0	8	1	5	5	1	6	0	0	32	6	4	0	0	22	11	0	1	0	18	120	28	36	0	2	86	5	0	0	0	1	0	9	24	2	30	17	84	155	14	9	57	3	47	60	80	0	0	0	1	9	0	13	0	0	362	5	0	30	74	92	32	3	20	10	0	10	3	14	2	0	101	15	0	0	0	0	9	0	0	130	256	212	3	0	0	0	7	0	6	0	4	0	6	0	15	7	0	1	0	0	0	0	0	0	7	1	1	0	4	5	0	0	0	0	0	0	1	0	0	0	1	0	3	181	2	1	0	0	0	0	0	2	0	0	0	0	7	0	2	0	18	4	27	8	0	10	10	3	9	0	8	1	24	0	6	0	0	17	452	16	56	9	8	42	5	15	29	3	30	20	0	0	1	1	10	3	6	0	0	17	0	8	10	0	33	16	2	3	17	1	0	122	52	0	29	0	0	2	4	0	0	54	15	20	14	75	11	56	39	3	78	19	23	9	0	1	5	1	34	61	150	111	0	64	28	68	4	5	0	7	0	8	0	0	0	47	4	0	0	0	0	0	118	1	0	0	6	5	0	10	5	8	69	12	23	38	2	19	9	51	30	9	37	19	12	94	35	85	2	2	2	3	0	0	0	14	2	52	15	26	42	2	0	6	0	2	0	0	0	0	0	0	0	0	1	2	0	23	343	387	2	236	306	69	14513	95	0	8	2	0	0	0	0	22	8	19	8	0	8	46	0	0	1	19	5	4	0	1	10	1	0	2	572	150	2	30	53	53	3	0	0	0	0	10	1	148	0	3	2224	0	0	0	22	0	73	1	3	0	3	0	1	0	3	2	1	0	27	0	0	2	0	0	8	0	0	0	0	0	0	2	4	0	2	0	4	3	3	1	0	0	0	0	2	25	0	509	316	2	14	24	23	28	25	40	27	0	50	3	39	2	0	0	0	0	0	0	0	0	0	0	5	0	2	0	2	23	7	0	2	1	5	4	20	3	0	0	0	12	0	0	0	0	1	0	23	0	1	20	16	0	1	0	1	1	0	0	0	1	0	3	3	3	11	0	39	59	75	26	26	1	2	1	0	0	0	0	0	21	0	102	4	0	6	27	0	88	62	0	0	0	0	0	3	0	3	0	9	3	3	0	0	3	0	0	6	0	0	0	0	0	0	0	0	0	10	2	2	6	0	0	0	0	0	830	0	0	0	0	0	6	0	0	6	4	0	0	1	0	0	0	4	0	0	3	0	0	0	0	1	0	0	4	2	0	21	7	0	0	141	0	0	0	0	4	0	45	1	0	6	1	0	6	0	0	5	55	12	0	259	0	0	0	0	0	16	0	0	0	0	0	0	2	0	12	0	1	0	0	8	3	0	0	0	0	0	1	2	0	0	0	0	0	0	0	0	0	0	5	3	0	3	0	20	0	2	3	0	1	0	0	0	0	0	0	3	3	0	0	3	0	0	2	3	0	0	0	0	9	0	0	0	0	3	0	0	3	0	0	0	0	31	0	0	0	0	0	0	0	3	0	0	0	0	0	2	0	0	0	0	5	0	1	1	0	4	2	0	215	0	0	0	0	3	0	3	24	0	0	0	12	2	77	0	154	16	2	0	0	12	0	22	0	0	6	450	0	12	3	4	456	0	164	0	2	6	0	0	6	3	2	6	11	0	0	8	6	81	11	20	0	38	1	0	18	6	11	0	62	0	43	0	66	10	16	8	110	0	14	14	0	2	16	8	5	11	10	5	0	11	9	0	0	4	26	9	5	142	4	14	4	0	54	31	3	0	2	0	115	35	36	17	9	2	29	1	28	31	0	10	5	8	59	0	4	731	8	2	12	5	8	0	158	6	44	50	3	0	12	4	24	42	26	5	16	12	0	3	9	16	9	22	0	52	88	39	19	230	195	77	29	0	0	4	124	0	14	0	3	0	2	0	0	0	0	13	0	9	0	0	0	0	0	13	2	315	18	63	0	4	4	0	2	6	2	136	0	32	37	1	3	0	8	10	2	0	2	0	0	1	3	0	0	3	12	3	12	0	5	22	3	0	0	7	0	0	0	0	0	1	53	0	0	0	0	0	0	1	3	0	0	2	4	123	2	0	0	4	1	1	9	12	13	1	1	40	1	2	0	0	0	32	4	0	9	2	2	0	0	1	0	30	0	31	1	1	0	2	3	0	2	0	1	4	10	2	7	0	0	0	21	4	117	0	8	0	2	0	19	0	0	0	3	88	0	22	8	0	2	0	2	3	0	1	4	0	1	1	0	2	0	0	0	0	2	8	70	28	0	45	72	0	2	0	6	2	8	6	2	1858	0	14	16	279	0	0	4	12	15	116	12	0	0	11	17	19	0	3	2	0	31	34	52	728	0	30	42	14	6	2	0	2	0	1	0	2	0	0	0	0	33	4	2	0	17	11	2	4	37	20	0	5	19	0	0	2	2	0	0	8	31	37	26	55	89	3	40	24	1182	0	55	22	7	52	5	61	22	31	0	12	0	0	0	13	108	14	0	0	0	0	61	35	1	0	0	27	0	0	0	0	4	2	5	0	31	31	23	0	0	99	1	0	0	7	0	0	11	2	2	3	9	0	36	13	8	33	0	45	0	40	0	1	1	7	17	0	13	0	43	0	41	110	28	74	34	3	0	24	7	6	30	426	57	1	10	0	2	0	0	5	0	0	8	0	0	0	1	0	0	0	30	33	0	7	0	2	21	7	44	0	11	0	7	7	41	8	18	0	0	0	1	2	70	56	133	45	33	0	2	0	7	16	0	0	6	2	5	2	130	98	82	0	36	0	0	19	24	6	2	0	0	0	2	25	47	24	85	54	6	12	8	200	0	12	4	31	22	3	15	24	23	59	8	4	13	66	84	7	0	1	0	0	0	0	61	0	0	114	0	1	0	0	3	5	4	111	5	20	0	2	0	0	1	0	0	10	4	6	0	6	0	0	0	58	16	6	250	3	27	1	0	0	5	0	89	16	3	0	13	1	6	0	14	2	0	74	23	7	151	1	1	0	12	66	0	0	5	4	0	61	0	2	1	1	1	0	0	1	32	23	0	9	4	20	21	0	4	0	0	0	0	0	86	2	3	0	58	0	0	15	0	13	23	2	37	35	0	0	0	3	0	103	47	0	5	8	3	5	14	1	0	4	5	10	0	0	33	131	29	1	0	0	0	3	5	0	0	0	0	3	5	33	27	12	173	24	16	106	5	6	337	30	27	16	72	113	7	143	47	32	94	6	72	44	0	11	7	8	0	25	0	5	7	4	5	1	29	0	1	2	0	0	0	2	2	0	0	4	0	18	6	5	16	12	8	1	0	0	0	0	0	3	6	0	0	0	0	0	1	0	0	0	0	0	0	0	0	0	0	0	3	19	9	1	0	0	1	0	0	0	3	0	0	0	1	0	0	0	0	0	0	3	2	1	0	2	0	12	52	0	85	4	0	0	14	0	0	0	62	31	54	27	2	22	54	4	0	13	1	8	7	0	0	0	0	0	0	0	45	147	18	89	13	39	1	6	1	33	12	11	5	0	0	0	6	8	1	0	0	0	0	13	1	7	9	6	1	19	14	35	17	28	2	12	33	22	1	37	44	3	0	6	0	5	0	0	6	56	2	4	0	1	0	0	1	12	9	25	0	0	113	3	5	7	0	138	0	0	0	0	21	0	4	2	204	0	6	15	0	12	484	1	1	0	7	8	0	19	0	0	67	0	0	26	18	0	53	10	4	1	23	71	0	1	1	11	0	8	0	7	2	7	15	3	15	58	0	6	0	7	0	26	4	0	0	21	117	6	55	23	8	5	9	22	0	21	3	1	7	12	4	0	0	39	0	0	5	15	11	0	8	8	1	2	2	2	0	11	2	7	0	5	11	0	0	6	0	0	1	1	0	2	2	30	3	0	0	0	0	8	5	8	3	0	14	0	2	0	1	1	8	37	12	20	18	0	51	1	0	346	15	191	12	28	0	5	609	137	0	34	60	3	0	0	19	75	4	24	0	34	0	47	48	22	1	5	4	0	2	4	19	20	0	0	152	144	55	7	0	0	0	0	0	0	169	0	3	8	0	0	0	3	4	0	2	0	13	298	11	147	3	27	0	84	5	7	0	0	0	0	0	7	0	5	0	11	0	39	0	0	31	11	0	127	15	726	101	3	1	0	73	22	25	179	53	38	68	47	260	3	86	207	12	0	0	10	2	10	15	26	703	106	27	0	56	0	32	0	0	67	0	2	6	12	0	5	0	105	213	0	0	0	152	52	46	48	9	18	38	17	108	2	5	101	0	0	55	13	26	0	7	1	3	0	1	0	15	9	0	0	7	0	2	0	1	0	0	0	0	0	1	0	152	16	0	1	3	65	32	20	0	0	6	28	15	6	0	2	0	13	29	13	5	79	0	37	23	0	0	6	56	1	41	8	0	3	46	50	63	12	47	194	102	0	2	5	319	24	92	98	4	0	0	1	0	0	1	0	3	0	0	4	7	0	0	0	0	0	0	0	23	0	6	5	23	7	15	2	0	19	0	10	0	3	2	3	17	0	0	4	49	15	7	60	21	12	62	0	4	0	0	0	0	2	13	0	0	0	4	1	35	1	0	0	0	0	0	7	0	0	0	27	0	4	0	2	14	4	9	6	0	12	0	59	0	0	9	0	2	17	0	0	0	0	0	7	4	0	0	1	0	2	23	19	15	4	5	20	10	56	0	19	0	388	1	231	302	4	2	12	6	11	3	0	1	21	173	1102	86	67	38	2	165	44	40	15	52	14	19	0	30	60	0	0	4	35	0	1	0	119	0	0	0	5	0	9	0	2	2	3	37	0	0	0	0	0	1	0	0	0	0	1	0	0	3	1	6	2	1	3	0	1	0	0	0	0	2	2	7	0	33	9	0	71	0	30	37	37	123	1	0	0	19	0	0	8	0	5	42	0	0	50	36	0	0	0	10	2	41	2	7	10	18	0	0	2	0	0	2	14	0	2	0	2	0	0	0	8	3	2	2	31	2	16	0	0	4	0	0	4	0	3	60	42	7	2	12	5	20	0	39	8	6	5	10	0	16	1	53	11	0	2	0	0	16	2	0	3	6	8	0	4	121	6	3	14	3	5	47	4	2	2	0	3	1	0	0	0	2	76	20	5	21	73	0	2	4	5	0	0	0	0	7	0	3	8	2	3
LakWasMet15_LOW5_2_rpkm	0	0	0	0	1	36	45	0	1	0	2	10	10	2	0	2	0	2	24	0	0	4	0	50	1	0	0	1	1	12	0	2	0	10	7	7	6	0	4	0	0	0	1	25	36	52	47	19	0	8	4	5	2	0	0	14	2	22	87	8	750	0	0	16	1	1	0	0	13	68	3	6	3	0	7	0	0	1	0	1	0	9	0	0	0	0	1	2	2	0	0	3	26	10	20	0	3	0	1	2	0	1	0	0	0	0	0	1	0	0	0	0	97	9	34	7	0	1	0	0	1	0	4	6	0	0	8	1	2	0	0	54	24	1	0	0	1	0	31	0	0	6	0	14	1	1	0	0	20	7	3	21	6	17	26	0	20	22	16	1	7	4	1	26	33	9	0	8	2	29	0	0	0	0	0	0	0	0	0	0	0	0	0	0	2	95	1	0	0	18	12	3	7	5	1	1	2	7	10	943	31	0	57	0	0	1	35	0	32	12	5	2	87	11	16	1	28	1	0	7	0	3	26	6	5	38	0	2	12	0	4	1	35	0	1	0	22	46	93	13	0	0	20	22	57	29	0	1	26	24	27	11	23	0	1539	745	0	0	0	1	2	2	8	20	20	0	1	2	2	60	84	0	17	0	1	3	0	3	84	94	3	27	67	17	35	0	0	0	18	1	3	0	0	1	2	1	1	7	6	1	0	23	69	2	34	2	47	26	32	2	52	0	37	20	0	0	1	1	1	0	3	0	0	5	9	5344	7	3	14	0	0	7	1	0	0	0	1	0	0	1	0	1	15	36	20	2	10	2	0	1	6	4	1	0	5	0	1	0	0	64	44	0	5	0	1	16	16	33	53	12	0	17	0	0	6	10	1	4	0	4	0	0	3	3	3	0	186	0	0	0	0	2	75	6	0	22	139	0	0	117	1	35	0	10	28	0	4	0	1	0	0	5	240	41	2	57	45	4	7	2	0	0	1	1	0	0	0	0	5	1	4	5	2	1	0	2	3	0	7	1	48	85	0	0	14	38	0	1	0	0	0	119	37	65	0	74	33	3	0	30	1	0	0	5	5	38	3	0	3	26	32	44	20	6	0	0	11	7	856	1	8	0	6	6	0	2	0	169	86	9	0	2	61	44	18	0	9	0	0	0	0	2	4	1	0	3	0	4	0	2	0	1	0	1	2	2	3	0	6	4	0	0	0	0	0	0	0	0	2	0	2	0	0	8	9	1	6	1	1	19	3	27	0	20	94	0	0	4	0	0	0	1	1	0	0	77	0	0	0	0	0	0	0	1	12	1	33	0	17	0	0	0	0	5	20	71	90	126	3	55	97	130	178	48	46	2	25	2	22	0	0	0	12	0	4	1	4	1	1	0	18	0	0	1	17	8	0	74	0	43	0	210	319	145	3	0	83	0	416	7	243	131	28	12	0	11	5	15	1	6	9	25	1	7	0	0	0	0	0	3	2	48	0	0	0	3	0	6	8	0	145	0	3	23	3	0	1	0	0	4	8	275	0	196	0	2	0	0	20	64	12	25	1	2	3	1	16	1	1	1	9	1	9	0	0	0	1	1	1	18	2	1	4	1	27	0	0	3	0	9	0	9	0	4	8	2	3	3	15	0	5	2	0	0	43	4	0	5	24	2	0	2	7	3	4	0	4	0	24	1	0	0	2	0	2	0	0	1	1	11	0	39	27	0	48	40	25	0	0	119	0	2	0	0	1	23	4	0	175	9	0	28	0	39	2	3	1	0	2	0	0	0	0	0	0	42	0	0	0	1	0	1	4	0	0	2	2	0	0	8	2	6	9	0	0	1	12	1	1	66	0	0	0	0	409	10	55	0	1	1	0	0	1	0	2	0	28	0	0	0	0	0	0	44	16	1	2	7	1	0	0	1	1	1	0	0	1	49	32	0	0	1	0	0	1	0	0	27	45	35	0	0	10	2	0	0	10	1	0	34	54	5	3	2	0	2	5	0	6	7	0	4	1	0	0	0	4	31	23	111	2	1	0	8	20	7	0	0	0	0	0	1	1	0	0	0	2	1	0	0	0	0	2	0	0	0	0	6	0	0	0	0	0	16	40	22	68	25	29	0	0	0	1	1	0	2	0	1	1	0	25	1	1	1	0	0	1	0	0	73	0	0	0	6	10	1	61	5	0	0	0	13	0	1	3	0	0	0	1	1	0	0	1	2	3	5	0	2	1	1	2	20	12	463	5	27	1	0	1	2	12	18	41	0	52	0	0	0	2	0	0	5	0	0	2	1	1	22	20	0	0	3	0	0	1	0	0	0	0	1	1	0	0	0	0	0	0	128	0	0	0	87	33	0	2	14	0	0	72	7	1	0	0	0	0	0	1	3	516	1	0	1	0	0	0	0	1	15	0	0	1	0	5	8	10	1	0	0	0	14	18	53	0	18	0	0	0	0	193	56	21	0	5	4	9	3	21	2	15	12	0	0	0	1	0	0	0	0	0	20	14	0	0	0	0	1	0	1	0	0	0	1	0	0	1	113	80	0	9	84	0	7	3	0	12	2	0	6	4	2	1	2	0	0	0	0	75	90	20	17	7	0	2	0	0	7	22	0	8	0	0	0	0	3	0	0	0	0	0	0	0	0	0	0	28	0	14	1	0	2	0	0	0	0	0	1	0	0	0	0	26	30	1	0	4	0	0	4	7	0	0	1	11	0	1	0	0	6	0	0	13	5	18	13	107	100	0	1	0	18	27	1	0	13	0	2	8	0	0	1	3	0	16	0	0	0	18	52	0	5	0	3	54	0	0	0	1	0	87	0	0	0	1	1	4	0	0	5	20	0	7	2	788	16	0	1	1	2	2	0	7	0	0	60	61	0	0	3	2	1	51	1	0	20	0	6	0	0	0	0	0	27	32	9	5	16	8	39	0	56	0	1	6	10	0	62	1	0	5	0	0	17	0	0	0	4	1	0	83	5	0	0	1	0	1	3	1	1	1	14	2	4	1	0	0	0	0	0	1	0	0	0	109	0	1	0	0	0	5	0	0	0	2	14	5	0	51	79	28	35	0	0	6	0	1	0	2	4	4	4	1	2	1	0	0	0	30	15	0	1	0	0	36	10	11	0	11	6	3	42	0	0	57	13	18	10	10	15	11	0	1	0	14	0	23	1	11	17	5	46	17	9	57	0	0	6	38	25	0	5	1	0	5	21	11	0	4	2	2	14	1	23	39	19	3	1	12	0	0	0	0	0	4	23	29	0	0	7	175	4	19	53	2	2	40	0	4	7	4	10	2	5	2	18	13	21	0	0	2	0	0	1	1	1058	92	13	52	0	4	1	0	0	0	0	2	70	8	4	2	22	2	1	0	22	134	82	45	22	1	3	1	149	1	0	5	0	7	0	1	1	84	53	28	79	87	78	0	27	84	9	0	0	5	0	0	0	362	6	1	0	0	10	0	13	6	1	0	5	0	6	0	3	0	1	0	2	24	1	1	1	1	6	0	8	30	44	1	0	1	0	0	9	0	1	0	0	0	0	2	2	0	0	6	1	0	1	0	0	0	6	0	6	0	145	1	1	0	0	0	0	0	1	0	0	0	3	0	0	0	0	0	1	0	0	4	0	2	1247	8	1	128	0	4	0	1	147	0	21	17	1	1	288	0	357	10	9	1	0	2	0	45	3	31	0	2	3	0	0	10	0	1	23	25	0	0	0	11	1	0	5	1	0	0	0	0	0	0	2	10	79	27	83	0	0	2	47	0	1	0	3	8	0	1	0	18	2	0	23	18	0	37	4	8	29	25	0	5	7	0	0	6	50	1	8	8	8	18	0	44	0	0	0	4	0	0	0	21	0	34	37	43	102	105	27	52	20	0	0	0	11	4	70	0	3	8	21	72	0	1	0	30	1	7	0	2	14	31	0	70	21	0	15	0	5	5	81	1	0	44	7	10	1	0	0	0	17	1	216	0	5	81	2	0	1	17	18	6	80	8	2	15	1	3	4	0	9	113	645	116	134	0	28	2	6	9	78	0	4	14	2	2	0	773	2	3	2	12	4	0	29	28	5	65	4	0	0	0	5	0	3	0	49	0	0	2	0	1	3	2	0	0	2	97	0	1382	19	2	69	360	247	0	48332	15	0	9	0	1	0	0	1	4	0	0	0	2	4	1	0	0	39	0	0	0	2	0	0	15	4	0	56	2	7	0	4	17	32	8	0	0	3	16	0	14	11	7	1	16	0	1	0	11	1	0	0	23	0	0	15	35	0	1	0	57	322	3	39	0	73	103	0	75	9	54	1	21	39	20	8	121	11	0	29	7	0	0	0	3	1	1	0	0	0	0	2	0	1	6	3	3	23	0	51	89	0	0	0	0	0	1	0	1	0	0	2	4	0	0	4	0	0	4	16	96	1	1	0	1	0	0	5	0	0	0	3	5	0	2	0	0	0	0	0	0	0	0	0	1	0	146	7	0	0	2	17	0	0	1	0	0	2	0	0	193	1	13	5	11	2	8	0	35	1	50	34	58	21	0	1	1	0	0	0	0	0	0	23	0	1	94	95	10	2	0	12	0	0	0	0	1	1	3	0	18	0	24	12	29	71	0	37	6	1	0	1	19	12	45	7	1	0	0	1	0	2	0	0	0	0	6	2	3	0	0	6	5	0	1	0	1	0	0	2	0	0	2	0	0	0	1	0	1	0	45	393	168	0	0	0	2	1	0	1	9	0	0	15	1	0	0	0	1	6	2	0	0	0	11	0	9	0	0	5	4	1	1	41	2	1	7	0	5	0	0	0	0	0	0	5	0	0	0	0	0	26	0	0	19	28	0	43	45	31	7	0	17	0	0	0	98	0	46	35	0	1	6	0	1	14	0	25	1	2	0	1	1	4	0	0	1	0	1	2	0	2	0	0	0	6	1	0	0	0	60	35	0	0	2	1	0	0	4	0	0	0	0	0	0	0	2	0	26	0	0	0	2	16	7	5	2	69	6	2	4	1035	0	3	137	219	56	12	4	1	16	10	0	0	1	0	0	4	99	1	0	22	5	3	0	0	0	0	6	1	14	0	0	1	3	62	0	1	30	0	53	0	1	2	0	0	0	12	1	1	0	2	2	15	39	0	2	3	0	17	2	0	39	35	1	8	9	0	0	0	12	51	0	0	0	0	1	1	0	1	5	0	0	1	1	6	133	2	1	0	0	0	6	4	0	3	1	0	4	0	0	0	0	0	1	0	0	2	1	1	1	1	0	0	0	0	1	0	7	1	0	0	0	1	2	22	1	0	5	2	28	1	37	0	9	0	3	4	0	0	0	0	0	8	5	1	0	0	1	0	143	148	79	157	210	106	92	252	16	134	164	339	266	90	28	78	27	253	302	16	64	13	432	454	309	316	469	129	199	64	151	21	98	16	1	3	0	0	0	0	0	0	2	0	136	79	0	0	4	0	0	1	1	0	4	2	0	0	1	0	1	28	0	0	1	0	10	0	6	0	15	4	3	0	2	1	35	1	5	3	7	4	0	1	1	2	0	0	1	0	0	17	0	0	0	0	6	6	3	14	1	0	1	4	0	0	0	14	0	0	3	2	0	1	0	0	212	0	0	33	1	0	2	0	0	2	1	1	1	1	4	9	0	13	0	0	1	0	12	0	0	3	0	3	1	1	1	2	1	6	2	218	5	2	11	7	0	0	1	0	0	8	0	2	1	0	1	0	0	59	3	4	0	1	3	0	1	1	6	11	5	5	5	3	2	1	2	1	4	61	3	9	2	2	0	0	0	2	0	0	72	0	64	40	1	0	0	0	0	15	0	3	2	2	1	0	4	1	0	0	1	0	0	5	0	0	3	0	1	0	0	1	3	2	1	0	0	599	2	8	0	473	4	0	1	0	0	1	0	1	0	3	4	0	1	0	0	0	10	0	35	37	2	0	0	0	32	0	3	48	15	0	67	14	0	55	0	25	12	9	0	0	1	1	4	12	0	11	4	3	0	2	0	2	3	0	6	0	0	3	4	0	0	0	0	0	0	1	3	1	0	0	5	0	3	0	0	1	33	1	6	0	0	41	20	16	166	388	14	1	0	0	0	0	0	1	0	1	0	1	0	0	0	0	1	0	31	5	6	7	1	2	3	11	0	0	0	0	20	12	4	1	0	0	663	2	0	0	0	0	1	0	0	0	2	0	0	0	53	43	0	1	0	0	2	0	0	2	0	1	22	29	7	6	2	2	1	1	29	19	0	20	0	0	0	1	1	0	0	0	3	5	3	0	50	2	1	0	0	0	0	8	1	0	2	3	3	3	2	2	2	1	6	5	4	0	0	3	0	0	2	0	4	15	1	0	0	0	0	1	0	9	5	1	85	1	2	25	0	28	0	5	1	1	10	1	3	15	1	18	26	11	0	0	0	0	0	3	6	63	0	0	0	0	0	0	47	0	21	40	61	16	0	48	36	21	0	24	0	28	0	35	0	17	2	13	1	17	12	6	0	12	1	11	0	14	1	0	0	34	0	13	1	12	18	6	18	21	8	19	4	0	22	6	3	0	43	5	16	0	44	26	1	21	1	6	3	11	32	11	0	0	0	4	0	2	32	0	0	0	0	8	9	0	2	0	2	414	0	0	0	0	0	0	0	0	8	1	0	10	0	6	4	3	1	0	0	1	2	0	0	0	0	2	0	251	6	3	32	15	33	0	21	1	19	1	1	1	141	0	0	1	2	4	10	0	121	1	18	14	0	0	3	0	0	27	2	0	38	5	0	202	0	36	3	1	0	47	88	0	0	0	4	6	2	2	0	0	7	0	4	4	0	1	48	3	0	1	57	58	1	1	1	0	0	1	653	1113	1503	4	0	0	2	8	1	22	10	53	0	3	0	1	1	1	127	390	37	2	1	0	0	0	1	0	56	4	11	0	0	0	2	0	1	5	0	0	4	0	0	0	0	0	0	0	2	0	113	255	1	2	1	0	0	1	1	73	4	0	0	0	0	3	35	89	0	1	0	0	0	0	1	117	2	3	6	0	6	14	0	1	5	4	0	9	0	12	1	2	0	1	0	3	3	4827	11	0	2	2	4	0	6	1	0	0	0	0	0	0	0	47	1	6	0	0	0	0	0	1	0	0	0	0	0	1	2	0	1	1	2	1	0	1	0	1	0	0	5	0	2	1	0	0	0	0	0	0	4	0	5	0	0	0	0	45	0	0	0	10	0	0	81	0	2	0	0	1	1	151	3	0	0	1	13	55	44	17	5	1	51	1	0	25	0	0	92	0	1	67	0	0	1	0	0	0	1	1	18	0	1	0	1	0	0	0	0	0	0	0	1	10	1	1	1	0	0	1	0	0	1	0	1	0	1	0	2	0	2	2	1	2	0	1	0	0	0	11	0	36	0	59	26	3	3	16	0	2	0	0	0	5	0	1	3	76	1	0	1	7	1	8	0	0	1	0	0	0	0	4	2	9	0	54	20	20	1	29	0	5	0	1	0	0	20	0	0	0	1	0	0	15	1	34	49	1	67	2	57	378	0	0	1	0	0	1	0	7	10	22	0	0	0	0	0	0	47	449	0	477	0	1	0	24	0	3	0	1	0	0	0	3	1	0	3	15	106	16	0	0	0	1	2	0	1	1	59	2	11	1	0	0	0	0	1	3	13	11	0	0	0	0	41	1	0	0	8	0	4	2	1132	1	0	10	5	3	0	1	62	0	2	0	16	1	2	2	1	0	0	7	341	0	0	0	4	14	2	0	0	0	0	1	7	0	2	0	0	0	1	125	1	0	0	0	0	0	0	65	0	0	0	0	0	2	2	0	0	0	0	2	1	0	4	2	1	0	0	3	7	1	1	0	36	0	3	2	2	1	0	1	1	0	1	0	6	1	7	0	1	0	3	19	1	7	0	1	2	0	0	2	0	0	0	2	0	1	2	0	7	1	1	3	1	0	4	0	0	0	0	0	0	3	1	0	2	1	0	1	0	1	0	3	6	0	1	0	35	2	1	21	2	1	1	1	0	1	0	0	0	0	0	0	0	0	2	2	0	0	0	0	5	1	0	1	0	13	0	0	0	0	196	1	0	2	14	0	1	1	0	0	1	1	0	29	0	0	0	2	4	4	0	1	1	67	6	0	2	3	18	1	0	0	0	6	0	1	7	2	0	0	17	0	0	197	0	0	0	4	7	0	0	0	476	0	1	0	0	0	0	3	0	0	2	2	0	1	83	0	4	1	0	0	4	0	0	1	3	42	0	0	0	2	0	190	0	1	0	0	3	2	0	0	0	9	0	0	0	0	1	2	0	0	1	0	0	0	1	0	0	0	0	0	0	0	0	5	0	0	0	0	0	2	0	0	2	0	6	1	0	0	1	0	0	0	0	1	1	2	2	0	6	1	0	0	66	0	0	0	1	0	0	0	1	3	3	0	0	0	1	0	1	1	2	0	1	1	0	0	0	0	0	0	0	0	0	1	0	0	1	0	0	0	0	0	0	2	59	0	0	24	4	0	0	0	2	16	0	0	5	3	3	1	3	4	4	3	38	0	3	1	1	4	0	261	143	4	9	4	8	292	0	37	0	1	1	6	8	1	0	0	0	0	2	0	0	2	0	2	0	1	0	0	4	1	1	6	0	16	4	1	0	1	1	0	0	3	0	0	0	0	0	0	1	0	0	0	0	0	0	113	0	31	4	0	0	0	1	9	0	0	1	0	94	0	0	0	1	0	4	1	3	0	0	0	1	3	0	5	0	1	3	0	1	2	0	0	1	5	0	0	0	1	13	2	0	0	0	0	0	0	0	3	14	0	5	1	1	0	0	0	2	0	0	0	5	1	43	2	0	2	0	0	34	0	0	76	0	2	4	0	0	0	0	0	1	0	1	0	0	0	0	3	1	0	2	1	72	0	36	0	0	4	0	0	0	43	0	3	0	0	0	1	0	0	0	1	0	0	0	0	0	1	0	16	0	0	0	3	0	0	3	0	15	1	0	0	1	0	1	3	2	0	0	0	0	1	2	1	7	2	1	2	1	7	8	6	56	0	37	2	3	0	13	0	0	0	1	1	0	0	0	0	1	0	0	84	15	0	59	1	1	2	1	2	0	3	3	0	4	0	0	3	1	0	0	0	138	0	16	0	33	0	2	3	4	0	89	39	0	54	0	0	0	0	0	0	0	0	0	1	3	10	5	1	13	2	0	0	0	14	0	0	9	0	0	6	2	1	0	0	0	2	0	1	4	0	0	3	1	2	0	0	0	0	0	0	23	0	18	0	2	1	9	1	0	1	0	0	43	1	0	0	0	2	3	3	0	1	8	35	7	1	1	3	0	2	1	0	10	0	0	7	8	15	1	54	3	1	140	284	2	0	14	0	693	0	32	134	22	0	0	0	119	652	0	57	0	38	24	1	1732	0	2	0	2	16	0	0	22	45	0	37	0	4	21	1	47	36	34	0	18	13	3	21	0	39	1	1	34	8	3	0	0	0	0	0	0	30	26	1	0	0	23	17	0	2	103	0	4	0	0	0	2	0	1	1	0	34	3	0	3	19	2	8	12	38	26	1	0	35	4	9	1	1	0	0	10	0	1	0	0	3	181	108	3	0	0	0	0	1	0	17	10	0	0	0	0	0	0	19	12	0	0	0	0	0	0	114	38	4	0	23	0	0	13	1	0	0	5	10	14	1	2	1	0	45	0	1	0	0	4	5	1	3	7	0	0	0	26	1	20	18	0	25	38	5	2	0	5	1	34	12	5	2	34	0	1	0	0	42	8	0	0	92	42	305	6	27	105	27	382	2	109	48	83	7	314	387	189	2	2264	74	154	49	85	9	209	15	230	2	21	0	16	0	9	0	0	0	3	1	0	3	1	5	7	17	2	0	0	0	0	0	64	3	1	43	10	2	7	2	2	0	0	6	0	9	12	1	0	0	3	1	1	27	0	1	0	5	1	0	0	85	8	0	0	2	101	4	0	18	4	14	1	175	0	0	0	0	4	0	7	151	11	12	3	50	0	0	0	1	0	0	2	0	0	0	0	0	0	0	1	50	0	0	2	0	14	0	0	1	1	50	0	0	28	2	5	0	1	0	0	7	1	10	7	447	3	5	6	0	0	0	9	7	4	74	10	0	5	0	0	2	4	0	2	1	0	6	0	105	0	1	66	1	0	1	2	1	0	0	133	1	8	6	0	8	0	0	2	0	10	0	0	25	3	5	5	5	4	1	3	2	1	4	0	0	4	1	4	0	1	0	0	0	0	0	1	0	1	105	3	0	0	2	1	0	0	0	0	0	0	3	216	0	0	0	0	31	7	4	2	13	3	0	0	84	194	193	0	0	0	0	43	5	0	0	1	11	0	0	1	1	1	0	0	0	0	268	5	16	0	45	0	0	2	0	3	0	0	4	20	8	0	6	3	0	0	0	2	1	4	36	1	21	12	0	8	4	43	0	2	8	91	0	0	9	18	1	10	11	0	9	0	0	1	1	41	0	1	10	0	1	4	6	208	0	10	1	0	0	0	2	0	46	0	22	0	2	0	3	0	2	0	0	3	0	0	0	16	5	9	6	1	20	11	3	0	0	43	0	0	1	1	3	2	34	3	3	1	0	0	4	6	19	1	0	0	0	1	1	1	8	13	0	6	0	9	0	0	0	0	1	45	14	4	0	6	0	0	0	5	1	2	0	6	1	3	0	2	0	0	0	1	0	1	34	5	2	16	3	13	0	0	0	0	0	0	0	0	0	5	0	0	1	0	8	6	6	1	0	0	88	144	16	17	0	1	0	0	0	0	0	2	2	0	0	92	14	1	6	0	0	0	42	0	48	23	18	41	28	31	41	14	1	0	2	0	2	16	3	1	30	5	8	5	0	0	0	3	6	0	32	12	3	14	10	16	31	2	0	0	0	165	0	3	1	16	1	0	6	3	0	0	2	0	1	0	0	2	0	2	2	2	0	0	0	3	0	0	85	24	0	1	0	0	11	21	14	2	40	2	0	0	0	10	0	3	0	0	0	2	432	4	63	0	0	0	27	0	0	11	0	3	0	1	0	3	1	0	1	0	0	13	19	0	3	1	2	1	19	1	2	0	0	0	0	0	5	2	0	6	2	1	1	1	1	14	1	1	14	2	0	2	24	0	1	1	0	6	0	3	2	0	0	42	4	5	2	4	0	2	1	3	12	2	39	2	0	14	1	8	0	1	6	0	0	0	8	0	3	4	9	0	0	2	0	13	4	2	21	1	3	0	4	229	0	8	0	9	1	39	1	3	7	0	0	5	7	2	33	6	0	7	2	0	2	26	0	3	2	0	0	0	63	3	6	0	2	1	0	0	210	12	0	0	0	2	6	0	13	0	1	18	3	3	1	2	0	0	7	0	2	0	0	1	0	3	0	0	0	0	13	1	0	1	1	0	0	0	0	0	0	0	0	0	0	1	0	0	0	0	0	0	1	144	0	1	0	1	0	0	3	0	11	0	0	5	0	0	2	6	0	2	0	1	1	2	1	0	2	0	2	0	2	0	0	0	6	4	7	0	0	2	0	0	235	2	0	8	1	0	23	1	8	1	0	3	1	1	0	7	20	6	1	3	1	0	0	1	23	5	1	191	0	3	186	0	3	1	0	0	2	0	0	54	0	73	0	0	0	0	0	5	0	2	0	0	141	1	0	1	0	0	0	0	0	1	0	2	1	0	0	2	32	0	19	31	0	0	0	0	0	2	1	3	0	7	0	0	0	1	0	1	14	0	5	0	1	341	0	0	0	17	11	1	0	0	0	7	0	0	6	0	0	0	0	0	0	0	0	0	0	3	93	0	2	0	1	0	0	1	42	0	1	3	4	0	1	0	1	1	9	4	1	0	0	1	6	24	8	0	0	0	0	0	17	0	13	15	1	0	0	0	7	0	28	0	19	0	2	1	0	1	0	0	0	0	12	14	0	0	0	0	0	1	0	38	41	40	10	6	1	1	0	1	0	28	5	3	0	4	34	20	22	122	0	41	34	0	59	0	0	3	64	6	0	33	2	0	1	10	8	0	0	0	116	40	8	13	69	1097	0	0	0	36	8	40	0	0	1	14	2	0	14	1	43	0	0	7	0	12	2	0	33	0	1	12	2	0	1	1	0	50	0	20	7	2	0	48	24	53	27	0	37	2	11	0	16	9	3	0	0	1	2	0	4	4	12	0	0	1	4	1	11	68	29	0	0	1	61	29	9	1	52	4	230	12	1	0	6	8	2	10	0	0	0	0	0	0	1	1	2	0	1	0	6	0	12	5	425	3	0	7	1	0	28	0	0	2	0	0	0	4	0	1	1	1	0	1	0	1	0	0	0	2	1	0	4	0	0	0	3	1	2	0	1	1	4	0	1	2	0	1	0	0	5	0	16	0	3	6	3	2	4	0	24	2	53	71	2	6	4	2	3	1	0	3	4	0	7	446	0	6	2	2	0	39	11	5	1	10	15	2	5	0	83	3	0	0	13	32	0	2	1	0	2	3	24	0	0	1	0	0	0	0	0	31	14	0	1	94	1	0	20	31	0	1	0	0	0	1	34	0	25	5	75	58	0	0	0	0	0	7	0	0	0	5	13	13	28	0	54	0	1	0	34	5	286	2	3	0	855	0	5	0	3	0	6	1	1	1	0	53	4	153	2	0	34	0	0	0	0	21	1	0	14	1	0	17	73	37	21	26	18	0	0	2	20	0	9	8	0	1	4	3	2	0	2	0	0	0	11	0	1	33	0	0	49	0	5	1	0	0	26	4	16	13	0	36	34	0	0	0	58	0	9	11	5	17	34	12	4	29	26	32	33	61	84	1	1	0	1	22	0	1	20	1	2	5	0	0	0	0	0	0	1	32	34	9	9	175	63	137	0	168	0	19	0	3	1	5	0	0	0	0	1	0	1	1	0	1	2	0	0	37	15	5	0	1	1	5	0	0	0	0	2	1	279	1	0	0	4	1	10	19	2	3	3	0	27	2	0	2	0	49	0	44	36	7	10	5	2	88	0	0	0	46	81	0	2	1	0	6	0	0	45	0	1	0	38	10	50	20	0	0	7	0	8	3	1	1	19	0	3	14	7	1	3	2	0	135	58	64	4	3	20	3	18	8	7	17	0	106	0	0	49	50	0	1	0	3	0	118	120	198	3	5	16	85	1	0	0	0	3	0	10	0	1	3	0	1	25	37	10	1	7	0	16	18	20	1	1	0	0	0	51	15	3	21	31	1	36	0	95	1	82	11	32	22	37	17	0	10	513	178	0	35	5	1	0	10	5	22	3	10	0	1	0	0	0	0	2	29	13	1	1	2	0	16	152	61	383	751	16	59	2	8	1	16	42	37	1	0	12	0	1	0	1	0	0	0	0	2	4	0	20	2	0	0	0	3	3	6	3	0	6	0	0	0	9	2	25	1	22	59	27	16	7	14	45	21	18	18	12	0	0	0	0	87	80	47	1	1	2	22	9	20	0	13	7	1	3	150	9	3	2	7	0	1	0	2	31	18	0	0	1	0	0	4	0	2	3	7	0	0	0	0	266	6	32	36	411	21	0	0	0	5	0	92	1	10124	0	2	0	6	104	152	19	0	0	0	0	0	0	0	0	38	8	11	1	0	0	0	1	0	1	1	5	0	0	66	0	0	5	0	2	3	5	14	0	3	54	0	1	0	0	2	0	0	2	0	9	2	0	4	0	0	0	1	1	0	0	0	0	0	0	2	4	17	0	31	17	1	66	0	1	3	0	13	88	2	0	1	1	1	0	0	1	54	5	0	4	2	0	4	0	1	0	4	0	112	39	1	17	179	1	6	2	1	25	0	257	33	33	17	1	0	0	3	4	2	3	114	3	0	0	3	152	0	2	29	15	0	9	0	0	0	0	0	1	0	2407	35	26	17	20	5825	3	41	48	69	20	3	407	269	271	37	193	58	29	0	9	522	277	250	127	80	4	0	2	1098	1	4	11	7	4	109	19	3	0	1440	1	1	1	0	1	2	7	89	0	2	0	6	18	131	48	22	20	19	16	8	0	17	2	34	77	6	37	7	6	0	0	0	0	0	1	0	1	10	11	1	31	10	24	5	10	52	0	2	2	12	11	5	6	3	0	6	1	0	14	61	0	0	1	1	0	7	0	2	0	12	1	43	23	0	35	22	0	1	70	233	204	2	2	52	175	70	10	60	121	2	79	0	37	59	2	99	0	0	21	22	9	102	18	1	54	45	34	50	0	0	24	31	1	0	33	6	7	1	0	2	96	0	12	16	0	13	0	4	9	3	1	65	0	0	16	2	0	0	0	0	0	3	1	0	20	0	2	1	7	1	505	10	10	0	1	8	7	1	71	5	1	18	1	0	1	129	14	4	114	107	0	20	13	9	2	23	5	27	21	8	5	49	15	68	19	75	44	6	2	0	1	0	3	0	1	1	0	84	58	0	43	0	0	0	0	0	6	35	38	0	4	7	0	12	1	0	0	11	6	5	2	0	0	0	1	1	3	0	2	3	0	0	1	0	2	2	0	4	0	0	21	0	0	0	25	7	2	3	0	23	10	0	4	0	1	0	0	0	13	2	0	0	0	0	0	0	59	2	34	9	7	10	3	11	0	2	0	2	0	4	0	0	13	126	4	0	1	0	0	1	17	26	11	0	0	0	0	0	92	0	14	19	10	17	0	0	1	0	3	4	0	1	1	0	81	46	54	23	52	23	15	48	23	45	0	45	34	86	62	35	224	135	95	172	16	27	14	8	4	20	11	2	10	15	2	32	61	201	103	76	129	41	45	100	47	188	31	23	49	33	28	37	39	1	0	16	1	233	394	9	25	3	84	47	11	26	656	266	59	1221	0	521	18	1	1	4	0	13	18	3	51	0	44	0	1462	3265	239	4	0	53	0	0	0	2	3	304	109	175	114	157	91	392	110	22	40	0	8	12	56	42	0	1	1	11	1	19	16	29	13	53	49	17	7	22	24	26	41	0	0	0	20	1	0	0	17	1	2	3	1	0	0	1	30	21	6	0	0	1	37	19	4	5	0	0	0	0	1	4	27	0	0	0	0	0	0	0	0	12	15	0	2	11	2	0	0	3	1	1	2	10	30	0	20	22	3	53	243	0	1	28	0	1	1	10	0	0	0	0	4	0	1	0	0	0	0	0	83	0	0	1	0	0	11	0	0	0	0	1	0	0	0	0	0	0	4	0	4	1	1	14	8	1	0	0	20	0	125	360	16	77	0	45	1	43	2	1	0	0	1	2	0	0	0	0	0	2	0	13	28	36	17	1	0	0	0	0	0	1	2	8	10	6	1	70	1	21	1	0	20	47	0	0	1	22	0	0	15	57	160	95	14	1	0	33	0	2	24	10	65	1	0	0	29	16	14	2	5	26	22	17	32	0	8	50	41	0	6	64	344	16	14	1	2	0	8	9	23	31	0	19	2	1	1	1	13	0	1	0	0	0	0	0	12	0	4	8	3	0	0	0	1	0	6	6	7	0	57	1	0	1	1	1	0	0	1	1	17	14	12	0	3	58	2	19	0	3	5	16	50	0	1	26	4	5	0	96	16	2	1	0	1	1	1	16	6	11	6	2	2	43	0	0	2	5	1	5	16	60	1	3	94	0	1	0	0	0	3	0	8	42	13	27	77	39	30	0	0	68	0	0	11	6	1	4	6	0	0	7	7	3	10	2	3	0	6	4	4	0	1	0	32	2	0	2	1	0	0	3	10	22	4	15	26	0	1	1	0	0	2	3	9	17	0	0	4	48	0	3	2	0	25	52	0	0	87	61	12	0	0	39	0	18	11	19	2047	0	0	34	0	15	0	0	0	0	2	1	0	34	55	0	33	15	7	7	3	375	0	20	0	0	0	1	0	4	0	0	0	0	0	3	0	4	2	1	0	0	3	2	0	1	0	5	0	8	1	8	13	17	0	0	0	0	33	25	2	0	0	0	93	46	0	7	1	1	7	1	56758	0	0	1	0	1	0	0	0	0	0	0	1	1	0	3	0	9	1	1	0	1	43	17	58	104	1	33	10	30	0	0	0	0	0	0	6	1	12	70	0	113	34	2	1	0	0	6	13	0	7	0	0	34	1	52	8	19	58	109	73	52	29	0	10	11	0	109	2	0	93	9	23	21	1	0	0	2	0	9	1	327	31	121	13	117	1	0	0	0	80	0	4	12	1	66	42	0	236	9	5	4	63	55	1	0	58	28	1	10	2	3	0	0	0	1	1	2	0	82	130	231	130	78	3	107	20	2	32	52	65	100	169	26	14	36	13	70	40	0	12	29	14	3	6	4	0	0	29	38	119	114	22	0	23	1	0	36	16	17	13	15	0	2	0	0	0	1	0	0	0	2	3	7	13	0	3	2	7	4	0	8	28	1	1	0	0	15	33	20	9	4	7	11	16	2	4	8	180	0	5	0	13	7	60	12	17	31	0	10	0	0	1	57	18	1	0	0	4	2	0	0	0	0	0	0	0	0	11	39	3	0	1	12	19	13	1	0	7	1	3	0	3	10	9	18	1	26	0	0	1	63	106	0	5	12	1	47	3	0	7	9	0	5	2	0	0	2	1	0	1	0	0	2	0	0	0	1	0	1	0	0	5	0	7	1	0	0	1	66	0	0	9	0	3	8	3	6	0	0	0	1	1	3	1	0	0	0	8	0	16	1	2	52	0	2	11	0	7	0	0	67	62	0	2	4	12	14	31	0	27	2	1	4	437	9	9	89	13	0	4	12	23	32	0	0	11	6	10	7	7	3	0	0	0	5	0	0	1	1	12	3	6	0	5	54	21	0	0	0	0	20	563	2	1	11	2	1	0	6	9	35	55	21	0	95	0	84	27	15	12	35	15	0	20	16	28	26	8	35	0	0	150	4	84	6	5	3	1	11	1	2	0	11	0	11	94	30	2	2	0	0	20	27	16	1	0	4	1	3	32	0	0	1	3	0	38	3	13	0	46	1	7	27	6	2	3	6	1	35	38	0	1	0	0	0	5	1	58	235	35	12	11	13	65	15	24	3	9	7	10	19	1	7	24	0	7	0	10	9	6	1	0	0	13	5	10	31	0	2	0	19	1	4	20	5	1	32	16	30	0	6	3	4	28	1	1	1	0	2	0	0	1	355	1	9	0	0	0	8	34	0	1	3	2	1	0	4	0	1	0	0	1	0	19	18	30	0	0	2	0	3	9	14	1	0	0	8	6	7	0	0	2	5	0	1	1	0	1	0	0	1	1	0	2	0	1	1	1	0	285	1	11	8	54	39	3	38	0	0	0	0	0	0	0	1	3	1	0	0	3	0	0	1	0	63	1	1	0	1	5	7	2	0	1	1	0	0	3	5	1	0	102	1	0	5	12	6	11	17	0	17	23	7	5	47	3	4	8	17	5	78	34	33	11	54	314	76	104	638	0	0	20	10	0	11	10	13	9	1	0	0	0	2	0	352	3	0	5	0	470	0	0	1	1	4	327	2	43	1	0	1	15	3	0	0	0	0	0	0	1	5	57	0	0	1	3	188	142	0	0	1	5	0	0	0	3	16	0	0	0	1	1	4	33	53	1	0	0	0	19	0	4	0	40	3	1	24	24	4	1	2	0	4	3	15	23	34	18	2	1	1	0	0	164	2	16	8	4	125	46	0	0	32	202	13	28	758	0	0	2	1	0	0	0	71	13	10	2	1	0	2	23	2	20	0	10	0	12	1	2	37	0	0	1	113	11	15	184	7	1	118	199	0	0	4	1	0	11	7	0	0	8	0	21	0	0	5	0	1	0	1	3	0	2	0	0	8	4	1	0	0	19	9	7	0	0	54	132	12	47	0	16	193	8	0	0	0	5	1	15	30	8	24	15	71	143	21	13	103	1	22	40	53	0	0	0	0	5	0	13	0	0	365	0	0	17	27	48	13	1	33	12	0	10	3	12	3	2	143	14	0	4	1	1	12	0	0	130	259	98	4	0	0	0	0	4	1	0	0	1	2	1	5	1	1	1	0	0	0	0	0	0	7	1	0	0	4	0	0	0	0	1	0	0	0	2	1	0	0	0	4	158	0	0	0	0	0	0	4	1	1	0	1	2	6	0	0	0	11	9	8	8	0	7	17	1	8	1	4	0	22	0	2	0	0	14	9	11	20	16	13	39	2	4	28	1	31	9	0	0	0	1	4	10	7	1	0	14	0	5	8	0	31	11	3	3	15	1	1	53	52	0	33	2	3	10	1	0	0	33	29	20	25	47	20	50	49	4	64	21	10	4	1	1	9	0	15	9	96	30	0	35	10	23	3	5	0	5	2	10	0	1	1	14	1	1	0	0	0	0	50	1	2	0	0	0	1	9	1	4	19	33	14	34	5	12	10	35	82	9	23	29	6	96	87	83	1	5	0	1	0	3	1	21	2	34	23	47	38	1	0	3	1	0	1	0	0	0	2	0	0	1	2	1	0	31	121	326	1	58	179	37	23771	81	1	3	1	0	0	0	0	47	6	7	7	1	5	39	0	4	1	10	7	1	0	1	4	5	0	0	1317	189	0	20	40	24	9	1	1	0	0	13	0	51	0	2	907	0	0	0	18	0	55	0	6	0	8	5	1	0	0	1	0	1	14	0	0	0	0	0	3	0	0	2	2	0	0	1	2	0	2	0	2	4	2	1	0	1	6	0	1	17	0	534	456	0	23	21	9	16	15	44	14	0	14	0	41	1	0	2	5	0	0	0	1	1	0	0	8	1	3	0	1	15	14	1	0	1	8	3	17	1	0	2	3	6	2	0	2	0	0	2	19	0	1	18	20	2	2	0	0	0	0	0	0	2	0	1	7	2	5	1	58	57	70	24	49	0	0	0	0	0	1	0	0	39	0	82	2	5	3	8	1	44	20	1	0	0	0	3	0	0	0	0	2	1	0	0	2	0	0	0	0	0	0	0	0	0	0	2	1	0	4	1	1	0	0	0	0	2	0	450	0	0	0	0	1	4	0	0	0	27	0	0	2	0	0	1	0	0	0	2	0	0	0	0	1	1	0	1	2	0	2	2	0	0	107	0	0	0	0	0	1	14	2	0	0	0	0	2	0	0	4	58	6	0	278	0	0	0	0	0	16	1	1	4	0	1	3	2	0	4	0	1	0	0	0	1	0	0	0	0	0	0	1	0	3	0	0	0	0	0	0	0	0	2	1	0	1	0	6	1	0	0	1	0	0	1	0	0	0	2	0	0	0	0	5	0	0	1	0	3	0	0	0	1	0	0	0	0	2	0	0	1	7	0	0	0	32	0	0	0	0	0	0	0	10	0	0	0	0	0	1	1	0	0	0	0	0	0	4	1	0	2	0	481	0	0	1	0	2	0	8	38	13	1	5	9	10	241	0	368	18	4	2	2	15	1	19	3	0	13	945	5	20	1	0	520	8	300	0	1	4	0	0	7	13	4	15	15	3	0	11	20	47	8	38	1	30	0	0	20	0	15	0	53	1	28	1	120	5	27	14	243	0	10	18	0	7	15	12	9	10	30	7	16	12	18	3	0	8	33	11	18	217	13	5	5	10	46	60	10	1	0	2	165	44	44	15	10	5	32	2	41	47	7	9	4	19	97	0	2	1395	3	5	32	1	21	0	346	8	68	70	10	0	15	3	27	52	45	5	29	4	1	7	7	18	4	50	10	42	89	40	15	282	336	50	19	1	2	12	69	0	10	0	1	0	8	0	0	0	0	19	0	7	0	0	0	3	0	9	0	129	15	162	0	1	1	0	2	33	1	104	1	32	18	0	2	1	10	13	2	0	5	0	0	0	19	1	0	5	11	4	7	1	2	22	2	0	0	6	0	0	3	1	3	0	14	0	0	0	0	0	8	1	2	0	0	2	5	116	0	0	1	3	1	0	3	12	3	0	3	60	0	1	0	4	0	53	1	0	0	6	0	1	0	1	2	12	0	9	0	4	0	2	2	0	1	0	0	2	16	3	3	0	0	1	30	3	100	5	18	0	1	0	12	1	1	0	1	311	0	8	11	2	0	0	2	9	5	5	0	0	0	1	0	0	1	2	0	0	0	8	51	34	0	31	33	1	1	0	7	2	2	5	3	948	2	26	24	540	1	0	5	5	10	74	13	0	0	7	27	16	1	1	2	1	11	69	95	1808	0	18	18	15	4	0	0	0	0	0	3	4	3	1	0	0	7	0	0	0	23	8	2	0	44	45	0	4	11	0	0	1	1	0	0	10	42	22	20	58	55	1	28	26	3	0	41	8	25	46	1	14	10	38	0	9	0	2	0	3	40	7	0	0	0	0	54	67	2	0	0	15	0	0	1	0	0	1	2	0	52	26	42	1	0	90	0	0	0	2	0	1	45	0	12	2	2	8	8	11	5	34	0	51	1	28	0	0	1	11	15	2	15	0	31	0	30	57	18	37	22	10	0	38	9	28	22	692	50	2	13	0	0	1	0	1	0	1	5	0	0	0	1	0	0	5	20	51	0	5	1	7	17	14	29	0	11	0	5	3	31	5	14	9	3	0	1	9	40	30	89	40	15	2	0	2	0	41	0	0	4	1	12	0	143	182	55	1	41	0	0	15	23	4	1	1	0	4	1	23	67	12	65	63	11	17	11	181	0	12	5	25	12	6	11	12	17	63	15	2	7	68	104	5	0	0	0	5	0	3	80	1	0	88	0	3	0	0	0	11	4	98	34	8	0	0	4	0	13	0	0	3	1	5	2	6	1	1	0	15	7	4	170	8	9	1	2	0	4	0	17	5	0	0	9	0	3	1	11	2	0	31	21	9	127	0	0	0	13	44	1	0	0	3	0	45	0	0	1	0	0	1	0	1	16	34	1	10	3	16	20	1	5	0	0	0	0	0	118	1	3	0	55	0	0	46	2	6	21	1	26	62	0	0	0	1	0	77	26	0	3	4	5	9	10	0	0	4	8	6	0	0	38	74	10	8	2	2	0	2	5	0	0	0	0	1	2	92	12	1	96	14	7	91	25	31	118	23	34	27	217	100	21	69	25	45	47	32	66	65	0	9	2	5	1	17	0	1	6	1	4	3	18	0	0	0	0	0	1	1	1	1	0	1	0	12	15	1	3	9	2	0	0	0	0	0	0	1	1	0	0	0	0	1	0	0	1	0	1	0	0	0	0	1	0	0	3	17	11	0	1	0	0	0	0	1	1	0	0	0	0	0	1	0	0	0	0	0	1	0	0	1	0	13	27	0	55	13	1	0	20	0	0	0	45	15	52	49	0	54	41	21	0	29	0	10	6	0	0	0	3	0	0	0	49	347	10	58	17	51	0	3	0	17	11	12	6	0	2	0	22	3	0	0	0	1	1	16	8	5	7	8	0	19	11	32	7	17	0	22	19	19	0	24	77	7	0	2	0	0	0	0	9	43	2	6	0	3	0	0	0	9	7	9	0	1	207	6	0	16	0	132	0	0	0	0	45	1	1	2	216	17	6	30	1	3	649	0	2	1	9	5	0	20	0	1	46	0	0	0	11	0	54	17	17	0	13	60	0	0	1	15	0	1	1	2	3	3	6	7	17	32	0	10	1	7	0	9	4	0	1	12	42	10	29	6	7	6	16	14	0	10	2	0	17	7	3	0	2	12	0	4	15	74	2	0	11	9	1	1	2	0	0	8	0	3	2	0	0	1	0	2	5	4	1	1	0	2	1	11	4	0	0	0	1	5	9	6	5	0	18	1	0	0	0	6	10	32	7	14	12	0	56	0	0	299	29	99	26	19	0	4	442	99	5	65	58	2	1	0	13	53	5	2	1	14	0	38	22	28	2	1	3	1	1	15	12	16	0	0	30	71	67	36	0	0	2	0	0	1	214	0	2	4	10	1	0	0	8	3	0	2	6	247	11	87	15	23	1	62	5	5	0	0	2	1	0	16	0	1	0	11	1	41	0	4	29	29	6	70	22	672	104	10	0	1	69	13	16	270	46	21	49	29	297	2	98	207	9	0	0	0	1	3	2	8	595	85	18	0	137	0	7	0	0	38	0	0	4	18	3	0	0	106	174	0	0	0	126	72	52	31	11	18	37	30	76	0	4	152	0	0	45	29	20	1	0	0	4	0	0	0	20	13	2	7	4	0	0	0	1	0	0	2	0	0	2	0	134	1	1	0	1	44	41	12	1	0	13	9	2	2	0	0	0	15	26	19	5	93	0	39	17	0	0	5	46	1	58	18	1	0	84	28	39	21	54	110	91	1	22	10	376	21	135	149	1	0	1	1	0	0	0	1	4	0	2	2	5	0	0	0	0	0	0	0	15	1	2	9	12	26	45	1	0	10	2	8	0	1	4	0	5	0	0	3	60	9	11	29	16	10	111	0	1	0	0	0	1	0	3	0	0	0	0	1	23	1	0	0	0	0	0	3	0	0	0	7	0	1	2	1	5	0	6	2	0	16	0	60	0	0	7	0	0	15	1	0	0	1	0	7	0	0	0	2	0	6	12	13	10	8	0	41	15	57	0	15	1	858	1	427	404	4	2	15	0	7	2	7	0	17	437	996	44	38	54	5	115	23	12	38	21	13	15	2	18	29	1	0	9	43	0	2	0	4	0	7	5	1	2	4	0	6	2	2	50	0	0	0	0	6	2	0	0	0	0	1	0	1	2	0	1	0	0	2	0	0	0	1	0	2	0	4	6	0	32	14	0	53	2	26	31	66	64	0	2	1	6	0	1	7	0	2	1	0	0	43	19	0	0	1	5	3	32	4	6	3	32	0	1	5	0	2	2	6	0	0	0	3	0	2	1	10	1	5	0	39	3	8	10	5	1	2	1	4	1	3	46	54	5	1	5	3	18	0	24	8	2	11	9	0	11	0	32	15	2	0	1	1	38	0	0	0	7	1	3	0	190	4	14	4	0	2	49	1	1	0	0	1	0	0	2	0	0	40	19	1	47	50	0	0	1	0	0	5	0	0	19	0	14	3	5	1
LakWasMet16_LOW5_2_rpkm	0	0	0	1	0	25	20	1	0	0	3	10	7	2	0	1	1	2	23	0	1	0	4	42	1	0	0	0	0	19	0	11	1	4	4	7	7	1	16	0	0	0	0	3	34	48	49	25	0	8	4	12	1	0	0	10	0	16	101	21	305	0	1	6	5	0	0	0	14	70	2	2	1	0	8	0	0	1	0	0	1	9	1	0	0	0	3	1	5	0	0	2	17	6	12	1	2	0	3	3	0	0	1	0	2	0	0	0	0	0	4	1	82	6	33	2	0	0	0	0	1	2	6	9	0	0	4	0	1	1	2	60	19	2	0	0	1	1	23	0	1	1	0	15	2	1	1	0	19	7	10	18	3	11	45	0	14	7	18	2	11	6	1	27	23	1	0	11	1	13	0	0	0	0	0	0	0	0	1	1	2	1	0	0	0	23	0	0	0	16	10	3	7	4	4	0	1	22	12	384	28	2	45	0	0	1	26	0	21	10	8	4	48	10	16	0	15	4	0	7	2	2	18	6	7	25	0	2	11	1	1	0	45	0	2	0	18	28	27	5	1	1	26	15	33	19	0	0	21	25	20	6	24	1	1557	637	0	0	0	0	3	2	3	19	19	2	6	5	7	51	49	2	17	0	0	1	0	0	50	40	6	30	30	28	37	0	0	0	13	0	4	0	0	3	1	2	0	11	20	0	0	37	69	4	17	4	45	21	29	1	32	0	44	22	0	0	0	1	93	1	1	0	0	4	15	1276	3	1	16	1	0	1	0	0	0	0	4	1	2	2	0	1	23	21	20	4	17	2	1	0	5	2	4	0	5	0	1	0	0	91	35	2	6	1	0	21	14	25	35	7	3	47	1	0	14	7	0	2	0	2	1	1	9	4	2	0	121	1	0	0	0	1	138	5	2	9	109	0	0	95	3	30	0	3	43	0	9	0	0	4	0	19	231	10	1	51	37	5	5	1	0	0	1	2	0	0	0	0	1	0	3	1	2	0	0	3	0	1	10	0	43	62	0	1	16	76	0	0	2	0	1	89	27	459	0	68	19	5	0	27	0	7	1	5	10	27	7	0	1	15	22	37	26	3	0	1	18	2	522	1	21	0	5	10	1	0	1	105	67	5	0	2	76	44	10	1	4	0	1	1	0	1	1	0	0	1	0	4	1	0	1	0	0	1	0	0	1	0	3	7	0	0	1	1	1	0	0	0	0	0	0	1	1	7	14	1	16	4	0	32	0	26	2	25	33	1	1	0	1	0	0	1	3	0	0	35	0	0	0	0	0	7	0	3	9	4	29	0	31	1	0	2	0	2	17	48	61	156	2	57	74	179	70	35	70	1	27	3	26	0	0	0	1319	0	11	3	0	0	1	0	20	0	0	0	14	9	0	37	0	30	0	178	179	115	2	0	85	2	251	14	173	88	35	11	0	8	5	14	0	2	4	15	0	1	3	0	0	1	1	4	4	72	0	1	0	2	0	14	7	1	82	0	5	19	9	1	1	0	0	3	3	157	0	57	0	0	0	1	18	34	15	27	1	1	3	0	8	0	2	0	5	2	10	1	1	0	3	0	0	32	1	0	18	0	22	0	0	2	0	19	0	8	0	3	4	2	8	0	24	0	0	2	0	0	15	8	0	0	11	1	1	0	6	9	3	0	3	1	16	0	1	0	2	0	0	0	0	0	1	22	0	34	21	0	45	45	10	0	0	50	1	0	0	1	16	11	2	0	122	9	0	20	0	54	1	1	3	1	0	0	0	0	0	1	0	33	0	0	0	0	0	0	4	1	0	0	2	0	0	4	2	7	5	0	1	1	11	0	0	25	0	1	0	0	213	6	62	0	1	0	0	0	2	1	0	0	25	1	0	0	2	0	0	27	14	2	1	6	2	2	5	2	0	0	0	0	2	62	34	0	0	0	0	0	1	0	0	14	40	15	2	0	11	0	2	0	6	0	0	18	33	6	4	0	0	7	1	0	2	3	0	2	0	1	0	1	6	24	8	35	5	2	1	4	2	5	4	1	0	0	0	0	0	0	0	0	1	1	0	0	0	0	0	5	0	0	1	3	1	0	0	0	0	18	38	29	61	29	23	0	0	0	0	0	1	1	0	0	1	0	11	1	0	0	0	0	1	0	0	27	2	0	0	8	11	0	29	10	0	1	3	2	0	0	4	0	0	0	1	0	0	0	1	1	1	3	0	0	0	1	1	16	8	293	10	40	1	0	2	0	20	17	34	1	30	0	0	0	1	0	0	10	0	0	1	0	0	8	7	1	1	3	0	0	0	1	1	0	0	0	0	3	0	0	0	0	0	95	0	2	0	59	17	1	4	18	0	1	80	2	4	0	0	0	0	1	1	1	270	1	0	2	0	1	0	0	1	8	0	0	2	0	1	2	10	0	0	0	0	4	5	14	0	2357	0	0	0	0	106	29	22	0	1	1	9	2	11	3	8	11	0	1	2	0	0	0	0	0	2	297	10	0	0	0	0	1	6	1	0	2	0	0	0	0	0	65	51	0	7	47	0	3	0	1	10	0	0	7	6	2	0	2	0	0	0	1	21	92	24	4	10	1	0	0	0	10	7	1	1	0	0	0	1	5	0	1	0	0	1	0	1	0	0	0	15	0	0	3	1	6	0	0	0	0	0	0	0	0	0	0	34	18	0	0	6	0	0	2	7	1	0	0	7	0	0	0	0	7	0	0	4	6	4	20	127	108	2	2	0	14	5	0	0	5	0	12	5	0	0	0	0	0	6	0	1	0	3	72	0	3	1	0	20	0	0	0	0	0	32	1	0	0	0	0	3	0	0	6	45	0	18	0	2510	13	1	1	3	5	0	0	4	0	3	89	128	1	1	3	5	1	38	0	0	15	1	5	0	0	1	0	0	12	12	18	4	21	7	42	2	90	2	0	7	5	0	57	0	0	11	0	0	8	0	0	0	9	0	0	29	5	2	0	3	0	0	4	0	2	0	18	1	1	0	0	0	0	1	0	0	0	0	0	65	0	0	0	4	0	7	0	0	0	1	16	9	1	50	56	35	23	1	0	11	0	0	0	5	3	3	11	0	3	3	0	0	1	36	11	0	2	0	1	30	8	6	0	13	4	5	24	0	2	37	14	12	14	12	13	11	0	1	0	12	0	23	2	10	14	4	49	17	4	38	0	0	6	28	20	0	3	1	0	5	10	10	0	6	1	4	7	1	15	25	19	3	0	13	0	0	0	0	0	4	32	15	0	0	0	84	2	24	55	3	5	27	0	10	17	3	8	1	3	1	10	8	19	0	0	1	0	0	1	3	1157	61	20	58	2	3	1	0	1	0	0	6	57	11	5	3	38	0	1	1	13	175	71	37	23	0	3	2	146	1	0	1	0	5	0	5	1	162	47	35	64	89	48	0	15	52	12	0	0	1	0	0	3	139	7	1	0	0	13	0	21	1	1	1	1	0	8	0	3	0	1	0	3	10	1	0	2	3	1	0	10	16	20	2	0	0	0	0	8	0	0	0	2	0	0	1	1	0	0	7	3	0	1	0	0	0	13	0	1	0	42	0	0	0	0	0	0	0	0	1	0	0	5	1	0	0	0	0	0	1	0	7	1	3	586	1	0	92	0	1	3	0	223	0	21	32	0	1	260	0	168	4	4	0	1	4	2	36	1	37	1	1	1	1	1	5	0	1	7	19	0	1	0	10	4	1	7	1	0	1	0	0	0	1	16	8	82	24	26	0	0	4	24	0	0	1	1	0	0	0	2	13	2	0	10	11	0	38	8	10	25	22	0	13	6	0	0	6	44	1	5	7	10	8	0	33	0	1	0	3	0	0	0	15	0	44	16	68	109	136	48	72	16	1	0	0	11	6	39	0	2	6	17	62	0	1	1	15	0	5	0	0	18	42	0	52	7	0	6	0	5	3	23	1	0	92	15	17	2	1	1	0	12	0	173	1	19	42	7	0	0	22	10	8	63	9	6	10	2	3	6	0	14	86	312	38	131	1	2	0	9	5	70	0	2	6	1	6	0	400	1	3	2	1	2	0	14	20	4	39	6	0	0	0	4	0	3	0	38	0	0	0	0	0	1	9	0	0	0	39	0	715	47	0	32	277	384	2	24509	10	1	4	0	0	3	0	1	4	0	1	0	3	3	2	0	1	81	0	0	1	1	0	2	4	9	0	41	1	8	0	2	6	23	4	0	0	1	8	0	5	12	7	0	17	0	2	0	4	0	1	0	35	1	0	14	24	0	2	3	100	191	3	24	1	106	140	0	52	4	49	1	29	22	17	12	66	13	1	22	6	0	1	2	7	1	1	0	0	2	0	5	0	0	9	1	2	14	0	23	74	0	0	1	0	0	0	1	3	0	1	1	2	0	0	2	0	0	8	19	44	3	1	0	0	0	2	3	1	0	0	0	5	1	0	0	0	0	0	0	0	0	0	1	0	1	1	6	1	0	0	8	0	1	2	1	0	1	0	0	104	1	19	5	9	6	3	0	29	0	25	29	123	9	0	6	3	0	1	0	0	0	0	14	1	1	45	23	1	2	0	8	0	0	0	0	0	3	5	0	9	4	11	11	28	35	1	38	4	1	0	0	24	18	45	4	3	1	0	0	0	0	0	0	0	0	2	1	1	0	0	5	3	1	1	0	1	0	1	0	1	1	2	0	3	0	0	0	0	2	14	209	65	2	0	0	1	0	0	2	6	1	0	24	5	0	0	0	2	10	0	0	10	0	3	0	11	0	0	9	3	1	1	55	2	1	0	0	2	0	0	0	0	1	0	16	0	0	0	0	1	18	0	1	13	24	0	28	38	40	11	0	7	0	0	1	79	0	40	15	0	0	0	0	1	10	0	15	1	2	0	0	4	1	0	0	3	3	0	2	0	1	0	2	0	6	0	0	3	2	21	39	0	0	0	0	0	0	4	0	0	0	0	0	0	0	1	2	14	0	0	0	0	11	5	2	0	81	6	2	0	720	0	3	74	124	29	54	5	1	22	9	2	0	0	0	1	2	86	0	2	15	7	7	4	0	0	0	14	0	17	1	0	0	7	45	0	0	32	0	31	2	1	2	0	0	0	5	0	1	0	3	3	11	8	0	4	2	0	11	6	0	27	14	1	9	4	0	0	0	10	35	0	0	1	0	4	2	0	2	12	2	0	3	1	6	181	1	0	0	0	1	1	3	0	1	3	2	1	0	0	0	0	1	0	0	1	1	0	0	0	0	0	0	0	1	0	0	3	1	0	0	0	1	0	16	3	0	4	5	26	0	18	0	10	1	6	1	0	1	0	0	0	22	7	1	1	0	0	1	125	206	105	145	317	130	181	255	15	184	155	207	298	127	24	105	31	364	270	10	66	9	407	451	492	474	638	141	224	54	190	26	155	26	1	8	0	0	0	0	1	0	1	0	81	85	1	0	1	0	0	1	2	0	5	0	0	0	1	2	0	20	0	0	3	0	12	0	11	0	9	5	1	0	2	2	88	0	3	1	4	2	1	0	1	0	1	0	1	0	0	20	1	0	0	0	4	8	7	28	2	1	0	7	0	0	2	8	0	0	10	8	0	3	1	1	130	0	0	24	1	0	0	0	0	1	0	1	0	1	8	3	0	3	0	0	0	0	10	0	0	5	0	1	0	2	2	6	0	4	3	222	1	0	7	6	0	0	0	0	1	5	0	2	1	1	2	0	0	24	8	3	0	0	0	0	2	0	9	12	12	6	0	6	0	2	0	3	2	64	6	5	4	11	0	0	1	2	0	0	69	0	46	35	1	0	0	0	0	6	0	7	0	0	2	3	1	0	1	0	1	0	3	8	0	0	7	0	0	0	0	1	7	2	4	1	0	123	0	9	1	433	3	0	0	0	1	2	0	1	0	0	1	0	0	0	0	0	8	0	61	70	0	1	1	1	19	1	0	94	8	0	13	7	0	53	4	14	6	3	1	0	1	1	0	10	0	6	2	3	0	0	3	0	1	1	6	1	1	1	7	1	0	0	34	0	0	0	3	1	1	0	4	0	3	0	0	0	24	2	0	0	0	19	10	7	125	253	9	0	6	0	0	0	0	0	0	0	0	2	0	1	0	0	1	0	36	0	5	7	0	1	1	6	0	0	1	1	39	19	13	0	0	0	462	0	0	0	0	0	0	0	0	0	0	0	0	0	74	29	0	0	0	0	0	0	0	4	0	3	27	20	7	3	0	3	1	3	26	19	0	1	1	0	1	0	1	1	1	2	3	5	4	3	26	2	3	1	2	0	1	2	0	2	3	4	2	2	6	2	2	2	3	5	6	0	1	18	0	0	2	0	1	9	1	48	0	0	0	0	1	10	6	0	429	0	4	17	1	35	0	3	0	0	2	0	3	23	1	21	13	2	0	0	0	0	0	2	2	39	0	0	0	0	1	0	40	0	16	51	43	20	0	39	34	15	1	15	2	26	1	27	3	18	5	21	6	15	7	0	1	14	3	11	1	21	1	12	2	30	0	13	0	35	29	16	29	31	11	9	1	0	15	6	8	0	22	1	6	0	34	23	0	29	4	5	1	18	34	14	0	1	0	3	0	5	27	1	0	0	1	17	6	0	2	0	3	295	0	0	0	0	0	0	0	0	9	0	0	11	0	34	8	3	0	0	0	1	1	0	1	1	1	1	0	226	2	2	70	47	37	0	25	1	16	0	1	0	118	0	0	0	0	1	4	0	101	0	5	9	0	0	1	0	0	32	6	0	36	6	0	141	0	26	2	0	0	50	77	0	0	6	8	4	0	0	1	0	10	2	6	4	3	3	71	6	0	1	43	20	0	0	3	0	0	1	752	581	717	14	0	1	3	4	0	16	4	52	0	2	2	2	0	0	73	350	40	4	1	0	0	1	1	1	108	2	5	0	0	1	1	0	0	7	0	0	1	0	2	1	0	0	0	4	1	0	116	282	3	2	2	0	0	1	2	41	11	0	0	1	0	1	35	35	0	0	2	0	0	0	0	69	3	1	3	1	4	8	1	0	14	1	0	10	2	11	0	1	0	2	0	6	4	3450	5	1	6	0	4	1	5	1	1	0	0	1	0	0	0	27	2	25	0	0	0	0	0	1	0	0	0	0	0	0	0	1	0	0	3	0	0	0	0	1	3	0	3	0	3	2	0	0	0	0	0	0	2	0	1	1	0	0	1	34	0	0	0	5	0	0	75	0	2	0	0	0	0	134	4	0	0	0	7	28	33	57	10	0	25	0	0	22	1	0	59	0	0	33	3	1	2	1	0	0	0	1	9	1	6	2	0	0	0	0	0	2	0	0	1	5	0	1	1	0	0	0	1	1	3	1	8	0	1	2	2	0	9	1	1	3	1	3	0	0	0	4	0	9	0	25	24	4	4	16	0	1	0	1	0	2	0	1	9	43	0	3	0	7	1	7	0	0	1	0	0	0	2	3	2	9	1	31	29	11	1	20	0	6	0	0	1	0	6	0	0	4	0	0	4	16	0	31	32	0	49	1	66	167	0	0	1	0	0	1	2	5	8	27	0	1	0	0	0	0	55	481	1	128	0	0	1	9	1	0	0	0	0	0	0	2	4	0	3	11	53	9	0	0	0	0	1	0	4	1	42	3	14	0	0	0	1	2	0	6	6	22	0	0	0	0	29	0	0	0	12	0	4	1	13	0	0	19	5	3	0	0	46	0	1	2	12	0	2	2	0	0	0	1	268	0	0	1	3	33	1	1	0	1	1	0	10	0	2	1	2	0	0	152	3	0	1	0	0	0	0	52	0	0	0	0	0	2	5	0	0	0	2	0	0	0	1	2	0	0	0	2	0	4	1	0	11	0	8	2	1	3	1	1	0	0	2	1	4	0	11	0	2	2	2	35	0	10	0	0	1	0	1	1	0	0	1	0	0	1	2	0	2	0	2	0	3	0	4	0	0	1	2	0	0	1	1	0	0	0	1	3	0	0	0	0	9	3	0	0	34	1	1	9	2	0	1	5	0	0	0	0	0	0	0	0	0	0	4	45	1	0	0	1	0	1	1	1	1	28	0	1	1	0	115	1	3	0	12	2	0	0	1	0	0	1	0	19	0	0	0	0	15	18	1	0	0	61	13	0	5	5	16	0	0	0	0	0	1	2	0	2	1	2	15	0	0	76	5	1	0	3	17	0	0	0	971	2	0	0	0	1	1	1	0	0	0	0	0	0	69	0	2	0	0	0	1	0	0	7	6	33	0	0	1	1	0	13	1	2	2	0	0	2	3	0	0	6	0	3	0	0	0	0	0	0	1	2	1	0	2	0	0	0	0	0	3	1	0	7	0	0	0	0	0	2	3	0	0	0	0	2	0	0	0	0	0	4	0	2	0	2	1	0	7	0	0	0	2	0	0	0	0	0	0	0	0	0	0	0	0	1	0	0	1	0	0	0	0	0	1	0	0	2	0	0	0	0	0	3	0	0	0	0	0	0	0	0	0	1	82	0	3	30	4	6	1	0	0	17	0	0	4	1	3	3	0	0	3	8	16	0	0	1	1	3	0	265	111	1	6	3	12	189	0	9	0	2	5	2	8	4	0	0	0	2	10	0	1	4	0	15	0	0	0	0	1	1	1	8	1	2	1	1	0	1	2	0	0	1	0	0	0	0	0	0	0	0	0	1	0	0	0	160	0	121	6	0	0	0	0	0	0	0	2	0	142	2	0	0	2	1	2	1	0	0	1	0	0	0	0	7	2	0	0	0	0	2	0	1	4	5	0	0	1	1	11	0	0	4	0	0	0	0	0	2	11	0	1	2	0	0	0	3	1	0	0	0	3	1	44	467	0	0	0	2	41	1	0	78	0	1	2	1	6	1	1	1	0	0	0	1	0	0	0	0	0	0	0	1	12	0	4	0	0	0	0	0	5	35	0	2	1	0	0	4	2	0	0	2	2	1	0	0	1	1	0	5	0	0	1	5	0	1	2	0	11	1	0	0	1	0	0	1	2	1	0	0	1	0	2	2	0	1	0	8	0	0	8	3	30	7	28	1	2	1	16	0	0	0	2	3	0	0	0	0	1	0	2	45	19	0	48	1	2	0	0	0	2	1	0	0	4	2	0	0	0	0	2	0	87	1	2	0	20	0	1	1	2	0	1	7	2	54	2	2	0	0	0	0	0	0	0	0	5	8	10	3	6	0	0	1	2	27	2	0	24	0	0	2	2	1	1	0	0	3	0	1	1	0	0	2	1	0	0	0	0	0	0	0	31	0	10	0	1	0	8	0	0	1	0	0	23	0	0	0	0	2	0	1	0	0	5	18	5	1	2	4	0	0	0	1	4	1	1	10	3	4	1	39	8	0	100	314	5	0	9	0	418	0	34	113	11	0	0	0	81	339	0	57	0	26	32	0	845	0	5	0	5	7	0	0	26	29	1	32	0	7	18	0	30	36	37	0	2	12	1	15	0	16	0	6	19	4	7	0	2	0	0	1	0	14	17	3	0	0	1	20	0	1	54	0	6	0	0	0	4	0	0	0	0	19	2	0	3	30	5	10	10	36	14	1	0	27	6	10	0	1	0	0	7	0	0	0	0	0	123	117	5	0	7	0	0	2	2	2	8	0	1	0	0	0	0	15	14	3	4	0	0	0	0	48	16	1	0	10	0	0	9	0	0	0	3	19	22	0	2	2	0	19	0	2	0	0	3	7	0	5	6	0	0	0	16	0	0	15	0	29	25	3	2	0	6	2	28	10	0	1	75	1	0	0	0	28	8	0	0	148	910	384	2	19	79	59	454	9	153	80	69	8	256	467	267	0	867	69	217	102	130	9	254	5	285	1	21	0	20	0	4	0	0	0	3	0	0	0	0	4	1	14	0	0	1	0	0	0	68	3	1	44	10	0	5	3	3	0	1	4	0	13	14	1	0	0	2	0	1	48	0	1	0	1	0	2	0	101	10	0	0	2	33	0	0	28	7	7	1	116	0	2	0	0	7	0	17	110	3	26	9	66	0	1	0	1	0	1	6	7	0	0	0	0	0	1	5	31	0	0	0	0	6	1	0	0	3	46	1	0	18	3	3	1	1	0	2	3	0	11	8	3	0	2	5	0	1	1	13	8	3	45	14	4	3	0	0	2	0	0	0	1	1	13	0	75	0	0	131	0	0	1	1	1	0	0	88	0	4	2	0	15	1	0	4	1	15	0	0	39	2	9	4	1	4	0	1	0	1	3	0	1	0	3	1	0	0	0	1	0	0	0	1	0	1	32	0	3	0	3	0	0	0	2	0	0	0	8	147	0	0	2	0	24	11	5	2	11	3	0	1	113	138	144	0	0	0	0	42	5	0	0	0	10	1	2	0	2	1	0	0	1	4	164	2	9	1	55	0	0	0	0	1	0	0	6	10	0	0	5	6	0	1	0	2	0	3	35	1	18	7	0	7	3	39	0	6	4	5	1	0	6	5	5	28	9	0	13	0	0	4	3	26	0	0	18	1	2	4	1	96	0	6	1	4	1	0	0	0	19	0	8	0	0	0	0	0	1	0	1	8	0	0	5	22	8	9	16	0	35	11	1	0	0	44	0	0	8	0	0	4	17	4	2	0	0	2	4	5	4	0	0	0	0	0	2	0	9	24	0	8	0	5	0	0	0	0	1	50	8	6	0	0	0	0	1	24	3	0	0	2	1	0	0	3	1	1	0	2	2	1	18	5	5	16	1	4	0	1	0	2	0	0	0	0	0	1	0	1	0	0	27	14	2	4	0	0	83	79	18	10	0	0	0	0	0	0	0	0	0	0	1	62	14	0	7	1	0	0	22	0	20	20	14	32	13	23	22	10	1	2	0	0	1	26	5	4	14	2	9	9	0	1	0	3	6	0	30	17	2	13	11	14	18	0	1	1	0	144	0	3	0	9	1	1	6	4	0	1	1	0	1	1	0	7	1	0	5	7	0	0	0	1	0	0	113	25	0	1	3	1	17	17	15	2	16	0	0	0	0	10	0	2	0	0	0	1	209	1	90	0	1	0	20	1	0	9	1	2	0	0	0	5	0	0	3	0	0	17	24	0	3	3	0	0	19	0	3	2	0	1	0	3	6	5	0	5	2	0	2	2	7	14	0	1	13	1	0	0	25	0	2	0	2	7	0	0	6	0	0	27	0	8	6	2	0	1	0	6	65	1	35	7	0	16	0	14	6	4	5	1	1	0	6	2	1	2	0	0	2	5	0	24	10	1	8	0	73	0	3	334	0	10	0	10	1	33	0	0	8	0	0	0	12	0	33	7	0	6	1	0	0	41	0	7	0	0	0	1	65	2	5	6	1	0	0	0	189	13	0	0	0	0	8	0	9	2	0	6	1	1	1	0	0	1	7	0	1	0	0	5	5	2	0	0	0	0	10	3	1	1	0	0	0	0	0	0	0	2	0	0	0	1	0	2	1	0	0	0	0	46	0	7	0	0	1	1	3	1	20	0	0	17	0	1	1	1	0	2	0	1	1	3	3	0	1	0	0	0	0	1	0	0	4	2	1	6	0	2	0	0	100	0	0	5	0	1	21	0	12	0	0	1	3	1	0	3	68	2	0	1	0	0	0	1	11	1	13	75	0	2	85	0	1	0	1	0	5	1	0	27	0	41	0	0	0	0	0	3	1	2	0	0	114	0	0	0	0	4	0	0	0	1	0	0	1	0	0	1	12	0	15	33	0	0	1	0	1	2	2	5	1	0	0	0	0	0	0	0	1	0	8	1	0	100	0	0	0	7	16	2	0	0	0	13	0	0	8	1	0	0	0	0	1	0	0	1	0	1	72	2	1	0	2	0	0	0	57	0	1	3	3	0	0	0	0	1	5	8	0	0	1	0	3	16	10	0	0	0	0	1	13	0	11	8	4	2	0	0	3	0	19	1	11	1	2	0	0	0	1	0	0	0	13	10	1	1	2	0	0	0	1	49	24	28	6	6	4	0	0	0	3	18	2	1	0	1	54	29	25	73	1	32	22	2	46	0	2	6	55	8	0	28	0	0	0	11	8	1	0	0	89	23	8	11	71	947	2	0	0	39	9	60	2	0	1	8	2	3	9	0	32	0	0	7	3	3	0	0	12	2	1	13	3	0	2	0	1	26	2	13	1	8	2	17	9	50	17	0	31	0	8	0	12	16	3	0	0	1	2	0	2	4	10	1	0	0	7	2	13	32	10	0	0	3	71	26	7	6	13	8	182	10	0	1	6	3	3	3	1	0	0	0	2	3	0	1	0	1	0	0	5	0	17	6	152	3	1	10	0	0	21	0	0	0	1	0	0	3	1	0	2	1	0	0	0	0	0	1	2	3	1	1	0	0	1	0	1	3	6	4	0	0	3	0	1	7	0	0	0	1	1	0	11	0	6	7	3	4	3	0	15	3	48	34	3	7	5	3	7	4	0	2	2	0	21	239	0	4	2	1	0	25	3	17	2	15	6	24	11	0	37	3	0	1	15	25	0	1	1	0	2	1	20	0	1	1	0	0	0	0	0	22	7	0	0	60	0	0	23	20	0	0	0	0	0	0	33	1	29	2	58	58	1	1	1	0	0	10	0	0	0	13	20	14	28	1	45	1	1	0	24	3	201	2	2	0	356	0	2	0	14	0	10	0	4	0	0	53	3	86	3	0	29	0	1	0	1	23	2	1	15	0	0	19	67	31	9	23	5	0	0	0	17	0	1	2	0	1	3	1	2	0	0	0	1	0	7	1	3	231	0	4	22	6	7	0	0	0	29	2	22	9	5	37	21	0	0	0	36	0	15	10	8	14	40	8	2	32	10	34	18	55	59	2	1	0	0	18	1	0	33	0	1	5	0	0	0	1	0	0	4	113	14	11	8	210	47	108	0	149	2	9	1	2	3	12	0	1	0	0	0	0	3	0	0	0	7	0	0	31	21	1	0	0	3	4	0	0	0	0	1	1	107	2	1	0	6	0	7	9	2	3	1	0	22	0	1	3	1	37	0	51	24	7	14	7	6	52	3	0	0	57	43	4	0	3	1	4	0	0	83	0	1	0	42	14	34	21	0	0	30	0	0	9	1	0	34	1	7	8	7	1	1	2	1	87	58	45	1	0	20	12	14	14	9	10	0	69	1	0	31	35	0	2	3	4	0	129	138	114	2	7	13	63	0	0	0	2	0	3	5	1	0	1	0	0	31	16	5	1	7	0	142	14	5	2	2	2	0	0	22	21	4	24	26	0	13	0	83	0	48	29	25	19	20	23	0	8	315	137	0	17	4	0	0	11	8	10	3	2	0	1	0	0	1	0	2	9	2	0	0	0	0	13	68	41	339	472	17	31	2	10	1	27	26	21	1	1	16	0	0	0	0	0	0	1	0	3	9	1	13	0	0	0	1	1	1	10	3	0	7	1	0	0	17	2	24	0	10	41	14	18	3	16	36	25	43	20	11	0	0	1	0	183	70	31	0	0	5	12	10	28	2	5	8	0	4	24	27	0	2	6	0	1	0	3	34	20	0	1	1	1	0	6	5	1	3	2	0	0	0	0	102	5	18	22	522	15	0	0	0	0	0	147	0	10103	0	6	1	9	67	101	17	0	0	0	0	0	0	0	0	26	7	7	2	0	0	0	1	1	1	0	13	0	0	102	0	0	4	0	0	1	3	12	0	3	26	0	0	0	0	0	1	0	1	0	13	1	0	3	0	0	0	1	3	0	3	0	0	0	0	1	3	13	0	31	4	0	23	0	1	6	1	17	86	0	0	1	1	2	0	0	5	62	4	8	2	2	0	2	1	5	0	1	0	90	30	1	13	96	0	4	0	0	27	0	127	20	22	10	0	0	0	1	7	0	4	70	3	0	0	0	78	1	0	81	12	1	3	1	1	0	0	0	0	0	2488	20	21	16	9	2951	2	34	48	65	31	10	391	272	253	26	104	48	39	0	17	285	183	177	73	47	3	0	2	1269	5	5	12	6	3	70	21	1	0	1040	9	6	0	1	1	2	4	45	0	5	0	4	6	89	41	14	16	12	14	17	0	7	1	27	47	6	44	1	1	0	0	2	0	1	2	0	1	7	1	0	12	3	32	0	4	37	0	12	0	8	7	9	4	4	0	4	0	1	14	48	0	0	1	1	0	3	0	0	0	6	3	21	19	0	36	13	0	0	37	146	196	2	3	27	89	43	4	27	60	0	30	0	35	12	0	98	0	0	13	14	7	91	15	2	23	20	30	33	0	0	19	11	2	0	51	3	7	1	0	4	56	1	1	11	1	7	4	10	9	0	3	35	0	0	7	2	0	0	0	2	0	6	0	0	15	0	2	5	5	0	549	10	16	0	0	13	2	0	40	6	3	20	0	0	1	95	11	7	63	79	0	22	21	9	6	28	9	28	12	8	6	27	23	43	11	146	91	25	2	0	0	0	5	0	0	1	0	26	26	4	29	1	1	0	0	1	6	46	31	0	14	5	0	2	0	0	1	13	9	3	3	0	0	0	2	2	3	3	0	1	0	0	0	0	2	1	0	7	0	1	11	0	0	0	35	7	1	4	1	19	3	0	1	0	1	0	0	0	14	1	0	1	1	0	1	0	47	4	11	9	9	11	3	22	0	4	0	0	0	2	0	0	12	143	0	0	2	0	0	0	18	13	18	0	0	1	1	0	73	0	9	13	13	18	0	0	2	1	1	5	0	1	0	0	41	51	63	21	31	18	19	33	11	31	1	40	28	40	41	48	175	98	109	129	24	24	19	16	7	35	3	0	22	8	16	11	40	85	36	69	124	14	70	35	50	130	24	28	28	42	32	18	59	0	0	9	2	230	98	8	19	8	87	58	6	23	403	219	133	927	0	242	21	1	1	2	0	12	19	5	86	0	21	1	841	1291	166	2	0	36	1	0	1	3	0	186	57	116	70	91	45	293	70	16	23	0	30	5	60	20	2	2	0	3	2	35	20	14	15	31	20	11	3	17	24	17	22	0	0	0	14	0	2	0	17	0	8	3	0	0	2	2	29	18	8	0	0	1	33	14	4	4	0	0	5	0	0	1	16	0	0	0	0	0	0	0	0	9	16	1	2	8	0	1	1	5	1	0	3	6	10	0	17	16	3	28	100	5	1	21	0	0	1	6	1	0	0	0	3	1	2	0	0	0	0	1	50	0	1	0	0	0	16	1	3	0	0	3	0	0	0	1	0	0	8	1	1	1	1	12	3	5	0	0	20	0	84	115	24	70	1	44	1	38	3	0	0	0	0	2	0	0	0	0	0	2	0	17	24	21	13	2	0	2	1	0	1	0	0	12	11	4	1	58	0	15	1	0	24	45	0	1	2	27	1	0	15	45	74	55	12	2	0	20	0	1	18	8	82	0	0	0	26	14	9	2	6	39	16	25	17	0	6	49	23	0	7	66	301	23	12	0	0	0	26	10	21	43	0	9	1	1	0	1	12	0	4	0	0	1	0	0	14	0	4	19	2	0	0	0	0	0	14	1	11	0	70	2	0	0	3	0	1	0	0	0	26	12	12	0	2	41	0	7	2	1	8	9	32	0	1	17	1	1	4	25	10	2	1	0	0	2	2	19	4	11	4	4	0	6	3	0	0	2	0	7	23	35	0	8	304	0	4	0	0	2	3	0	17	56	5	7	74	28	23	0	0	44	2	4	8	4	1	0	3	0	0	6	9	3	2	0	2	0	9	2	8	0	2	0	38	6	0	4	1	0	0	5	14	8	8	16	20	0	2	0	0	2	0	7	11	9	2	0	2	32	0	2	3	0	27	46	0	0	40	44	14	0	1	35	0	13	8	13	1214	0	1	34	0	4	0	1	1	1	4	0	1	39	21	1	24	10	20	8	3	1074	0	40	0	0	0	0	1	6	0	0	0	2	0	0	0	5	0	0	0	5	6	0	2	0	1	3	0	2	0	7	14	12	0	0	0	0	39	17	5	0	0	2	87	43	0	5	0	1	7	1	57837	0	0	0	0	0	1	0	0	0	0	1	1	0	0	6	0	18	0	0	1	0	45	27	79	64	0	27	19	25	1	1	0	0	0	0	1	2	14	69	1	76	25	0	3	0	0	3	9	0	8	0	1	25	2	44	6	12	64	128	54	41	16	0	20	6	0	30	1	1	66	5	31	48	1	2	1	7	4	16	0	165	51	59	3	45	0	0	0	0	37	2	0	4	1	76	25	0	112	3	3	3	26	40	1	0	70	29	1	13	2	7	0	0	0	0	2	0	0	73	128	157	92	235	7	138	27	3	48	71	126	168	281	62	37	72	18	124	33	0	38	64	27	0	6	3	0	0	78	38	155	191	33	0	19	1	0	32	19	15	13	13	0	4	0	0	0	0	0	0	0	1	1	3	13	3	17	4	6	4	0	3	24	1	0	0	0	31	26	15	16	4	1	4	8	0	6	12	99	0	4	1	9	5	33	20	16	22	0	4	0	0	1	41	21	0	0	2	9	1	0	0	0	0	2	0	0	0	7	65	1	0	1	18	6	5	0	4	4	2	0	0	3	5	6	20	1	19	0	0	0	77	66	0	4	5	0	67	16	0	18	8	1	4	3	0	0	2	0	1	3	0	0	1	0	1	1	2	0	0	2	0	6	0	11	1	1	0	1	13	0	0	0	0	7	17	0	5	0	0	0	0	1	3	4	0	0	0	3	0	5	0	3	31	0	6	12	1	1	0	0	26	37	1	1	2	9	18	6	0	39	3	2	3	278	20	24	11	10	0	3	10	16	38	0	0	9	2	7	6	7	4	0	0	0	2	0	1	1	0	2	1	7	0	9	28	18	0	0	0	0	114	845	1	0	6	0	0	0	6	14	24	46	15	7	63	0	45	36	8	1253	19	5	1	25	23	19	29	4	42	0	2	70	2	62	9	5	4	0	2	1	0	1	15	0	6	79	26	4	1	1	0	28	30	13	1	1	1	0	4	23	0	1	3	7	0	16	4	6	1	22	2	7	18	9	3	6	11	7	28	20	1	0	0	0	0	1	4	45	191	54	15	12	19	40	17	73	0	7	15	17	9	0	5	22	7	15	0	13	9	4	0	0	6	13	4	8	12	3	0	0	15	0	2	5	6	2	22	16	15	10	4	6	4	21	0	1	0	1	3	1	3	1	182	0	12	0	0	0	4	14	1	2	0	1	2	0	2	0	0	1	0	0	2	5	8	39	0	0	1540	0	1	10	13	0	1	1	7	6	85	0	1	0	1	2	2	0	0	0	0	0	3	0	0	4	0	0	0	3	0	189	1	19	13	64	66	8	41	0	0	0	0	0	0	0	0	3	0	1	2	0	0	0	5	1	265	1	0	1	0	0	9	2	1	0	0	0	0	1	9	0	1	87	0	0	5	8	7	8	15	0	15	12	9	2	83	4	6	10	28	12	36	21	23	26	74	370	157	120	645	0	1	39	5	0	13	9	13	10	1	1	0	0	0	0	255	0	0	2	0	356	0	1	0	0	5	225	1	58	1	0	2	9	8	0	1	1	0	1	0	3	7	11	2	1	2	4	147	84	0	0	0	3	0	0	0	1	40	0	0	0	1	0	4	32	42	0	1	0	0	22	3	4	0	64	5	1	29	17	4	0	3	0	5	2	20	10	24	8	5	1	1	0	0	66	2	5	9	3	67	27	1	0	17	197	18	17	916	0	1	0	1	0	1	0	173	12	16	0	1	3	1	30	3	15	0	7	0	10	0	0	26	0	4	1	44	6	6	101	5	1	63	187	0	2	1	0	0	6	8	4	1	4	0	29	0	0	7	1	0	1	3	5	0	5	0	1	23	7	2	0	0	14	4	3	0	0	17	44	8	30	0	3	78	9	0	0	0	3	1	8	18	4	17	11	68	85	7	11	33	1	29	59	102	0	1	0	0	6	0	11	0	0	272	3	0	15	38	65	28	1	15	15	0	3	6	17	2	1	136	17	1	3	1	0	8	0	0	61	240	72	1	0	0	0	0	2	4	0	0	0	1	2	4	1	0	0	0	0	0	0	0	0	13	0	0	0	3	2	0	0	0	0	0	2	1	1	0	0	0	1	5	117	0	0	0	0	0	0	0	2	0	0	1	1	5	0	0	0	11	8	19	7	0	10	11	3	6	2	6	3	12	0	5	0	0	32	380	12	34	10	4	36	3	15	15	4	29	17	1	0	0	1	4	1	9	0	0	25	0	12	9	0	33	19	1	3	11	1	1	50	29	0	17	0	1	5	0	0	0	35	16	17	10	42	10	30	37	4	80	11	12	0	0	0	4	0	18	21	96	64	0	53	20	28	4	8	0	10	0	2	0	0	2	6	8	2	0	0	0	0	49	0	1	0	0	0	1	5	0	10	22	22	31	30	1	10	6	43	34	8	25	13	5	72	47	71	1	5	3	1	0	0	0	14	6	85	22	27	35	0	0	11	0	0	0	0	0	1	1	0	0	0	0	0	0	27	79	234	0	54	132	37	16426	48	0	12	0	0	0	0	1	14	2	15	3	0	3	34	0	0	0	19	4	4	0	0	8	2	0	0	335	113	0	17	56	16	5	2	3	2	0	7	0	78	0	4	1158	0	0	0	25	0	42	0	3	0	3	2	0	0	0	1	0	1	18	0	0	1	0	0	1	0	1	0	1	0	0	1	7	0	4	1	0	1	3	1	4	1	2	2	3	17	1	310	307	4	24	31	18	17	18	48	25	0	10	0	30	1	0	1	0	0	0	0	0	1	0	0	14	0	2	0	1	19	8	1	1	1	10	3	18	0	0	3	1	12	0	0	0	0	0	14	13	0	4	20	10	1	1	0	0	0	1	0	0	1	0	3	4	0	4	3	37	45	42	31	39	0	0	0	0	0	0	1	1	23	0	86	2	7	4	13	0	78	61	0	0	1	0	1	1	1	0	0	0	2	0	0	2	2	0	0	2	1	0	0	0	0	0	0	0	0	3	2	0	2	0	0	3	0	0	444	0	0	0	1	0	0	0	0	1	10	0	1	0	0	2	1	1	0	3	1	0	2	1	0	0	0	0	1	1	0	2	2	1	0	87	1	1	0	2	1	0	18	0	0	1	1	1	0	2	1	5	11	0	0	342	0	0	0	0	0	1	0	1	3	1	2	7	2	1	9	2	1	0	1	0	0	0	1	0	0	0	0	0	1	5	0	0	0	0	0	0	1	1	0	1	1	0	0	15	2	2	0	0	0	0	1	0	7	0	9	1	1	0	1	6	1	0	4	0	0	1	0	0	0	0	0	1	1	3	0	0	0	1	0	0	0	31	1	0	1	0	0	0	1	0	0	0	0	0	0	1	0	2	0	0	2	1	0	3	5	0	3	1	328	0	0	0	1	3	0	19	25	8	1	2	1	6	114	0	190	3	3	0	0	10	2	25	0	0	6	401	2	10	3	0	352	6	222	0	1	3	0	0	9	2	4	6	8	1	0	12	13	55	2	17	0	18	1	0	10	3	10	0	49	0	15	0	78	9	18	0	101	1	20	7	0	4	12	4	6	11	16	4	0	6	8	3	2	1	20	3	6	107	5	5	3	4	23	39	8	1	0	0	92	49	30	14	4	0	23	1	21	19	4	10	3	11	59	0	0	549	2	2	14	3	11	0	196	6	49	37	9	0	6	2	10	27	19	3	20	6	0	6	6	26	3	21	9	33	78	59	12	138	290	48	21	0	2	11	81	0	10	0	0	1	4	0	1	0	0	13	0	5	0	0	0	3	0	4	2	117	20	62	0	0	3	0	7	55	1	83	1	41	24	1	2	0	7	8	1	1	1	0	0	1	11	0	0	2	15	1	9	2	7	11	1	1	0	6	0	0	1	0	2	0	19	0	0	0	2	0	6	0	1	1	0	0	4	46	1	2	4	6	1	0	5	5	4	0	1	45	1	1	0	4	0	23	0	1	0	6	3	0	0	0	4	9	2	17	0	2	0	3	0	0	1	0	1	2	6	0	2	0	0	1	27	4	105	2	5	0	1	0	4	0	0	0	1	79	1	20	7	0	2	0	4	3	2	0	2	2	0	0	1	2	6	0	0	0	0	4	53	26	3	34	32	2	0	0	2	1	2	3	2	699	0	14	16	211	0	1	4	0	20	58	8	0	0	9	15	22	0	2	2	0	11	40	47	769	1	26	20	14	1	3	0	2	0	0	0	9	2	0	0	0	13	0	2	0	16	9	1	0	20	50	5	3	22	2	1	0	5	0	1	10	34	26	24	42	57	0	37	34	1103	0	48	19	19	85	0	14	18	18	1	4	0	3	0	4	52	6	0	0	0	0	37	35	15	0	0	18	0	0	0	0	1	3	1	0	38	11	23	0	0	72	3	0	0	2	0	0	21	0	10	4	3	3	19	10	0	30	0	40	0	74	0	0	0	6	11	0	17	0	17	0	24	96	56	83	19	7	1	21	6	14	13	421	47	3	15	0	2	0	2	1	0	2	8	0	1	0	4	0	0	15	28	28	0	11	0	1	14	13	29	0	8	0	5	7	43	3	17	1	7	0	0	10	45	27	91	32	16	1	0	3	2	34	0	1	8	6	16	1	109	99	54	0	31	0	0	14	8	8	2	0	0	0	3	43	60	7	51	50	17	9	4	146	1	8	17	29	14	4	8	20	28	61	8	3	19	102	80	2	0	0	3	0	0	0	57	0	0	86	0	4	0	0	1	3	2	98	14	16	0	0	3	0	9	0	0	1	4	4	0	6	2	0	0	5	15	4	130	2	8	0	0	0	3	0	19	9	1	0	17	0	1	0	19	2	1	35	14	3	89	0	0	0	16	57	0	0	5	1	0	35	0	2	2	0	1	0	0	107	18	16	1	21	5	14	8	0	3	0	0	1	0	0	88	1	1	1	56	1	0	44	1	8	24	1	16	44	0	0	0	5	0	46	22	0	1	4	4	5	7	0	0	5	10	5	0	0	31	49	15	4	0	1	0	1	7	0	0	0	0	7	6	61	19	0	132	11	24	143	34	65	300	40	35	31	117	166	44	160	55	70	113	20	90	48	0	8	0	11	2	11	0	0	3	2	4	4	17	1	0	0	2	1	0	1	8	0	1	0	0	11	19	0	3	14	8	0	0	7	1	0	0	1	0	0	0	0	0	0	1	0	1	0	2	0	0	0	0	0	0	0	1	19	8	0	0	1	0	0	0	0	0	0	0	0	0	0	0	0	0	0	0	0	1	0	0	1	0	14	15	0	64	9	1	1	9	0	0	0	44	31	44	39	2	40	64	30	0	26	0	8	3	0	0	0	2	0	0	0	37	78	9	47	14	41	0	3	2	19	6	11	6	0	4	1	10	10	0	0	0	0	0	14	4	2	5	9	3	13	10	30	8	14	0	21	30	19	0	20	32	5	0	3	0	2	0	0	7	37	0	3	0	2	1	0	0	19	7	17	0	0	181	12	1	8	0	67	0	0	0	0	32	1	1	0	208	28	4	8	0	4	310	0	0	0	5	5	1	17	0	1	50	0	0	2	10	1	37	13	12	0	22	42	0	0	4	15	0	5	0	5	4	4	11	8	9	15	0	6	1	7	3	7	5	0	2	13	109	19	29	15	5	2	6	30	0	14	2	1	21	2	0	1	1	22	0	2	8	20	2	1	19	7	0	1	0	0	1	13	0	1	2	1	1	1	0	3	2	1	0	0	0	1	4	11	4	0	0	0	0	3	6	6	9	0	23	1	0	1	0	4	16	18	6	15	9	0	52	1	0	168	35	119	40	20	1	6	445	127	2	32	71	7	2	0	18	35	8	5	4	18	2	30	32	23	0	5	2	0	0	14	14	13	0	0	33	56	44	7	0	1	2	0	0	0	142	0	4	6	20	2	0	0	5	0	0	2	13	227	11	201	29	13	0	50	4	5	0	0	0	2	0	6	0	0	2	10	0	132	0	0	33	16	0	69	18	332	67	15	0	1	43	14	44	223	43	38	60	20	212	0	48	112	4	0	1	0	1	8	9	3	491	96	16	0	78	0	24	0	0	33	1	1	2	14	2	1	0	109	145	0	1	1	177	53	43	38	6	21	16	22	69	1	2	88	0	2	17	23	8	1	0	0	7	1	1	0	13	10	0	0	2	1	2	3	0	1	0	0	1	0	1	0	130	5	1	0	0	65	26	27	0	0	5	9	3	4	3	3	0	25	24	12	2	73	2	32	12	1	1	5	43	1	14	7	0	0	56	17	32	21	50	83	65	3	13	2	263	12	91	94	0	1	0	1	0	0	1	2	4	1	2	3	0	0	0	0	0	2	0	0	19	0	1	9	10	4	19	0	1	11	0	9	0	1	4	1	18	0	0	6	49	12	4	46	25	14	176	0	4	0	5	0	1	1	3	0	0	0	1	1	20	0	0	0	0	0	0	3	1	0	0	6	1	0	2	0	6	2	13	0	0	25	0	115	0	0	9	2	1	16	1	0	1	0	0	6	1	0	0	1	0	2	8	18	14	5	4	38	6	30	0	11	0	475	1	233	318	4	5	2	2	7	0	1	0	22	250	966	51	29	46	7	118	20	25	22	33	19	13	1	18	41	0	0	8	31	1	0	0	0	5	2	7	2	3	1	0	0	2	2	24	0	0	0	0	9	1	0	0	1	0	0	1	2	0	1	1	0	0	0	0	0	0	0	0	1	0	3	7	0	31	11	0	70	1	48	60	38	46	1	0	0	7	0	1	3	1	2	71	2	0	49	33	4	0	3	5	0	30	2	7	14	22	0	0	2	0	8	1	5	0	1	0	1	0	1	2	5	10	2	0	28	6	16	8	5	2	0	2	6	2	1	53	31	4	1	7	10	11	0	17	4	2	8	11	0	6	0	35	12	0	1	0	0	10	0	0	1	9	2	0	0	133	10	8	5	4	3	33	1	2	1	0	0	0	0	1	0	1	24	11	4	42	59	0	0	4	2	1	1	1	0	15	0	6	5	1	6
LakWasMet19_HOW5_2_rpkm	2	0	0	0	0	0	15	2	0	0	0	1	3	0	0	0	0	1	10	0	0	0	0	22	0	0	0	0	0	10	0	1	0	7	2	6	1	0	3	0	0	0	0	13	11	25	24	9	8	1	6	4	4	1	0	5	0	1	41	8	339	1	2	6	6	0	0	0	8	17	5	1	0	0	3	0	0	0	0	0	0	11	1	0	0	0	0	0	0	3	1	1	2	5	15	0	0	0	1	0	1	0	0	0	0	0	0	0	0	0	0	0	58	3	18	5	0	4	0	0	0	0	0	6	0	0	39	0	0	0	0	379	10	2	0	4	0	0	10	0	1	0	0	4	32	0	0	0	13	10	5	13	0	25	27	1	9	2	19	0	11	3	0	5	10	3	0	4	1	25	0	1	0	1	0	0	0	1	0	0	1	0	0	1	7	20	0	0	0	10	2	4	4	5	0	0	0	3	10	708	8	1	30	0	0	1	5	0	16	4	9	0	20	4	6	0	6	6	0	1	1	1	19	7	3	10	0	0	7	0	0	0	121	0	0	0	6	11	66	3	0	0	11	9	24	7	0	1	8	5	15	4	3	0	861	179	0	3	0	0	5	0	2	17	2	0	0	0	0	16	14	0	12	0	0	1	0	2	35	35	5	15	15	28	16	0	0	0	1	1	0	2	0	0	100	0	0	13	1	0	0	46	17	0	8	1	22	27	6	1	14	1	28	9	0	0	1	0	6	0	0	1	0	1	29	3122	0	0	4	0	0	12	0	0	0	0	1	1	12	2	1	1	15	22	17	1	5	4	1	0	6	1	1	0	1	0	2	19	0	34	16	0	0	0	0	12	7	13	14	3	0	17	0	0	6	0	0	8	1	1	0	0	2	4	0	0	91	0	0	0	0	1	29	1	1	9	31	0	0	23	0	5	0	3	14	0	0	0	0	4	0	9	34	116	2	30	13	8	3	3	0	2	0	2	0	0	17	0	0	1	280	3	6	0	0	0	1	1	8	1	9	14	0	0	8	29	0	0	0	0	0	49	13	61	1	22	18	0	0	8	4	3	0	5	1	10	5	0	1	14	17	9	10	3	0	0	11	3	229	0	1	7	8	6	0	0	0	50	84	1	0	2	26	21	8	0	9	0	0	0	0	1	2	3	0	0	0	0	0	3	1	0	0	3	1	0	0	0	1	5	0	0	0	4	0	0	0	0	0	0	2	0	18	4	5	0	6	0	0	14	1	8	3	11	13	0	0	1	1	0	0	0	1	0	0	25	0	0	3	0	0	3	1	1	52	1	12	0	15	1	0	2	0	0	3	7	30	76	6	12	12	78	58	6	14	0	4	5	17	0	0	0	5	6	4	4	1	0	1	0	9	0	0	1	22	8	0	22	0	13	0	141	150	147	0	0	72	1	187	4	91	67	10	4	0	34	3	3	1	5	3	2	1	0	0	2	1	0	0	2	2	29	0	0	0	3	2	10	5	0	59	0	1	7	5	0	2	0	5	4	1	96	0	9	0	0	1	1	13	37	6	11	0	0	0	0	4	0	0	0	0	1	7	22	0	0	0	0	0	13	3	0	12	0	2	2	2	2	0	0	0	1	0	0	4	0	2	0	13	0	0	0	1	0	35	8	0	3	20	0	3	1	5	9	0	0	1	1	12	2	0	13	1	0	4	0	0	0	0	2	0	13	12	1	19	16	5	0	0	34	0	0	1	3	0	0	6	0	74	9	0	19	0	23	0	0	0	0	0	0	0	0	0	0	0	31	0	0	0	0	0	0	2	0	0	5	3	0	0	3	4	14	4	0	0	9	1	0	1	16	1	0	0	0	174	14	26	1	3	2	0	1	104	0	2	0	9	0	0	0	0	0	0	6	8	0	0	3	1	2	4	0	0	1	0	0	1	70	24	0	0	1	0	0	0	0	0	8	14	29	0	0	4	0	0	1	1	4	2	9	15	10	0	6	0	32	0	0	7	2	0	0	0	1	0	0	2	4	0	37	0	3	7	8	9	5	11	1	0	0	0	0	0	0	0	0	0	2	0	0	0	0	4	0	0	0	0	0	0	1	0	0	0	21	15	8	14	9	11	1	0	0	0	0	0	0	0	0	0	0	358	0	0	0	0	0	2	0	0	6	0	0	0	3	11	0	6	0	0	0	0	5	0	0	2	0	1	0	3	0	0	0	0	0	0	2	0	0	1	0	1	7	6	212	0	16	1	6	1	0	13	8	9	0	22	0	0	2	0	0	0	5	0	0	1	0	0	1	2	0	0	2	0	0	0	0	0	0	0	0	0	0	0	0	1	0	0	108	0	1	0	34	9	0	0	15	0	0	167	2	4	0	0	0	0	2	0	0	140	17	0	1	0	0	1	0	2	1	0	0	0	0	2	3	1	0	0	0	0	5	3	14	0	16	0	0	0	0	41	19	4	0	0	2	2	0	2	0	17	23	3	3	0	0	1	0	0	0	3	6	11	0	1	1	1	0	0	0	0	0	0	0	0	0	21	11	33	0	4	19	0	6	0	0	3	1	0	6	2	0	5	0	0	0	0	2	60	35	10	0	0	0	96	0	0	5	24	0	5	0	0	0	0	0	0	1	0	0	0	0	0	0	0	0	9	0	0	3	0	2	0	0	1	0	0	0	0	0	16	0	4	3	0	0	0	0	3	0	7	0	0	0	0	0	0	0	0	3	1	0	7	0	4	2	2	21	1	0	0	22	15	0	0	3	2	109	14	0	0	0	0	0	5	0	1	0	12	29	0	3	0	0	6	0	1	0	0	1	21	0	0	0	0	0	6	0	0	0	6	0	27	0	111	7	0	1	1	3	0	2	8	0	31	52	32	0	0	1	0	1	24	0	0	13	0	12	1	0	0	0	0	2	8	34	2	5	12	9	0	25	1	0	4	2	0	91	1	0	4	0	0	12	0	1	0	3	0	1	72	4	9	0	1	0	0	1	2	0	1	5	0	5	0	1	0	0	4	0	1	2	0	0	55	0	3	0	4	0	6	0	0	1	2	6	4	0	20	25	17	40	0	0	11	3	0	0	30	3	2	9	2	2	2	1	1	0	12	11	0	2	0	0	9	2	7	0	7	1	4	13	3	0	3	32	2	3	6	10	2	0	0	0	3	0	15	0	5	14	5	26	6	2	20	0	0	24	10	10	0	5	2	1	2	12	12	0	3	0	0	7	4	11	11	14	1	0	11	0	0	0	0	0	1	5	3	0	0	0	51	0	1	16	0	0	11	1	1	2	1	2	1	0	7	13	1	11	0	0	0	0	0	0	0	402	4	87	18	4	0	2	0	0	0	0	0	20	7	2	0	21	0	0	4	17	188	621	43	35	0	0	7	58	0	0	5	0	4	0	1	0	37	33	20	43	55	56	0	12	27	11	0	0	1	0	0	0	137	23	0	0	0	2	0	9	1	0	0	4	0	0	0	3	0	0	0	4	6	0	0	1	2	0	0	10	14	10	0	0	0	0	0	2	0	2	0	1	3	1	2	0	1	0	2	0	0	0	0	0	0	7	0	8	1	106	0	0	0	0	0	0	0	0	0	1	1	1	0	0	0	0	0	0	0	0	0	8	0	278	8	0	55	0	0	6	0	109	1	24	32	0	0	97	0	243	1	0	2	0	0	0	32	0	44	1	0	1	1	0	0	0	0	3	10	2	1	0	6	0	0	2	1	0	0	0	0	0	0	13	3	21	4	19	0	1	23	8	0	0	0	29	3	1	0	1	10	0	0	9	16	0	6	3	2	11	8	0	2	11	0	0	5	65165	1	5	1	7	0	0	10	0	0	0	1	1	0	0	0	0	2	10	8	50	27	16	29	12	0	0	0	8	0	28	0	20	6	9	32	0	2	0	7	0	1	2	4	8	10	0	7	8	0	3	0	2	1	18	6	0	16	2	0	0	0	0	0	9	0	87	4	5	9	4	0	1	13	11	8	69	6	0	4	3	1	0	0	4	36	258	47	75	0	7	3	0	4	8	0	0	10	2	2	0	170	0	7	0	1	4	0	26	12	2	238	0	0	0	0	6	0	2	0	8	0	0	2	0	8	2	1	0	0	0	19	0	426	0	0	31	211	194	0	16281	2	0	6	0	0	1	2	1	3	3	0	0	1	7	0	0	0	29	2	0	0	1	0	0	1	2	0	23	0	0	0	0	80	8	5	0	0	0	8	0	9	7	2	0	7	0	5	0	2	0	2	0	25	1	0	7	16	0	0	2	24	79	10	18	0	16	65	0	44	2	21	2	2	15	6	1	40	3	0	50	3	0	0	0	5	0	0	0	0	1	0	1	0	0	6	7	1	6	0	29	36	0	0	1	0	0	1	2	0	0	0	1	0	0	3	0	0	1	13	4	18	3	0	0	5	0	3	0	2	0	0	0	13	0	0	0	0	0	0	0	0	0	0	0	0	2	0	3	0	0	1	15	0	0	0	1	0	0	0	0	78	0	75	64	1	3	5	0	10	0	10	12	61	12	3	2	0	0	0	0	0	0	0	2	0	0	12	2	0	0	2	4	0	0	0	0	0	0	4	0	3	3	5	7	7	36	0	15	2	0	1	0	18	20	39	1	4	0	0	0	0	0	0	0	0	1	5	0	0	0	0	0	3	0	0	0	0	1	4	36	0	0	0	0	1	0	4	0	0	0	15	80	11	0	0	0	3	0	0	0	8	1	0	34	2	0	0	0	6	2	0	0	0	0	10	0	8	0	0	23	3	0	0	22	0	0	0	1	0	0	0	0	17	0	0	61	0	0	0	0	4	13	0	2	17	12	0	16	19	9	4	0	3	0	1	2	69	0	19	17	0	0	0	2	4	4	0	16	0	1	2	0	3	3	0	0	0	0	0	4	0	0	1	0	0	0	0	0	0	1	6	24	0	0	9	38	0	0	3	0	0	0	0	0	0	0	0	0	4	2	2	0	0	6	5	0	1	13	2	0	0	347	0	1	55	145	27	0	0	0	5	4	0	0	0	0	0	0	37	0	2	12	12	0	0	0	0	0	1	6	12	0	1	0	21	20	0	0	8	0	11	0	5	4	0	0	0	0	4	0	0	2	1	13	14	0	2	2	1	9	4	0	14	4	0	3	2	0	0	0	4	27	0	0	0	0	0	0	0	0	8	0	0	2	0	4	59	2	0	0	0	0	6	7	0	11	2	11	1	0	0	0	0	0	0	0	0	1	0	3	0	0	0	1	0	0	1	0	5	2	0	1	5	0	0	4	1	0	3	1	10	1	13	0	8	1	3	4	1	0	0	0	1	14	4	3	0	0	0	0	58	28	18	36	83	21	40	200	11	91	128	145	45	28	42	23	15	415	44	0	21	0	67	83	78	90	239	35	37	25	29	41	40	15	1	9	0	0	0	0	1	0	2	0	36	41	4	0	2	0	0	0	2	0	1	3	0	0	0	1	0	22	0	0	2	1	1	0	13	0	26	6	3	0	2	2	5	2	0	0	0	2	0	0	1	0	0	0	2	0	0	15	0	0	3	0	16	10	1	7	2	0	2	2	0	0	0	2	0	0	13	0	0	0	0	0	159	0	0	28	1	2	0	0	1	0	0	0	1	0	3	16	0	7	0	1	0	0	6	0	0	4	0	1	0	2	1	5	2	6	0	54	1	4	4	7	0	0	0	0	1	4	0	1	5	0	2	0	0	10	9	0	0	0	0	0	0	0	13	10	16	3	2	12	5	3	2	7	2	10	2	3	0	35	0	0	0	0	0	0	17	0	27	9	1	1	0	0	0	4	0	0	0	1	1	0	2	6	0	2	0	0	2	5	0	0	1	0	0	0	0	0	6	4	1	0	0	237	0	2	2	488	6	0	0	0	0	0	1	0	0	2	0	0	0	0	0	0	4	0	7	100	0	12	1	0	33	0	0	22	5	0	47	8	0	39	1	7	6	1	1	1	0	0	1	9	0	2	0	2	0	1	14	0	1	1	2	0	0	3	9	0	0	1	19	0	0	0	0	3	0	0	0	0	0	0	0	0	13	0	1	0	0	12	1	15	111	47	4	0	12	0	0	0	1	2	0	10	3	0	0	10	0	0	0	0	14	2	7	15	2	1	1	7	0	0	0	0	47	16	18	0	0	1	154	0	0	0	0	0	0	0	0	0	0	0	0	1	31	12	0	3	0	0	0	0	0	5	0	1	6	7	7	2	0	0	0	0	16	2	0	21	1	0	0	0	3	0	1	0	2	7	1	1	15	5	0	0	1	0	5	2	0	0	3	1	1	0	0	2	7	0	13	3	3	0	1	4	0	0	3	0	5	5	0	0	0	0	1	0	1	14	3	0	109	3	1	6	0	42283	1	5	1	1	0	1	2	14	2	13	10	1	0	0	0	0	0	0	0	22	0	0	0	0	0	0	53	2	2	23	10	10	0	13	15	12	9	10	2	11	0	11	0	29	4	5	0	6	3	3	1	7	1	6	0	10	1	0	0	32	0	4	0	1	16	2	19	16	8	0	4	0	5	8	8	1	13	0	13	0	63	8	11	5	0	4	0	20	11	5	0	0	0	6	0	3	9	0	4	0	0	5	11	1	0	0	4	69	0	1	1	1	0	0	0	0	6	0	0	2	0	24	7	0	2	0	0	6	3	0	0	1	0	1	0	25	5	0	69	53	28	0	41	0	15	0	0	40	64	2	0	0	0	3	4	0	74	0	1	9	0	0	1	0	2	16	0	0	24	5	0	111	0	12	0	0	0	13	25	0	0	0	0	3	3	0	1	3	1	0	3	3	2	2	14	2	0	0	18	23	3	0	1	1	0	0	608	306	535	3	0	0	0	0	0	5	2	27	0	0	0	7	0	1	151	145	25	1	0	0	14	0	6	0	56	2	3	0	0	0	37	0	0	5	3	0	0	0	0	0	0	1	1	0	3	0	54	93485	0	1	0	0	2	0	0	24	0	1	0	0	0	0	9	78	0	0	16	0	1	0	0	1426	10	31	2	0	13	3	0	0	4	0	0	13	2	2	0	5	1	2	0	2	2	1988	8	0	0	0	0	0	0	2	0	0	0	0	0	0	0	22	0	2	0	0	0	0	0	2	0	0	0	0	0	0	0	0	0	0	2	0	5	1	0	1	0	0	0	0	0	0	1	0	0	0	1	0	0	0	7	2	0	0	2	12	0	1	0	4	1	0	38	0	0	0	0	0	0	103	1	1	0	3	6	5	17	23	6	0	15	0	0	10	1	0	44	0	0	21	0	2	0	0	0	0	0	0	15	0	0	0	0	0	0	0	0	0	0	0	0	15	1	0	0	0	0	0	0	0	0	0	0	1	5	0	6	0	0	0	0	2	0	2	0	2	0	9	4	2	1	6	10	5	2	7	0	0	0	0	0	0	0	3	6	75	0	4	0	6	0	10	2	0	0	0	0	0	0	5	0	0	0	9	24	3	0	8	2	2	0	1	2	1	6	0	0	0	0	11	0	8	0	7	23	0	17	0	114	19	0	0	0	0	0	2	0	0	0	17	0	1	0	0	0	1	12	165	0	275	0	0	0	7	0	0	0	0	0	1	0	17	1	0	4	8	32	7	0	0	0	0	1	0	1	0	39	0	7	3	0	22	2	0	0	0	5	1	0	0	0	0	23	0	0	1	2	0	6	0	12	3	0	18	0	4	0	0	29	0	0	0	6	0	0	0	0	0	0	8	147	0	0	0	1	0	0	2	0	0	0	1	5	0	1	0	0	0	1	113	14	0	0	0	0	0	0	43	0	0	0	2	0	8	2	0	0	2	0	9	4	0	0	0	2	0	0	1	10	4	0	0	33	0	2	0	3	2	0	0	0	0	0	0	5	0	15	0	11	0	3	18	0	1	0	0	3	0	0	3	0	0	0	0	0	0	2	0	0	0	0	3	1	0	6	0	0	0	15	0	1	3	14	1	0	0	2	2	0	0	0	3	6	0	0	0	19	0	0	5	5	0	0	0	0	0	0	0	0	1	0	0	0	0	6	1	0	0	1	0	2	0	0	0	0	4	0	0	3	0	57	0	0	0	14	1	1	0	4	0	2	0	1	8	0	0	0	0	9	4	0	0	0	24	11	0	1	3	9	0	0	0	0	0	0	0	0	1	0	0	6	0	0	52	0	0	0	0	3	0	0	0	92	0	0	0	0	1	0	2	0	0	0	4	0	0	21	0	3	0	0	0	3	0	0	0	1	11	0	0	0	0	0	158	0	0	0	0	0	0	10	0	0	5	1	0	0	0	0	0	0	0	0	0	0	0	0	0	0	0	0	0	0	3	0	0	0	0	0	0	0	0	0	0	1	0	0	15	0	0	0	0	0	0	2	0	0	0	10	0	2	2	0	0	0	0	0	0	0	0	0	0	6	0	2	0	0	0	0	0	2	5	0	0	0	0	0	0	0	3	0	0	0	0	0	2	0	2	0	0	0	0	0	0	0	1	28	0	7	15	10	1	4	0	0	0	0	0	0	0	22	20	3	0	0	0	10	0	8	0	0	0	0	84	32	3	0	0	0	116	0	22	0	1	0	16	4	0	2	0	0	0	0	1	0	4	0	5	0	0	0	4	0	0	1	4	0	0	0	0	0	2	0	12	0	3	0	0	0	0	0	0	0	0	0	5	0	0	0	58	0	26	1	0	0	0	1	0	0	0	0	0	258	2	0	0	0	0	6	0	0	0	0	0	0	2	0	0	0	1	2	0	2	6	0	0	0	0	0	0	0	3	4	0	0	0	0	0	1	0	0	0	28	0	4	1	0	0	0	0	0	0	0	0	0	0	31	2	0	0	0	0	12	0	0	47	0	0	2	0	0	0	1	0	0	0	0	0	0	0	2	0	0	0	0	0	0	0	0	0	0	2	0	0	0	32	0	0	0	0	0	0	0	0	1	0	2	0	0	0	1	2	0	8	0	0	1	4	0	0	11	0	10	2	0	0	0	0	0	0	0	0	0	2	0	0	3	0	4	2	0	0	0	0	5	2	28	0	63	1	1	0	9	0	0	0	0	0	0	0	1	0	2	2	0	21	13	0	12	0	0	0	0	0	1	53	0	0	1	3	0	0	0	0	0	0	87	2	19	0	31	0	0	0	0	0	0	75	1	29	0	0	0	0	4	2	0	0	0	1	0	59	6	0	1	0	0	0	0	0	1	0	6	0	1	0	3	1	0	1	3	0	0	0	3	2	0	0	0	0	0	0	0	0	0	0	32	0	7	0	0	0	7	0	0	1	0	0	11	0	0	0	0	0	8	8	0	0	6	3	3	0	1	6	0	0	1	0	6	0	0	45	6	2	0	26	3	4	37	138	15	0	7	0	261	0	14	58	5	0	0	0	69	291	0	30	0	9	3	0	698	0	0	0	0	30	0	0	13	8	0	4	0	1	11	1	10	14	37	0	0	5	1	14	0	18	9	0	2	7	2	0	0	1	0	1	0	10	15	1	0	0	8	8	5	2	13	0	2	0	0	0	2	0	0	0	0	8	0	0	2	16	1	2	13	15	14	0	0	6	2	5	0	0	0	0	0	0	0	0	0	0	28	51	5	0	0	0	0	66	1	3	5	0	0	0	0	0	0	21	0	0	9	0	0	3	0	38	9	2	0	8	0	0	0	0	0	0	0	0	5	0	0	0	1	2	0	2	0	0	3	5	0	51	5	0	0	0	26	0	0	2	0	13	10	0	0	0	4	1	8	13	1	0	3	0	0	0	0	11	0	0	1	33	38	60	1	5	36	16	66	0	47	24	18	1	142	126	64	0	527	23	94	13	25	5	42	2	68	0	6	0	17	1	4	0	1	0	0	0	0	0	3	1	2	3	0	0	0	0	0	0	45	0	1	11	8	1	4	0	3	0	0	0	0	5	3	0	0	0	4	1	2	92	0	0	0	4	0	0	1	74	8	3	0	0	7	0	0	20	2	4	2	46	0	0	0	0	5	0	5	47	6	10	6	28	0	0	0	1	3	0	0	0	1	0	0	0	0	0	0	30	0	0	0	0	8	0	0	0	0	16	1	0	7	3	1	1	6	1	2	0	0	0	2	1	0	2	7	0	0	0	9	8	2	32	49	0	2	2	0	0	2	0	2	0	3	3	1	78	0	0	48	0	1	0	0	0	0	0	45	0	1	26	1	10	74	23	5	0	10	0	0	0	4	6	2	0	4	2	3	0	0	4	0	0	0	0	0	0	2	0	0	0	0	0	2	0	0	18	9	0	0	5	7	0	0	0	0	0	0	2	106	0	0	2	0	20	3	2	0	5	1	0	0	12	120	101	0	0	3	0	17	5	0	1	0	10	2	0	0	5	0	1	0	1	0	94	0	4	0	25	0	0	0	0	6	0	0	3	6	8	0	0	2	0	0	0	0	2	1	17	0	2	6	0	2	5	17	0	1	2	15	0	0	8	4	2	23	5	0	5	0	0	0	1	5	0	5	14	1	0	1	10	35	0	2	0	1	0	0	0	0	6	0	9	0	0	0	0	0	0	0	0	7	0	0	0	8	3	4	0	0	38	11	0	1	0	27	0	0	10	0	0	2	14	0	1	0	0	1	2	0	2	2	0	0	1	1	0	0	5	8	8	1	1	0	0	0	0	0	0	28	15	8	0	0	0	0	0	0	0	0	0	4	0	0	0	1	2	0	0	0	1	0	20	2	0	12	4	4	0	0	0	0	0	0	0	0	0	0	0	0	2	0	2	2	0	1	0	0	46	37	7	1	0	0	1	2	0	0	0	2	0	0	0	22	14	0	0	0	2	0	10	0	20	21	4	36	5	42	37	7	1	1	2	0	1	66	1	0	60	0	6	3	0	0	0	3	7	0	23	7	4	10	187	14	69	0	0	0	0	94	0	0	0	12	0	0	0	0	0	3	0	0	0	0	0	0	0	1	7	9	0	3	0	1	0	0	110	0	0	0	0	0	6	17	0	1	20	0	3	1	0	13	1	2	0	0	0	0	11	4	11	0	0	0	1	1	2	9	0	4	6	0	0	8	0	37	1	0	0	0	14	0	0	1	0	1	124	0	4	0	0	0	0	0	7	3	4	3	9	0	0	1	8	11	0	0	0	1	0	2	5	0	0	0	0	9	1	0	2	1	0	15	0	4	0	0	0	7	1	0	101	0	21	0	0	8	0	4	0	0	2	1	0	0	8	0	25	2	8	0	0	7	0	2	4	0	17	0	65	0	3	265	0	5	0	0	0	8	0	0	4	1	0	1	27	1	24	1	0	0	1	0	2	4	0	1	0	0	1	0	15	0	0	3	0	1	5	0	81	0	0	0	5	0	4	0	0	3	0	20	0	0	0	0	0	0	5	0	1	0	0	2	0	4	0	0	0	0	15	0	0	0	0	0	0	0	0	0	0	0	0	0	0	0	0	0	0	0	0	0	1	21	0	0	7	1	0	331	8	0	7	0	2	2	0	0	2	2	2	3	0	0	0	9	0	0	0	5	0	0	2	1	0	1	0	4	2	0	0	4	0	0	78	0	0	0	0	0	13	1	5	0	0	3	1	3	0	4	10	6	0	1	0	0	0	0	9	7	0	115	1	0	70	0	1	0	0	0	1	0	0	115	0	25	0	0	0	16	0	0	2	0	0	0	39	0	0	0	0	0	0	0	0	3	0	0	0	8	0	0	8	0	6	39	0	0	1	0	0	0	0	0	1	0	0	6	0	1	0	0	4	0	0	0	0	19	0	0	0	0	13	2	0	0	0	3	0	1	6	0	0	0	0	2	0	0	0	0	0	0	36	0	2	0	0	0	0	0	1	0	0	0	0	1	0	0	0	0	2	5	0	0	0	0	1	21	9	0	0	0	0	0	4	0	6	3	0	0	0	0	2	0	10	0	0	0	9	0	0	0	1	1	0	0	8	6	0	0	0	0	0	0	0	16	14	6	0	6	0	0	0	0	0	14	0	0	0	3	12	12	5	41	0	14	29	0	8	0	0	1	14	16	1	18	1	0	0	3	19	0	0	0	33	20	2	9	4	286	0	0	0	29	15	72	0	40	0	37	1	0	7	101	16	1	0	0	0	132	0	0	5	0	0	5	3	0	3	0	2	20	9	7	6	3	2	12	6	178	12	2	11	0	8	0	3	13	1	1	0	0	6	0	3	8	7	6	4	0	1	4	15	30	13	0	0	0	105	10	8	7	6	2	104	26	0	1	1	2	0	4	0	0	2	0	0	1	0	5	0	1	3	0	10	0	8	2	151	3	0	3	3	0	4	0	0	8	0	0	0	10	0	0	0	0	0	0	0	0	0	1	1	2	3	0	0	1	0	3	0	2	0	0	1	0	1	0	3	24	2	1	1	0	1	0	8	0	6	19	2	0	3	1	7	3	18	21	3	0	5	2	1	4	0	1	1	0	59	172	0	2	6	1	0	27	19	15	8	3	5	5	20	3	65	3	0	0	24	21	0	1	0	0	0	0	4	0	0	0	0	0	1	5	0	6	3	0	0	17	1	0	9	8	2	0	0	0	0	0	19	0	33	2	28	27	0	2	0	1	0	6	0	0	0	6	3	14	14	0	10	0	0	0	2	1	181	4	4	0	142	0	1	0	14	0	9	0	7	0	0	3	1	99	3	0	10	0	1	0	0	6	1	0	6	0	0	12	19	44	15	26	5	0	1	0	16	0	0	0	0	1	1	1	1	0	0	0	0	0	7	0	0	3	0	0	20	26	7	0	0	0	19	1	8	2	0	14	11	0	0	0	29	0	13	4	2	22	13	3	7	40	4	10	8	16	10	13	0	0	2	9	0	0	3	0	0	4	0	0	0	0	0	0	0	5	7	6	5	72	13	23	1	248	0	2	0	2	2	0	0	0	0	0	1	0	0	1	0	0	1	0	0	113	3	3	0	6	1	24	0	6	0	0	1	0	46	1	0	0	4	0	4	5	3	9	0	0	10	5	5	0	0	33	0	29	19	4	2	0	1	2	7	1	0	13	11	0	5	1	1	1	0	1	7	0	1	0	60	25	48	53	0	1	0	1	26	0	0	0	14	0	10	4	5	1	5	17	0	62	21	12	3	2	20	5	12	8	11	19	0	1	0	0	23	25	0	1	1	4	0	55	48	47	3	0	3	43	0	0	1	2	0	1	16	1	0	0	0	0	217	27	3	0	7	0	6	4	3	0	0	0	1	0	2	7	5	1	3	0	1	0	79	0	43	0	8	2	13	9	1	4	159	22	0	115	4	0	0	5	11	10	1	1	1	1	0	14	0	0	2	4	13	1	0	0	0	3	50	20	174	181	5	25	0	5	0	28	44	24	0	1	20	0	0	0	0	0	0	0	0	1	2	8	7	1	0	1	0	2	3	4	2	0	32	4	0	0	3	0	14	0	9	19	16	10	4	17	21	16	8	6	5	0	0	1	0	58	34	13	2	1	1	4	7	9	0	2	5	0	3	83	7	0	3	0	0	2	1	1	9	20	0	0	0	0	0	2	2	0	3	3	0	0	0	0	22	4	25	30	25	38	9	0	0	1	2	354	0	3956	0	3	0	1	80	77	5	0	0	0	0	0	0	0	4	26	3	13	1	0	0	0	0	1	0	1	1	0	2	57	0	0	2	1	4	0	0	13	0	23	36	0	0	0	2	3	0	4	2	0	16	1	0	8	0	0	0	0	4	0	0	0	0	0	0	4	0	9	0	15	7	4	10	0	1	2	0	4	43	1	0	0	1	1	1	0	0	27	9	0	1	1	1	2	5	1	0	1	0	32	27	0	16	43	0	2	9	1	12	0	117	14	15	6	0	0	0	4	8	0	0	24	7	0	0	1	17	0	0	8	21	7	10	0	0	3	0	0	2	0	3136	11	7	2	7	3895	0	27	79	23	21	6	242	182	232	12	112	24	38	0	3	203	106	117	117	30	42	5	0	689	23	4	10	6	1	44	7	1	0	648	3	2	0	0	8	0	2	12	0	3	0	9	4	64	41	5	22	15	7	4	0	8	3	10	9	12	19	0	2	0	0	1	0	2	0	1	0	21	1	0	3	5	12	2	4	66	0	4	0	7	2	6	0	0	0	2	0	0	0	4	0	1	0	0	0	7	0	6	0	6	0	19	10	0	20	6	0	0	18	118	266	1	3	11	40	24	3	19	37	3	39	0	35	54	0	34	0	1	23	10	7	85	5	0	4	12	12	12	0	0	20	5	0	0	9	2	7	1	1	0	44	0	1	5	0	1	0	7	9	4	1	54	0	0	4	0	0	0	0	4	0	1	2	1	14	0	2	2	8	0	226	4	8	0	0	15	5	0	30	2	2	106	0	0	0	31	10	2	32	60	1	4	4	3	0	7	3	23	16	5	4	35	6	20	8	37	12	15	0	0	0	12	0	0	3	1	0	20	0	4	43	0	0	0	1	1	2	35	7	1	13	0	0	0	0	0	0	11	4	3	6	0	2	0	0	0	0	2	0	3	0	0	1	0	0	0	0	5	0	0	1	0	0	0	13	6	1	2	2	17	9	0	1	0	0	0	0	0	4	2	3	0	2	0	0	0	69	2	2	10	5	1	1	3	0	0	0	1	0	1	0	0	3	33	0	0	3	0	1	0	5	5	13	0	0	1	0	1	19	0	6	1	0	6	1	0	0	0	2	23	0	2	0	0	6	34	51	4	28	12	1	23	9	29	0	12	1	0	20	31	39	40	38	59	40	13	8	7	0	11	15	6	35	9	33	10	13	86	25	29	166	5	20	15	72	17	13	8	35	27	14	17	10	0	0	0	0	82	87	4	13	2	74	12	9	4	69	72	88	1024	0	397	13	2	0	0	0	9	4	2	0	0	20	0	1182	1789	88	9	0	19	0	0	1	0	0	98	63	49	56	37	48	153	39	14	40	0	11	5	28	10	2	2	0	10	2	7	5	11	15	27	103	7	11	13	6	3	9	0	0	0	11	5	0	2	14	0	0	4	0	0	1	0	14	5	10	0	0	3	16	21	21	1	0	11	0	0	0	31	24	0	0	7	0	0	0	0	0	8	33	0	4	9	0	0	2	7	0	0	1	5	10	0	7	11	2	26	61	0	0	0	0	0	0	7	0	0	0	0	3	0	1	1	0	0	0	0	19	0	5	0	0	0	16	0	1	0	0	4	1	0	0	0	0	0	4	0	1	1	1	10	0	1	0	0	4	4	75	103	15	54	0	16	2	38	0	0	0	0	0	0	0	0	1	0	1	0	0	6	4	13	6	0	1	0	2	0	0	0	2	13	9	1	0	23	0	14	0	1	14	22	0	0	0	5	0	1	13	38	79	19	7	1	0	7	0	8	12	2	17	0	0	0	5	2	5	3	6	30	6	21	6	2	3	6	15	0	7	50	140	10	3	0	0	0	1	90	161	15	0	3	2	1	0	1	3	0	32	0	1	0	1	0	4	2	5	14	0	0	0	0	2	0	5	15	1	0	120	3	0	1	1	0	0	0	0	0	18	27	11	1	2	17	1	4	5	2	42	4	7	0	0	4	0	3	9	68	6	2	0	0	0	1	0	3	0	12	0	2	2	6	0	0	0	9	0	3	12	18	0	1	11	0	0	0	0	0	6	0	0	7	2	2	27	17	10	0	0	22	5	0	3	2	0	0	4	2	0	0	5	0	4	1	1	0	6	1	0	0	2	0	9	25	0	2	1	0	0	1	0	26	2	1	11372	0	3	1	0	1	0	0	1	72	13	0	1	12	0	0	1	0	18	24	0	1	42	12	5	0	1	22	0	5	2	3	595	0	7	6	0	4	0	0	1	0	0	1	10	13	9	0	12	8	3	0	0	33	0	34	0	0	0	0	0	67	0	0	0	0	0	0	1	2	2	1	0	2	0	0	2	1	0	2	0	6	0	11	16	6	0	0	2	0	9	6	1	0	0	1	22	17	0	1	6	0	17	1	29500	0	0	0	0	0	13	0	0	0	0	0	0	0	0	1	0	6	0	1	0	0	10	9	31	24	1	22	11	17	1	0	0	1	0	0	0	1	12	10	2	71	9	0	0	1	0	0	4	0	12	0	0	19	0	21	7	7	35	21	47	31	21	2	8	3	0	4	0	0	76	21	14	19	0	0	0	8	6	21	0	111	29	33	1	30	0	0	0	0	27	0	9	1	0	36	12	0	21	1	2	0	21	27	0	0	16	10	2	1	0	1	0	0	0	0	0	0	0	35	53	41	68	70	2	21	35	0	80	9	20	66	86	21	2	29	11	78	40	6	16	16	0	0	0	0	0	0	11	27	37	81	16	2	5	0	5	30	8	10	0	4	2	2	0	0	0	0	0	0	0	3	0	1	7	1	4	3	4	1	1	1	11	0	0	1	0	2	16	5	3	1	0	3	2	0	0	2	63	0	9	0	6	1	25	0	5	20	0	6	0	0	0	5	15	1	3	0	5	0	0	24	0	0	1	0	0	0	2	0	0	3	0	7	6	7	0	0	0	0	0	0	1	0	2	16	3	15	1	0	2	28	39	0	4	5	4	21	0	0	11	19	0	2	4	0	0	1	0	1	0	0	0	6	0	0	1	11	0	8	0	0	2	2	0	3	0	0	2	21	0	0	5	0	0	0	0	4	0	0	0	0	10	1	1	0	1	0	2	1	29	0	2	7	1	6	12	0	6	1	1	78	5	0	3	6	5	10	69	2	35	3	1	1	324	6	10	23	12	0	0	4	7	10	0	1	27	1	8	6	4	3	0	1	0	0	0	0	0	0	29	0	2	0	3	20	6	0	0	0	1	1434	8870	1	0	0	0	0	3	0	11	10	142	7	4	41	0	22	8	4	4	2	12	0	10	8	14	13	4	72	0	0	56	1	207	2	2	1	0	1	2	0	0	12	0	8	32	3	7	3	54	0	11	15	36	4	0	0	0	128	1	0	0	1	0	0	36	4	0	0	20	0	94	11	2	7	5	3	1	7	17	1	3	0	0	0	0	1	16	133	25	1	8	7	30	17	0	1	12	7	7	5	2	4	23	2	8	0	9	0	4	0	0	0	2	1	13	28	0	13	1	5	0	8	9	6	3	12	0	9	13	2	0	1	18	0	0	0	0	1	0	0	20	107	1	9	0	0	0	3	6	0	0	13	1	0	0	0	0	0	0	0	0	0	25	18	23	0	0	2	0	2	1	3	0	0	3	6	6	38	1	0	0	0	0	0	0	0	0	0	0	0	1	0	0	0	3	0	0	0	98	0	11	18	26	55	20	21	0	0	0	0	0	0	0	0	2	0	1	0	0	0	0	0	0	17	1	0	1	1	5	17	6	0	0	0	0	4	1	4	0	0	53	0	0	21	1	1	6	3	0	13	3	4	1	8	3	1	15	5	1	62	96	4	16	9	124	27	36	129	0	1	15	0	0	6	1	7	3	1	0	0	0	0	0	145	0	0	2	1	168	0	8	0	0	2	108	0	3	0	0	0	4	3	0	0	0	0	0	0	0	11	67	0	0	4	5	88	46	0	0	0	2	1	0	0	2	9	0	0	0	0	0	8	9	18	3	2	0	0	15	0	3	0	12	1	2	30	10	2	0	1	0	1	0	3	5	13	6	5	2	3	0	0	52	0	8	10	3	16	29	0	0	12	95	7	14	1610	0	5	6	0	1	10	0	154	25	43	0	0	0	0	2	0	0	0	9	1	17	0	1	16	1	0	1	8	4	10	72	3	0	61	156	1	1	2	0	2	10	7	1	0	3	0	7	0	0	3	0	3	0	1	2	0	0	0	0	14	1	3	0	0	5	1	1	0	0	39	21	9	10	0	0	50	9	0	0	0	6	0	8	18	3	11	12	32	37	8	10	17	4	18	52	103	0	0	0	0	2	0	1	0	0	220	0	2	3	10	30	24	2	9	47	0	8	8	59	1	3	75	3	1	0	0	0	6	0	1	58	111	98	0	0	0	0	0	8	0	0	11	0	14	0	14	7	1	0	0	0	1	0	0	2	4	2	0	2	5	0	1	0	0	0	2	0	0	2	0	5	0	1	2	6	0	0	0	0	0	0	0	1	0	0	0	3	4	0	0	0	5	3	12	0	1	1	2	4	2	2	1	1	2	0	53	0	0	11	1	9	26	14	2	9	3	6	8	0	11	3	1	0	0	0	4	3	0	17	0	19	0	7	5	0	10	3	0	31	9	1	1	18	13	0	6	4	0	1	0	0	0	15	5	14	2	25	3	22	46	1	36	13	5	12	0	0	10	0	9	23	25	28	0	7	2	10	5	6	0	2	1	8	7	0	0	3	2	2	0	0	0	0	31	0	1	1	0	0	0	2	1	5	8	6	8	37	0	13	3	21	26	5	15	8	4	26	27	33	0	0	0	0	0	1	0	8	1	46	5	14	11	0	0	2	1	0	0	0	1	0	1	0	0	0	1	2	0	19	75	194	6	76	122	36	6730	19	0	0	0	0	0	0	0	9	23	8	8	0	1	21	0	0	2	3	1	1	1	0	4	3	0	0	400	91	0	7	35	10	2	1	0	0	1	11	0	91	0	1	340	0	1	0	8	0	25	0	6	0	0	8	0	0	0	0	0	7	4	0	0	1	0	0	1	0	0	0	1	0	0	0	0	0	1	1	5	3	1	0	0	0	0	2	8	4	3	220	123	0	25	9	6	5	8	18	6	0	3	1	6	12	0	0	0	0	0	0	0	0	0	0	13	0	0	0	0	0	0	0	0	1	1	0	13	0	0	0	1	7	1	0	0	0	1	0	15	0	0	12	8	0	0	0	0	0	0	0	0	3	0	0	11	15	4	0	24	22	10	11	60	1	0	1	0	0	0	0	0	6	0	42	2	0	2	4	0	68	18	1	0	0	0	3	0	10	0	0	0	3	0	0	0	0	0	0	0	0	1	0	0	0	0	0	0	0	8	3	0	0	0	0	0	1	0	221	0	0	0	23	0	0	0	0	0	4	0	0	0	7	0	0	7	0	4	0	0	1	0	0	0	1	0	0	0	0	0	0	2	0	30	0	0	0	0	0	0	8	0	1	4	0	0	0	14	1	25	0	6	0	544596	0	0	1	0	0	0	0	0	0	0	2	2	2	1	4	0	0	0	1	0	0	0	0	0	0	1	0	2	0	4	0	0	2	0	0	0	0	6	13	0	0	0	0	5	0	2	0	0	0	0	0	0	0	1	0	2	0	0	0	7	0	0	1	0	0	0	0	0	9	0	0	0	6	2	0	0	0	0	1	0	0	9	0	0	1	1	0	0	0	0	1	0	0	0	0	0	0	0	0	0	0	0	0	4	0	0	4	0	119	0	0	3	0	3	0	3	4	11	1	0	1	5	73	0	165	16	0	0	0	0	0	95	3	0	3	166	4	4	1	0	164	2	101	0	0	2	0	0	3	7	4	5	3	0	0	3	3	0	2	14	0	3	0	1	7	2	9	4	17	0	15	0	97	3	6	0	169	0	4	10	0	0	8	0	4	2	6	3	12	1	13	0	0	1	5	14	0	60	6	4	2	7	17	13	5	0	2	0	38	20	18	1	10	4	0	3	17	17	1	2	3	4	40	0	0	407	0	1	21	0	4	0	78	1	18	24	4	0	9	4	2	7	20	0	2	0	0	0	6	15	6	13	0	16	18	12	3	143	420	11	3	0	0	4	36	0	7	0	2	0	5	0	0	0	0	13	1	11	2	0	0	0	0	2	1	146	7	50	0	0	2	0	0	55	3	22	4	24	25	0	1	1	16	3	1	1	1	0	0	0	0	0	0	5	6	0	4	0	5	5	4	0	21	2	0	0	0	0	0	0	11	0	0	0	0	0	0	1	1	0	0	1	2	5	0	0	0	7	1	0	1	0	10	0	3	37	0	1	0	0	3	20	1	1	3	1	0	1	1	3	5	0	0	4	0	4	0	0	4	0	0	0	0	1	5	4	0	0	0	3	3	3	99	3	3	0	0	0	2	8	0	0	0	69	0	6	3	0	2	3	1	5	2	3	0	1	0	2	0	0	8	3	0	0	0	6	25	19	1	10	24	1	0	0	0	1	2	21	0	942	1	17	9	211	0	0	1	0	14	18	10	0	0	4	5	6	3	0	1	2	8	89	15	776	0	12	9	21	3	0	0	0	0	0	2	1	23	0	0	0	2	0	0	0	5	5	0	0	17	35	2	1	6	0	0	0	3	0	0	3	15	8	40	32	90	2	15	23	5	0	32	0	62	31	0	10	12	10	0	9	0	1	0	3	66	6	0	0	1	0	36	32	0	0	0	15	0	0	0	1	2	4	0	0	16	6	17	0	0	32	0	0	0	0	0	0	9	2	20	0	3	1	9	9	4	3	0	24	0	1	0	0	1	104	7	0	5	0	5	0	3	17	19	9	2	8	1	0	11	14	4	268	32	1	18	0	0	13	0	0	0	1	3	2	0	0	1	0	0	7	8	24	3	13	0	6	22	15	9	0	5	0	1	2	12	6	7	5	0	30	0	5	10	7	18	10	4	1	1	0	0	15	0	0	2	1	1	0	147	54	20	0	7	0	1	4	10	4	7	0	0	0	0	8	34	8	6	27	5	9	2	28	2	2	2	32	326	2	3	27	7	14	6	2	25	33	13	2	0	0	1	4	0	0	20	2	0	32	0	2	0	0	1	0	0	27	41	10	0	0	1	2	11	0	0	2	1	0	3	15	3	3	0	3	4	2	67	3	4	0	0	0	2	1	17	0	2	0	2	1	0	0	12	1	2	21	6	7	30	1	0	0	10	28	1	0	2	0	0	14	0	0	2	2	0	0	1	7	6	6	1	7	0	8	3	2	0	0	0	0	0	0	40	1	0	0	24	1	0	21	1	6	14	0	23	32	0	0	5	2	0	27	8	0	1	4	2	7	3	8	0	13	5	13	0	0	13	22	5	5	2	1	0	1	0	0	0	0	0	3	4	26	2	0	38	2	0	55	9	3	56	22	9	9	169	28	0	45	17	13	21	18	10	9	0	2	1	9	1	4	0	2	2	1	1	2	13	0	0	0	0	0	0	1	0	1	0	0	0	8	20	1	37	12	0	1	1	0	0	0	0	0	1	0	0	0	0	0	0	0	0	0	0	0	0	0	0	0	0	0	3	9	5	0	0	0	0	0	1	0	0	0	0	0	0	0	0	0	0	0	0	1	0	0	0	2	0	11	11	0	47	3	0	0	11	1	0	0	57	9	19	33	21	37	8	10	0	7	0	6	7	0	0	0	1	0	0	14	61	175	26	21	3	19	0	1	0	7	3	7	2	5	0	1	17	1	0	0	0	0	4	8	4	3	2	5	0	10	5	12	2	7	0	26	11	15	0	7	21	27	0	0	0	0	0	0	2	27	2	0	0	0	2	0	0	0	4	10	0	0	134	5	2	8	0	23	0	2	10	0	45	2	0	0	76	3	0	4	0	2	151	0	0	0	7	11	1	11	0	0	9	0	0	0	24	0	7	19	6	0	9	20	0	0	0	7	0	1	0	2	2	2	1	8	7	5	0	1	0	2	0	16	1	0	6	4	8	0	11	9	16	1	11	4	1	8	0	1	34	3	2	0	0	11	0	1	4	58	2	0	16	3	0	15	1	0	0	1	1	3	1	1	0	0	0	0	0	4	0	0	0	0	2	17	1	0	0	0	0	4	1	6	3	0	4	1	0	0	0	1	6	8	4	77	4	0	16	0	0	82	14	24	44	8	0	1	82	64	0	19	29	3	2	0	7	10	6	3	0	12	0	18	14	12	3	3	2	0	0	8	7	5	0	0	30	28	77	0	0	0	0	0	0	0	45	0	1	0	0	0	0	0	2	12	1	44	3	101	2	41	14	5	0	12	17	7	0	0	0	1	0	46	0	0	0	3	0	12	1	0	8	17	2	26	2	138	16	5	0	0	13	22	10	172	12	10	31	18	113	0	54	52	4	0	0	0	0	1	11	9	382	20	5	0	177	0	6	0	0	18	3	2	0	7	2	0	0	72	56	0	2	0	109	30	7	10	3	15	27	20	11	0	1	47	0	0	7	8	10	2	1	0	6	0	0	0	6	15	0	0	1	0	2	0	11	0	0	1	0	0	1	0	53	3	0	3	1	38	11	6	1	2	3	3	3	1	0	0	0	11	12	6	4	40	0	14	6	0	0	3	16	2	17	4	0	0	24	0	3	9	23	10	13	4	6	3	156	8	46	55	0	0	0	0	1	0	0	1	6	1	1	2	7	0	0	0	0	0	0	0	19	0	1	3	77	47	32	1	0	3	0	8	0	2	4	0	1	0	0	2	0	3	9	11	19	7	54	0	17	0	0	0	0	0	0	0	0	0	0	1	12	0	0	0	0	0	2	3	0	0	0	11	0	1	0	1	2	0	7	0	0	30	0	49	0	0	22	5	0	8	1	0	0	0	0	5	13	0	0	0	0	4	2	4	9	4	0	12	5	9	0	5	0	406	0	145	168	8	2	0	0	3	1	7	0	33	111	174	25	36	96	0	39	9	9	32	28	63	38	0	58	8	0	2	3	18	0	4	1	2	5	0	0	0	0	1	0	0	1	1	5	0	0	0	0	0	129	0	1	0	0	0	0	1	0	0	0	0	0	5	1	0	0	0	0	3	0	2	2	0	18	2	0	38	0	48	41	10	18	0	0	0	3	5	0	0	0	2	2	0	0	22	23	3	0	0	3	0	9	1	21	4	74	0	0	0	0	0	0	1	1	0	0	0	2	1	1	11	3	6	0	38	1	18	7	0	3	3	0	4	0	0	12	4	1	0	4	8	12	0	10	5	1	1	6	0	3	0	20	6	0	2	0	0	20	0	0	0	9	5	0	0	26	4	16	1	11	2	9	1	0	0	0	2	0	0	0	0	8	30	8	6	10	22	0	0	0	2	0	2	0	0	16	0	3	3	4	0
LakWasMet20_HOW5_2_rpkm	0	1	0	0	0	20	5	2	0	0	0	2	6	2	1	0	1	2	6	1	0	0	0	21	0	2	1	1	0	12	0	1	1	8	2	6	2	1	10	0	0	0	0	4	24	25	39	96	0	0	2	6	0	0	0	10	0	18	48	11	297	0	0	15	9	1	0	0	6	32	0	0	1	0	1	0	0	0	0	0	0	7	0	0	0	0	0	1	0	0	0	1	7	6	9	1	4	0	0	1	1	0	0	0	0	1	0	0	0	1	3	0	83	0	26	4	0	2	0	0	0	2	3	20	0	0	2	1	0	0	0	43	6	1	0	0	0	1	9	0	1	0	0	7	1	1	0	0	6	2	4	18	1	6	43	0	6	9	7	2	7	11	1	11	10	10	0	5	1	14	0	0	0	0	1	0	0	0	1	1	0	0	0	0	2	34	0	0	0	11	6	6	18	3	0	0	0	5	7	657	18	0	28	0	0	4	23	0	20	5	6	3	56	5	10	0	10	2	0	1	1	0	44	2	11	11	0	0	17	0	1	0	143	0	0	1	18	9	259	8	0	0	12	6	41	9	0	0	7	13	10	7	20	0	1932	267	0	0	0	1	2	1	2	14	4	0	4	1	5	27	22	2	10	0	0	0	0	0	66	48	0	21	52	14	23	0	0	0	5	1	4	0	0	0	192	0	2	9	6	0	0	25	32	0	66	0	29	50	21	1	40	0	25	5	0	0	0	1	61	1	0	0	25	4	64	3564	1	1	8	0	0	3	0	1	0	0	3	0	0	0	1	0	18	19	18	6	21	0	0	0	3	0	0	0	2	1	0	0	0	46	3	1	1	0	0	10	7	29	15	10	1	22	1	0	45	2	0	4	0	2	1	2	6	5	4	0	147	0	0	0	0	0	55	2	1	4	38	0	0	22	0	8	0	1	32	0	2	0	0	2	0	14	15	15	0	17	20	7	1	0	0	0	1	0	0	0	1	0	3	0	26	0	3	0	0	4	1	0	6	0	48	22	0	0	6	29	0	0	0	0	1	70	17	291	1	30	13	3	0	14	0	0	0	7	0	25	1	0	2	14	16	19	29	1	0	1	4	1	368	4	0	0	3	1	0	0	0	57	32	4	0	0	62	27	9	0	5	0	0	0	2	0	3	0	0	0	0	2	1	0	0	0	0	0	0	0	0	0	1	8	0	1	1	0	0	0	0	0	1	0	0	0	2	6	8	0	21	10	0	22	1	15	1	10	10	0	0	0	0	0	0	0	1	0	0	14	0	0	0	0	0	1	0	1	3	3	30	0	22	0	0	0	0	9	10	19	26	148	4	44	65	104	46	39	30	0	7	3	23	0	0	0	933	1	2	6	0	0	1	0	11	0	0	1	7	8	0	42	0	12	0	165	144	114	1	0	82	0	188	7	175	53	13	11	0	11	3	7	0	4	3	10	0	1	0	1	0	0	0	1	0	23	0	0	0	7	0	7	1	1	75	0	5	12	2	0	2	1	1	2	4	161	0	18	0	0	0	0	11	25	5	18	1	0	1	0	6	0	0	1	2	1	5	2	0	0	0	0	0	23	6	0	5	0	2	0	0	1	0	3	0	1	0	2	3	1	5	0	19	0	1	0	0	0	22	7	1	0	3	0	2	0	5	8	0	0	0	0	11	0	0	0	0	1	1	0	0	0	0	8	1	32	11	0	26	25	9	0	0	40	1	0	0	2	2	8	0	0	56	2	0	10	2	58	0	0	0	0	0	0	0	0	1	0	1	46	0	0	0	0	0	0	8	1	0	3	1	0	0	1	8	3	2	0	0	0	5	0	0	30	1	0	0	0	188	7	77	0	0	0	2	1	2	0	0	0	16	0	1	0	1	0	0	18	13	0	0	3	0	0	0	0	0	1	0	0	2	33	20	0	0	0	0	0	0	0	0	8	33	46	0	0	3	0	0	0	3	1	1	15	26	11	12	1	0	1	0	0	1	4	0	1	0	1	0	0	0	5	9	47	1	0	2	8	5	1	0	0	0	0	0	0	0	0	0	0	5	0	0	0	0	0	0	1	0	0	0	0	0	1	0	0	0	9	30	15	46	18	22	1	0	0	0	1	0	0	1	0	0	0	15	0	0	0	0	2	0	0	0	22	0	0	0	6	9	0	10	0	0	0	0	3	0	0	1	1	0	0	0	0	0	0	0	0	0	2	0	0	1	0	0	8	2	322	0	31	0	0	1	0	9	2	33	0	40	0	0	3	1	0	1	1	0	0	0	1	0	6	3	0	2	0	1	0	1	0	0	0	0	0	1	2	0	0	0	0	0	83	0	2	0	48	8	0	1	12	0	0	187	3	0	0	0	0	1	0	1	0	171	0	0	0	0	0	0	0	1	4	0	0	1	0	1	9	3	0	0	0	0	1	4	16	0	1397	0	0	0	0	39	22	5	0	2	0	5	0	14	0	8	28	0	0	2	0	0	0	0	0	0	18	10	0	0	0	0	0	1	0	0	1	0	0	0	1	2	39	20	0	6	23	0	5	0	0	3	0	0	2	1	0	0	2	0	0	0	2	21	33	8	0	3	0	5	0	0	2	5	0	15	0	0	1	0	0	0	0	0	0	0	0	0	0	0	0	11	0	3	0	1	6	0	1	0	0	0	0	1	1	0	0	10	8	0	0	1	0	3	0	2	0	0	0	5	2	1	1	2	6	0	0	4	12	1	17	0	422	0	0	0	8	7	1	0	2	0	155	2	0	0	1	1	0	11	0	0	0	15	3	0	1	0	0	2	0	0	0	0	0	25	1	0	0	0	1	3	0	0	18	9	0	2	0	46	12	1	3	2	4	3	2	1	0	3	90	48	0	1	1	3	10	16	1	0	16	0	1	0	0	0	0	0	4	16	9	3	8	4	9	1	29	0	7	2	3	0	11	2	0	4	1	0	4	0	0	0	7	0	0	31	5	0	0	0	0	0	2	4	2	0	13	0	0	0	0	0	0	3	2	0	0	0	0	53	0	1	3	4	0	5	0	0	0	1	13	3	0	26	30	18	11	0	2	5	0	0	0	1	3	2	26	1	0	3	0	0	0	15	11	0	0	0	0	18	1	7	0	9	4	1	17	0	1	21	5	3	12	12	5	6	0	0	0	3	1	28	0	30	6	8	44	7	5	25	0	0	3	19	13	0	8	1	1	2	8	6	0	4	1	0	6	1	16	24	13	1	0	5	0	3	0	0	0	1	5	6	0	0	0	25	2	3	21	1	1	21	0	5	5	2	3	0	3	2	21	8	8	0	1	0	3	0	0	4	606	32	22	60	0	0	3	0	0	0	0	1	50	6	3	4	12	0	0	1	15	152	55	59	11	0	0	0	114	0	0	1	0	2	0	1	0	82	46	34	49	104	51	22	4	63	11	0	0	13	0	0	0	99	9	1	0	0	5	0	18	0	1	0	1	0	2	1	2	0	0	2	3	15	0	0	1	1	0	0	5	6	20	0	0	0	0	1	24	0	2	0	0	2	0	1	0	2	0	11	1	1	0	0	0	4	2	0	1	0	185	0	0	0	0	0	0	0	0	2	0	0	6	0	0	0	0	0	0	0	0	0	0	0	371	2	0	61	0	0	0	0	217	2	15	13	0	2	289	0	83	5	5	0	0	0	4	43	9	23	0	1	3	0	0	3	0	0	6	6	1	0	0	13	1	0	4	6	0	0	0	0	0	1	7	1	58	7	25	0	0	4	16	0	0	0	9	0	0	0	2	4	0	1	10	52	0	8	4	6	13	14	0	3	10	0	1	1	1123	0	6	4	10	4	0	15	0	0	0	1	0	0	3	5	0	18	7	46	101	60	22	40	7	0	0	0	5	0	21	0	1	2	6	74	0	0	0	6	0	6	0	2	5	32	0	27	9	0	3	0	7	1	42	0	0	25	3	0	0	0	0	0	5	0	173	0	9	26	6	0	0	39	14	4	74	2	1	5	1	5	2	0	16	38	304	23	83	0	2	3	9	4	116	0	5	8	1	1	1	175	0	0	4	0	0	0	9	7	1	39	6	0	0	4	1	0	0	0	9	0	0	0	1	1	1	13	0	1	0	17	0	507	1	0	41	252	1673	1	19307	2	0	5	0	0	0	0	1	0	0	0	0	2	4	1	2	1	37	2	2	0	1	0	0	2	17	0	44	1	32	2	3	5	12	19	0	1	4	8	0	5	6	3	0	3	0	1	0	1	0	0	0	16	0	0	12	17	0	0	0	12	229	0	20	1	25	67	1	40	4	61	0	11	12	6	2	40	5	0	24	2	0	0	0	3	0	0	0	0	1	0	0	0	0	6	0	11	8	0	17	69	0	0	0	0	1	1	0	1	0	0	2	1	0	0	0	0	3	4	13	29	0	0	1	1	0	2	0	2	0	0	2	9	0	3	0	0	0	0	0	0	0	0	0	0	0	0	13	1	0	0	3	0	0	0	1	1	2	0	0	477	3	28	9	8	0	1	0	31	0	16	29	73	19	1	0	0	0	1	0	0	0	0	4	0	2	26	8	1	0	0	6	0	0	0	0	1	1	0	0	2	1	13	6	13	40	0	41	2	0	1	0	25	50	38	9	3	0	0	0	0	0	1	0	0	0	5	0	2	0	0	3	1	0	0	0	0	0	22	272	0	0	1	0	1	1	0	2	0	0	17	139	21	4	0	0	1	0	0	0	6	0	1	11	2	0	0	0	0	5	0	0	2	0	3	0	6	0	0	3	9	0	0	21	0	0	0	4	2	0	0	1	0	0	0	2152	0	0	0	0	16	15	0	0	4	13	1	27	28	31	7	0	2	0	0	0	29	0	19	6	0	0	2	1	3	5	0	14	0	2	0	1	0	0	0	1	2	4	0	7	0	0	1	3	0	3	0	0	3	0	8	25	0	0	0	0	0	0	0	0	0	0	0	0	0	0	2	0	13	0	0	0	0	8	7	1	0	27	3	0	0	591	0	5	110	228	47	6	0	0	14	5	3	0	0	0	2	3	41	0	7	11	4	1	0	2	2	1	8	0	9	0	1	1	2	34	0	0	15	0	10	0	0	4	0	1	0	9	0	0	0	0	1	13	5	0	1	1	2	7	1	0	38	5	0	7	3	0	0	1	6	24	0	0	0	0	0	0	0	0	5	1	3	1	0	17	85	1	1	0	0	0	20	5	0	2	1	6	2	0	0	0	0	0	0	0	1	1	0	0	0	0	0	0	0	0	0	0	1	1	0	0	1	0	0	14	0	0	9	2	7	0	16	0	8	0	1	1	1	0	0	0	0	9	3	1	0	0	0	0	99	114	65	59	111	81	116	215	13	109	190	124	111	89	39	53	54	102	149	6	19	11	214	243	184	131	688	57	76	40	80	11	66	4	0	7	0	0	0	0	3	0	2	1	56	68	5	0	4	0	0	0	0	0	0	0	0	0	0	5	0	11	0	1	7	5	7	1	13	0	2534	4	3	0	3	0	8	0	3	0	0	1	0	0	0	1	0	1	0	0	0	12	0	0	0	0	6	9	3	15	2	0	2	5	0	0	0	5	0	0	8	1	0	1	0	1	98	0	1	15	0	0	0	0	0	4	0	0	0	0	8	9	0	11	0	0	0	0	3	0	0	1	0	0	0	4	0	5	0	3	1	63	0	1	3	1	0	0	2	0	0	0	0	0	1	0	0	0	0	18	7	2	0	0	0	0	0	0	3	1	3	0	11	2	1	1	1	0	2	23	4	0	0	0	1	0	2	0	0	1	14	0	16	16	3	0	0	0	0	7	0	0	5	0	1	0	4	0	0	1	1	0	0	4	1	0	1	0	0	0	0	0	1	3	3	5	0	24	0	5	0	694	14	2	0	0	0	0	0	0	0	1	1	0	0	0	0	1	8	0	39	138	0	2	0	0	17	0	0	14	36	0	45	4	0	35	0	17	11	2	1	0	0	1	0	3	0	6	0	3	1	0	0	0	0	0	2	1	1	3	7	1	0	0	0	1	0	0	3	0	2	0	0	0	1	0	0	2	9	0	0	0	0	14	3	2	83	107	4	0	0	0	1	0	0	0	0	2	1	0	0	2	0	0	1	0	18	2	5	1	1	1	4	0	0	0	0	0	27	22	1	0	0	1	403	1	0	1	0	9	0	0	0	0	0	0	0	1	59	10	0	0	0	0	0	0	0	0	1	6	23	12	3	0	0	7	0	4	26	3	0	4	4	0	0	0	0	0	2	0	0	2	0	2	29	1	2	1	0	70	3	4	0	0	3	2	1	3	5	2	4	1	15	2	6	0	0	2	0	0	0	0	0	6	0	0	0	0	0	0	0	8	2	0	92	0	0	17	0	924	0	3	2	1	0	1	1	15	2	15	11	1	0	0	0	0	0	0	0	24	0	0	0	0	0	0	48	0	8	10	21	0	0	20	31	9	0	9	1	22	0	27	0	14	0	7	2	8	9	0	0	15	0	14	0	13	0	0	1	15	0	4	0	11	9	6	6	8	4	8	0	0	7	3	1	1	26	1	10	0	28	10	1	12	0	5	4	8	14	16	0	0	0	2	0	2	11	0	0	0	0	5	8	0	0	0	0	109	1	0	0	0	0	0	0	0	6	0	0	5	0	0	8	2	0	0	0	0	1	0	0	0	1	0	0	114	2	1	46	19	28	0	15	0	9	0	0	10	111	0	0	0	2	2	10	3	42	0	14	9	0	0	0	0	2	16	0	0	28	7	0	139	0	19	3	1	1	28	55	0	0	1	1	10	1	1	1	1	2	1	1	4	0	1	32	3	0	0	33	13	0	16	0	0	0	1	598	396	597	2	0	0	1	2	0	9	2	72	0	0	6	2	0	0	171	342	14	5	0	0	0	2	0	0	49	1	2	0	0	0	2	0	0	3	0	0	11	0	0	1	0	2	0	0	5	0	64	4395	0	0	1	0	1	0	0	19	2	0	0	0	0	0	34	31	0	0	1	0	0	0	0	182	3	1	3	1	1	4	1	0	0	5	0	18	3	2	0	0	0	0	0	2	2	2107	1	0	4	0	0	0	0	0	0	0	0	1	0	0	0	7	0	12	0	0	0	0	0	1	0	0	0	0	0	0	0	0	0	0	0	0	0	0	0	0	0	0	1	0	0	0	0	0	0	0	0	0	0	0	6	1	0	0	0	14	0	0	0	6	0	0	72	0	0	0	0	0	0	376	2	0	0	0	1	14	5	40	4	0	6	0	0	14	6	1	53	0	0	32	0	0	0	0	2	0	0	1	8	0	0	0	0	0	0	0	1	0	0	1	0	0	2	0	0	0	0	1	0	5	0	0	1	1	1	1	3	0	0	0	0	6	0	0	1	0	0	7	2	10	0	8	16	6	7	13	1	1	0	0	1	6	0	0	4	170	0	3	0	5	0	6	0	0	0	0	0	0	1	0	5	0	0	12	12	4	0	13	0	10	0	0	0	0	0	0	0	0	0	0	0	10	1	7	21	0	18	2	42	43	0	0	0	0	0	0	0	5	1	10	0	1	0	0	0	0	48	284	0	130	0	0	2	7	0	0	0	0	1	0	0	5	1	0	1	4	26	8	0	0	0	0	0	0	1	0	16	0	16	3	0	1	0	0	0	1	4	2	0	0	0	0	27	0	0	0	4	0	6	6	5	0	0	10	0	1	0	0	38	0	0	0	11	0	0	1	0	0	5	6	337	0	0	1	1	0	0	0	1	0	0	0	4	0	1	0	3	0	0	59	0	0	0	0	0	0	0	39	0	2	0	0	0	1	3	0	1	1	0	1	0	0	0	1	1	0	2	1	9	5	0	0	52	0	1	0	1	0	0	0	0	0	0	0	3	12	6	0	0	0	5	12	1	8	0	0	0	1	0	3	0	0	1	0	0	0	2	0	2	0	0	1	5	0	1	1	0	0	3	0	4	1	1	0	0	0	2	1	0	0	0	1	23	0	1	4	24	0	1	12	0	0	1	0	0	0	0	0	0	0	0	0	0	0	5	941	1	0	0	1	0	0	0	0	0	5	0	58	0	0	88	0	0	3	11	0	0	1	0	0	1	1	0	4	0	0	0	0	1	10	0	0	1	38	18	1	0	3	3	6	0	0	0	0	0	0	0	1	0	0	14	1	1	254	0	0	0	0	0	0	0	0	44	0	0	0	0	0	0	0	0	0	0	1	0	1	99	0	2	0	0	0	1	0	0	2	1	27	0	0	1	4	2	3	0	0	0	0	1	0	1	0	1	5	1	1	0	0	0	0	0	0	2	0	0	0	1	0	0	0	0	0	0	9	0	6	0	3	0	0	0	3	0	0	0	0	1	0	0	0	2	0	0	0	1	0	0	2	0	0	2	0	0	0	5	0	0	0	0	0	0	0	0	0	0	0	0	0	0	0	0	1	0	0	0	0	0	0	0	1	0	0	0	0	0	1	0	0	0	0	0	0	0	0	0	0	47	0	0	38	11	0	2	0	0	8	0	0	7	1	3	0	11	1	0	0	19	0	10	0	0	2	1	145	115	2	0	1	2	605	0	73	2	0	0	0	4	1	0	0	0	1	1	0	0	4	0	18	0	1	0	0	0	0	0	7	0	0	3	2	0	0	0	0	0	0	0	0	0	0	0	2	0	1	0	2	0	0	0	88	0	36	6	0	2	0	0	0	0	0	0	0	192	0	0	0	0	0	4	0	0	1	0	0	0	3	0	0	4	0	20	0	1	2	1	0	0	9	0	0	0	2	3	3	0	0	0	2	2	0	1	1	8885	0	4	0	0	0	0	0	0	0	1	0	0	0	32	2	0	0	2	4	38	0	3	64	0	0	5	0	0	0	0	0	0	0	0	1	0	0	0	1	0	0	0	0	1	0	3	0	0	0	0	0	0	30	0	2	0	0	0	4	0	0	3	514	0	0	0	0	0	1	1	11	0	0	0	3	0	0	0	0	15	0	0	0	1	0	0	0	0	1	0	1	0	0	2	2	0	0	0	0	1	0	3	0	19	0	7	0	1	0	12	0	0	0	2	0	0	1	0	0	0	0	1	16	8	0	6	0	0	0	0	0	3	2	4	0	1	4	0	0	0	0	0	0	175	0	0	0	24	0	2	0	0	0	2	18	0	37	0	0	0	0	0	0	0	0	0	1	3	25	4	0	6	0	0	0	0	14	0	0	11	3	0	1	0	1	1	0	0	0	0	1	1	0	0	0	0	0	0	0	0	0	0	1	42	0	2	0	3	0	11	0	0	1	0	0	13	1	0	0	0	1	0	2	0	0	2	17	13	0	0	3	0	5	2	0	4	0	0	8	4	2	0	29	2	4	60	176	25	0	6	0	465	1	10	79	4	0	0	0	91	260	0	68	3	15	26	0	679	0	0	0	0	5	0	0	12	15	0	18	0	2	10	0	23	14	18	0	0	14	1	14	0	19	2	2	19	4	1	0	0	0	0	0	0	13	18	1	0	1	13	8	0	0	28	5	1	2	0	0	2	0	0	0	0	20	0	0	0	5	1	1	14	17	7	0	0	13	1	5	3	0	7	2	1	0	1	0	0	1	56	63	3	2	83	1	2	1	0	7	6	1	0	0	0	0	0	9	4	0	3	0	0	0	0	39	12	2	0	13	0	0	0	0	0	0	0	19	1	0	0	0	0	7	0	1	0	0	1	18	2	5	13	0	0	0	8	0	0	5	0	19	7	2	1	0	6	0	7	28	1	0	61	1	0	1	0	12	0	0	1	74	51	128	1	11	20	37	192	7	97	44	35	2	330	219	100	0	561	48	100	54	63	7	92	3	96	3	14	0	16	0	1	0	2	0	0	1	0	0	0	2	1	8	1	0	3	0	0	0	111	0	3	18	7	1	0	1	1	0	2	0	0	3	12	0	0	0	0	0	0	44	0	1	0	3	0	0	1	85	5	0	0	0	12	1	0	10	2	18	1	39	1	0	0	0	9	0	1	67	7	20	2	28	0	0	0	1	3	0	6	0	0	0	0	0	0	0	0	18	0	0	0	0	12	0	0	0	1	22	0	0	11	0	5	0	1	1	0	0	0	2	4	0	0	3	7	0	0	2	0	6	1	15	8	0	1	0	0	0	0	0	0	0	1	2	0	81	0	0	72	0	0	1	2	0	0	0	45	0	5	5	1	1	1	0	1	0	13	1	1	78	4	13	6	1	1	0	5	0	2	11	0	0	4	0	2	0	0	0	0	0	0	0	0	0	1	23	5	0	0	7	1	0	1	0	0	0	0	5	171	0	2	0	1	9	4	6	3	6	1	0	0	57	113	144	0	0	0	0	27	2	0	0	4	11	0	1	0	6	0	0	0	0	1	125	1	2	0	51	0	0	0	5	2	0	0	16	12	3	2	2	1	0	0	0	0	1	3	17	0	8	4	0	2	2	24	0	2	0	27	0	0	1	5	4	12	9	0	8	2	1	0	2	18	0	0	15	0	0	3	155	84	0	7	1	1	1	0	0	0	11	0	4	0	1	0	21	0	2	0	0	5	0	0	2	25	4	3	0	0	18	6	0	0	0	68	1	0	0	0	1	5	13	1	1	1	0	0	0	1	5	0	0	0	0	0	0	0	0	16	1	4	0	2	0	0	0	0	1	72	8	6	0	2	0	0	1	16	1	1	0	4	0	0	0	2	0	0	0	1	0	0	7	7	0	31	3	2	0	0	0	0	0	0	0	0	0	1	0	0	1	0	162	2	1	0	0	0	98	46	16	6	0	0	0	1	0	0	0	1	0	0	1	53	3	0	4	0	4	0	17	1	23	10	4	44	7	9	43	5	3	0	0	0	1	26	0	1	37	5	6	3	0	0	0	0	4	0	20	20	2	9	17	13	23	0	0	0	0	81	0	3	0	30	2	0	4	0	0	1	0	0	0	0	0	0	0	0	1	5	0	0	0	1	0	0	78	2	0	0	0	0	11	25	0	11	3	0	1	0	0	2	2	0	0	0	0	1	23	1	32	0	0	0	6	0	0	9	6	4	0	0	0	0	0	2	1	1	0	1	38	0	2	0	1	0	15	0	2	0	0	0	0	0	8	2	0	0	5	0	0	3	9	12	4	1	4	5	0	0	8	0	0	0	0	240	1	2	2	0	0	32	4	1	6	1	1	0	3	2	12	0	50	4	0	3	0	6	0	12	0	0	1	0	0	4	1	1	3	1	0	2	0	4	8	0	26	0	1	0	4	111	0	3	1	0	0	6	3	1	2	0	0	1	2	1	86	10	0	1	0	0	0	4	0	0	1	0	0	0	43	0	2	5	0	0	0	1	142	14	0	0	0	0	4	0	2	1	0	2	0	0	0	2	1	1	7	0	1	0	0	0	1	2	0	0	0	1	42	0	0	3	0	0	0	0	0	0	0	2	1	0	0	0	0	0	0	0	0	0	0	26	0	0	0	1	1	3	1	1	7	0	0	2	0	0	3	1	3	0	0	0	1	5	2	0	0	0	0	0	0	2	0	1	4	1	2	16	0	8	0	0	113	0	0	0	1	2	16	0	5	0	1	1	5	0	0	4	49	0	0	2	0	0	2	0	5	1	2	82	0	0	34	0	2	0	0	0	4	0	0	283	0	30	1	0	0	1	0	0	0	4	0	0	79	4	0	0	0	0	0	0	0	2	0	2	0	2	0	0	11	1	17	20	0	0	0	0	0	0	0	14	1	0	0	0	0	0	0	1	1	0	0	0	1	102	0	0	0	3	4	0	0	0	3	13	0	0	8	0	0	0	0	0	0	0	2	0	0	0	50	0	2	0	0	0	0	3	2	2	0	1	0	0	0	0	0	0	4	8	0	0	0	0	1	10	4	0	0	1	0	0	10	1	8	8	1	1	0	1	6	0	6	1	4	0	2	0	0	0	0	0	0	0	3	12	0	0	0	0	0	0	0	30	27	21	5	8	1	0	1	0	0	6	0	0	0	0	414	14	16	68	0	14	16	0	18	0	1	19	35	9	0	17	1	0	0	3	20	0	0	1	55	16	1	6	1	420	0	0	0	57	8	63	0	1	0	7	5	2	12	1	28	0	1	2	0	9	0	0	9	0	2	4	4	0	5	20	1	30	0	5	1	3	3	15	12	81	7	0	14	0	12	0	4	4	3	0	0	1	6	1	5	13	2	0	1	0	0	1	11	2	14	0	0	4	39	20	28	3	8	4	109	10	5	0	2	2	0	1	2	0	0	0	0	0	0	0	1	1	1	0	11	0	11	3	127	0	0	1	0	2	8	0	0	0	0	3	2	1	0	1	0	0	0	0	0	1	0	0	0	1	6	1	0	0	0	0	0	0	0	3	0	0	1	0	0	10	0	1	0	2	1	0	10	0	4	3	1	0	2	0	14	3	30	36	1	4	5	1	1	2	0	1	0	1	16	172	0	1	2	0	0	7	3	14	2	9	3	5	2	1	68	1	0	1	15	19	0	0	1	0	1	0	26	0	0	0	0	0	0	0	0	10	4	1	3	39	0	6	11	17	0	0	0	0	0	0	12	0	4	9	95	50	0	4	1	0	0	19	0	0	0	5	13	9	22	1	26	1	0	0	16	3	158	1	2	0	245	0	0	0	4	0	0	0	4	0	0	29	1	87	2	0	46	0	0	0	1	11	1	0	9	0	0	7	38	21	15	29	8	0	0	0	17	0	2	0	0	2	2	1	1	0	4	0	1	0	9	0	0	20	0	0	51	4	3	0	0	0	16	0	11	5	0	24	9	0	0	0	28	0	6	6	4	14	26	5	7	21	10	22	11	22	15	1	0	0	0	14	0	0	10	2	0	4	0	1	0	0	2	0	8	5	8	4	4	79	32	51	0	196	2	2	0	1	1	1	0	0	0	0	2	0	0	0	1	0	1	0	0	92	15	1	0	2	2	4	0	0	0	0	0	1	34	1	0	0	9	0	10	10	0	46	0	0	10	1	0	0	1	26	0	42	38	5	4	0	3	22	2	1	0	32	18	0	3	1	0	5	0	1	41	0	0	0	24	18	25	8	0	3	0	0	1	5	0	2	14	0	2	4	3	1	0	5	0	63	18	39	2	0	10	8	18	3	10	34	4	2	0	0	35	23	0	2	2	3	0	90	113	69	0	0	10	56	1	0	4	1	0	1	18	1	0	2	0	0	5223	23	4	2	6	1	31	22	9	3	0	0	0	0	2	12	3	9	9	1	5	0	68	3	44	5	9	33	13	6	0	11	244	52	2	53	0	0	0	4	9	12	3	1	0	1	0	1	0	1	3	1	5	2	16	0	0	9	78	50	279	413	17	15	1	3	1	4	28	34	1	0	8	0	0	0	0	0	0	0	0	2	0	1	5	1	0	0	0	0	2	1	2	0	30	0	0	0	3	1	9	0	5	22	5	1	5	4	23	14	9	13	12	0	0	2	0	104	45	20	0	0	1	5	1	31	0	7	6	0	2	123	3	2	6	0	0	3	0	3	7	20	0	1	1	0	0	2	4	2	0	1	0	4	0	0	66	0	6	8	186	8	2	0	0	0	0	157	0	7008	0	7	0	3	47	54	5	1	0	0	0	0	0	0	0	16	4	6	0	0	0	0	0	1	0	0	1	0	0	82	0	0	2	0	4	0	1	4	0	65	9	0	1	0	0	1	0	0	0	0	15	2	0	2	0	0	0	0	0	0	0	0	0	1	0	1	1	9	0	20	3	0	9	0	1	1	1	17	55	0	0	2	1	3	0	0	0	62	0	0	0	1	0	0	0	1	0	0	0	85	48	3	94	96	0	1	0	0	18	0	173	14	22	6	1	0	1	0	3	0	3	66	1	0	0	2	58	0	0	7	6	4	8	0	0	0	0	0	0	0	3014	141	28	3	6	2193	1	29	29	19	34	3	151	130	105	8	156	58	32	0	8	141	101	79	62	33	3	1	0	1134	1	0	4	2	1	85	18	1	0	1464	0	3	0	0	0	0	4	31	0	3	0	8	78	113	23	9	20	9	7	12	0	4	3	23	11	12	25	5	0	0	0	1	0	1	0	0	1	25	0	0	4	2	19	0	2	24	0	4	0	1	6	2	2	7	1	5	0	0	9	19	0	0	0	1	0	1	0	0	0	5	0	29	11	0	33	12	0	0	14	110	142	1	1	19	60	28	3	26	39	1	30	0	24	23	1	74	0	0	7	6	14	44	15	0	23	31	22	16	8	0	15	10	0	0	10	2	4	0	0	3	50	0	20	6	2	6	0	4	11	1	2	16	1	0	8	1	0	0	0	0	1	2	0	0	5	0	2	1	8	0	256	4	9	0	0	10	4	0	24	3	1	19	1	0	0	45	95	2	50	71	0	13	7	4	4	30	14	12	4	4	2	14	7	25	11	57	22	12	0	0	0	0	0	0	0	1	1	3	0	2	10	1	0	0	0	0	3	20	23	0	19	0	0	0	4	0	0	8	1	1	1	0	0	0	0	0	1	0	1	2	0	0	2	0	3	0	0	6	0	1	5	0	0	0	24	3	2	0	1	15	4	0	0	0	1	2	0	0	5	1	0	0	0	0	0	0	15	3	0	2	35	4	0	7	0	0	0	2	0	1	0	0	3	80	4	0	9	1	0	3	13	2	34	0	0	2	0	1	34	0	10	9	5	8	0	0	1	0	1	4	0	2	0	0	25	13	15	7	14	2	7	23	5	18	0	14	5	14	3	13	46	15	26	26	7	19	6	7	1	4	5	1	5	6	7	2	9	25	45	16	54	9	16	25	17	14	6	12	12	17	10	7	23	0	0	4	0	91	143	10	8	1	43	15	3	9	152	86	16	536	0	952	5	4	0	1	0	13	7	2	4	0	21	1	1309	1271	108	10	0	38	0	0	0	0	5	185	36	107	43	65	45	270	19	10	31	0	2	7	29	11	2	5	0	7	0	11	15	8	18	22	29	7	3	6	14	16	10	0	0	0	25	0	3	0	11	0	2	2	0	0	0	0	22	6	1	0	0	0	19	9	10	2	0	1	3	0	0	3	18	0	0	0	0	0	0	1	0	3	5	0	2	3	0	0	0	2	0	3	2	5	1	0	14	23	1	14	59	0	3	3	1	0	0	6	0	0	0	0	0	0	0	0	0	0	0	0	38	0	0	0	0	0	11	0	0	0	0	1	0	0	0	0	0	0	3	1	0	0	2	14	1	4	1	1	10	0	56	94	12	48	0	27	2	42	0	0	0	0	0	2	0	1	0	0	1	1	0	4	16	19	5	0	0	0	0	0	1	3	0	14	9	4	0	41	2	9	0	0	10	54	0	0	0	10	0	0	6	59	202	34	8	0	0	15	0	1	14	1	47	0	0	0	10	18	4	0	3	9	5	13	18	0	3	33	17	0	3	35	295	13	4	1	1	0	0	21	36	17	0	6	0	1	1	0	8	0	1	0	0	0	0	0	2	0	2	9	1	0	0	0	0	0	13	2	3	0	49	1	0	0	0	1	0	0	0	0	9	8	4	0	2	30	0	11	1	0	8	2	17	0	1	10	0	2	1	12	3	0	0	0	0	0	0	9	2	12	0	1	1	2	3	0	2	1	1	10	12	12	1	14	21	2	0	1	0	2	2	0	10	8	7	2	46	21	11	0	0	15	1	0	4	2	0	0	1	0	0	3	14	5	1	0	1	0	4	1	1	0	0	3	16	5	0	2	0	0	1	4	7	12	6	5	212	0	0	0	0	2	0	8	2	14	1	0	0	46	0	4	1	0	5	17	0	0	33	28	14	1	1	21	1	12	5	8	472	0	0	17	0	4	0	0	0	0	7	1	0	20	17	0	25	2	18	4	5	34	0	16	1	0	0	0	0	9	0	0	0	0	4	0	0	0	1	2	0	4	1	0	0	1	0	2	0	2	0	1	16	16	1	0	0	0	30	8	1	1	0	0	53	19	0	6	0	2	3	1	39444	0	0	0	0	0	6	0	0	0	0	0	0	0	5	2	0	4	0	0	0	0	26	12	40	44	0	21	15	4	1	0	1	0	0	0	2	3	10	29	0	56	15	214	0	0	1	1	4	0	17	0	0	9	0	37	5	11	40	68	58	37	13	0	8	4	1	17	1	1	51	16	22	11	0	0	0	3	3	11	0	106	30	37	1	20	1	0	1	0	28	0	0	0	0	42	16	1	28	1	1	0	55	48	0	0	48	9	0	7	1	3	0	0	0	0	0	0	0	35	104	88	105	73	1	40	21	1	27	25	39	97	306	17	15	37	32	95	26	0	14	43	8	0	0	0	0	0	52	28	72	171	37	0	6	0	0	43	10	7	4	5	0	15	0	0	0	1	0	0	0	1	2	2	4	0	7	11	3	0	0	1	19	1	0	0	0	15	15	7	14	1	3	6	4	0	4	3	93	0	5	0	2	4	54	0	16	9	0	6	2	0	0	14	12	3	0	0	2	0	0	1	0	0	0	0	0	0	7	1	0	0	1	11	7	4	0	4	3	0	0	0	0	1	3	9	1	12	0	0	1	53	44	0	1	1	0	33	1	0	6	4	0	1	18	1	0	2	0	0	0	1	0	1	0	2	1	2	0	1	0	0	2	0	3	2	0	0	0	50	0	0	1	2	2	0	0	1	0	0	0	0	1	2	3	0	1	0	5	0	0	0	2	28	0	0	5	0	1	0	1	41	11	3	2	1	0	12	5	6	37	1	1	3	392	7	10	7	3	0	0	7	6	21	0	5	1	3	12	12	9	8	0	0	0	0	0	0	0	0	7	0	0	1	2	28	15	0	0	0	0	461	1289	2	0	4	0	0	0	1	5	8	39	21	2	66	0	29	16	3	736	9	3	0	9	7	12	10	4	17	0	0	30	1	34	5	2	2	1	0	0	0	0	19	0	13	59	17	6	2	0	0	19	9	6	0	1	1	0	5	2	0	1	0	2	1	16	0	9	0	26	5	4	14	14	2	3	7	0	29	20	1	3	1	0	0	3	0	45	213	29	9	7	10	29	3	0	1	13	25	9	14	0	1	6	0	12	0	4	1	3	0	0	0	8	1	9	4	0	1	0	8	0	4	6	14	0	20	0	9	0	4	4	1	9	1	0	3	0	2	3	5	4	176	0	8	0	0	0	1	12	0	1	0	1	1	0	1	8	6	0	0	0	0	7	7	21	0	0	918	0	2	5	9	0	0	0	3	2	6	1	0	0	1	0	2	0	0	1	0	0	0	0	0	0	0	2	0	2	1	128	1	23	17	38	72	8	21	0	0	0	0	0	0	0	0	1	0	1	0	0	0	0	1	1	29	0	0	0	0	3	6	1	0	0	0	0	0	2	0	0	0	43	0	0	8	10	5	12	4	0	9	2	2	4	25	4	5	13	7	8	2	23	14	12	37	193	25	46	246	0	0	17	8	0	4	4	15	5	0	1	0	0	1	0	240	1	0	3	0	262	0	0	0	0	4	186	0	6	1	0	0	7	4	0	0	0	0	0	0	0	21	20	0	0	0	2	134	131	0	0	0	0	0	0	3	5	23	0	0	0	0	0	1	30	39	0	0	0	1	20	2	6	0	40	1	0	17	7	6	0	6	0	1	2	9	7	14	7	0	0	2	0	2	59	0	3	6	2	12	110	0	0	13	151	13	10	625	0	2	5	2	3	2	0	204	22	55	0	0	0	0	11	0	7	0	7	0	23	0	0	12	0	0	0	21	3	5	264	2	0	42	134	0	0	2	0	0	16	8	3	2	2	0	27	0	0	6	0	1	0	2	1	0	1	0	0	8	2	1	0	0	14	0	2	0	0	22	41	4	15	0	1	77	5	0	0	0	2	0	7	17	2	8	8	49	94	4	14	26	0	16	41	51	0	0	0	1	0	0	7	1	0	186	2	0	14	13	36	22	2	14	14	1	14	1	23	1	2	102	9	1	1	0	0	3	0	0	49	138	139	0	0	0	0	0	1	2	0	2	3	1	0	1	0	1	0	0	0	0	0	0	0	0	1	0	0	0	2	0	0	0	0	0	0	0	0	0	0	0	1	2	18	0	0	2	0	0	0	0	0	0	0	0	0	4	0	0	0	10	3	10	6	0	4	2	0	1	0	4	3	16	0	2	0	0	11	219	4	20	36	4	22	7	9	8	3	34	9	1	0	0	1	4	2	4	0	0	6	0	3	5	0	21	2	7	1	4	0	0	54	10	0	11	3	0	9	0	0	0	23	7	8	4	61	9	39	16	2	60	4	2	0	1	0	5	0	9	43	58	45	3	26	10	22	1	2	0	3	1	9	1	0	0	19	1	4	0	0	0	1	35	0	0	0	0	0	0	1	0	5	22	8	34	11	1	11	2	24	19	12	22	16	4	63	25	60	0	1	0	0	0	1	0	4	6	32	9	22	16	0	0	7	0	1	0	0	0	0	0	0	0	0	1	2	0	15	152	323	2	127	137	42	10610	35	0	5	0	0	0	0	1	10	5	6	20	0	1	11	0	0	1	1	1	3	0	0	3	7	0	0	910	105	0	12	41	0	4	2	0	1	0	29	0	68	0	0	732	0	6	0	14	1	32	0	0	0	4	0	0	0	0	0	0	0	12	0	0	0	0	0	11	0	0	0	0	1	0	0	1	0	8	0	1	1	0	1	0	0	5	0	0	17	1	270	128	1	16	10	16	19	13	9	2	0	11	1	20	1	0	0	0	0	0	0	0	0	0	0	7	2	1	0	2	1	1	1	0	3	7	2	4	2	3	0	1	3	2	0	0	1	0	0	9	0	1	13	7	1	3	1	1	1	0	0	0	0	0	3	16	3	3	0	21	27	34	8	16	0	0	0	1	0	1	0	0	18	0	61	0	0	1	15	1	45	43	0	0	0	0	4	0	1	0	0	2	3	0	0	0	2	0	0	0	0	1	0	0	0	0	0	0	0	2	2	0	0	0	0	0	0	0	239	1	0	0	1	0	0	0	0	3	1	0	0	0	0	0	0	0	0	0	3	0	0	0	0	0	0	0	1	0	0	1	0	1	1	66	0	1	2	0	0	8	12	0	0	2	0	1	0	0	1	4	0	0	0	14470	2	0	0	0	0	1	0	0	0	0	1	4	0	0	3	0	0	0	0	2	0	0	1	0	0	0	0	1	0	0	0	1	0	0	0	0	0	0	15	0	0	6	1	33	0	1	0	0	0	0	0	0	1	0	0	0	2	0	0	4	0	0	0	5	12	0	0	0	0	0	0	0	1	0	0	0	3	1	0	0	0	20	0	0	1	0	0	1	3	0	0	0	0	0	0	1	1	1	0	0	2	0	6	2	2	1	1	0	166	1	0	0	0	0	0	1	10	1	1	0	1	5	65	0	136	11	1	0	4	5	0	10	0	0	2	167	1	4	0	0	139	4	99	0	0	0	0	0	1	4	1	4	6	0	0	5	7	2	1	24	1	9	1	0	1	1	6	0	27	0	0	1	46	5	8	3	89	2	5	8	0	4	7	11	3	4	14	0	17	2	8	0	1	1	6	3	2	40	3	3	1	3	20	0	1	0	1	0	71	12	19	11	6	1	10	2	2	6	3	10	3	5	34	1	0	331	4	1	13	1	4	0	186	2	40	22	4	0	6	1	5	10	77	2	8	2	0	1	3	19	7	21	0	25	48	29	11	167	399	58	13	0	0	2	68	0	5	0	0	0	4	0	0	0	0	9	0	2	0	0	0	0	0	2	0	106	7	54	0	0	5	0	0	10	1	41	1	27	17	2	3	2	3	5	1	0	2	0	0	0	6	0	0	0	18	2	3	0	0	7	0	0	0	1	0	0	0	0	1	0	11	0	0	0	0	0	1	0	8	0	0	0	4	14	0	1	0	3	0	0	0	7	3	0	4	102	2	1	0	0	0	33	2	1	1	1	0	0	1	2	2	7	0	3	0	0	1	2	1	0	0	0	0	0	4	1	1	0	1	2	10	1	69	2	4	0	0	2	2	1	0	0	0	39	1	59	5	1	0	0	1	1	6	0	0	0	0	0	0	0	1	1	0	0	0	3	26	21	1	59	33	1	0	0	2	0	0	4	0	371	0	4	7	100	0	0	4	0	13	28	7	0	0	3	5	5	0	0	1	0	15	29	24	691	0	10	9	7	1	0	0	1	1	0	0	2	1	0	0	0	2	0	0	0	4	8	1	1	14	18	1	2	20	0	0	3	2	0	0	3	26	8	16	36	37	1	16	21	635	1	40	2	21	36	1	11	10	16	0	1	0	1	0	0	49	6	0	0	0	1	43	40	5	0	0	14	0	0	1	0	0	4	1	0	19	16	13	0	0	60	2	0	0	0	1	0	8	1	24	1	7	2	3	1	1	8	1	42	0	4	0	0	0	13	5	0	11	0	17	0	8	30	11	27	27	2	0	12	5	4	4	212	21	0	6	0	0	0	0	2	0	1	11	0	0	0	0	0	0	4	16	18	0	1	1	1	35	9	15	0	4	0	1	5	14	3	4	15	2	2	1	10	77	64	65	21	0	1	0	0	6	24	0	0	1	2	3	2	77	45	37	1	28	0	0	5	8	5	2	1	0	0	2	12	36	15	14	8	7	10	3	36	0	2	3	27	802	2	3	5	3	48	2	0	4	46	39	2	0	0	0	0	0	0	23	0	0	72	0	2	0	0	0	0	1	40	22	1	0	1	8	0	5	0	0	1	3	1	0	6	1	1	0	11	8	6	66	3	2	0	1	0	1	0	38	0	0	0	10	0	0	0	13	0	1	36	8	3	55	0	0	0	14	46	0	0	6	3	0	18	0	0	0	0	0	0	1	11	10	7	0	21	1	10	9	0	2	0	0	0	2	0	56	6	0	0	38	3	1	16	1	3	42	0	23	66	0	0	0	3	1	33	17	0	0	2	0	14	3	4	0	4	1	6	0	0	22	43	10	2	0	0	0	1	1	0	0	0	0	4	7	34	0	0	108	1	0	58	13	10	123	15	14	12	231	15	2	77	25	55	24	2	45	17	0	3	178	1	0	6	0	1	5	10	1	2	24	0	0	1	0	1	0	0	0	3	0	0	0	7	3	2	2	6	0	0	0	0	0	0	0	0	0	0	0	0	0	0	0	1	1	0	0	0	0	0	0	0	0	0	1	7	0	0	0	3	0	0	0	0	0	0	0	0	1	0	1	0	0	0	0	0	0	0	0	0	0	9	19	0	61	10	0	0	13	0	0	0	28	38	36	10	4	16	57	4	0	8	0	2	1	0	0	0	1	0	0	0	9	118	1	28	7	13	0	1	0	9	6	8	2	0	1	0	4	2	1	0	1	0	0	13	5	1	1	8	0	8	8	23	3	9	0	6	10	12	0	11	53	13	0	2	0	0	0	0	4	35	1	0	0	0	1	0	0	5	5	6	5	0	205	15	0	10	0	52	0	0	1	0	17	1	1	0	152	9	1	3	0	2	308	0	1	0	5	9	0	6	0	6	19	1	0	0	2	1	26	15	10	0	7	32	0	0	1	8	0	0	0	4	1	3	4	4	9	12	0	2	0	5	0	7	10	0	0	5	13	10	25	16	7	2	9	3	0	12	0	1	42	0	1	0	1	14	0	0	3	9	1	0	2	4	2	2	0	0	0	8	0	0	1	0	0	0	1	2	1	5	0	0	0	0	3	15	0	0	0	0	0	3	2	1	5	0	12	2	2	0	0	0	9	13	5	5	7	1	40	0	0	199	18	60	17	22	0	2	169	105	0	35	28	4	12	0	4	25	6	3	1	10	0	16	20	9	1	0	0	0	0	58	4	15	0	0	55	62	51	3	0	0	0	0	0	0	80	0	0	4	3	8	0	1	0	0	1	3	3	156	4	50	6	8	2	28	5	3	0	1	1	2	0	2	0	30	0	13	0	21	0	4	19	8	0	70	6	349	52	1	0	0	14	8	20	108	15	18	26	24	133	1	38	66	3	1	0	0	1	31	9	11	340	78	15	0	43	6	8	0	0	33	0	1	3	10	0	0	0	123	126	0	0	0	62	60	20	29	4	19	8	27	15	0	1	73	0	0	14	8	45	1	3	0	256	0	0	0	11	7	1	0	0	1	2	0	0	0	0	0	0	0	0	2	68	17	0	0	0	42	16	11	0	0	1	3	0	1	0	0	0	10	15	10	0	50	0	22	3	0	0	0	21	2	22	14	3	0	30	11	20	5	28	50	56	2	5	3	178	8	30	52	0	0	0	1	0	0	0	0	5	0	0	3	0	0	0	0	0	0	0	0	13	0	0	0	9	12	13	0	0	11	1	7	0	0	4	2	19	0	0	3	2	0	6	26	75	8	222	0	6	0	0	0	1	1	0	0	0	0	0	0	6	0	0	0	1	0	0	3	0	0	0	2	0	1	0	1	1	2	5	0	0	4	1	32	0	0	4	1	0	8	3	0	0	0	0	4	0	0	0	0	1	2	5	6	1	1	0	18	13	23	0	6	1	367	1	168	175	3	4	1	2	4	0	0	0	37	107	799	34	30	123	5	46	17	17	31	34	54	44	0	53	11	0	0	2	12	0	4	0	5	1	0	0	0	0	0	0	0	4	1	15	0	0	0	0	3	0	0	0	0	0	0	0	0	0	0	2	1	2	1	0	0	0	0	0	5	1	2	2	0	23	3	0	38	1	26	22	16	39	1	0	0	4	0	0	1	0	0	1	0	0	32	29	0	0	0	8	2	23	21	7	5	15	0	1	3	0	2	1	2	0	0	2	0	0	0	1	14	2	13	0	47	0	5	11	0	2	1	0	0	1	0	24	13	2	0	9	0	11	0	14	2	2	2	3	0	2	0	23	7	0	0	0	0	0	0	0	1	14	2	0	0	49	6	11	5	0	0	35	0	0	0	1	1	0	0	0	0	2	30	10	2	32	45	0	0	1	1	0	4	0	0	11	0	2	1	1	1
LakWasMet21_HOW5_2_rpkm	0	0	0	1	1	4	10	0	1	0	0	1	2	0	0	0	0	1	3	0	0	0	0	9	0	0	0	0	0	5	0	2	0	2	1	0	0	0	2	0	0	0	0	0	7	7	11	6	0	1	2	0	0	0	0	5	0	6	24	6	104	0	1	2	4	0	0	0	2	11	0	0	1	0	0	0	0	0	0	0	0	2	0	0	0	0	0	0	0	0	0	2	3	0	6	13	0	0	0	0	0	0	0	0	0	0	0	0	0	0	0	1	23	0	4	1	0	3	0	0	0	0	0	0	0	0	2	0	0	0	0	12	4	0	0	1	0	0	3	0	0	0	0	3	0	0	0	0	3	0	0	6	0	5	11	0	1	6	4	0	2	5	0	9	4	2	0	1	0	6	0	0	0	0	0	0	0	0	0	0	1	0	0	1	4	10	0	0	0	7	3	0	1	1	1	0	0	4	1	160	7	0	13	0	0	0	6	0	9	2	1	1	28	2	1	0	4	1	0	0	0	1	3	0	2	5	0	0	2	0	0	0	39	0	0	0	7	10	10	1	0	0	8	7	13	1	0	0	3	7	8	3	7	0	406	118	0	0	0	0	0	0	13	5	3	0	0	0	0	14	18	1	3	0	0	0	0	0	24	14	1	4	13	2	6	0	0	0	1	0	2	0	0	0	41	0	0	1	1	0	0	21	17	0	5	1	10	8	10	1	7	0	8	2	0	0	1	2	26	0	0	0	0	1	9	599	1	0	3	0	0	1	0	0	0	0	1	0	0	0	0	0	2	8	2	0	2	0	0	0	2	1	0	0	1	0	0	0	0	76	7	0	1	0	0	1	2	5	6	2	1	7	0	0	15	0	0	0	0	0	0	0	2	0	0	0	30	0	0	0	0	0	13	1	1	0	20	0	0	13	0	5	0	30	6	0	1	0	0	0	0	5	14	7	1	16	11	4	0	0	0	0	0	0	0	0	0	0	0	0	1	1	0	0	0	0	0	0	4	0	16	21	0	0	2	18	0	0	0	0	0	24	9	141	0	17	9	1	0	3	0	3	0	1	0	11	1	0	0	3	3	9	7	0	0	0	0	0	222	0	0	0	2	0	0	1	0	26	15	1	0	0	21	8	7	0	1	0	0	0	1	0	1	0	0	0	0	0	0	0	0	0	0	7	0	0	1	0	0	1	0	0	0	0	0	0	0	0	0	0	0	0	2	1	2	0	5	4	0	7	0	5	0	6	7	0	1	1	0	0	0	0	1	0	0	11	1	0	0	0	0	1	0	0	1	0	10	0	5	0	0	0	0	2	2	5	8	24	0	8	25	40	29	8	13	0	3	0	2	0	0	0	574	0	1	1	1	0	0	0	5	0	0	0	1	2	0	11	0	14	0	47	61	22	0	0	19	0	108	1	52	24	4	2	0	0	1	2	0	1	1	2	0	0	0	0	0	0	0	1	0	7	1	0	0	0	0	4	2	0	20	0	0	5	1	0	1	0	0	1	2	51	0	20	0	0	1	0	6	9	4	7	0	0	1	0	1	0	0	0	0	0	2	0	0	0	0	1	0	6	0	0	1	0	2	0	0	0	0	4	0	0	0	1	0	0	0	0	11	0	1	0	0	0	5	4	0	2	1	0	0	1	1	1	0	0	0	0	4	0	0	0	0	0	0	0	0	0	0	5	0	10	2	0	8	7	2	0	0	22	0	0	0	0	0	4	0	0	33	0	0	4	0	9	0	0	0	0	0	1	0	0	0	0	0	10	0	0	0	0	0	0	0	0	0	0	1	0	0	1	1	0	0	0	0	0	4	0	1	9	0	0	0	0	74	3	28	0	0	0	0	0	1	0	0	1	7	0	2	0	0	0	0	8	4	0	0	6	0	0	0	1	0	1	0	0	0	10	9	0	0	0	0	0	0	0	0	3	5	10	0	0	0	0	0	0	3	0	1	5	7	2	4	1	0	0	0	0	2	1	0	0	0	0	0	0	0	4	4	24	1	0	0	1	1	1	2	0	0	0	0	0	0	0	0	0	1	0	0	0	0	0	0	0	0	0	0	0	1	0	0	0	0	8	10	9	17	7	8	0	0	0	0	0	0	0	1	0	0	0	1	0	0	0	0	0	0	0	0	18	0	0	0	3	1	0	10	2	0	0	0	0	0	1	0	0	0	0	0	0	0	0	0	1	0	2	0	1	0	0	0	2	2	162	2	11	0	0	1	0	3	5	11	0	15	0	0	0	0	0	0	0	0	0	0	0	1	3	7	0	0	0	0	0	0	0	0	0	0	0	0	2	0	0	0	0	0	28	0	1	0	14	3	0	1	1	0	0	100	8	2	0	0	0	0	0	1	1	100	0	0	0	0	0	0	0	0	2	0	0	2	0	0	0	4	0	1	0	0	1	2	4	1	1021	0	0	0	0	24	5	4	0	0	0	1	0	5	0	4	1	0	0	1	0	0	0	0	0	0	3	10	0	0	0	0	0	0	1	0	0	0	0	0	0	1	13	8	0	3	11	0	0	0	0	3	0	0	0	1	0	6	0	0	0	0	2	15	14	3	0	1	0	0	0	0	5	3	0	4	1	1	0	0	0	0	0	0	0	0	0	0	0	0	0	6	0	3	3	0	1	0	0	0	0	0	0	0	0	0	0	7	5	0	0	0	0	1	0	0	0	0	0	2	0	0	0	0	4	0	0	0	0	0	6	2	6	0	0	0	4	1	0	0	1	0	1	1	0	0	0	0	0	2	0	0	0	0	6	0	0	0	0	2	0	0	0	0	0	8	0	0	0	0	0	3	0	0	2	1	0	3	0	59	4	0	0	0	1	0	3	0	0	0	22	25	0	0	0	1	0	11	0	0	4	0	1	0	0	0	0	0	1	6	1	2	6	1	2	0	2	0	0	1	1	0	14	2	0	2	0	0	1	0	0	0	2	1	0	21	1	1	0	0	0	0	1	0	1	0	3	0	1	0	0	0	0	0	0	0	0	0	0	22	3	0	1	1	0	2	0	0	0	5	7	6	0	9	13	6	4	0	0	2	0	0	0	0	1	1	7	0	0	0	0	6	0	10	2	0	0	0	0	6	2	3	0	3	1	1	8	0	0	5	3	1	4	1	2	2	0	0	0	2	0	5	0	1	1	0	14	3	1	11	0	0	3	7	5	0	0	0	0	2	3	4	0	0	0	0	4	0	3	9	8	2	0	2	0	0	0	0	0	1	4	2	0	0	0	39	0	2	8	0	0	10	0	1	3	1	2	0	0	3	5	3	4	0	0	0	0	0	0	1	249	18	6	20	0	0	0	0	0	0	0	0	17	7	1	0	16	0	0	0	7	29	12	8	7	0	0	0	32	0	0	0	0	2	0	1	0	36	6	5	18	26	19	3	8	22	1	0	0	1	0	0	0	35	0	0	0	0	3	0	8	0	0	0	0	0	1	0	0	0	0	0	0	2	0	0	0	0	1	0	2	3	7	0	0	0	0	0	7	0	1	0	0	0	0	0	0	0	0	2	0	0	0	0	0	0	0	0	0	0	46	0	0	0	0	0	0	0	0	0	0	0	1	0	0	0	0	0	0	0	0	1	0	1	191	1	0	38	0	0	0	0	31	5	8	4	0	0	58	0	38	2	0	0	0	0	0	7	1	11	2	0	0	0	0	1	0	0	3	3	0	0	0	4	3	0	1	0	0	0	0	0	1	1	6	0	12	5	19	0	0	2	9	0	0	0	2	0	0	0	1	2	1	0	2	10	0	1	0	1	3	6	0	0	4	0	0	0	687	0	2	2	0	5	0	10	0	1	1	1	0	0	6	5	0	15	7	16	25	32	3	24	1	0	0	0	1	0	12	0	0	5	4	17	0	0	0	6	0	1	0	1	3	11	0	14	8	0	1	0	1	0	9	0	0	12	2	0	0	0	0	0	1	0	50	0	3	10	2	0	0	6	5	1	51	0	1	2	1	1	0	0	6	23	245	10	19	0	5	0	0	1	1	0	0	1	0	0	0	124	0	0	0	0	0	0	6	3	0	5	0	0	0	0	1	0	0	0	11	0	0	0	0	1	1	4	0	0	0	8	0	337	1	0	7	145	138	1	19391	1	0	1	0	0	5	0	0	2	0	0	1	0	0	0	0	0	6	0	0	0	0	0	0	1	24	0	18	0	0	0	0	2	3	2	0	0	0	4	0	5	2	1	0	2	0	0	0	0	0	0	0	9	0	0	4	10	0	0	0	6	54	0	11	0	10	30	0	13	1	20	0	3	8	5	5	19	3	0	3	1	0	0	0	1	2	0	0	0	0	0	0	0	0	1	1	1	3	0	7	13	0	0	0	0	0	0	0	0	0	0	0	0	0	0	0	0	0	0	0	8	0	0	0	0	0	1	0	0	0	0	0	0	0	1	0	0	0	0	0	0	0	0	0	0	0	0	1	0	0	0	1	0	0	2	0	0	0	0	0	30	0	3	1	1	0	11	0	5	0	14	10	23	1	0	1	1	0	0	0	0	0	0	7	0	0	11	0	0	0	0	1	0	0	0	0	0	2	0	0	2	0	9	2	6	21	0	15	0	0	0	0	1	1	15	1	0	0	0	0	0	0	0	0	0	0	1	0	2	0	0	0	0	0	0	0	7	0	1	17	0	0	0	0	0	0	0	0	0	0	5	59	6	7	0	0	0	0	0	0	6	0	0	1	0	0	0	0	1	5	0	0	0	0	0	0	0	0	0	0	0	0	0	8	1	0	0	1	2	0	0	1	0	0	0	1316	0	0	0	0	2	3	1	0	4	6	0	5	9	19	0	0	2	0	0	0	29	0	8	5	0	0	0	0	1	1	0	4	0	0	0	0	0	0	1	0	0	0	0	2	0	0	0	0	0	6	0	0	0	0	56	5	0	0	0	0	0	0	0	0	0	0	0	0	1	0	0	0	2	0	0	0	1	1	1	0	0	11	1	1	1	224	0	1	37	74	17	1	2	0	3	1	0	0	0	0	0	1	21	0	1	1	1	0	0	0	0	0	1	0	1	0	0	1	1	11	0	0	4	0	9	0	1	2	0	0	1	1	0	1	0	1	0	3	0	0	0	0	0	3	0	0	13	3	0	3	2	0	0	0	0	13	0	0	0	2	1	0	0	0	3	0	1	2	1	0	33	0	0	0	0	0	0	5	0	1	0	1	0	0	0	0	0	0	0	0	0	0	0	1	0	0	0	0	0	0	0	0	0	0	0	0	0	0	0	4	0	0	1	0	3	0	4	0	2	0	0	0	0	0	0	0	0	5	1	0	0	0	0	0	23	30	12	24	62	32	44	137	2	47	45	77	62	31	11	29	4	54	78	4	8	2	90	93	47	87	260	48	27	9	50	6	68	0	0	1	0	0	0	0	0	0	0	0	24	22	2	0	0	0	0	0	0	0	0	1	0	0	0	1	0	3	0	0	2	0	6	0	2	0	1020	0	0	0	0	0	5	0	1	1	0	2	0	0	0	0	0	0	0	0	0	4	0	0	0	0	2	1	2	3	2	0	0	0	0	0	0	1	0	0	3	0	0	0	1	0	41	2	0	10	0	0	0	0	0	0	0	1	0	0	1	0	0	2	0	0	0	0	3	0	0	1	0	0	0	0	0	1	0	4	0	27	0	0	2	2	0	0	1	0	0	1	0	0	0	0	0	0	0	8	1	0	0	0	1	0	1	0	1	2	2	0	1	1	0	2	0	0	1	11	3	0	0	3	0	0	0	0	0	1	2	0	11	13	0	0	0	0	0	2	0	0	0	0	0	0	19	0	0	1	0	0	0	3	0	0	1	0	0	0	0	0	0	0	2	0	0	60	1	1	0	272	3	1	0	0	0	0	0	0	0	1	1	0	0	0	0	0	3	0	7	41	0	0	0	0	25	0	0	7	4	0	8	1	0	12	0	3	2	1	0	0	0	0	0	2	0	3	3	1	0	0	3	0	0	1	0	0	0	0	2	0	0	0	0	0	0	0	0	0	1	0	0	0	1	0	0	0	5	0	0	0	0	8	0	3	13	65	5	1	2	0	0	0	0	0	0	0	0	1	0	0	0	0	0	0	4	1	2	12	0	0	0	1	0	0	54	0	5	1	0	0	0	0	102	0	0	0	0	0	0	0	0	0	0	0	0	0	17	12	1	0	0	0	0	0	0	1	0	2	1	3	0	3	2	1	0	0	16	2	0	1	0	0	0	0	0	0	1	0	1	0	0	0	6	0	1	0	0	0	1	1	1	1	0	0	1	1	0	0	1	1	3	1	0	0	0	2	0	0	0	0	0	3	0	0	0	0	0	0	0	1	0	0	25	1	0	2	0	349	0	0	1	0	2	0	0	2	0	4	5	0	0	0	0	0	0	0	0	9	0	0	0	0	0	0	16	0	3	11	12	4	0	13	6	3	0	8	0	10	0	9	0	7	4	3	1	4	2	2	0	3	0	3	0	4	0	0	0	2	0	5	0	2	9	4	5	5	3	2	1	0	0	1	0	0	7	0	0	0	6	6	1	2	0	1	1	2	2	3	0	0	0	2	0	1	3	0	0	0	0	2	2	0	0	0	0	82	1	0	0	0	0	0	0	0	2	0	0	1	0	2	1	1	0	0	0	0	1	0	0	0	0	1	0	24	0	1	18	9	12	0	8	1	2	0	0	3	54	0	0	1	0	0	2	0	24	0	4	5	0	0	0	0	0	7	0	0	6	5	0	68	0	8	1	0	0	9	21	0	0	1	0	1	1	0	0	0	3	0	3	0	0	0	16	0	0	0	13	9	1	0	0	0	1	0	173	212	233	1	0	0	0	1	1	1	1	19	0	1	0	1	0	0	21	115	3	0	0	0	0	0	0	0	14	1	0	0	0	2	0	0	0	1	0	0	1	0	0	0	0	0	0	0	0	0	19	1521	1	1	0	0	0	0	1	16	0	0	0	0	0	2	9	7	0	0	0	0	0	0	0	84	2	1	0	0	0	3	0	0	0	1	0	3	1	3	0	0	0	0	0	0	4	995	2	0	2	0	2	0	0	0	0	0	0	0	0	0	0	6	0	6	0	0	0	0	0	2	0	0	0	0	0	0	0	0	0	0	2	0	0	0	0	0	0	3	1	0	0	0	0	0	0	0	0	0	0	0	1	1	0	0	0	6	0	0	0	1	0	0	14	0	0	0	0	0	0	71	2	0	0	0	1	9	6	17	3	0	5	0	0	2	3	0	15	0	0	10	0	0	0	0	0	0	0	0	2	1	0	0	0	0	1	0	0	0	0	0	0	0	1	0	0	0	0	0	1	0	0	0	0	1	0	0	0	0	0	0	0	2	0	0	0	0	0	1	0	2	0	5	4	1	1	0	1	0	0	0	0	1	0	0	1	22	0	0	0	0	0	0	0	0	0	0	0	0	1	1	0	1	0	15	3	5	0	2	0	8	0	0	0	0	3	0	0	0	0	0	0	6	1	9	11	0	10	0	9	11	0	0	0	0	0	0	0	1	0	7	0	0	0	0	0	0	11	134	0	54	0	0	0	2	0	0	0	0	0	0	0	1	0	0	7	1	13	4	0	0	0	0	1	0	0	0	11	0	4	1	1	0	0	0	0	5	0	0	0	0	0	0	14	0	0	0	4	0	2	0	4	0	0	2	1	1	0	0	7	0	0	0	7	0	0	0	0	0	1	2	229	0	0	1	1	0	0	0	0	0	0	0	0	0	0	0	0	0	0	29	0	0	0	0	0	0	0	7	0	0	0	0	0	1	0	0	0	0	0	1	0	0	0	1	0	0	0	0	0	0	0	0	2	0	1	0	0	0	0	0	0	0	0	0	0	1	0	0	0	0	0	6	0	2	0	0	0	0	0	1	0	0	0	0	0	0	0	0	1	0	0	0	0	0	0	0	0	0	0	0	0	1	2	0	1	0	0	0	0	0	0	0	3	0	0	1	4	0	0	14	0	0	0	0	0	0	0	0	0	3	1	0	0	0	0	0	0	0	3	0	0	0	0	0	0	0	1	6	0	0	56	0	0	0	6	0	0	0	0	0	0	2	0	7	0	0	0	0	1	3	0	0	1	5	8	0	0	0	1	0	0	0	0	0	0	1	0	1	0	0	5	0	0	69	0	0	0	0	0	0	0	0	14	0	0	0	0	0	0	0	0	0	0	0	0	0	35	0	0	0	0	0	1	0	0	0	0	15	0	0	0	0	0	9	0	0	0	0	0	0	0	0	0	1	0	0	0	0	1	0	0	0	0	1	0	0	0	1	0	0	0	0	0	0	0	0	0	0	0	0	0	2	0	0	1	0	3	0	0	0	0	0	0	0	0	0	0	1	0	0	3	0	2	0	1	0	0	0	0	0	0	0	0	0	0	0	0	0	0	0	1	0	0	0	0	0	0	0	0	0	0	0	0	0	0	0	0	0	0	0	0	0	0	0	0	0	13	0	0	15	0	0	0	0	0	4	0	0	0	0	4	0	0	0	1	0	10	0	0	0	1	0	0	137	30	1	3	1	0	46	0	4	1	0	0	0	4	0	0	0	0	0	0	0	0	0	0	2	0	0	0	2	0	0	1	1	0	0	0	0	0	2	2	0	0	2	0	0	0	0	0	0	2	0	0	0	0	1	1	37	0	12	3	0	0	0	0	1	0	0	0	0	83	0	0	0	0	0	0	0	0	0	0	0	0	0	0	0	0	0	0	0	0	0	0	0	0	1	0	0	0	0	2	3	0	0	0	0	0	0	0	0	2615	0	0	1	2	0	0	0	0	0	0	0	1	0	18	0	0	0	0	0	13	0	1	29	0	0	0	0	0	1	0	0	1	0	0	0	0	0	3	0	1	0	0	0	17	0	3	0	0	0	0	0	0	12	0	0	0	0	0	0	0	0	2	5	1	0	0	0	0	1	0	0	0	0	0	1	0	0	0	0	2	0	0	0	0	0	0	1	1	0	0	0	0	0	1	3	2	0	0	0	0	3	1	0	15	0	7	0	0	0	2	0	0	0	0	0	0	0	0	0	0	1	0	19	3	0	44	3	0	0	0	0	0	1	0	0	0	0	0	0	0	0	0	0	79	0	4	0	8	0	0	1	0	0	96	7	1	12	0	0	0	0	0	1	0	0	0	0	1	9	5	0	1	0	0	0	0	0	0	0	5	0	0	1	0	0	0	0	0	0	0	0	0	0	0	0	0	0	0	0	0	0	0	0	39	0	5	0	2	0	3	0	0	0	0	0	5	0	0	0	0	1	0	0	0	0	1	6	6	0	0	1	0	0	0	0	0	0	0	6	4	4	0	7	2	0	9	63	7	0	1	0	149	0	6	21	1	0	0	0	30	104	0	7	0	10	10	0	301	0	0	0	0	2	0	0	6	10	1	9	0	1	5	0	9	6	10	0	4	4	1	4	0	6	0	0	9	1	0	0	0	0	0	0	0	4	8	0	0	0	2	2	0	0	21	2	1	0	0	0	0	0	1	0	0	8	1	0	0	2	3	1	1	1	8	0	0	3	0	4	1	0	3	1	2	0	0	0	0	0	33	12	4	0	0	0	0	1	0	3	3	0	0	0	0	0	0	2	4	0	1	0	0	0	0	25	2	0	0	6	0	0	2	0	2	0	0	4	3	0	0	0	0	4	0	0	0	0	1	6	0	1	0	0	0	0	1	0	0	2	0	13	7	1	2	0	3	0	3	5	0	1	6	1	0	0	0	5	1	0	0	29	31	73	1	5	9	12	122	1	47	20	8	1	145	133	82	0	391	15	45	28	33	1	38	0	52	1	2	0	2	0	1	0	0	0	0	1	0	0	0	2	0	6	0	0	0	0	0	0	40	1	1	7	4	0	0	0	0	0	0	27	0	1	3	0	0	0	1	0	1	14	0	0	0	0	0	0	0	50	2	0	1	0	13	0	0	8	0	2	0	33	0	0	0	0	1	0	0	23	3	7	0	13	0	0	0	1	0	0	0	0	0	0	0	0	0	0	0	11	0	0	0	0	5	0	0	0	0	10	0	0	9	0	1	0	0	0	1	3	0	6	1	0	2	1	0	0	0	0	1	0	0	3	6	3	1	0	0	0	0	1	0	1	0	1	0	34	0	0	37	0	0	0	0	0	0	0	18	0	1	0	0	0	1	0	0	0	2	0	0	4	1	11	2	0	3	2	0	0	0	2	0	0	0	0	0	0	0	0	0	0	0	0	0	0	1	12	1	0	0	0	0	0	0	0	0	0	0	2	73	0	0	1	0	4	1	1	0	6	2	0	0	16	79	98	0	0	2	0	9	2	0	0	0	3	0	0	2	1	1	0	0	1	0	79	1	2	0	14	0	0	0	0	0	0	0	0	2	0	0	1	0	0	0	0	0	0	1	3	0	5	4	0	2	0	9	0	0	0	2	0	0	0	3	0	4	2	0	2	0	0	0	1	8	0	1	5	0	0	0	3	22	0	1	0	0	0	0	0	0	7	0	2	0	0	1	0	0	0	0	0	1	0	0	4	9	0	4	0	0	3	4	0	0	0	18	0	0	0	0	0	1	3	0	0	0	0	0	0	1	1	0	0	0	0	0	0	0	0	10	0	2	0	1	0	0	0	0	0	17	1	0	0	3	0	0	0	6	0	0	0	0	0	0	0	0	1	0	0	1	0	0	6	1	0	8	1	49	0	0	0	0	0	0	0	0	0	1	0	0	0	0	2	2	2	1	0	0	36	25	3	7	0	0	1	0	0	0	0	0	1	0	0	14	0	0	1	0	0	0	5	0	3	1	4	6	5	7	12	1	0	0	0	0	0	5	0	0	3	1	2	1	0	0	0	0	2	0	5	3	5	5	4	4	0	0	1	0	0	45	0	3	0	3	0	0	1	0	0	0	0	0	0	0	0	0	0	0	0	1	0	0	0	2	0	0	15	0	0	0	0	0	7	2	1	2	1	0	0	0	0	2	1	0	0	0	0	0	1	1	15	0	0	0	1	0	0	5	1	1	2	0	0	0	0	1	0	0	0	1	6	0	0	0	0	1	5	1	0	0	0	0	0	0	0	0	0	5	0	1	0	1	2	1	0	1	0	1	0	0	5	0	0	1	0	3	0	0	2	0	0	9	0	2	0	1	0	1	1	0	3	0	15	1	0	2	0	2	0	1	0	0	0	0	1	1	0	2	0	0	0	2	0	2	1	0	3	0	0	0	7	50	0	0	0	0	1	0	0	0	2	1	0	1	0	0	6	3	0	0	0	0	0	4	0	0	0	0	1	0	13	0	1	0	0	0	0	0	58	2	0	0	0	1	3	0	1	0	0	1	0	1	0	0	0	0	1	0	1	0	0	0	1	0	0	0	0	0	6	0	0	0	0	0	0	0	0	0	0	0	1	0	0	0	0	0	0	0	0	0	0	51	0	0	0	0	0	0	1	0	3	0	0	1	0	0	1	0	0	1	0	0	0	2	0	0	0	0	0	0	0	0	0	0	0	1	1	0	0	1	0	0	51	0	0	0	0	0	4	0	5	0	0	0	0	0	0	4	29	1	0	1	0	0	0	0	3	0	0	47	0	0	34	0	0	0	0	0	1	0	0	34	0	38	0	0	0	0	0	1	0	0	0	0	38	1	0	0	0	0	0	0	0	0	1	0	0	0	0	0	6	0	7	4	0	0	0	0	0	1	0	0	0	0	0	0	0	0	0	0	1	0	2	0	0	21	0	0	0	2	0	1	0	0	0	2	0	0	0	0	0	0	0	0	0	0	0	0	0	0	38	0	0	0	0	0	0	7	0	0	0	1	0	1	0	0	0	0	1	1	0	0	0	0	1	6	0	0	0	0	0	0	2	0	1	0	0	0	0	0	9	1	1	0	0	0	1	0	0	0	0	0	0	0	1	8	0	0	0	0	0	0	0	11	5	7	0	1	0	0	0	0	0	2	0	0	0	0	2	3	1	19	0	6	8	0	5	0	0	0	9	0	0	9	0	0	0	0	4	0	0	2	18	6	0	2	0	230	0	0	0	30	6	25	0	0	1	3	1	0	2	1	5	0	0	4	0	0	0	0	7	0	0	3	0	0	1	0	0	24	2	0	0	0	0	9	6	14	7	1	4	0	1	1	3	3	1	0	0	0	1	0	1	0	2	0	0	0	0	0	1	6	1	0	0	0	6	8	2	0	18	1	72	7	1	0	0	2	0	1	1	0	0	0	0	0	0	1	0	0	0	0	2	0	2	2	67	1	0	1	0	0	0	0	0	0	0	0	0	0	1	0	0	0	0	0	0	0	0	0	0	0	0	1	0	0	0	1	0	0	0	0	0	0	0	0	0	0	0	0	0	0	1	0	5	0	0	1	1	0	0	0	6	0	13	10	1	4	1	0	0	0	0	0	0	0	1	67	0	0	0	0	0	1	0	2	2	6	1	2	104	0	12	0	0	0	6	7	0	0	0	0	0	17	3	0	0	0	0	0	0	2	0	12	1	0	0	14	0	1	1	7	0	0	0	0	0	0	5	0	2	2	20	11	0	1	0	0	0	2	0	0	0	0	6	3	5	0	9	2	0	0	2	0	74	5	0	0	84	0	1	0	4	0	3	0	2	2	0	7	0	31	0	0	11	0	0	0	0	3	0	0	6	0	0	3	14	11	2	2	0	0	0	0	8	0	0	0	0	0	2	1	0	0	0	0	0	0	3	0	0	9	0	0	3	0	0	0	0	0	7	1	1	0	0	4	4	0	0	0	12	0	0	3	2	4	7	0	4	3	6	6	3	13	15	0	0	0	0	4	0	0	4	0	0	1	1	0	0	0	0	0	0	9	4	3	3	39	12	18	0	40	0	0	0	2	0	0	0	0	0	0	0	0	1	0	0	0	0	0	0	19	2	0	0	0	0	1	1	0	0	0	0	0	40	1	0	0	0	0	3	2	0	5	0	0	3	0	0	0	1	9	0	12	8	5	2	1	0	14	1	0	0	8	7	0	0	0	0	1	0	0	28	0	0	0	5	5	2	2	0	0	1	0	2	0	1	0	6	0	1	6	0	0	0	1	1	18	9	17	0	0	1	3	4	0	1	0	0	2	0	0	9	12	0	0	0	1	0	17	34	24	0	0	5	18	0	0	1	0	0	0	1	0	0	0	0	0	2933	9	2	0	1	0	0	7	1	0	0	0	0	0	5	1	0	3	5	0	2	0	14	0	16	0	7	1	9	4	0	2	68	28	0	11	0	0	0	3	1	6	1	1	0	0	0	1	0	0	0	1	0	0	0	1	0	2	19	16	55	135	4	7	0	1	1	5	3	4	0	0	1	0	0	0	0	0	0	0	0	0	0	0	4	0	0	0	0	1	0	0	0	0	3	0	0	0	0	0	4	0	5	11	5	1	3	2	10	7	0	4	5	0	0	0	0	18	20	7	0	0	0	10	3	8	0	1	6	0	0	14	2	2	0	0	0	1	0	0	6	3	0	0	3	0	0	1	0	0	0	0	0	0	0	0	252	0	4	8	106	4	1	0	0	0	0	48	0	2767	0	4	0	2	24	17	3	0	0	0	0	0	0	0	0	6	1	0	0	0	0	0	0	0	0	0	0	0	0	27	0	0	0	0	0	0	1	6	0	12	4	0	0	0	0	0	0	0	1	0	4	0	0	2	0	0	0	0	0	0	0	0	0	0	0	4	0	5	0	10	3	0	9	0	0	0	0	2	16	0	0	0	0	0	2	0	0	8	0	0	1	0	0	0	0	0	0	0	0	13	19	1	6	23	0	0	0	0	8	0	57	6	5	3	0	0	0	1	4	0	1	17	0	0	0	1	157	0	0	1	1	0	1	0	0	0	0	1	0	0	1390	10	8	5	3	1045	0	9	11	15	14	0	58	49	36	0	23	8	8	0	0	60	45	42	36	15	0	0	0	346	2	0	4	1	0	15	4	0	0	425	1	0	1	0	0	1	1	9	0	0	0	1	35	23	8	3	3	3	1	0	0	0	0	3	8	4	3	4	0	0	0	0	0	0	0	0	0	5	0	0	3	2	7	1	0	26	0	5	0	1	0	1	3	5	0	1	0	0	3	6	0	0	0	0	0	0	0	1	0	1	0	2	4	0	8	3	0	0	12	65	35	1	1	7	44	10	1	9	15	1	12	1	10	5	0	33	0	0	3	4	3	23	5	0	8	11	5	10	2	0	4	3	0	0	3	1	1	0	0	0	16	0	2	0	0	9	0	3	1	1	0	7	0	0	3	0	0	0	0	0	0	0	3	0	5	0	0	1	2	0	102	2	2	0	0	7	1	0	15	0	0	4	0	0	0	18	1	0	24	33	0	9	5	1	3	7	4	7	2	2	2	5	4	6	1	22	5	4	1	0	0	0	0	0	0	0	0	14	5	0	8	0	0	0	0	0	0	9	3	0	8	0	0	0	0	0	0	2	0	0	0	0	9	0	0	0	0	0	0	0	0	0	0	0	0	0	0	0	0	0	3	0	0	0	12	1	0	1	0	7	3	0	0	0	1	0	0	0	3	0	0	0	0	0	0	0	7	1	2	1	0	0	0	1	0	0	0	0	0	0	0	0	1	53	4	0	0	1	0	1	2	0	4	0	0	0	0	0	11	0	3	3	2	1	0	0	0	1	0	0	0	0	0	0	4	4	12	3	5	6	1	15	2	4	0	8	2	18	3	1	25	17	7	18	0	2	1	0	1	4	1	1	1	2	5	5	2	13	17	4	29	5	2	9	8	18	1	1	6	7	2	4	9	0	0	3	0	27	55	0	2	1	15	9	1	3	61	27	4	147	0	49	2	2	0	1	0	2	7	1	1	0	8	0	708	975	56	2	0	17	0	0	0	0	0	62	12	33	17	21	30	109	8	5	7	0	19	1	10	8	1	2	1	0	1	1	4	4	7	14	8	4	1	3	2	4	7	0	0	0	4	0	0	0	1	0	4	0	0	0	0	0	3	19	1	0	0	0	6	5	0	0	1	0	1	0	0	2	3	0	0	0	0	0	0	0	0	1	5	0	0	2	0	0	0	0	0	0	1	1	0	0	3	1	0	10	31	0	1	2	0	0	1	0	2	0	0	0	0	0	0	0	0	0	0	0	16	1	0	0	0	0	4	0	0	0	0	1	0	0	0	0	0	0	0	1	1	0	0	2	0	0	0	0	3	0	31	57	1	19	0	7	0	10	0	0	0	0	0	0	0	0	0	0	0	1	0	3	7	5	4	0	0	0	0	0	0	0	0	2	0	1	0	15	0	4	0	0	1	11	0	0	0	5	0	0	2	18	30	25	2	0	0	5	0	0	6	1	10	0	0	0	4	4	2	2	4	0	5	4	5	0	2	4	18	0	1	15	76	1	0	1	0	0	0	4	5	7	0	0	0	0	0	0	4	0	0	0	0	0	0	0	2	0	0	1	2	0	0	0	0	0	1	0	0	0	8	0	0	0	0	0	0	0	0	0	2	2	3	0	0	13	0	5	2	1	1	2	6	0	1	4	1	0	0	13	3	0	0	0	0	0	0	3	1	2	1	0	0	0	0	0	0	1	0	0	5	6	0	2	11	0	1	0	0	0	0	0	4	7	0	0	9	8	4	0	0	10	0	0	2	1	0	0	6	0	0	5	3	2	3	0	1	0	0	4	3	0	1	2	7	3	0	0	0	1	1	1	2	4	0	2	110	0	0	0	0	0	0	2	0	1	0	0	1	8	0	0	1	0	5	8	0	0	6	8	5	1	0	6	0	3	1	2	284	0	0	5	0	0	0	0	0	0	2	1	0	6	10	0	5	2	1	0	1	19	0	2	0	0	0	0	0	8	0	0	0	0	0	0	0	1	0	0	1	0	0	0	0	0	0	0	0	5	0	0	2	8	0	0	0	0	9	3	0	0	0	0	20	10	0	2	0	0	3	8	19995	0	0	0	0	0	4	0	0	0	0	0	0	0	1	0	0	4	0	1	1	0	15	5	17	21	0	6	1	3	0	0	0	0	0	0	2	0	2	8	0	26	6	1	0	0	0	2	2	0	1	0	0	7	1	15	3	2	7	9	11	15	2	0	2	2	0	10	0	2	145	7	12	3	0	0	0	0	1	0	0	30	9	23	1	10	0	0	0	0	12	0	1	3	0	10	4	0	24	1	0	0	56	9	0	0	13	6	0	5	0	0	0	0	0	0	0	0	0	10	36	30	16	42	0	41	3	0	10	22	33	35	108	7	1	18	3	24	31	0	10	14	4	0	5	0	0	0	14	10	34	89	3	0	2	0	0	9	3	2	1	7	0	1	0	0	0	0	0	0	0	1	2	0	2	0	3	0	1	1	0	2	4	1	0	0	0	3	10	2	6	1	3	4	5	0	0	3	73	0	0	0	2	1	11	3	7	11	0	2	0	0	0	8	3	0	0	0	0	0	0	0	0	0	0	0	0	0	3	0	0	0	0	1	2	1	0	0	1	0	0	0	0	0	0	4	0	3	0	0	0	19	11	0	1	6	0	31	0	0	2	3	0	0	1	0	0	0	0	0	1	0	0	0	0	1	0	0	0	0	0	0	0	0	1	1	2	0	0	5	0	0	5	0	0	0	0	0	0	0	0	0	0	0	0	0	0	0	0	0	1	0	0	10	0	1	5	0	1	0	0	6	10	0	0	0	0	2	3	0	4	0	0	0	124	2	1	5	2	0	0	1	6	6	0	1	2	2	8	14	1	3	0	0	0	0	0	0	0	2	77	2	0	0	1	9	3	0	0	0	0	31	262	0	0	0	0	0	0	4	2	2	8	2	1	26	0	18	5	2	422	3	0	0	2	3	6	6	1	5	0	0	19	0	20	1	1	0	0	1	0	1	0	1	0	5	16	5	1	0	0	0	3	10	8	1	0	0	0	0	1	0	0	0	0	0	9	0	4	0	8	0	0	5	6	0	0	1	0	8	4	0	0	0	0	0	1	1	9	36	15	3	3	3	3	3	0	0	4	4	7	2	1	2	4	1	3	0	0	3	0	0	0	0	4	1	2	5	0	2	0	1	0	1	4	2	0	3	1	4	0	2	1	0	3	0	0	0	0	0	0	0	0	88	0	2	0	0	0	1	6	0	0	0	0	0	0	2	0	4	0	0	0	0	11	9	5	0	0	515	0	0	2	2	0	0	0	2	0	0	0	0	0	0	0	0	0	0	0	0	0	1	1	0	0	0	0	0	0	0	78	0	2	0	9	7	3	2	0	0	0	0	0	1	0	0	1	0	0	3	0	0	0	0	0	13	0	0	0	0	0	2	2	0	0	1	0	0	1	0	0	0	23	0	0	2	1	0	1	0	0	1	3	0	2	5	4	2	4	1	0	12	3	3	9	7	68	3	19	54	0	0	2	1	0	3	3	5	2	0	0	1	0	0	0	74	1	0	0	0	96	0	0	0	1	0	103	0	2	1	0	0	3	0	0	0	0	0	0	0	0	1	5	0	0	1	0	36	11	0	0	0	0	0	0	0	1	11	1	0	1	0	0	0	5	12	0	0	0	0	6	0	1	0	7	0	0	5	3	0	0	0	0	1	0	2	2	7	1	1	0	2	0	0	57	1	2	0	1	7	7	0	0	3	72	3	6	200	2	0	0	0	0	0	0	61	5	5	0	0	0	1	6	1	4	0	2	0	2	0	0	6	0	0	0	8	1	7	125	2	0	17	46	1	0	1	0	0	5	1	1	0	1	0	16	1	0	2	1	0	0	1	0	0	0	0	0	2	0	0	0	0	3	0	0	0	0	9	36	1	8	0	0	26	0	0	0	0	1	0	3	4	0	3	4	15	9	4	8	12	0	3	11	4	0	0	0	0	2	0	4	0	0	56	0	0	3	6	8	6	1	6	4	1	4	5	2	1	1	75	2	0	1	0	0	4	0	0	19	44	51	0	0	0	0	0	0	1	0	0	1	0	0	0	4	0	0	0	2	0	0	0	0	0	0	0	0	0	2	0	0	0	0	0	0	0	0	0	0	0	0	1	3	0	0	0	0	0	0	0	0	0	0	0	0	0	0	0	0	1	2	5	3	0	0	0	0	1	3	1	0	2	0	0	0	0	1	126	4	16	2	0	3	3	2	3	0	7	3	1	0	0	0	0	3	3	0	0	3	0	0	1	0	4	2	0	0	3	0	0	11	8	0	6	1	0	5	0	0	0	30	5	4	3	8	4	9	8	1	22	6	1	0	0	0	2	0	5	10	22	14	0	11	4	5	3	1	0	0	0	1	0	0	0	5	0	0	0	0	0	0	11	0	0	0	0	0	0	0	0	2	8	4	2	7	1	0	1	5	11	2	11	6	5	20	19	16	1	0	0	0	0	1	0	5	0	5	6	2	10	0	0	1	0	0	0	0	0	0	0	0	0	0	0	0	0	9	43	156	1	66	54	15	9424	13	0	1	0	0	0	0	0	2	2	4	1	0	0	7	0	0	0	0	1	0	0	0	2	0	0	0	165	54	0	2	9	0	2	1	0	0	0	51	0	40	0	0	242	0	0	0	4	0	7	0	1	0	0	0	0	0	0	0	0	0	3	0	0	0	0	0	0	0	0	1	0	0	0	0	1	0	1	0	1	1	0	0	0	0	4	0	1	0	0	139	72	0	3	7	3	0	2	5	1	0	9	0	3	0	0	0	0	0	0	0	0	0	0	0	0	0	0	1	0	0	1	0	0	0	7	0	6	0	0	0	2	0	0	0	0	1	0	0	3	0	0	2	1	0	0	0	0	0	0	0	0	0	0	0	3	0	0	0	9	8	8	5	3	0	0	0	0	0	0	0	0	3	0	23	0	1	0	3	1	7	17	0	0	0	0	0	0	0	1	0	1	0	0	0	0	0	0	2	1	0	0	0	0	0	0	0	0	0	2	0	0	0	0	0	1	0	0	87	0	0	0	0	0	0	0	0	0	14	0	0	0	0	0	0	0	0	2	0	0	0	0	0	0	0	0	0	0	0	0	1	0	0	21	0	0	0	0	0	0	6	0	0	0	0	0	0	0	0	0	0	0	0	5169	0	0	0	0	0	3	0	0	1	0	0	0	0	0	2	0	0	0	0	0	0	0	0	0	0	0	0	0	0	0	0	0	0	0	0	0	0	0	0	0	0	1	0	13	0	0	0	0	1	0	0	0	0	0	1	0	0	0	0	2	0	0	0	0	0	0	0	0	0	0	0	0	0	0	0	0	2	1	0	0	0	5	0	0	0	0	0	0	0	0	0	0	0	0	0	0	0	0	0	0	1	0	0	1	1	0	0	0	128	0	0	0	0	1	0	1	3	4	0	0	1	1	24	0	94	2	2	0	0	6	0	5	1	0	4	182	2	2	0	0	74	1	47	0	0	0	0	2	5	3	0	2	3	1	0	3	3	2	0	7	0	2	0	0	1	1	3	0	13	0	6	0	20	3	6	0	83	2	2	3	0	0	2	5	3	1	4	1	0	1	3	1	0	0	7	0	1	33	1	1	0	0	11	5	0	0	0	0	41	3	8	2	1	0	5	0	7	1	1	5	0	2	34	0	0	279	0	1	8	0	2	0	61	0	15	10	3	0	4	0	2	4	13	3	6	5	0	1	2	4	2	7	1	7	14	6	3	91	86	22	8	0	0	3	31	0	2	0	2	0	0	0	0	0	0	2	0	0	0	1	0	2	0	1	0	61	2	29	0	0	0	0	0	4	0	24	1	11	3	0	0	0	3	2	0	0	0	0	0	0	4	0	0	1	0	0	1	0	0	4	0	0	0	2	0	0	1	0	2	0	2	0	0	0	0	0	1	0	0	0	0	1	1	5	0	0	0	1	0	0	0	0	0	0	1	19	0	0	0	0	0	14	0	0	0	2	0	0	0	0	0	4	0	2	0	0	0	0	0	0	0	0	1	0	7	0	1	0	0	1	8	1	32	0	1	0	0	0	1	0	0	0	0	20	0	3	1	2	0	0	0	0	0	0	0	0	0	0	0	0	0	4	0	0	0	1	6	7	0	8	9	2	0	0	2	1	0	0	0	172	0	8	3	80	0	0	1	0	1	6	0	0	0	4	2	2	0	0	0	0	1	14	28	290	0	5	2	0	2	0	0	1	0	0	1	0	0	0	0	0	0	0	0	2	7	1	0	0	12	10	0	1	5	0	0	0	0	0	0	0	9	6	6	10	13	0	7	5	379	0	9	0	0	11	0	8	4	5	0	0	0	0	0	0	21	2	0	0	2	0	12	11	3	0	0	1	1	0	0	0	0	1	1	0	6	4	4	0	0	16	0	0	0	0	0	0	1	0	4	0	2	0	3	4	0	0	0	18	0	1	0	0	0	1	3	0	2	0	5	0	9	10	0	1	11	0	0	10	2	4	1	154	21	0	0	0	0	0	0	0	0	1	1	0	0	0	0	1	0	3	5	15	0	0	0	0	3	1	7	0	2	0	0	0	11	2	1	2	0	0	0	3	46	9	23	5	0	0	0	3	2	7	0	0	0	1	0	0	34	38	9	0	14	0	0	2	2	0	0	0	0	1	0	3	17	0	9	6	1	3	0	17	0	3	1	0	96	0	3	3	10	9	2	1	1	18	17	1	0	0	0	0	0	1	18	0	0	145	0	2	0	1	0	0	0	17	5	2	0	0	2	0	3	0	0	1	2	1	0	8	0	0	0	6	1	2	44	1	0	1	0	0	0	0	16	0	0	0	1	0	1	0	6	2	2	6	6	1	37	0	0	0	3	4	0	0	1	0	0	10	0	0	1	0	0	0	0	1	10	5	1	1	0	6	7	0	0	0	0	0	1	0	20	0	1	0	9	0	0	5	0	1	6	0	10	37	0	0	0	0	0	11	5	1	0	2	1	1	3	0	0	2	2	0	0	0	4	21	2	1	0	0	0	0	1	0	0	0	0	2	3	22	2	0	30	0	2	25	6	4	81	2	6	11	25	30	3	34	3	4	24	6	24	11	0	1	0	1	2	3	0	0	0	1	2	0	5	0	0	0	0	0	0	0	0	1	0	0	0	3	7	0	2	0	0	0	0	0	0	0	0	0	0	0	0	0	0	0	0	0	0	0	0	0	0	0	0	0	0	0	0	3	3	0	0	0	0	0	0	0	1	0	0	0	0	0	0	0	0	0	0	0	0	0	0	0	0	3	25	0	13	2	0	0	1	0	0	0	8	6	8	7	0	9	20	2	0	2	0	1	1	0	0	0	0	0	0	0	7	26	1	12	1	6	0	0	0	4	1	2	0	0	1	2	2	2	0	0	0	0	0	4	1	0	0	3	0	14	0	6	1	3	0	0	3	8	0	3	14	0	1	0	0	0	0	0	0	9	0	1	0	0	0	0	1	2	1	1	0	0	114	3	0	0	0	20	0	0	1	0	6	0	0	0	48	5	0	1	0	3	63	0	0	0	4	8	0	4	0	1	15	0	0	0	0	0	11	2	1	0	2	16	0	0	0	7	0	1	0	4	2	1	1	0	3	5	0	2	0	0	0	8	1	0	0	2	7	1	7	5	1	0	4	3	1	4	1	1	10	4	0	0	0	3	0	0	1	8	2	0	1	3	0	1	0	0	0	4	0	0	0	0	52	0	0	1	0	0	0	0	0	0	1	1	0	0	0	0	0	1	2	1	2	0	2	0	0	0	0	0	3	4	0	0	1	0	12	0	0	76	7	16	2	6	1	1	76	30	0	11	3	1	0	0	4	10	0	0	0	7	0	7	6	4	0	0	1	0	0	7	3	3	0	0	13	15	7	4	0	0	0	0	0	0	26	0	0	0	3	1	0	0	0	0	0	0	1	52	1	22	4	6	0	13	0	0	0	0	0	0	0	4	0	11	0	1	0	11	0	0	9	3	1	14	0	97	31	1	0	0	14	5	7	58	9	10	5	9	43	0	22	25	2	0	0	0	0	1	1	2	100	34	4	0	21	0	1	0	0	9	0	0	2	4	0	0	0	23	42	0	0	0	28	13	5	8	3	9	0	6	11	0	0	26	0	0	5	6	1	0	0	0	0	0	0	0	4	0	0	0	1	0	0	0	0	0	0	0	0	0	0	0	25	6	0	0	1	18	10	0	0	0	0	1	0	2	0	0	0	2	6	4	0	20	0	4	1	0	0	0	7	0	9	4	0	0	16	8	5	2	6	22	13	0	1	3	50	7	23	25	0	0	0	0	0	0	0	0	0	0	0	2	2	0	0	0	0	0	0	0	3	0	0	0	3	2	11	1	0	3	0	4	0	0	0	0	4	0	0	0	1	0	0	9	14	2	36	1	4	0	0	0	0	1	2	0	0	0	0	0	1	0	0	0	0	0	0	1	0	0	0	0	0	0	0	2	4	0	0	0	0	3	0	7	0	0	0	0	0	1	1	0	0	0	0	4	1	0	0	0	0	1	1	0	5	1	0	14	4	8	0	3	0	272	0	137	145	0	0	1	0	2	0	5	0	8	156	77	9	9	6	2	21	5	10	5	6	15	8	0	5	5	1	0	0	8	0	0	0	0	0	0	1	1	0	0	0	6	0	0	2	0	0	0	0	0	1	0	0	0	0	0	0	0	0	0	0	0	0	0	0	0	0	0	0	0	0	0	0	0	5	2	0	8	3	10	11	11	18	0	0	0	2	0	0	3	0	0	2	0	0	12	4	0	0	2	2	0	7	0	1	1	8	0	0	0	0	0	0	0	0	0	0	0	0	0	0	3	3	0	0	6	0	0	6	2	0	0	0	0	1	0	5	6	1	0	0	2	2	0	3	2	0	1	2	0	4	0	7	3	0	0	0	0	3	0	0	0	2	0	0	0	42	0	2	0	0	1	7	0	0	0	0	2	0	0	0	0	0	6	1	0	22	10	0	0	0	0	0	0	0	0	2	0	0	2	2	0
LakWasMet22_HOW5_2_rpkm	0	1	0	0	0	9	13	3	0	0	0	3	2	2	4	2	0	3	11	0	1	3	0	34	1	2	0	0	0	15	0	12	0	13	5	9	2	0	7	0	0	0	0	26	26	38	28	10	1	7	0	2	1	0	0	7	1	5	23	20	325	0	0	39	2	1	0	0	20	18	3	1	0	0	4	0	2	0	0	0	0	17	0	0	0	0	0	0	2	0	0	0	12	10	12	12	1	0	1	0	0	0	0	0	0	0	0	0	0	0	2	0	67	5	21	11	0	54	0	1	0	1	1	10	0	0	4	3	0	0	0	74	14	0	0	0	0	0	7	0	0	0	0	6	4	0	0	0	8	3	7	17	0	11	36	0	9	6	26	2	6	7	0	12	6	14	0	5	0	64	0	0	0	0	0	0	0	1	0	1	0	0	0	1	5	68	0	0	0	16	18	2	5	7	1	0	8	13	18	2652	8	0	16	0	0	1	10	0	15	3	7	3	55	24	8	0	12	1	0	2	0	2	27	4	3	8	0	0	32	0	3	0	86	0	0	0	9	15	237	3	0	0	11	8	57	6	0	0	9	26	4	4	22	0	2012	181	0	1	0	0	2	0	1	13	5	0	8	1	6	16	20	0	28	0	2	1	0	1	37	27	1	35	55	33	26	0	0	0	4	0	0	0	1	0	2	0	4	15	5	0	0	60	56	1	3	14	22	64	9	0	48	0	24	10	0	0	0	7	9	0	2	1	0	0	28	10880	2	1	4	0	0	11	0	2	0	0	15	0	0	0	0	1	42	42	16	0	8	2	0	1	0	1	1	0	11	0	1	1	0	47	7	1	2	0	1	8	1	27	19	19	0	40	3	0	43	3	0	3	0	1	0	0	21	3	7	0	171	0	0	0	0	1	81	0	0	22	23	0	0	87	0	22	0	92	54	0	4	0	0	4	1	12	13	7	5	28	12	18	2	1	0	0	0	0	0	0	1	0	5	0	233	3	7	0	0	1	3	1	5	0	28	18	0	0	2	22	0	0	0	0	0	84	14	58	64	23	19	6	0	4	0	0	0	10	1	27	6	0	3	8	44	16	46	0	0	0	7	2	231	0	2	3	2	9	0	2	0	89	72	2	0	3	57	16	32	0	23	1	0	1	3	4	3	0	0	0	0	4	1	1	0	0	0	4	4	0	1	0	3	9	0	0	0	0	2	0	0	0	0	0	1	0	0	6	10	0	13	2	0	16	4	8	1	18	8	0	1	1	4	0	0	1	1	0	0	35	0	0	0	0	0	1	0	1	6	4	6	0	14	0	0	0	0	8	34	7	2	134	4	35	21	60	139	14	26	0	5	28	27	0	0	0	3	1	9	5	4	0	0	0	18	0	0	3	31	10	0	40	0	10	1	213	116	227	3	0	75	0	162	1	58	75	38	6	0	11	1	10	0	11	4	9	0	0	0	2	0	0	0	8	3	85	0	2	0	4	0	5	3	1	39	1	5	11	10	0	1	0	1	5	2	163	0	6	0	0	2	6	7	24	2	27	1	0	1	0	8	0	2	0	2	3	5	2	0	0	0	1	0	20	7	0	13	0	4	0	1	3	0	9	0	5	3	2	2	0	9	0	9	0	0	1	0	0	59	4	0	5	6	0	3	0	8	1	3	1	1	0	10	0	0	2	1	0	3	0	0	1	0	12	0	26	1	0	32	31	5	0	2	37	1	0	0	14	2	6	1	0	73	6	0	7	0	46	0	0	0	0	0	0	0	0	0	1	0	65	0	0	0	0	0	0	3	1	0	0	11	0	0	6	6	22	1	0	0	1	2	0	2	34	0	0	0	0	97	2	31	1	0	0	0	0	1	0	0	0	6	0	0	0	0	0	0	7	16	0	0	4	1	1	1	0	0	1	0	0	0	121	27	0	0	2	0	0	2	2	1	9	61	17	0	0	11	2	0	0	1	6	1	12	36	22	0	1	0	0	2	0	5	1	0	1	0	1	0	0	0	0	2	29	3	0	1	0	23	4	0	0	0	0	0	0	0	0	0	0	1	0	0	0	0	0	0	2	0	0	1	0	0	0	0	0	0	7	22	11	49	4	11	0	0	1	0	3	0	0	0	0	0	0	364	1	0	1	0	0	2	0	0	12	0	0	0	9	8	0	9	2	0	0	0	2	0	0	0	0	0	0	2	0	0	0	0	0	1	1	0	2	0	2	2	7	7	225	7	20	2	0	2	0	7	8	23	0	11	1	0	2	1	0	0	14	0	0	1	1	0	3	2	0	1	2	2	0	0	0	0	0	0	1	0	3	0	0	0	0	0	67	0	0	0	43	12	3	1	17	0	1	173	3	11	0	0	0	0	1	1	5	157	0	0	1	0	1	0	0	1	1	0	0	2	0	2	6	1	0	0	0	0	4	4	6	0	9	0	0	0	0	21	19	6	1	2	2	0	3	9	1	10	31	0	0	4	0	0	0	0	0	1	26	9	0	0	0	1	0	4	0	0	0	0	0	0	0	6	18	43	0	6	23	0	6	0	0	5	4	0	2	6	0	0	3	0	0	0	3	127	43	23	0	1	0	5	0	0	10	13	0	18	0	0	2	0	0	1	1	0	0	0	0	0	0	0	0	10	0	0	1	0	2	0	0	0	0	0	0	0	0	1	0	35	12	1	0	0	0	3	6	4	0	0	0	13	0	0	0	0	3	0	0	5	0	27	25	11	113	0	2	0	11	2	0	0	1	0	7	4	0	0	0	0	0	0	1	0	0	37	51	0	0	1	2	13	0	0	0	0	1	12	1	0	0	0	0	14	0	0	2	21	0	3	0	28	10	0	5	0	15	0	0	3	0	1	63	71	0	0	0	0	3	13	1	0	23	0	14	1	0	0	0	0	1	7	23	3	19	5	21	0	39	1	0	2	2	0	30	2	0	9	1	0	6	0	0	0	6	0	0	35	4	1	0	0	0	0	1	0	3	1	10	0	2	0	0	0	0	4	1	0	0	0	0	40	0	0	3	2	0	2	0	0	0	0	1123	3	0	64	19	32	19	1	4	8	0	0	0	4	2	3	4	1	1	2	0	0	1	25	10	0	1	0	0	17	3	5	0	12	2	8	21	0	2	12	16	8	8	7	17	3	0	0	0	3	0	27	0	10	13	11	77	11	4	26	0	0	4	10	7	0	13	1	2	0	35	6	0	10	0	2	21	2	16	29	17	2	1	20	0	0	0	0	0	1	3	4	0	0	0	6	1	3	105	1	0	17	0	18	6	1	2	0	5	2	31	4	5	0	0	4	2	0	0	0	543	43	52	44	2	1	4	0	0	0	0	0	47	4	3	0	17	0	0	1	107	272	61	66	13	0	1	0	122	0	0	4	0	1	0	1	0	53	77	41	41	89	62	10	0	32	4	0	0	3	0	0	2	78	5	3	0	0	3	0	46	10	0	0	0	0	3	0	1	0	1	0	1	8	0	0	1	5	0	0	6	5	13	0	0	0	4	2	29	0	2	0	0	0	0	1	1	0	0	1	0	0	1	0	1	2	13	0	1	2	336	0	0	0	0	0	0	0	0	0	0	0	0	0	0	0	0	0	0	0	0	1	5	0	154	2	0	41	0	0	0	0	144	7	27	17	0	0	158	0	64	0	0	3	0	2	0	46	8	54	0	1	1	0	0	3	1	0	9	4	1	0	0	15	0	3	3	0	0	0	0	0	0	0	11	5	79	9	14	0	3	6	4	0	0	0	13	12	0	0	0	10	2	0	19	15	0	21	4	4	20	21	1	1	14	0	0	5	1165	0	3	10	2	6	1	14	0	0	0	0	0	0	0	2	0	17	6	25	85	49	22	70	5	0	0	0	5	1	20	0	9	4	31	52	1	0	0	3	1	3	1	0	8	46	0	32	13	1	6	1	4	1	24	0	0	87	12	17	0	1	0	0	18	0	102	0	22	38	10	0	0	33	8	4	71	17	7	3	1	2	7	0	11	33	146	13	82	0	2	2	14	5	21	0	1	5	3	1	2	143	0	2	0	3	5	0	7	5	1	163	7	4	0	2	0	0	1	0	38	0	0	2	0	0	2	9	0	4	0	28	0	636	0	1	36	280	692	0	12594	4	1	8	0	0	1	2	0	16	0	0	0	1	11	2	0	0	75	0	0	0	1	0	0	1	79	0	21	0	4	0	2	253	6	9	0	0	1	5	0	6	13	0	0	17	0	3	0	2	0	1	0	7	0	0	22	13	1	0	3	92	93	6	31	0	47	76	1	52	3	61	1	16	26	9	5	34	4	0	42	5	1	0	0	0	0	0	0	0	0	0	2	0	0	10	2	1	3	0	51	120	0	0	0	0	0	0	0	1	0	0	0	1	0	0	0	0	0	8	15	28	0	0	0	4	0	2	1	2	0	0	3	8	0	4	0	0	1	1	1	0	0	0	0	0	0	0	3	0	0	4	1	0	0	3	0	0	6	0	0	137	0	19	18	7	4	23	0	25	0	5	29	79	32	0	5	0	0	0	0	0	0	0	4	0	0	18	14	0	1	0	2	0	0	0	0	1	4	0	0	5	15	4	5	11	51	0	29	2	0	2	0	19	27	64	3	0	0	0	0	1	0	0	0	0	0	2	0	6	0	1	0	4	0	0	0	4	0	23	3	2	0	0	0	2	0	0	4	0	1	34	94	15	1	0	0	10	0	0	0	4	0	0	29	0	0	0	0	3	12	0	0	4	0	36	0	0	0	0	3	15	0	1	40	0	0	0	0	1	0	0	0	2	0	0	4897	0	0	0	0	0	26	0	0	5	42	0	25	33	17	6	0	3	0	0	0	53	0	58	6	0	1	0	0	0	2	0	14	1	0	0	0	0	9	0	0	1	5	0	1	0	0	0	0	0	0	0	0	0	1	13	61	0	0	7	1	0	0	2	0	0	1	0	0	0	0	0	0	8	2	0	0	2	12	1	2	1	32	0	2	0	478	0	0	99	131	38	3	3	0	15	4	0	0	0	0	2	1	129	0	13	42	19	2	13	1	0	0	8	0	12	0	0	4	3	22	0	1	9	2	6	0	0	16	0	0	2	15	0	0	0	2	2	11	2	0	3	3	1	1	2	0	19	8	0	8	2	0	0	0	8	38	0	0	1	1	0	0	0	2	11	1	1	3	0	3	35	1	0	0	1	0	20	10	0	4	0	1	8	0	0	0	0	0	1	1	0	2	1	1	0	0	0	0	0	0	0	2	6	1	0	1	1	0	1	4	0	0	10	1	15	0	16	4	20	0	0	11	1	0	0	0	0	14	2	1	0	0	2	1	47	58	42	17	63	58	67	117	48	41	247	96	59	42	11	40	13	137	125	6	13	12	103	182	223	52	526	40	49	23	47	2	63	6	0	6	0	1	0	0	0	0	5	0	33	125	1	0	1	0	0	0	2	0	1	0	0	0	0	0	0	6	0	0	2	4	8	0	14	0	36	1	4	0	1	1	21	0	0	1	2	1	0	7	0	0	0	0	2	2	2	21	2	0	0	0	3	5	3	17	2	0	2	4	0	1	0	8	0	1	8	6	0	0	0	1	113	0	0	47	1	0	0	0	1	7	0	0	5	0	12	9	0	16	0	0	0	0	8	0	0	2	0	0	0	5	7	2	0	8	2	76	0	9	10	6	0	0	0	0	0	0	0	2	4	0	0	0	0	54	11	2	0	0	1	0	0	0	5	10	22	5	14	8	7	1	1	0	3	75	5	1	2	7	2	2	0	0	0	1	23	0	18	15	5	0	2	0	0	16	0	0	9	0	0	0	1	5	0	1	1	0	1	1	0	0	2	0	4	1	1	0	4	2	1	0	0	960	0	5	1	796	5	1	0	0	2	3	0	0	0	4	1	0	0	0	0	1	8	0	44	66	0	4	0	0	40	0	0	27	5	0	53	1	0	95	0	14	9	2	0	0	0	1	1	3	0	3	1	5	2	0	54	1	4	1	2	0	0	6	23	0	0	0	0	0	0	0	0	0	3	0	0	0	1	2	0	0	11	0	1	0	0	13	3	8	281	128	4	0	11	0	1	0	0	0	1	2	2	1	0	0	0	0	0	1	10	3	18	34	0	9	0	0	0	1	32	0	34	17	17	1	0	1	177	0	0	1	0	0	0	0	0	0	0	0	0	2	50	13	0	2	0	0	0	0	0	0	0	2	14	14	4	4	1	1	0	1	26	1	0	17	1	0	0	0	6	0	0	1	9	0	0	1	34	3	0	0	0	0	1	2	0	4	2	3	1	2	4	2	2	2	16	3	9	0	0	3	0	0	0	0	1	9	0	0	0	1	0	0	0	6	4	0	234	1	1	13	0	1342	1	16	0	0	3	1	2	18	1	13	5	0	0	0	2	0	0	1	0	16	0	0	1	0	0	0	53	0	13	10	26	9	0	9	9	7	1	6	0	14	0	10	1	9	1	6	7	10	2	2	0	4	0	8	0	3	0	0	0	18	0	9	0	19	36	11	30	27	8	14	1	0	5	12	5	0	15	3	43	0	59	10	3	14	0	3	2	13	14	13	0	0	0	3	0	0	7	1	0	0	0	19	9	0	0	0	7	50	0	0	0	0	0	0	0	2	15	0	0	3	0	1	4	0	0	0	0	1	1	1	0	0	0	2	1	79	1	0	43	26	43	0	15	1	2	0	0	23	167	1	0	2	0	7	2	0	25	0	19	4	0	0	0	0	0	17	0	0	45	11	0	138	0	12	1	0	0	14	35	0	1	1	6	12	4	2	1	0	0	3	8	4	0	4	30	3	1	3	45	13	0	12	5	0	0	0	812	285	375	3	0	0	1	2	0	7	2	65	0	0	0	1	0	2	27	318	14	5	0	1	0	0	0	0	59	2	1	0	0	1	2	0	1	6	0	0	16	0	0	0	0	0	0	0	6	0	117	3973	0	1	0	0	0	0	1	16	1	0	0	0	0	0	26	23	2	0	1	0	0	0	1	142	3	1	1	0	5	2	0	0	9	2	0	14	2	1	0	0	0	0	0	5	2	2043	2	0	3	4	6	0	1	0	0	0	0	1	0	0	0	8	1	20	0	0	0	0	0	1	0	0	0	0	0	0	2	0	0	0	13	0	1	0	0	0	2	0	0	0	0	0	0	0	0	0	0	0	0	0	13	0	0	0	0	13	0	0	0	9	1	0	69	0	0	0	0	0	0	424	2	1	0	4	3	6	6	168	7	0	29	3	0	13	4	2	105	0	0	63	0	0	0	0	0	0	0	0	10	0	0	2	0	0	0	0	0	0	0	0	0	0	2	0	0	0	0	0	0	1	6	0	1	0	1	1	18	0	1	1	0	18	0	1	0	1	0	7	0	17	0	15	28	9	2	6	0	1	0	0	0	0	2	0	4	221	0	4	0	14	1	19	0	0	0	0	0	0	1	4	5	0	0	14	20	3	0	8	5	8	0	0	0	1	4	0	0	2	0	0	0	29	0	7	7	0	10	2	53	28	0	0	0	0	0	0	0	10	2	26	0	0	0	0	0	0	35	234	0	63	2	0	0	5	0	0	0	2	0	0	0	3	14	0	4	12	35	8	0	0	0	1	3	1	5	0	77	0	15	3	0	2	2	0	0	0	9	6	0	0	0	0	25	0	4	0	13	0	4	4	10	5	0	21	7	8	1	1	25	0	0	0	11	0	0	11	0	0	0	20	287	0	0	1	0	1	3	0	1	0	0	0	3	0	1	0	0	0	0	76	89	0	0	0	0	0	0	65	0	3	0	1	0	2	0	1	4	0	1	2	2	0	0	1	0	3	3	5	20	4	0	0	35	0	5	0	0	0	0	2	3	0	4	0	6	5	8	0	0	0	9	21	2	10	1	0	2	0	0	1	0	0	0	0	0	0	0	1	16	0	0	6	1	0	1	0	0	0	0	0	0	2	3	0	13	1	0	0	0	0	0	1	9	0	0	1	45	1	0	5	4	0	0	1	0	0	0	0	0	17	0	0	1	0	3	3	2	0	0	0	0	0	0	0	1	16	0	2	1	0	157	1	0	0	22	1	0	0	0	1	0	0	0	11	0	0	0	0	14	4	0	0	6	45	11	0	3	2	11	7	0	0	0	0	0	0	0	2	0	0	11	0	1	75	0	0	2	0	2	0	0	0	43	0	0	0	0	0	0	5	0	0	0	0	0	1	59	0	12	0	0	0	6	0	2	0	9	39	0	0	0	0	0	1340	0	2	0	0	0	0	22	0	0	9	0	1	0	0	0	1	0	0	0	1	1	0	1	0	0	0	0	0	4	0	0	9	0	0	0	0	0	1	7	0	2	0	2	0	0	0	0	0	0	5	1	0	0	2	2	0	2	0	0	1	3	0	0	0	0	0	0	0	0	0	0	0	0	0	0	0	0	0	0	0	0	1	0	0	0	0	0	0	0	0	0	3	0	0	0	0	0	0	3	0	0	0	101	0	7	26	0	1	2	0	0	9	0	0	2	0	40	0	16	0	0	1	12	0	1	0	0	0	0	195	96	2	6	1	0	65	0	148	10	0	0	2	3	0	0	0	0	0	1	0	1	10	0	0	0	0	0	13	0	0	1	11	0	0	1	1	0	0	4	1	0	0	0	0	0	0	0	0	0	0	0	0	0	3	0	78	0	44	2	0	6	0	1	1	0	0	4	0	282	0	0	0	0	2	1	0	0	0	1	0	0	0	0	4	2	0	34	0	0	2	0	0	1	0	0	0	0	4	14	0	0	0	0	0	1	0	0	2	27	0	4	0	0	0	0	0	0	3	0	0	2	0	23	1	0	3	0	2	19	0	0	101	0	0	0	0	1	0	0	0	0	0	0	0	0	0	2	0	0	0	1	0	9	0	1	0	0	26	0	0	0	45	0	0	0	0	1	1	0	0	11	177	0	0	0	0	0	0	0	22	0	1	0	3	0	0	1	0	23	3	0	0	0	0	2	0	0	0	0	0	0	0	2	0	0	5	1	0	0	0	5	2	21	0	20	0	3	0	4	0	0	0	0	0	0	1	0	0	1	0	0	25	14	0	49	1	3	0	0	3	1	14	1	0	0	1	0	0	0	0	0	0	86	0	3	0	10	0	0	0	0	0	4	78	2	36	0	0	0	0	1	1	0	0	1	1	0	25	5	1	1	0	0	0	0	24	0	0	11	2	0	5	0	4	1	0	2	3	0	0	2	3	0	7	0	0	0	0	0	0	0	0	11	0	4	0	6	0	2	1	0	0	0	0	7	0	0	0	0	2	0	11	0	0	6	2	5	0	1	0	0	0	0	0	12	0	0	7	1	6	0	57	13	5	124	214	10	0	1	0	248	1	16	79	3	4	0	0	78	134	0	44	0	9	26	0	973	0	0	0	0	9	0	0	14	9	0	16	0	0	9	1	17	19	53	1	1	24	0	24	0	21	3	0	9	2	1	0	0	0	0	1	0	6	16	0	0	1	14	23	0	4	31	6	1	1	0	0	8	0	0	0	0	5	2	0	0	18	1	2	43	65	0	0	0	18	1	11	0	0	8	0	1	0	0	1	1	0	35	103	1	0	3	2	0	0	0	8	1	1	0	0	0	0	0	21	4	0	2	0	0	0	0	34	8	7	0	22	0	0	2	0	0	0	5	0	12	0	2	2	0	4	1	1	0	0	3	13	1	5	13	0	0	0	28	0	0	4	0	21	6	1	1	0	4	0	3	11	0	2	21	1	0	1	0	7	0	1	3	46	43	86	3	9	19	19	121	2	60	19	24	1	120	149	77	0	484	22	57	37	20	4	62	8	85	5	11	0	47	0	3	0	0	0	2	3	0	0	0	1	1	6	1	0	1	0	0	0	72	2	2	39	2	0	3	0	1	0	0	74	0	13	8	1	0	0	1	1	0	61	0	1	0	5	1	0	0	135	7	0	3	0	9	1	0	64	0	20	1	96	0	3	0	0	5	0	36	117	4	21	1	69	0	2	0	3	0	1	10	2	0	0	0	0	1	0	2	27	9	0	0	0	22	0	0	0	2	33	0	0	13	3	2	0	1	0	0	3	0	4	2	0	0	2	8	2	0	6	21	14	3	13	13	0	1	0	1	0	2	0	5	0	0	4	0	73	0	1	53	1	0	2	0	0	0	0	31	0	1	8	0	0	0	0	6	0	8	1	0	18	5	10	4	0	3	2	2	0	0	9	0	0	0	1	0	0	0	0	0	0	0	1	0	0	0	12	10	0	1	7	1	0	0	0	0	0	0	4	156	0	0	0	1	74	2	5	2	9	1	0	0	67	72	129	0	0	1	0	33	0	0	0	0	19	0	1	1	2	0	0	0	0	1	131	1	6	0	36	0	0	2	0	6	1	0	4	13	3	0	0	0	0	0	0	0	1	6	34	0	9	5	0	2	7	11	0	2	4	39	0	1	5	6	1	40	16	0	10	0	0	1	3	4	0	5	15	0	2	0	17	41	0	6	0	0	0	0	3	1	12	0	3	0	0	0	0	0	1	0	2	16	1	1	1	13	4	10	0	1	38	4	0	0	0	40	0	0	0	1	0	8	12	0	1	0	0	2	7	2	8	0	1	0	0	0	0	0	0	11	0	6	0	2	0	0	1	0	1	29	6	3	0	12	0	0	0	14	3	0	0	5	1	0	0	7	0	0	0	4	2	2	21	4	0	25	2	185	0	0	0	0	0	0	0	0	0	0	0	3	3	0	5	5	0	1	1	0	71	23	13	6	0	1	0	0	1	0	0	2	1	0	0	37	2	0	4	0	0	1	12	0	75	46	1	43	5	66	62	7	0	1	4	0	0	71	0	0	68	3	6	16	0	0	0	0	7	0	30	12	0	9	36	16	84	0	0	0	0	82	0	3	0	2	0	2	1	0	0	0	0	0	2	0	0	3	0	0	3	6	1	1	2	6	0	0	105	5	0	0	2	0	13	15	0	4	11	0	0	1	0	9	0	0	0	0	0	0	11	6	52	0	0	0	1	0	0	10	2	3	1	0	0	0	0	1	2	0	0	26	3	0	0	2	0	1	33	0	2	1	0	0	0	0	4	6	0	2	34	0	1	3	6	13	5	0	13	10	0	3	17	0	3	0	0	142	0	0	0	0	0	16	2	3	8	6	0	2	5	0	12	0	54	9	0	9	0	15	0	5	2	0	1	0	18	7	13	1	0	0	1	0	0	9	11	0	75	0	4	0	0	248	0	4	1	0	2	10	0	2	16	0	0	1	5	1	59	3	0	0	2	0	0	3	0	0	1	1	0	0	82	5	13	6	0	3	3	0	167	7	0	0	0	0	8	0	2	1	0	40	2	0	0	1	3	1	5	1	3	0	0	5	0	10	0	0	0	0	17	0	0	3	1	0	0	0	0	0	0	0	0	1	0	0	0	0	0	0	0	0	1	66	0	2	0	1	2	22	3	0	10	0	0	12	0	0	5	3	0	0	0	0	2	3	0	0	0	1	0	0	0	1	0	0	8	15	7	1	0	9	1	0	113	0	0	0	1	0	10	0	6	0	1	3	2	0	0	3	35	1	2	1	0	0	0	2	4	1	0	63	0	0	42	0	12	0	0	0	4	0	0	87	0	17	0	2	0	1	0	4	0	0	0	0	53	0	0	2	0	19	2	0	0	0	3	0	0	0	0	0	14	0	16	27	0	0	0	0	2	2	0	0	2	0	0	0	2	0	0	1	4	0	1	0	0	44	0	0	4	2	26	1	0	0	0	23	0	0	6	0	0	0	0	0	0	0	0	0	0	0	82	0	0	18	0	0	0	6	3	1	0	1	0	3	1	0	4	0	3	3	1	0	1	0	3	47	5	0	0	0	0	1	16	0	6	6	0	0	0	0	7	3	4	0	1	4	6	0	0	0	2	0	0	0	13	11	0	2	0	0	0	0	0	23	32	24	1	17	0	1	0	0	0	11	1	1	0	1	35	28	13	58	1	6	42	0	35	0	1	5	22	1	0	19	1	0	0	0	9	0	0	16	81	15	2	6	4	202	0	0	0	20	69	100	0	1	1	61	2	1	10	1	34	1	0	2	0	17	0	0	19	0	0	6	10	0	11	0	2	12	2	5	1	28	4	20	13	74	6	1	16	0	6	0	5	8	3	0	0	1	6	0	7	11	2	0	0	0	11	1	18	6	6	0	0	1	252	30	3	5	11	4	186	28	7	0	0	3	0	1	4	0	0	0	0	3	0	0	1	0	2	0	37	0	9	1	107	1	0	1	0	3	0	0	1	0	0	0	1	8	0	0	2	0	0	0	0	1	0	1	0	1	9	0	0	2	1	2	0	0	1	1	0	0	0	0	3	4	0	1	1	0	3	0	4	0	2	5	3	0	2	1	15	1	58	15	0	5	1	0	0	2	0	2	0	0	14	99	0	3	3	1	0	19	4	12	0	10	17	6	16	8	162	2	0	1	16	19	0	1	1	0	0	57	39	0	0	0	0	0	1	0	1	213	12	0	0	28	0	0	12	8	0	1	0	0	0	0	20	0	7	1	110	65	1	2	0	0	0	15	0	0	0	21	7	24	35	0	13	3	0	0	9	7	96	2	0	0	141	0	0	0	8	0	20	0	9	0	0	14	2	230	0	0	58	0	1	0	0	13	0	0	9	1	0	20	23	33	23	33	18	0	0	2	21	0	2	2	0	5	0	4	3	0	2	0	0	0	17	0	0	14	0	1	108	1	9	0	0	0	22	0	17	1	0	35	13	0	0	1	14	0	20	7	2	25	28	4	11	25	5	34	6	48	16	1	0	0	0	16	0	0	2	1	1	4	1	0	0	0	0	0	2	5	10	5	7	46	21	40	0	224	0	5	1	0	2	2	0	0	0	0	0	0	0	0	0	0	0	0	0	21	11	3	0	4	1	42	0	0	0	1	2	0	54	1	0	0	9	0	7	5	0	5	0	0	15	0	0	19	0	11	0	14	16	8	8	0	1	21	5	0	0	27	16	0	0	11	3	2	0	0	19	0	0	0	47	31	33	13	0	2	0	0	15	7	1	0	31	0	0	0	8	0	11	3	0	65	28	27	2	2	14	3	44	4	9	5	0	5	0	0	40	14	0	4	4	2	0	101	74	37	2	4	8	129	2	0	2	5	0	1	35	3	0	0	0	0	13006	50	5	2	6	0	10	24	1	8	0	0	0	0	14	7	9	16	7	0	5	0	88	0	126	14	25	11	7	12	0	5	173	59	0	106	0	0	0	18	11	14	2	3	0	2	0	0	0	0	3	1	11	0	2	0	0	8	47	20	323	236	26	13	0	11	1	20	55	58	0	0	34	0	0	0	0	0	0	0	0	2	1	1	24	1	0	0	0	2	1	4	1	0	7	0	0	0	2	2	38	0	6	35	12	5	7	47	11	64	20	15	3	1	0	0	0	100	57	31	0	4	1	7	6	32	1	1	13	0	2	224	7	1	0	0	0	4	0	4	11	15	0	0	0	0	0	1	2	2	4	3	0	0	0	0	176	3	19	11	150	6	1	0	0	3	0	132	2	4113	0	11	0	6	87	49	11	0	0	1	0	0	0	0	1	18	6	7	0	0	1	0	0	1	0	0	6	0	0	61	1	0	5	0	12	1	1	27	0	3	15	1	0	0	2	0	0	0	1	0	14	2	0	11	0	0	1	1	0	0	0	0	0	1	1	3	0	14	0	28	4	2	5	0	1	3	15	2	68	2	0	2	1	4	1	0	0	73	26	0	0	2	0	1	0	0	0	1	0	75	22	7	44	31	0	4	0	0	11	0	176	22	29	13	1	0	1	3	3	0	3	42	0	0	0	2	41	0	0	9	34	2	6	0	0	0	0	0	1	2	2001	8	11	10	5	1693	1	11	40	22	22	6	227	241	277	62	220	16	31	0	5	133	62	60	64	22	8	0	0	1169	1	1	13	12	0	68	7	7	0	928	2	0	3	0	0	4	5	24	0	1	0	2	40	257	10	24	38	28	6	17	0	9	3	34	8	17	25	3	0	0	0	1	0	0	0	0	0	23	1	0	6	4	32	0	5	14	0	3	0	0	0	5	2	0	0	2	0	0	13	12	0	0	0	0	0	0	0	3	0	26	4	73	4	0	46	5	0	0	58	86	386	1	0	20	39	41	2	38	66	1	45	1	23	122	1	56	0	0	43	6	17	89	6	0	6	10	48	12	6	0	45	3	1	0	27	2	6	0	1	0	137	1	7	4	0	3	0	30	11	6	1	17	1	0	15	2	0	0	1	1	0	1	0	9	16	1	3	6	19	0	358	7	5	0	0	15	1	0	14	8	1	40	1	0	1	41	33	1	47	59	0	3	5	7	7	18	4	11	15	1	2	8	5	30	28	53	18	16	1	0	0	1	0	0	3	1	0	3	2	1	12	3	0	0	0	4	3	50	10	0	16	0	0	1	0	0	0	11	1	1	2	0	0	0	0	0	1	2	1	1	0	0	0	0	0	0	0	3	0	2	1	0	0	0	15	8	2	0	0	11	5	0	1	0	0	0	0	3	13	1	0	2	0	0	0	0	24	1	1	0	7	5	2	11	0	0	0	3	0	1	0	0	5	58	11	1	0	0	0	5	9	5	12	0	0	0	1	0	16	0	16	3	7	6	0	0	0	0	2	9	0	7	0	0	16	14	30	18	81	2	17	21	10	46	0	27	9	11	5	54	58	57	149	95	20	18	18	16	2	12	16	1	36	4	4	3	7	259	27	74	104	4	32	14	20	10	5	37	34	16	17	4	35	0	0	0	0	179	72	8	65	9	55	45	1	12	81	96	49	577	0	87	13	10	0	3	0	15	8	2	2	0	18	0	1573	1155	121	12	0	40	1	2	2	9	4	214	46	151	30	29	40	219	26	11	37	0	29	2	20	11	6	2	1	16	0	6	22	8	28	8	119	1	3	6	31	12	7	0	0	0	114	0	2	0	16	0	3	6	0	1	0	0	24	35	3	1	0	0	30	9	11	2	0	3	0	0	0	1	49	0	0	0	0	0	0	0	0	4	7	0	1	8	0	0	0	1	0	1	0	4	20	2	14	34	2	61	123	0	4	3	0	0	2	1	0	1	0	0	8	1	0	12	0	0	0	0	18	2	2	1	0	0	19	3	0	0	0	4	1	0	0	0	0	0	0	5	1	0	1	21	0	1	0	0	7	0	105	689	21	109	2	26	0	95	0	0	0	0	0	0	0	1	0	0	0	9	0	16	11	32	16	3	0	1	0	0	0	3	1	7	16	2	0	24	1	11	0	0	12	30	0	0	0	23	0	0	20	32	401	30	11	0	0	6	1	3	30	3	73	0	0	0	5	15	3	3	6	16	13	27	7	0	2	28	13	0	6	49	98	17	3	0	1	0	1	15	41	29	0	6	0	4	0	2	3	0	1	0	1	0	0	0	14	0	9	19	3	0	0	0	0	0	4	10	9	0	24	2	0	0	1	1	0	0	5	0	25	22	6	0	3	27	1	7	2	0	4	4	10	0	0	14	0	1	0	252	18	2	3	0	0	1	0	11	4	14	1	5	0	16	1	0	0	2	0	6	16	10	0	3	14	1	2	0	0	0	3	0	5	29	5	8	58	37	10	0	0	9	9	0	1	1	0	3	4	0	0	2	11	9	4	3	2	0	0	5	0	0	0	0	37	5	1	0	1	0	1	1	5	28	5	10	465	0	1	1	0	0	0	15	2	93	0	0	0	17	0	1	1	0	30	18	0	1	82	18	6	0	0	51	0	9	3	4	317	0	0	12	0	6	0	0	0	0	0	0	0	39	15	0	31	8	11	3	6	7	0	27	0	0	0	0	1	2	0	1	0	1	0	1	1	0	4	4	0	3	2	1	4	0	0	2	0	2	0	3	37	8	0	0	0	0	32	5	0	0	0	0	40	34	0	0	1	1	10	2	33243	0	0	0	0	4	0	0	3	0	0	0	0	0	0	1	0	15	0	1	0	0	24	7	55	28	0	15	23	46	1	0	1	1	0	0	0	12	7	19	1	47	10	1	0	0	0	3	5	0	43	0	0	17	0	28	13	18	30	40	18	18	42	0	7	2	1	8	0	0	124	21	19	31	0	1	0	14	3	3	0	65	58	18	5	7	0	0	0	0	20	0	1	1	1	46	14	0	75	3	1	2	66	76	1	0	46	11	0	5	0	1	0	0	0	1	1	0	0	18	72	50	161	72	3	28	18	1	28	17	65	69	411	33	16	15	41	93	16	0	12	31	9	2	0	0	3	0	18	8	52	105	28	0	12	1	0	54	12	7	6	6	0	1	0	0	0	0	0	0	0	3	1	5	7	1	10	1	7	0	3	3	33	1	1	0	0	11	39	16	11	1	5	3	4	0	2	2	83	0	6	0	2	1	33	0	8	4	0	9	1	0	0	37	7	2	0	0	12	2	0	0	0	0	0	0	0	0	2	1	5	0	1	13	2	4	0	0	5	0	0	0	3	1	1	19	0	15	0	1	1	40	36	0	14	7	2	112	2	0	4	12	1	4	42	0	0	1	0	0	0	1	0	0	0	0	2	0	0	3	0	0	3	0	3	1	2	0	1	59	1	0	2	1	2	0	0	7	0	1	0	0	1	2	3	0	0	0	1	0	29	0	0	20	0	1	5	1	9	0	2	147	4	0	10	7	2	17	64	0	26	1	0	0	309	10	16	31	1	0	3	2	0	20	0	1	147	1	8	11	6	6	0	0	0	0	0	0	1	0	0	0	0	0	12	17	22	1	0	0	0	818	3383	3	3	0	4	1	0	0	11	8	50	9	1	30	0	32	24	4	15	1	3	2	23	18	16	34	5	55	0	0	29	1	70	14	2	6	0	1	0	0	0	13	0	5	60	18	2	1	3	0	19	18	11	2	0	0	0	8	5	0	0	0	2	1	11	7	5	0	35	0	5	10	6	7	3	6	10	21	11	1	4	0	0	0	0	2	40	221	33	10	10	14	95	110	1	2	10	10	9	15	0	2	8	2	20	0	5	1	18	1	0	0	4	4	9	6	0	17	2	2	0	1	3	11	2	20	0	21	6	4	8	0	21	1	0	13	1	4	2	2	4	143	0	12	0	0	0	1	12	0	3	0	2	1	0	2	0	11	0	1	7	0	57	33	24	0	0	2	1	3	1	14	0	0	1	11	6	5	1	2	0	7	0	0	1	0	0	0	0	0	1	0	2	0	0	0	0	0	89	0	16	30	78	56	13	35	0	0	0	0	0	0	0	0	2	0	0	1	0	0	1	0	0	31	1	0	0	0	0	37	2	0	0	1	0	0	0	8	0	0	85	0	0	7	9	1	18	1	1	12	8	10	3	53	6	8	5	4	3	1480	46	12	16	25	287	225	48	186	0	0	18	5	0	3	4	11	2	0	1	0	0	1	0	216	0	0	1	0	261	0	0	0	0	3	88	0	5	0	1	0	2	8	0	0	0	0	0	1	0	5	79	0	0	0	6	102	152	1	0	0	4	0	0	0	4	20	0	0	0	1	0	5	29	26	0	2	0	0	22	5	8	0	51	1	2	12	6	7	0	0	0	3	3	7	5	31	3	7	4	2	0	0	64	1	3	4	1	9	108	0	0	11	99	16	3	1004	0	2	0	2	0	0	0	124	39	105	1	2	2	0	12	3	2	0	11	1	38	0	0	16	0	0	0	15	1	9	181	1	0	44	303	3	0	2	0	5	5	39	3	1	7	1	7	1	0	8	0	0	1	5	6	0	0	0	0	9	4	2	0	0	8	2	16	0	0	15	23	1	10	0	3	30	7	0	0	0	1	0	8	12	17	16	9	23	45	4	1	33	0	21	51	55	0	0	0	0	3	0	7	0	0	210	0	1	21	30	30	16	1	9	8	0	10	19	26	0	1	57	5	1	0	3	0	7	0	0	31	170	157	1	0	0	0	0	7	0	0	0	1	1	0	2	3	0	0	0	3	0	0	0	0	2	4	0	0	15	1	2	0	0	0	0	0	0	0	0	0	0	0	2	22	0	0	0	0	0	0	0	0	0	0	0	0	3	0	0	0	21	1	11	3	0	4	2	1	2	1	3	3	8	0	2	0	0	26	8	12	25	18	4	10	1	10	4	1	17	3	2	0	0	0	8	1	11	36	0	23	0	1	2	2	15	6	2	0	6	1	0	39	14	0	12	1	3	11	1	0	0	35	9	30	7	33	6	76	19	3	79	7	3	1	0	3	7	0	9	18	34	37	0	11	7	13	10	5	0	1	0	27	1	0	2	3	1	4	0	0	1	0	29	0	0	0	0	0	0	4	2	11	32	25	30	5	0	9	4	33	34	11	28	8	3	71	29	48	0	0	0	0	0	3	1	7	6	30	7	29	9	0	0	10	1	0	0	2	0	0	2	0	0	0	0	7	0	7	198	305	1	102	142	94	12544	36	0	7	2	2	0	0	2	5	5	6	16	0	0	24	0	6	1	5	1	3	0	0	5	0	0	0	1572	223	0	11	23	19	3	0	0	1	0	13	0	66	0	1	490	0	4	0	23	0	28	1	1	0	1	0	0	0	0	0	2	2	8	0	0	0	0	0	1	0	0	0	2	0	0	0	0	0	0	2	0	0	1	0	0	0	5	2	1	18	1	350	220	0	73	17	11	12	7	93	35	0	23	0	9	1	0	0	0	0	0	0	0	0	0	0	9	3	0	0	0	1	6	0	0	0	3	0	12	1	0	0	1	7	0	1	0	2	0	1	7	0	0	6	9	0	1	0	0	0	0	0	0	0	0	3	10	3	5	0	13	14	19	16	73	0	0	2	0	0	1	0	0	6	0	50	1	2	2	14	0	62	21	1	0	0	0	3	0	1	0	0	2	0	0	0	0	0	0	0	0	0	5	0	0	0	0	0	1	0	1	3	0	4	0	0	0	0	0	471	0	0	0	0	0	1	0	0	1	3	0	0	2	0	0	0	2	0	0	0	0	1	1	0	0	0	0	0	0	0	1	3	0	0	58	0	0	2	2	0	10	10	2	2	0	1	0	0	0	5	21	8	0	1	18326	0	2	1	0	0	9	0	0	1	1	3	2	0	0	7	0	0	0	0	0	0	0	0	0	0	0	0	4	0	0	0	0	0	0	0	0	0	1	0	0	0	1	0	61	0	3	0	0	0	0	0	0	1	0	0	1	1	0	0	1	0	0	1	0	1	0	0	0	0	1	0	0	1	0	0	0	0	1	1	0	0	49	0	0	0	3	0	0	0	0	0	0	0	0	0	0	0	1	0	1	0	0	3	8	5	0	1	0	115	0	0	2	0	2	0	4	7	4	0	2	1	2	26	0	382	0	1	0	0	4	0	180	1	1	2	208	0	5	0	0	140	1	142	0	0	0	0	0	5	12	4	2	3	0	0	3	4	6	2	43	2	4	0	0	1	0	10	0	17	0	8	0	61	2	3	0	70	1	3	6	0	1	4	2	1	2	7	1	8	0	4	1	1	2	7	0	0	60	4	4	1	3	12	4	3	2	0	1	34	10	25	9	2	9	3	0	16	3	1	12	1	11	41	1	0	277	3	1	10	0	2	0	72	0	19	7	5	0	6	2	6	8	34	2	6	0	0	1	1	17	13	14	2	19	21	9	7	80	948	33	18	0	4	9	114	0	3	0	0	1	8	0	1	0	0	11	0	33	0	0	0	0	0	4	0	147	18	54	0	1	0	0	0	22	1	65	2	46	28	1	14	3	21	4	0	1	5	0	0	1	5	0	0	22	19	0	7	0	3	11	1	0	0	2	0	0	0	0	0	1	0	0	0	0	0	0	2	1	1	0	0	2	4	5	0	1	0	7	1	0	3	0	13	1	2	47	0	0	0	0	0	9	1	0	0	6	4	0	2	2	0	7	0	8	2	8	0	9	0	0	0	2	1	0	16	1	0	0	0	1	4	0	145	0	2	0	0	0	1	0	1	0	0	47	0	9	11	2	0	2	5	2	4	3	0	1	0	0	0	0	0	1	0	1	1	3	21	34	2	22	4	25	0	0	3	1	0	3	0	1656	1	22	3	102	0	0	3	5	26	31	10	0	0	7	4	30	0	0	1	1	20	28	8	622	0	50	31	35	5	1	0	0	1	0	1	3	3	0	0	0	6	0	1	0	5	4	2	0	10	51	1	0	22	0	0	1	9	0	0	23	14	31	34	49	60	4	12	35	3	0	45	4	48	50	0	11	19	11	0	9	0	1	0	1	67	5	1	0	1	0	36	28	2	0	0	10	0	0	1	0	0	2	0	0	27	13	15	0	1	78	0	0	0	1	1	0	7	1	35	1	7	1	4	3	2	8	0	16	0	5	0	0	0	13	13	0	24	0	23	0	5	39	29	20	10	6	1	6	7	22	6	194	20	2	23	0	0	1	0	2	1	2	5	0	0	0	0	0	0	18	22	10	1	17	0	1	68	33	29	0	3	0	2	0	12	6	13	10	42	2	2	21	64	37	49	13	0	2	2	2	2	17	0	4	1	9	2	1	91	62	29	0	14	2	0	6	28	4	0	0	0	0	0	5	19	24	13	13	4	11	3	30	0	0	5	2	24	1	7	10	26	41	3	0	14	67	48	1	2	0	1	9	16	1	30	1	0	66	0	1	0	1	0	3	5	48	50	1	0	0	3	1	32	0	0	3	5	0	0	29	0	0	0	9	12	2	90	2	4	0	1	0	2	0	26	2	0	0	9	0	1	0	12	0	1	25	7	2	38	0	0	0	14	36	0	0	3	1	0	16	0	0	3	0	0	0	0	0	13	5	2	13	3	12	13	0	4	0	0	0	1	0	60	0	1	0	24	1	0	56	0	23	37	1	28	58	1	0	12	2	0	41	12	0	0	2	2	14	1	7	0	17	4	3	0	0	15	29	14	2	0	0	0	1	4	0	0	0	0	4	2	23	7	0	68	6	0	34	15	13	84	44	6	10	393	50	21	56	26	36	36	6	33	24	0	3	2	30	1	1	0	3	2	3	1	1	13	1	0	0	0	0	0	0	0	0	0	1	0	11	5	5	8	5	1	0	0	0	0	0	0	0	1	0	0	0	1	0	0	1	0	0	1	2	0	1	0	0	0	0	1	11	7	0	0	0	0	0	1	0	2	0	0	1	0	1	0	0	0	0	0	0	0	0	0	0	0	22	23	0	83	15	0	1	33	0	1	0	21	14	40	27	3	23	50	10	0	8	0	6	2	0	0	0	4	0	0	1	29	180	4	18	15	21	0	0	0	11	2	9	0	0	2	1	2	2	0	0	1	0	0	14	7	3	5	12	0	15	2	15	4	18	0	58	11	24	0	19	47	41	0	0	0	1	0	0	5	17	1	0	0	0	0	0	0	5	2	8	1	0	219	37	0	17	0	16	0	0	0	0	29	3	0	1	124	47	0	1	0	2	369	0	0	1	5	7	0	8	2	5	22	1	0	2	1	0	13	49	8	0	13	24	0	1	2	8	0	3	0	1	7	0	13	5	12	9	0	1	0	4	2	7	7	0	0	9	19	7	22	13	19	1	36	1	0	14	0	0	9	4	0	0	2	5	1	1	3	184	7	0	7	1	0	2	0	0	0	3	0	2	1	0	0	0	1	2	2	4	0	0	0	0	1	13	7	0	1	0	0	1	2	3	10	0	3	0	0	0	0	8	8	14	10	9	10	0	37	0	0	100	51	73	16	10	0	3	164	90	2	22	36	1	20	0	7	11	7	3	0	13	0	20	16	10	0	7	1	0	0	12	15	9	0	0	42	60	33	3	2	0	0	0	0	0	44	0	7	10	8	4	0	0	0	0	11	2	9	95	5	39	4	5	0	19	9	14	0	0	2	2	3	15	0	78	0	7	0	16	0	2	32	57	2	28	4	266	14	4	0	0	21	8	2	99	19	15	24	15	133	6	28	43	13	0	0	0	1	4	11	6	300	30	4	0	305	2	3	0	0	35	1	1	1	7	2	0	0	196	74	0	1	0	104	75	13	12	1	10	0	56	26	0	4	35	0	0	11	4	10	0	2	1	0	0	0	0	14	23	0	0	1	2	0	0	2	0	0	1	0	0	0	0	36	3	1	0	0	44	11	14	0	0	7	9	1	2	0	1	0	27	22	7	5	80	0	35	6	0	2	4	43	3	14	7	0	1	25	22	30	15	60	42	50	3	8	3	171	5	31	43	1	0	0	1	0	0	1	3	3	0	0	2	0	0	0	0	0	0	2	0	13	1	0	10	6	78	189	0	1	13	0	11	0	1	4	2	4	0	0	2	0	0	5	24	103	1	178	0	4	0	1	0	3	0	1	0	0	0	0	1	9	0	274	0	0	0	0	1	0	0	0	9	0	4	0	0	22	0	1	1	0	24	1	90	0	0	1	1	0	13	0	0	0	0	0	11	5	0	0	0	1	1	9	18	9	1	0	23	14	20	0	7	0	425	0	227	181	2	58	6	0	5	1	2	0	89	70	219	64	59	202	3	44	42	16	53	34	52	37	1	49	11	0	0	0	8	0	1	0	1	0	0	0	0	0	1	0	0	1	1	8	0	0	0	1	2	0	0	0	0	0	1	0	0	0	2	0	0	4	5	0	0	0	1	0	2	0	2	5	0	44	7	0	53	5	30	32	22	50	0	0	0	4	0	0	4	0	0	0	0	0	77	64	0	0	0	6	0	19	1	5	3	132	0	6	0	0	2	20	7	1	0	0	1	0	0	2	12	6	1	0	57	0	6	31	2	6	0	0	1	2	0	18	11	6	1	1	50	33	0	16	2	3	1	10	0	3	0	28	5	1	2	1	0	84	0	0	0	15	35	0	0	67	14	8	10	1	2	40	0	1	0	1	3	0	0	0	0	0	52	23	1	33	34	0	1	2	2	0	8	0	1	40	0	6	16	13	4
LakWasMet25_LOW6_2_rpkm	0	0	0	0	0	32	27	3	0	1	2	3	2	1	0	0	0	0	32	0	0	1	4	32	1	0	0	1	0	27	0	12	0	18	3	9	5	0	3	0	0	0	0	5	23	49	65	20	6	15	1	12	0	0	0	5	0	18	118	23	113	0	1	6	8	1	0	0	10	85	1	2	1	0	2	0	0	1	0	0	0	18	0	0	0	0	0	0	1	0	0	1	12	2	15	1	1	1	2	1	0	0	0	0	0	0	0	0	0	0	3	1	127	3	31	4	0	0	0	0	0	0	2	9	0	2	0	2	0	1	0	47	15	1	0	0	0	2	13	0	2	0	0	11	0	3	0	0	8	6	6	44	2	22	61	0	10	16	21	0	11	2	0	6	20	3	0	4	0	12	0	0	0	0	1	0	0	0	1	0	2	0	0	0	0	15	0	0	0	6	8	6	8	26	2	0	1	15	20	198	28	0	24	0	0	1	19	1	9	3	17	8	55	27	16	0	9	1	0	3	1	7	6	4	2	13	0	0	12	0	0	0	62	0	1	0	28	37	51	3	0	0	21	13	57	14	0	0	10	26	9	13	28	0	1419	430	0	0	0	1	4	3	1	25	20	0	4	3	3	75	31	0	11	0	0	1	0	0	46	38	0	49	28	66	43	0	0	0	8	0	1	0	0	0	2	0	0	4	11	0	0	19	61	1	13	0	26	35	23	0	12	1	60	32	0	0	0	1	53	0	0	1	0	1	34	634	5	3	20	1	1	1	0	0	0	0	2	1	0	0	0	0	39	9	22	2	18	4	1	1	3	2	2	0	2	1	0	0	0	73	49	0	8	0	0	25	14	35	17	12	0	56	0	0	10	3	1	6	0	1	0	0	6	5	3	0	59	0	0	0	0	3	308	3	0	7	68	0	0	97	1	34	1	2	54	2	16	0	1	2	2	33	19	1	1	74	71	5	2	0	0	0	0	0	0	0	0	0	1	0	0	3	0	1	0	0	0	0	10	0	22	28	0	0	5	78	0	2	0	0	1	77	14	353	0	43	57	0	0	8	0	0	0	15	1	60	16	0	0	7	22	18	29	1	0	0	6	1	163	3	14	1	7	0	0	0	0	60	57	13	0	0	107	70	12	0	3	0	0	0	0	0	6	0	0	0	0	1	0	2	0	0	0	0	0	0	1	0	4	2	0	0	1	0	0	0	0	0	0	0	0	0	0	6	31	0	27	1	0	25	0	18	1	33	40	2	0	0	0	0	0	0	0	0	1	26	0	0	0	1	0	3	0	4	20	0	16	0	22	0	0	0	0	0	28	31	47	128	0	24	59	168	46	21	135	0	8	4	12	0	0	0	992	0	2	6	0	0	3	0	28	0	1	2	9	14	0	54	0	12	0	103	87	57	0	0	76	0	155	0	102	54	72	16	1	4	4	16	1	5	1	10	0	2	0	0	0	0	0	3	1	56	0	0	0	1	0	15	7	1	32	1	5	15	4	0	0	0	0	6	3	98	0	36	0	0	0	0	7	17	5	23	0	0	2	0	2	0	1	0	6	1	10	0	0	8	1	0	0	18	0	0	15	4	0	0	0	7	0	5	0	2	0	4	7	1	0	0	36	0	3	0	0	0	26	10	0	0	14	0	1	1	3	8	4	0	7	0	7	0	0	1	1	0	0	0	0	1	0	18	0	33	7	0	24	40	17	0	0	9	2	0	0	1	2	6	3	0	57	4	0	21	0	43	0	1	0	0	0	0	0	0	0	0	0	35	0	1	0	0	0	0	0	0	0	1	10	0	0	7	1	0	7	0	0	0	7	1	0	20	0	0	0	0	147	3	34	0	1	0	0	0	2	0	0	0	16	0	3	0	0	0	0	7	35	0	3	10	0	2	4	0	1	0	0	0	0	30	24	0	5	0	0	0	0	0	0	10	51	14	0	0	13	5	0	0	5	0	0	10	23	7	10	2	0	1	0	0	9	2	0	0	0	0	0	0	1	6	10	16	0	0	1	6	2	5	0	0	0	0	0	0	0	0	0	0	1	0	0	0	0	0	3	2	0	2	0	2	0	1	0	0	0	8	45	39	73	37	32	0	0	0	0	0	0	1	0	0	0	1	15	1	0	0	0	0	2	1	0	23	0	1	0	10	15	1	0	11	1	0	0	4	0	0	0	0	0	0	1	0	2	0	4	1	6	7	0	0	1	2	0	8	10	97	12	33	5	1	0	0	66	18	13	0	33	0	0	4	0	2	0	3	1	0	0	0	1	2	3	0	2	3	0	0	5	0	0	0	0	2	0	2	0	0	0	0	0	69	1	0	0	62	10	0	2	15	0	0	74	4	4	1	1	0	1	0	0	1	45	1	0	1	0	0	0	0	0	4	0	0	0	1	1	6	5	0	0	0	0	0	3	7	0	2019	0	0	0	0	50	21	27	0	1	0	4	2	8	4	6	21	0	0	0	0	1	0	0	1	0	35	3	0	0	0	1	1	3	0	0	0	0	0	0	0	1	60	46	0	5	35	0	2	0	1	11	0	0	3	3	0	0	0	0	0	0	0	6	71	21	0	0	0	6	0	0	13	3	0	1	0	1	0	0	2	0	0	0	0	0	0	0	0	0	0	9	0	0	0	1	23	0	5	0	0	0	0	2	0	0	0	25	10	0	0	0	0	1	0	2	1	3	0	34	0	0	0	1	7	0	0	0	0	9	19	132	64	3	1	0	14	4	0	0	4	0	3	4	0	0	1	2	0	0	0	2	0	2	49	0	3	0	1	12	0	0	0	0	0	27	2	0	0	0	0	2	0	0	8	93	0	6	1	1075	12	1	0	0	2	0	1	4	2	0	135	134	0	1	1	3	1	29	0	0	45	0	3	0	0	0	0	0	9	10	7	0	8	16	18	0	62	4	2	5	3	0	21	0	0	11	2	0	6	0	1	0	4	0	0	10	6	1	0	7	0	1	5	2	4	0	13	1	6	0	0	0	0	0	0	0	1	0	0	47	0	1	1	1	0	5	0	0	0	0	28	7	0	61	25	33	15	0	0	12	0	0	0	1	3	3	12	0	0	2	2	0	0	12	10	0	3	0	0	15	5	21	0	6	3	1	14	0	0	17	20	10	6	12	5	5	0	0	0	7	0	52	2	11	13	8	34	13	8	34	0	1	7	20	22	0	3	1	1	4	18	7	0	16	1	0	1	1	9	22	14	2	0	17	0	0	0	0	0	4	18	12	0	0	1	19	1	11	47	3	0	15	0	9	8	1	6	0	3	1	23	12	3	1	0	0	0	0	3	0	948	41	9	50	1	6	1	0	0	0	0	1	62	1	2	0	25	1	0	0	4	118	68	6	11	0	1	0	174	0	0	0	0	5	0	0	1	257	40	47	36	68	29	0	16	46	13	0	0	0	0	0	0	50	2	1	0	0	27	0	24	3	2	0	5	0	5	0	3	0	0	0	1	13	0	0	0	1	1	0	3	14	18	1	0	0	0	0	8	0	2	0	1	0	0	4	1	0	0	7	1	0	0	0	0	2	1	0	0	0	21	5	0	0	0	0	0	0	2	2	0	0	3	0	0	1	0	0	0	0	0	5	0	0	357	4	0	19	0	0	0	0	295	0	25	26	0	0	144	0	142	3	2	0	0	0	0	38	0	14	1	0	2	0	1	2	0	0	5	7	1	2	0	13	6	1	4	1	0	0	0	0	0	0	9	2	69	13	17	0	1	3	13	0	0	1	12	3	0	0	1	4	4	0	11	14	0	27	0	5	21	16	0	9	17	0	0	3	9	1	8	7	9	13	0	19	0	0	1	2	0	0	0	3	0	189	13	93	89	126	60	101	14	1	0	1	7	7	30	1	1	6	14	73	0	0	0	8	2	5	0	2	23	63	0	52	11	0	3	0	5	1	9	6	0	133	14	37	0	0	0	0	2	0	86	0	52	23	2	0	0	33	6	2	110	4	23	8	2	4	12	0	17	34	104	51	122	0	3	3	14	8	23	0	0	3	5	9	0	119	0	0	0	1	2	0	14	3	4	17	12	0	0	0	1	0	0	0	28	0	1	2	0	0	0	10	1	0	0	13	0	117	63	0	14	70	354	0	3377	6	0	5	1	0	1	0	1	6	0	0	1	0	1	1	0	0	90	2	0	0	0	0	2	2	2	0	68	0	4	0	1	4	30	4	0	0	0	7	0	9	11	4	1	33	0	2	0	1	2	2	0	31	0	1	25	11	0	2	1	90	124	2	14	0	38	194	0	25	1	70	1	27	7	19	5	37	4	0	19	1	0	0	1	1	0	1	0	0	2	0	0	0	0	18	0	1	5	0	15	134	0	0	0	0	0	2	0	1	0	0	0	0	0	0	0	0	0	47	10	38	1	0	1	5	0	2	0	3	0	0	0	9	0	1	0	0	0	0	0	0	0	0	0	0	0	1	6	0	0	3	7	1	0	5	0	0	0	1	0	110	3	6	4	5	5	4	0	17	0	6	36	164	10	0	0	3	0	0	0	0	0	0	4	0	4	33	12	0	1	0	1	0	0	0	0	0	7	1	0	2	1	8	3	27	13	0	38	6	0	1	0	25	51	62	0	1	0	1	1	0	0	0	0	0	0	4	0	4	0	0	0	5	0	0	0	0	0	0	0	1	0	1	0	1	0	1	0	2	1	12	60	26	3	2	0	1	0	0	2	10	0	0	14	5	0	0	0	0	13	0	0	0	0	1	4	6	0	0	2	4	0	2	51	1	3	0	0	4	0	0	0	1	1	0	38	0	0	0	0	0	30	0	0	1	42	0	39	31	24	3	0	5	0	0	0	70	0	28	8	0	0	0	0	0	13	0	6	0	0	0	0	0	2	0	1	1	0	0	4	0	1	0	1	0	0	0	0	4	0	13	59	0	0	0	0	0	0	1	0	0	0	0	0	0	0	1	0	21	0	0	1	0	2	11	2	2	31	4	0	0	335	0	11	53	103	10	17	4	0	15	6	0	0	0	0	0	3	51	0	1	2	2	1	0	1	1	1	14	0	14	0	1	0	1	30	0	0	24	0	10	0	1	0	0	0	0	2	0	1	0	1	1	4	3	0	0	0	0	3	2	0	27	7	1	11	3	0	0	0	9	58	0	0	3	1	3	0	0	0	8	3	1	4	1	2	78	1	0	1	0	0	0	1	0	5	1	0	0	0	0	0	0	0	0	2	0	0	0	0	0	0	0	1	0	0	0	0	4	0	0	0	1	1	0	2	0	0	7	1	6	1	11	1	15	0	15	0	1	0	0	0	0	12	14	0	0	0	0	0	101	128	88	170	331	111	231	354	16	152	58	200	194	110	35	98	14	257	307	11	60	15	892	457	643	315	602	116	123	53	162	11	74	7	0	2	0	0	0	0	4	0	0	0	32	42	2	0	0	0	0	0	1	0	0	0	0	0	0	5	0	15	0	0	4	0	12	0	9	0	5	4	1	0	0	2	152	0	16	0	0	0	0	0	0	0	0	0	2	0	0	17	0	0	0	0	7	2	5	33	15	1	1	8	0	0	0	4	0	1	3	4	0	2	0	0	55	0	0	10	0	6	0	0	0	1	1	0	0	0	5	9	0	1	0	1	0	0	4	0	0	1	1	1	0	1	3	2	0	5	1	95	4	1	10	7	0	0	0	0	0	2	0	3	0	0	0	0	1	7	4	3	0	0	2	0	0	0	5	5	9	6	2	8	1	3	4	2	2	53	2	8	0	1	0	0	3	0	0	0	22	0	44	26	7	0	0	0	0	2	0	3	1	0	1	0	2	0	1	2	1	26	0	4	0	0	6	0	1	0	0	0	0	0	2	0	0	71	0	15	0	360	6	0	1	0	0	0	1	2	0	2	0	0	0	3	0	0	9	0	49	26	1	0	0	0	19	0	0	47	15	0	5	3	0	47	3	17	6	0	0	0	0	1	1	1	0	9	0	1	0	0	1	0	4	0	3	0	0	2	10	1	0	0	0	0	0	0	0	0	1	0	2	0	1	2	0	0	24	0	1	0	0	30	5	8	80	170	9	3	8	0	0	0	0	0	0	0	0	0	0	0	1	0	1	1	25	2	2	7	0	1	0	10	0	0	0	0	45	23	4	0	0	0	110	0	0	0	0	0	0	0	0	0	2	0	0	0	102	9	0	0	0	2	0	0	1	4	0	1	22	10	7	1	3	1	1	0	27	8	0	4	0	0	0	0	0	0	0	0	0	1	4	0	149	3	2	0	0	0	4	2	0	0	0	0	1	1	2	0	3	1	5	2	2	0	0	9	0	0	2	0	0	14	1	6	0	0	0	0	0	3	3	0	106	1	2	18	1	10	0	1	1	0	3	1	2	33	2	16	4	1	0	0	0	0	0	1	0	11	0	0	0	0	0	0	70	0	6	10	72	6	0	30	30	18	0	11	1	29	0	24	1	12	1	11	4	10	4	7	2	16	0	6	0	15	1	0	0	11	0	20	0	57	47	43	43	29	20	14	5	0	12	7	8	0	22	4	2	1	10	50	0	20	0	8	2	11	31	19	0	0	0	2	0	0	20	0	0	0	0	14	4	0	0	0	0	93	0	0	0	0	0	0	0	0	7	0	0	9	0	7	3	1	2	0	0	0	1	0	0	0	0	1	0	1177	3	0	36	30	26	0	25	0	11	2	0	0	219	0	0	0	0	0	27	0	35	0	2	4	0	0	1	0	0	7	4	0	26	13	2	119	0	12	1	0	0	74	36	0	0	2	2	2	1	1	1	0	11	0	12	1	0	1	64	0	0	0	38	7	0	0	0	0	0	0	1152	281	384	4	0	0	1	4	0	8	1	38	0	0	0	1	0	7	82	175	47	2	0	0	0	0	0	0	213	0	1	4	0	1	0	0	0	4	0	0	0	0	0	0	0	0	0	1	3	0	116	260	5	1	3	0	0	0	2	11	7	0	0	0	0	0	62	18	0	0	0	0	0	0	0	36	0	0	1	0	0	3	1	3	11	1	0	3	1	7	0	0	0	0	0	2	0	1708	2	1	1	0	1	0	1	0	0	0	0	0	0	0	0	7	1	20	0	0	0	0	0	1	0	0	1	0	0	0	0	0	0	0	0	0	0	0	0	0	0	0	1	0	3	0	0	3	0	0	0	0	1	0	4	0	0	0	0	90	1	0	2	1	0	0	70	1	0	0	0	0	0	145	1	0	0	0	4	8	18	33	8	0	24	0	0	15	2	1	71	2	0	11	3	0	0	0	3	0	0	0	20	4	0	2	0	0	0	0	0	2	0	2	0	20	3	0	0	0	0	0	0	0	0	0	3	0	1	0	0	1	4	0	0	4	0	1	0	0	0	17	0	5	0	16	25	11	4	31	0	0	0	0	0	7	0	1	6	21	0	2	0	13	0	22	0	0	2	0	0	1	1	4	0	6	0	15	20	7	0	8	0	6	0	0	0	0	18	0	0	1	1	0	0	29	0	17	14	1	74	2	28	404	0	0	0	0	0	0	0	2	9	61	0	0	0	0	0	0	247	494	0	50	5	0	3	4	0	0	0	0	0	0	0	4	2	0	3	7	40	6	0	0	0	0	1	0	1	4	35	3	15	1	0	0	0	0	0	2	5	10	0	0	0	0	14	2	0	1	2	1	6	1	1629	3	0	24	46	0	0	0	66	0	1	1	30	0	0	3	0	0	0	2	198	0	0	0	1	30	0	0	1	0	0	0	9	0	0	0	1	1	0	136	0	0	0	0	0	0	0	55	0	0	0	0	0	0	0	0	0	0	0	0	1	1	0	0	1	0	1	1	2	2	0	0	3	0	24	1	2	0	0	1	0	0	2	0	4	12	16	0	2	0	3	31	0	9	0	0	1	0	0	1	0	0	0	0	0	0	2	0	4	1	1	1	2	0	2	0	0	0	0	0	1	6	0	1	0	1	0	0	0	2	0	2	6	0	0	0	20	0	0	4	5	0	6	13	0	0	0	0	1	0	0	0	0	0	4	4	0	2	0	0	0	0	0	0	0	39	0	3	1	1	59	3	0	0	6	0	1	1	0	0	2	2	0	30	0	1	0	2	18	5	0	0	0	37	8	0	1	4	6	0	0	0	0	1	0	1	0	1	1	0	21	0	0	43	0	0	0	3	10	0	1	0	192	0	1	0	0	0	0	0	0	1	3	0	0	2	43	0	7	0	0	0	0	0	0	2	0	26	0	0	0	0	0	20	0	0	0	0	0	1	1	0	0	6	0	0	0	0	0	5	0	0	0	1	0	0	0	0	0	0	0	0	1	0	0	0	0	0	0	9	0	0	0	0	3	0	5	2	0	0	0	0	0	0	0	0	0	2	1	0	1	0	0	0	0	0	0	0	0	0	3	0	0	0	0	0	0	0	0	0	0	0	0	0	0	1	0	0	0	0	0	0	2	0	0	0	1	0	0	0	0	0	0	0	0	1	109	0	1	43	0	0	0	0	0	9	0	0	13	0	0	0	0	1	2	0	0	1	3	0	0	13	0	106	103	10	1	2	3	76	0	10	0	0	0	6	2	2	0	0	0	2	1	0	0	0	3	8	0	0	0	0	0	0	0	28	0	3	0	1	0	1	3	0	0	0	0	1	0	0	2	0	0	0	0	0	0	0	0	195	0	61	6	0	3	0	0	0	0	0	0	0	99	0	0	0	0	0	2	0	0	0	0	0	0	0	0	4	9	0	0	0	0	0	0	0	0	4	0	0	0	0	16	0	0	1	0	0	0	0	0	19	13	0	6	2	0	0	0	1	1	0	1	0	0	0	49	63	0	0	0	0	56	0	0	83	0	0	0	0	1	0	0	0	0	0	1	2	0	0	3	0	5	4	0	1	3	0	4	0	0	0	0	1	3	38	0	0	0	0	0	0	0	0	0	0	1	0	0	0	0	0	0	7	3	0	0	1	0	0	0	0	22	0	0	0	0	0	2	0	0	1	1	0	0	0	0	1	4	0	0	4	1	3	13	0	27	0	41	1	0	0	8	0	0	0	1	0	0	0	0	4	1	2	0	18	16	0	20	0	1	0	0	7	0	3	7	1	4	1	0	1	0	2	0	4	41	0	4	0	6	0	3	2	0	0	0	6	1	40	0	0	0	0	0	0	0	0	1	0	6	6	13	0	1	2	0	0	0	21	0	0	34	1	0	0	0	4	0	0	2	3	0	3	1	1	0	0	1	1	0	0	0	0	0	0	21	0	16	2	0	0	6	0	1	0	0	0	12	0	0	3	0	2	0	1	0	0	16	10	3	0	1	0	0	0	1	1	3	0	0	13	4	2	1	82	20	0	238	392	6	0	7	0	310	1	25	78	11	0	0	0	37	250	0	62	0	16	44	0	369	0	3	1	0	3	0	0	16	11	0	17	0	2	5	0	22	24	35	0	0	6	1	3	0	17	1	3	13	3	3	0	1	0	0	4	0	24	4	0	0	0	1	20	0	1	11	0	5	0	0	0	0	0	0	0	0	11	0	0	0	9	4	22	7	47	1	0	0	7	1	29	1	2	0	0	0	1	1	0	1	0	62	136	1	0	4	0	2	3	1	1	8	0	0	0	1	0	0	11	25	0	3	0	3	0	0	14	10	3	0	2	0	0	0	0	0	0	0	13	11	0	1	0	3	7	0	0	0	0	4	10	0	2	5	1	0	0	20	0	0	13	0	14	9	0	2	0	3	2	28	10	0	0	17	0	0	0	0	21	2	0	0	79	337	290	3	11	87	100	262	1	82	75	33	5	243	342	196	0	338	57	191	49	109	5	385	19	300	0	30	0	6	0	7	0	0	0	1	0	0	0	0	4	2	7	4	1	1	0	0	0	90	1	0	58	8	3	7	0	1	0	1	9	0	14	9	1	1	0	1	0	0	39	0	0	0	0	1	2	0	83	12	0	1	2	21	1	2	18	4	12	4	64	0	0	0	0	5	0	36	100	8	44	6	108	0	0	0	0	2	0	0	0	0	0	0	0	0	0	2	8	0	0	0	0	10	0	0	0	0	39	0	0	15	0	11	1	2	0	0	2	6	5	5	1	0	5	2	0	0	0	8	5	4	30	11	1	0	0	0	0	3	0	2	0	0	4	0	34	2	0	133	2	0	1	1	0	0	0	122	1	5	1	0	10	0	0	1	0	12	1	0	63	8	10	8	1	11	2	1	1	4	4	0	1	0	0	6	0	0	1	0	0	2	0	0	0	0	43	0	0	0	5	1	0	0	0	0	0	0	3	92	0	0	0	0	14	1	5	1	11	8	0	0	49	30	46	0	0	4	0	36	4	1	0	0	4	0	1	0	0	0	0	0	0	0	41	0	3	0	49	0	0	0	0	0	0	0	5	8	2	0	3	0	0	0	0	0	0	1	43	1	3	11	0	5	1	19	0	2	4	1	0	0	2	1	2	13	11	0	21	0	0	5	1	16	0	0	41	3	2	4	1	49	0	10	0	1	1	0	0	0	9	0	17	0	0	0	0	0	0	0	2	8	0	0	2	12	1	2	3	0	15	2	10	0	0	25	0	0	3	0	2	3	18	3	0	0	0	0	3	13	3	0	0	0	0	1	0	0	6	18	0	9	0	3	0	0	0	0	1	75	10	3	0	0	0	0	0	63	0	0	0	4	1	0	0	0	0	0	0	1	2	1	12	3	0	27	3	1	0	0	0	0	0	1	0	0	0	1	0	1	1	0	8	9	1	1	2	0	84	44	39	9	0	0	0	0	0	0	1	1	2	0	1	64	8	0	6	0	0	0	12	0	9	9	9	12	8	20	24	7	1	0	0	0	1	10	2	2	5	3	6	2	0	0	0	3	4	0	18	20	1	24	10	16	3	1	1	0	0	85	0	0	0	3	0	0	3	3	0	0	3	0	1	0	0	2	0	0	2	5	0	0	0	9	0	0	90	34	0	0	5	1	15	12	9	1	9	4	1	0	0	21	0	0	0	0	0	8	784	1	63	5	0	1	5	0	2	22	0	2	0	0	0	0	0	0	1	0	0	39	6	0	0	0	0	0	16	0	0	0	0	0	0	1	9	0	2	1	1	0	1	1	2	12	0	1	30	0	0	1	22	1	0	0	2	6	1	0	1	0	1	39	2	2	4	0	1	0	0	0	6	1	41	13	0	18	0	26	2	4	8	0	2	1	13	1	2	0	0	0	0	0	0	23	12	2	12	0	2	0	3	232	0	6	0	12	0	9	0	3	57	0	2	2	5	1	32	10	0	1	3	0	2	35	0	0	2	0	0	0	86	2	3	0	1	0	0	0	139	6	0	0	0	0	16	0	0	1	0	3	0	1	0	0	1	0	10	0	0	0	0	1	0	0	0	0	0	0	13	0	0	9	0	0	0	0	0	0	0	3	0	0	0	0	0	0	0	0	0	0	0	94	0	0	0	0	0	0	0	1	11	0	0	18	0	0	1	0	0	0	0	0	0	18	0	0	0	0	0	0	2	1	0	0	10	0	4	0	0	0	1	0	75	0	0	0	0	0	12	0	9	1	0	0	3	1	0	8	54	3	1	0	0	0	0	0	6	2	0	38	0	1	69	0	0	0	0	1	2	0	0	9	0	33	0	0	0	2	0	2	1	2	0	0	82	0	0	0	0	2	0	0	0	0	0	3	0	0	0	0	17	0	11	30	0	4	0	0	3	5	0	0	1	0	0	0	0	0	0	0	4	0	11	0	0	152	0	0	0	4	7	2	0	4	9	9	0	0	36	1	2	0	0	0	0	0	0	0	0	2	53	0	2	0	1	5	1	1	7	0	0	2	0	0	1	0	0	3	5	2	0	0	1	1	2	18	40	1	0	0	0	1	9	0	13	7	2	1	0	0	12	0	24	0	5	0	2	0	0	0	0	0	0	0	6	2	1	0	0	0	0	0	0	113	27	56	18	0	1	0	0	0	2	23	2	0	0	2	58	54	20	56	0	27	22	0	24	0	1	0	34	33	0	30	2	1	2	6	4	0	0	0	53	20	1	10	51	828	5	0	0	18	7	27	0	0	0	11	0	0	8	1	28	0	1	0	1	1	1	0	168	0	1	6	0	0	0	2	2	43	1	12	0	10	4	12	6	40	14	0	27	0	8	1	9	17	5	0	0	0	1	0	5	2	7	0	1	0	3	9	25	34	7	0	0	0	52	39	12	4	8	2	154	1	0	0	6	7	2	2	2	0	1	0	0	1	0	0	0	0	0	0	9	0	22	5	47	0	0	4	0	0	6	0	0	2	0	1	0	0	0	2	2	0	0	0	0	0	0	1	0	2	2	0	0	0	1	0	0	0	6	10	0	0	13	0	0	1	1	1	1	4	0	0	11	0	5	3	0	0	3	0	10	2	43	20	1	2	0	0	2	1	0	2	0	0	9	146	2	4	0	2	0	19	9	7	4	13	7	8	2	0	13	4	0	0	11	12	0	1	0	0	0	2	12	0	0	0	0	0	0	0	0	15	2	1	0	28	2	0	24	11	0	0	0	0	0	0	27	0	15	1	28	74	1	1	0	0	0	16	0	1	0	12	10	53	31	0	26	0	0	0	11	1	131	0	7	0	172	0	22	0	22	0	0	0	0	0	3	55	2	39	20	0	28	0	0	0	0	29	2	0	13	0	0	31	37	61	11	27	8	0	0	0	12	0	2	4	0	0	0	0	8	0	1	0	0	0	9	0	0	319	0	0	5	1	11	0	0	0	60	0	6	5	0	35	16	0	0	0	48	0	28	0	6	12	41	6	0	32	14	58	10	60	16	1	0	0	1	12	1	0	4	1	2	5	0	0	0	0	0	0	0	152	5	10	5	151	21	67	0	209	0	3	0	0	0	3	0	0	0	0	0	0	1	0	0	1	3	0	2	24	36	2	0	0	1	5	1	0	0	2	3	0	55	1	1	0	4	1	3	2	1	2	0	0	36	0	0	2	0	18	0	105	20	22	6	10	1	23	0	0	0	62	25	0	0	0	1	3	0	0	61	0	2	0	51	12	16	20	0	0	23	0	0	21	18	0	29	0	1	9	4	0	0	3	0	83	81	65	5	4	6	7	3	14	7	2	0	5	0	0	29	16	0	1	1	3	0	63	87	55	0	3	13	113	0	0	2	2	0	0	3	0	1	2	0	0	32	16	2	0	5	0	33	18	1	1	0	3	0	1	17	31	0	10	14	0	8	0	153	0	21	33	29	17	16	16	0	4	145	66	0	35	3	0	0	10	20	8	2	5	0	0	0	0	0	0	4	3	3	2	2	0	1	11	45	12	196	249	18	22	0	10	0	35	66	36	0	0	15	0	0	0	2	1	0	0	0	0	6	1	3	0	0	0	1	3	2	4	2	0	4	0	0	1	15	1	24	2	7	50	6	28	2	11	24	20	30	10	8	0	0	0	1	186	71	24	0	1	3	5	17	19	0	1	4	0	1	13	19	1	1	0	0	0	0	0	38	25	0	0	3	1	0	2	0	0	4	1	1	0	0	0	48	3	4	7	670	10	0	0	0	0	0	41	0	9368	0	18	0	9	16	58	5	0	0	0	0	0	0	0	0	16	2	12	0	0	0	0	0	1	0	0	9	2	1	89	0	2	3	2	1	0	5	5	0	1	23	5	0	0	1	1	0	0	0	0	13	4	0	3	0	0	0	1	1	0	0	0	0	0	0	0	6	9	0	45	8	0	11	0	0	2	0	1	65	0	0	1	1	0	0	0	0	80	1	0	4	2	0	3	1	0	0	1	0	132	10	0	15	101	0	1	0	0	16	0	74	18	39	12	0	0	0	0	7	0	0	74	3	0	0	1	138	0	0	6	2	2	2	0	0	0	0	0	0	0	1205	14	31	10	9	1043	0	17	31	21	14	4	349	148	147	25	63	45	20	0	8	181	53	81	39	19	6	1	0	1352	4	1	22	2	4	74	11	1	0	349	8	0	0	0	2	0	5	34	0	2	0	21	19	75	20	13	32	17	6	25	0	9	1	29	20	9	24	0	0	0	0	2	0	0	2	0	0	15	2	0	9	3	28	2	2	29	1	2	0	3	8	8	2	0	0	11	0	0	16	14	0	0	0	0	0	30	0	3	0	9	7	14	11	0	44	3	2	0	21	66	248	4	1	11	19	36	4	8	28	1	16	0	19	9	0	62	0	2	5	7	17	84	5	0	16	10	37	18	0	0	18	7	0	1	52	2	9	1	0	1	40	0	1	5	5	2	0	6	11	0	0	18	0	2	7	2	0	0	0	0	0	10	0	1	17	0	1	3	1	0	224	32	14	1	0	12	1	1	26	7	0	15	0	0	1	60	25	2	27	43	0	35	18	8	10	20	8	16	4	7	5	16	12	8	5	188	79	66	0	0	0	0	2	0	1	1	0	10	2	1	8	0	0	0	0	0	12	53	18	0	6	0	1	1	0	0	0	11	14	1	1	0	0	0	0	0	7	3	1	0	0	0	0	0	1	0	0	8	0	0	5	0	0	0	47	10	1	3	0	10	2	0	0	0	1	1	0	0	14	1	0	0	0	0	0	0	34	1	0	2	10	10	2	6	0	1	0	0	0	0	0	0	6	179	0	1	9	0	0	1	9	8	13	0	0	0	1	1	21	0	35	4	6	13	0	0	0	0	1	1	0	0	0	1	28	42	71	25	71	6	16	38	7	22	0	67	12	12	18	96	207	90	71	105	10	12	40	23	1	19	4	2	25	19	13	6	17	119	14	37	103	3	29	11	72	22	9	66	12	35	33	0	60	0	0	4	4	105	26	2	15	22	79	82	3	5	157	372	283	511	0	42	29	0	0	0	0	33	12	2	79	0	11	0	555	296	166	0	1	14	0	0	0	2	0	132	48	108	64	36	30	167	59	6	23	0	28	4	61	10	0	1	3	6	0	17	13	9	16	28	12	5	1	4	22	47	21	0	0	0	6	0	1	0	12	0	1	0	1	0	1	0	14	17	2	0	0	0	21	12	1	2	0	0	2	1	0	0	19	0	0	0	0	2	0	0	0	3	9	0	0	6	0	0	0	1	0	3	4	6	7	0	15	21	2	17	49	2	0	19	0	0	0	2	0	0	0	0	2	2	1	0	0	0	1	0	16	0	0	0	0	0	14	2	0	0	0	0	0	0	0	1	0	0	1	0	1	1	0	14	1	1	0	0	7	1	75	39	12	62	0	52	4	43	1	1	0	1	1	0	0	1	0	0	0	0	0	49	14	31	8	6	0	0	0	0	2	1	1	11	7	5	0	50	0	12	0	0	60	48	0	0	3	18	0	0	19	23	55	17	10	0	0	7	0	2	50	2	73	1	0	0	11	24	7	1	4	26	11	41	11	0	0	49	20	0	6	87	242	9	4	0	0	0	18	10	7	17	0	5	0	2	0	1	4	0	0	0	0	1	0	0	30	0	0	26	3	0	0	0	0	0	17	5	3	0	95	1	0	0	0	0	0	0	0	0	46	16	6	0	1	19	1	9	0	1	19	3	18	1	0	8	0	0	0	9	5	2	0	0	1	1	0	16	6	11	5	4	2	5	0	0	0	0	0	12	16	30	1	5	135	0	0	0	0	0	7	0	6	11	2	2	88	33	14	0	0	24	0	5	4	2	0	2	0	0	0	1	0	1	9	0	3	0	0	0	2	0	2	12	52	2	0	2	0	0	0	0	16	4	12	8	18	0	1	1	0	1	0	2	13	6	0	0	0	13	0	1	3	0	31	44	0	0	42	21	9	0	3	56	0	16	5	11	579	0	0	21	0	2	0	0	0	0	0	0	2	55	13	0	31	7	35	4	2	558	0	40	0	1	0	0	0	0	0	1	0	0	0	0	1	2	0	0	0	2	1	0	0	0	0	3	0	1	0	2	11	12	0	0	1	0	35	2	4	0	2	1	75	35	0	7	3	0	10	3	38834	0	0	1	0	0	0	0	3	0	0	1	0	0	0	2	0	18	0	2	0	0	28	9	70	38	1	9	2	7	0	0	0	0	0	0	1	1	46	79	0	73	12	0	0	0	0	2	9	1	1	0	0	19	1	23	8	12	48	113	28	76	18	0	28	2	0	15	0	2	57	6	13	26	3	0	0	3	1	9	0	78	79	58	4	33	0	0	2	0	61	0	0	2	1	84	11	2	32	1	0	2	42	38	0	0	89	23	0	7	0	4	0	0	0	0	0	1	0	48	56	60	180	178	0	61	91	2	189	92	134	265	464	98	68	79	90	102	28	0	36	133	54	0	8	0	0	0	209	120	191	133	106	0	13	0	0	43	35	10	11	7	0	1	0	0	0	0	0	0	0	1	0	2	10	1	5	1	12	1	0	0	18	0	1	0	0	13	46	12	15	2	2	5	10	0	8	4	28	0	8	0	3	3	12	0	11	24	0	10	0	0	0	35	19	0	0	0	0	2	0	0	0	0	0	0	0	0	6	40	0	1	0	32	11	5	0	5	0	3	0	0	2	5	5	25	1	11	0	0	0	63	43	3	2	5	0	63	3	0	12	4	0	6	4	0	0	1	1	0	1	0	0	1	1	0	0	2	0	0	0	0	2	1	6	1	1	0	0	11	0	0	2	1	1	9	0	3	0	0	0	2	0	1	2	1	0	0	2	0	2	1	11	34	0	3	10	0	1	0	0	1	6	1	2	0	26	17	27	1	110	1	0	1	189	31	61	13	6	0	1	7	12	28	0	1	32	2	18	6	11	8	0	0	0	1	0	0	0	0	4	0	16	0	7	21	14	0	0	0	0	399	2366	0	0	2	0	2	1	2	31	18	70	18	2	31	0	48	34	4	914	2	9	0	49	42	12	23	5	49	0	0	27	2	48	18	5	0	0	1	0	0	0	22	0	6	56	24	1	1	1	0	26	29	7	0	0	0	0	3	2	0	1	0	4	0	13	7	5	0	9	0	4	1	5	1	0	6	2	12	13	1	1	0	0	0	3	0	29	109	29	20	24	29	43	2	49	1	13	15	4	21	0	1	10	3	4	0	2	5	0	0	1	0	24	5	5	4	0	0	0	9	0	11	5	11	0	13	2	11	14	7	4	0	28	0	0	1	0	3	1	1	1	100	0	21	0	1	0	4	4	1	15	0	13	0	0	0	0	0	0	0	0	0	6	7	62	0	0	912	0	1	1	11	0	0	0	3	0	12	0	8	0	2	3	7	0	0	0	0	0	6	1	0	0	0	3	0	0	0	87	0	19	8	61	164	17	27	0	0	0	0	0	0	0	0	1	0	0	0	3	2	0	0	0	283	0	0	0	1	1	2	13	0	1	0	1	0	0	1	0	0	88	0	0	5	9	0	11	4	0	12	8	6	0	49	5	4	6	23	11	8	11	25	40	42	368	293	33	191	0	0	26	4	0	10	3	11	4	0	0	0	1	0	0	179	0	0	0	0	191	0	1	0	0	1	107	7	124	0	1	0	4	4	0	0	0	0	0	0	0	1	5	0	0	0	5	167	53	0	1	0	3	0	0	0	0	38	0	0	1	0	1	4	27	36	0	0	0	0	12	2	8	0	52	10	1	59	14	4	1	2	0	3	3	4	6	10	6	1	1	4	0	0	56	5	2	4	3	45	12	0	0	20	103	23	9	1316	1	0	1	2	0	0	0	268	26	29	0	1	0	0	23	2	16	1	9	0	6	0	0	13	0	1	0	18	1	6	21	9	1	32	149	1	1	4	0	2	10	3	1	0	4	0	26	0	0	8	0	0	1	1	0	0	4	0	0	12	3	3	0	0	10	3	1	0	0	12	13	3	29	0	4	33	4	0	2	2	2	0	11	14	9	30	12	38	49	6	0	28	0	19	41	65	0	0	0	0	1	0	6	2	1	147	1	0	6	27	79	55	1	12	9	0	7	2	7	3	0	61	14	1	5	0	0	7	0	1	48	151	102	2	0	0	0	0	4	0	0	0	2	5	0	4	2	0	0	0	3	0	0	0	2	7	0	0	0	2	2	0	0	0	0	2	3	0	0	0	0	0	0	0	63	1	0	0	0	1	0	0	0	0	0	0	0	8	1	0	0	22	6	29	6	0	15	5	2	1	1	3	1	9	0	1	0	2	13	269	12	43	17	9	18	1	3	5	0	46	15	0	0	0	0	16	6	36	0	0	18	0	3	16	0	22	10	0	1	6	1	0	88	22	0	11	0	1	3	0	0	0	21	7	28	7	24	8	30	15	5	88	7	12	1	0	2	4	0	16	61	87	77	0	71	49	42	4	2	0	14	1	1	2	0	0	4	3	3	0	0	0	1	30	0	0	0	0	3	0	8	1	16	28	20	19	6	0	15	1	49	17	22	22	14	7	84	24	60	0	0	1	0	0	4	0	0	5	45	20	79	16	0	0	10	0	1	2	0	0	2	0	0	0	0	1	1	0	7	62	93	0	41	45	51	2958	28	0	9	0	0	0	0	1	10	3	4	1	0	2	34	0	0	0	8	7	0	0	0	2	2	0	1	190	77	0	20	62	5	2	1	2	1	0	4	0	58	0	1	1133	0	0	0	32	0	41	0	2	0	0	1	0	3	0	0	0	1	10	0	0	0	0	0	9	0	0	2	1	2	0	0	1	0	4	3	1	3	4	0	0	0	0	2	1	25	1	156	706	1	30	39	19	165	21	84	40	0	12	0	15	1	0	0	0	0	0	0	0	1	0	0	17	0	0	0	0	9	11	0	0	2	5	0	18	0	0	0	0	26	1	0	0	0	0	0	9	0	0	18	5	0	0	0	0	0	0	0	0	1	0	2	0	1	5	1	19	36	37	15	55	0	0	0	0	0	0	0	0	117	1	69	2	0	5	13	1	47	33	0	0	0	0	1	0	0	0	0	0	0	0	0	0	0	0	0	2	0	2	0	0	2	0	0	1	0	2	0	0	0	0	1	2	0	0	303	0	0	0	0	0	0	0	0	1	5	0	0	0	0	0	2	1	0	0	2	0	0	2	0	0	1	0	1	0	0	1	1	0	0	122	0	1	4	0	1	0	44	0	0	0	2	1	0	0	1	2	22	0	0	14	3	0	1	0	0	6	0	0	0	0	1	0	0	0	12	0	1	0	0	0	2	0	0	0	0	0	0	0	0	3	0	0	0	0	0	0	0	0	11	0	0	0	0	41	0	0	0	0	0	0	0	0	0	0	0	0	2	0	0	5	0	0	1	0	0	2	3	0	19	0	0	0	0	3	0	0	0	3	0	1	0	16	0	0	0	0	0	0	1	0	0	1	0	0	0	0	0	0	0	0	2	0	0	1	11	1	0	0	80	0	0	0	0	0	0	1	8	1	2	2	3	3	92	0	28	8	1	0	0	6	0	7	1	0	11	66	0	3	1	1	248	3	97	0	0	0	0	0	1	6	4	9	4	0	0	9	8	9	8	11	0	8	0	0	7	0	10	0	19	0	7	0	50	7	7	0	32	11	10	10	0	3	9	0	8	42	12	5	10	1	3	1	0	2	6	6	0	82	4	3	2	3	22	8	0	2	0	0	41	13	22	4	3	1	8	3	6	25	3	7	2	4	48	0	0	124	3	2	11	3	9	0	49	0	21	25	9	2	4	2	14	20	17	8	4	3	0	1	3	16	19	13	21	31	29	36	13	78	343	48	15	0	0	7	81	0	5	0	0	0	1	0	0	1	0	11	0	0	0	0	0	7	0	5	1	70	15	34	0	0	4	0	0	50	1	102	0	46	54	1	0	2	16	4	2	0	2	0	0	0	5	0	0	2	37	1	13	0	1	5	0	0	0	5	0	0	1	0	1	0	12	0	0	0	0	1	1	0	0	0	0	0	5	17	0	1	1	4	0	1	0	1	4	2	1	55	1	2	0	4	0	13	2	1	0	5	1	1	0	0	1	19	0	9	0	1	0	3	0	0	2	2	0	0	4	0	0	0	1	0	10	0	87	0	2	0	0	2	0	0	0	0	1	82	0	18	3	2	0	0	0	0	1	0	0	0	0	0	0	0	1	0	0	0	0	1	73	43	2	41	37	1	0	0	2	0	0	1	0	370	1	10	4	66	0	1	0	0	10	29	8	0	0	5	4	4	0	2	3	0	19	14	17	223	0	29	39	37	1	0	0	1	1	0	1	1	0	0	0	1	37	0	1	0	5	3	1	0	6	25	0	0	10	0	0	0	1	0	0	14	15	25	18	45	45	0	35	51	626	0	58	10	6	53	0	6	11	6	0	0	0	0	0	2	70	13	0	0	0	0	52	19	9	0	0	16	1	0	1	0	1	3	4	0	18	8	20	1	0	72	0	0	0	2	1	0	4	1	8	0	14	0	28	9	2	22	1	14	0	52	0	1	0	6	5	4	30	0	16	0	10	52	24	36	16	4	1	13	1	4	4	119	81	2	3	0	0	0	0	1	0	2	4	0	0	1	2	0	0	19	50	10	0	3	0	1	31	14	39	0	7	0	1	21	25	3	44	0	0	0	1	15	22	25	75	26	0	1	0	2	0	11	0	0	1	3	7	1	137	38	51	0	17	1	0	5	9	12	2	2	0	0	3	28	78	16	32	40	24	10	0	156	0	6	5	14	9	4	7	12	35	38	2	3	11	125	41	2	0	0	0	0	0	0	40	0	0	106	0	0	0	0	0	2	8	80	16	6	0	1	1	0	6	0	0	1	3	6	0	3	1	1	0	4	25	11	119	5	7	1	1	0	3	0	43	12	0	0	17	0	0	0	15	3	1	49	17	3	39	0	2	0	15	37	0	0	2	1	0	24	0	3	4	0	0	0	0	0	29	9	1	17	2	10	1	0	0	0	0	2	2	0	33	0	1	0	51	0	0	125	0	34	12	0	14	22	0	0	0	5	0	37	15	0	2	2	3	3	3	0	0	0	2	2	0	0	77	38	13	2	2	1	1	2	3	0	0	0	0	6	0	13	23	0	208	18	2	198	146	106	427	122	18	50	334	337	261	194	182	81	169	33	116	31	0	5	0	3	2	14	0	1	0	5	3	1	19	0	1	0	0	1	0	4	3	2	0	1	0	9	14	2	3	3	6	0	0	0	1	0	0	0	0	0	0	0	0	0	0	1	0	0	0	0	0	0	1	3	0	0	1	24	15	0	0	4	0	2	2	0	0	0	0	0	0	0	0	0	0	0	2	0	0	0	0	1	0	19	21	0	81	8	0	1	15	0	0	1	30	92	61	35	2	45	102	25	0	40	1	6	4	0	0	2	1	0	0	0	16	45	3	26	12	34	0	0	0	33	4	17	5	0	1	1	15	1	0	2	0	1	2	7	4	5	3	5	1	18	6	28	7	17	0	16	28	12	0	21	25	5	0	0	0	0	0	1	1	49	0	0	0	0	0	0	0	10	2	6	0	0	105	8	2	27	0	47	0	0	0	0	20	2	0	1	222	20	3	5	0	0	375	0	0	0	3	11	1	11	0	1	34	0	0	1	11	0	23	40	51	0	18	36	0	0	8	21	0	1	0	6	4	2	12	14	7	35	0	7	0	4	1	37	9	0	3	14	63	10	30	10	10	4	15	16	0	14	0	1	14	1	0	0	0	46	0	1	7	8	8	1	6	5	1	1	0	0	0	22	2	1	0	0	0	2	0	2	2	1	0	1	0	1	2	12	0	0	0	0	0	3	3	4	6	0	0	1	7	0	0	1	31	9	7	6	3	0	49	0	0	96	58	105	18	19	0	2	638	381	0	28	62	0	2	0	4	22	6	16	0	29	0	47	34	14	0	0	2	1	0	4	12	11	0	0	28	25	61	2	0	0	0	0	0	0	64	0	11	11	20	2	0	0	3	3	0	0	13	288	3	106	20	9	0	48	4	5	0	0	0	1	0	2	0	0	0	6	0	196	0	3	17	10	0	44	10	306	34	2	0	0	21	23	6	173	42	18	30	13	76	1	47	57	2	0	0	0	2	1	10	10	769	172	13	1	27	0	32	0	0	34	0	0	1	7	0	3	0	174	99	0	1	0	110	59	25	24	8	13	17	32	87	0	5	20	0	1	9	19	14	0	1	1	2	0	0	0	17	32	1	2	3	2	0	0	0	0	0	0	0	0	0	0	134	6	0	1	0	35	31	29	0	0	1	13	5	2	0	3	0	48	38	6	0	34	10	25	6	0	1	4	50	3	21	2	0	1	19	29	34	22	54	62	90	1	5	2	152	6	34	61	0	0	0	0	0	1	0	1	8	0	0	0	0	0	0	0	1	0	1	0	54	1	4	4	16	4	19	0	0	24	2	9	0	0	4	0	4	0	1	1	55	10	9	42	20	14	26	0	7	1	1	0	0	3	1	0	0	0	0	0	11	1	0	0	0	0	0	3	0	0	0	7	0	0	2	2	3	0	2	4	1	13	0	139	0	0	5	1	0	15	4	0	0	2	0	12	0	0	0	1	0	1	4	15	14	5	0	75	2	33	0	8	0	97	1	46	103	1	3	2	0	8	0	4	0	108	62	615	48	50	192	12	49	33	23	34	37	54	83	2	30	26	0	0	3	20	0	1	0	3	1	0	10	3	0	1	0	0	1	1	14	0	0	0	1	1	0	4	0	1	0	1	0	0	2	0	1	0	0	2	0	0	0	0	1	1	0	3	3	0	37	3	0	72	0	36	103	23	39	0	0	0	7	0	0	0	0	2	82	0	0	34	59	0	0	0	3	0	38	1	13	13	26	0	0	1	0	2	0	0	0	3	1	1	0	0	1	7	7	5	0	16	3	1	6	2	0	2	0	0	1	3	41	18	3	0	5	3	22	0	21	8	0	3	16	0	24	0	33	12	1	1	1	0	2	0	0	0	9	5	0	2	80	4	2	2	0	0	21	0	1	0	0	1	0	0	1	0	2	12	8	0	32	80	0	1	1	2	1	0	0	0	17	0	3	6	1	0
LakWasMet28_LOW6_2_rpkm	0	0	0	0	0	21	21	1	1	1	0	9	8	0	1	0	0	1	13	0	1	0	0	30	0	0	0	0	0	8	0	6	0	3	5	5	4	0	4	0	0	0	0	9	28	24	46	7	0	4	2	8	0	0	0	5	0	11	73	17	313	0	0	2	0	1	0	1	14	69	1	3	1	0	5	0	0	0	0	0	0	6	0	0	0	0	1	1	0	0	0	1	16	4	10	0	1	0	1	2	0	0	0	0	0	1	0	0	0	0	0	0	103	6	31	0	0	0	0	0	0	1	0	2	0	0	0	0	0	0	0	40	22	0	1	0	0	1	23	0	1	0	0	8	1	0	0	0	9	4	4	11	6	6	7	0	6	12	9	0	5	2	0	4	29	3	0	3	0	9	0	0	0	0	0	0	0	0	1	0	0	0	0	0	0	28	0	0	0	23	0	0	3	7	3	0	0	22	10	278	18	0	25	0	0	0	23	0	21	5	8	1	44	6	12	0	20	1	0	4	1	2	20	1	3	22	0	1	11	0	0	0	4	0	1	0	13	45	34	11	0	0	18	14	30	29	0	0	21	10	17	4	20	0	1459	803	0	0	0	0	0	0	1	15	16	1	3	3	3	34	56	1	3	0	0	1	0	0	45	51	1	15	36	18	20	0	0	0	12	0	1	0	0	3	1	0	1	3	3	0	0	23	56	3	24	1	30	20	39	0	25	0	28	10	0	0	0	1	1	0	1	0	0	1	5	1424	4	0	8	0	0	1	0	0	0	2	1	0	0	0	0	1	16	22	8	1	4	0	0	0	7	1	2	0	4	1	1	0	0	47	21	0	11	0	1	13	14	22	33	5	1	27	0	0	5	5	0	0	0	3	1	0	1	4	0	0	96	0	0	0	0	1	79	2	0	5	142	0	0	66	0	22	0	1	19	1	5	0	0	0	0	7	95	4	0	38	28	1	1	0	0	0	2	0	0	0	0	0	0	1	3	1	1	0	0	1	1	0	9	0	28	56	0	0	30	46	0	0	0	0	2	84	26	70	0	71	32	4	0	31	0	1	0	7	4	36	4	0	1	11	16	27	16	4	0	0	4	7	426	1	17	0	2	4	0	0	0	124	54	12	0	0	66	26	5	0	6	0	0	0	0	0	2	0	1	0	0	2	0	0	0	0	0	2	1	0	0	0	2	1	0	0	0	1	0	0	0	0	0	0	1	0	0	5	11	0	7	1	0	13	0	23	0	12	28	1	0	1	1	0	0	0	2	0	0	30	0	0	0	4	0	0	0	0	11	0	26	0	22	0	0	0	1	1	28	78	132	153	2	52	153	133	109	102	50	2	31	0	2	0	0	0	4	0	4	0	1	0	1	0	10	1	0	1	5	22	0	68	0	22	0	92	146	73	0	0	44	1	131	5	146	68	32	8	0	3	2	13	1	3	13	10	0	0	1	0	0	0	0	2	0	37	0	0	0	1	0	5	4	0	61	0	4	14	6	0	0	0	0	1	5	127	0	72	0	0	0	0	12	33	35	17	0	1	2	0	12	0	0	0	3	4	6	0	0	0	2	1	0	13	0	0	6	2	5	0	0	4	0	4	0	5	0	3	2	0	0	0	15	2	1	0	0	1	9	2	0	2	9	0	0	1	2	4	2	0	9	0	9	0	0	0	2	0	0	0	0	0	0	17	0	31	14	0	31	30	12	0	0	30	0	0	0	0	1	14	0	0	100	1	0	19	0	38	1	4	1	0	0	0	0	0	0	0	0	25	0	0	0	0	0	0	4	0	0	0	2	0	0	6	3	5	3	0	0	0	5	0	0	18	0	0	1	0	250	3	10	0	0	3	0	0	2	0	0	0	12	0	1	0	0	0	0	28	10	0	3	4	1	1	0	0	1	0	0	0	0	34	12	0	0	0	0	0	0	0	0	12	33	23	0	0	1	1	1	0	6	0	0	17	28	1	1	0	0	3	2	0	0	4	0	0	0	0	0	0	1	20	3	53	0	0	0	3	4	3	0	0	0	0	0	0	0	0	1	0	0	2	0	0	0	0	0	1	0	0	0	2	0	1	0	0	0	4	30	30	47	22	24	0	0	0	0	0	0	1	0	0	0	0	10	0	0	1	0	0	0	0	0	31	0	0	0	4	5	0	20	5	0	0	1	6	0	0	1	0	0	0	0	0	1	0	1	0	2	2	0	1	1	2	1	17	6	271	7	18	2	0	1	0	10	7	18	0	31	0	0	0	2	0	0	2	1	0	0	0	0	17	19	0	0	1	0	0	0	0	0	0	0	0	0	1	1	0	0	0	0	57	0	0	0	56	13	0	4	8	0	0	9	4	4	0	0	0	0	0	1	2	168	0	0	0	0	0	0	0	0	12	0	1	1	0	0	1	8	0	0	0	0	2	7	12	0	2	1	0	0	0	115	16	15	0	2	1	8	3	12	2	5	10	0	4	0	0	0	0	0	0	0	11	3	0	0	0	0	0	1	0	0	0	0	0	0	0	2	39	57	0	9	55	0	3	0	0	4	0	0	3	6	1	1	1	1	0	0	0	25	25	6	2	11	0	3	0	0	6	5	0	0	0	0	0	0	5	0	0	0	0	1	0	0	0	0	0	19	0	7	0	0	3	0	0	0	0	0	0	0	0	1	0	18	25	0	0	0	0	1	1	5	0	1	0	7	0	1	0	0	4	0	0	6	2	27	19	120	72	1	1	0	5	4	0	0	7	0	8	2	0	0	0	2	0	11	0	0	0	2	40	1	5	1	1	5	0	1	0	0	0	46	0	0	0	0	0	2	0	0	8	15	0	7	0	906	14	0	1	0	16	0	0	6	0	0	73	70	0	0	1	1	0	51	0	0	11	0	3	0	0	0	0	0	1	13	8	3	11	10	50	0	55	2	1	7	7	0	22	0	0	4	1	0	5	0	0	0	4	0	0	15	6	0	0	6	0	0	2	3	2	1	20	2	2	0	0	1	0	0	0	0	0	0	0	84	0	1	0	0	1	7	0	0	0	0	14	5	0	27	42	28	35	0	0	9	0	0	0	1	5	2	7	0	1	1	0	0	0	16	13	0	1	1	0	22	2	8	0	5	4	2	17	0	1	37	4	3	4	5	7	7	0	0	0	11	0	19	2	6	20	3	33	8	6	31	0	0	5	10	14	0	3	0	2	4	16	6	0	7	0	1	12	0	14	21	10	1	0	9	0	0	0	0	0	1	25	20	0	0	2	33	1	22	39	3	4	20	0	2	8	7	5	0	4	1	16	9	16	0	0	0	0	0	0	2	505	57	5	18	0	0	1	0	0	0	0	0	41	3	1	2	33	1	0	0	5	56	32	35	18	0	0	2	105	0	0	1	0	2	0	1	0	145	41	21	48	66	36	0	37	87	6	0	0	0	0	0	0	156	1	0	0	0	20	0	9	2	0	0	2	0	4	0	3	0	0	0	3	6	0	0	0	2	2	0	5	14	19	0	0	0	0	1	7	0	2	0	0	0	0	2	3	0	0	7	1	0	0	0	0	2	4	0	2	0	43	0	0	0	0	0	0	0	0	0	0	0	1	0	0	0	0	0	0	1	0	3	0	1	696	6	1	132	0	1	0	0	75	0	22	13	0	0	131	0	81	1	10	0	0	4	0	14	0	13	0	1	1	0	0	1	0	0	11	41	0	0	0	7	2	1	3	0	0	1	0	0	0	1	3	5	68	26	26	0	0	4	29	0	0	0	2	3	0	2	1	8	1	0	8	5	0	12	5	9	19	8	0	13	5	1	0	0	10	1	6	8	8	10	0	26	0	0	0	1	0	0	0	14	0	57	10	63	80	166	80	41	5	0	0	1	10	10	40	0	0	3	21	43	0	0	0	18	1	6	0	1	23	25	0	55	12	0	3	0	4	6	6	1	0	117	5	3	0	0	0	0	6	0	77	0	13	65	1	0	0	5	8	1	36	3	5	14	0	1	4	0	6	32	232	42	56	0	22	3	8	10	14	1	2	7	1	3	0	382	0	2	0	2	0	1	13	14	1	18	5	0	0	0	2	0	2	0	29	0	0	0	0	2	13	1	0	0	0	44	0	513	65	0	14	151	144	0	14315	13	0	8	1	1	0	0	0	0	0	0	0	0	1	1	0	0	26	1	0	0	0	0	1	1	3	1	24	0	0	1	2	3	21	1	0	0	1	11	0	11	7	4	0	15	0	1	1	4	2	0	0	21	1	0	11	20	0	3	0	114	234	1	23	0	24	80	0	38	9	37	2	20	22	34	7	56	28	0	12	1	0	0	0	1	0	1	0	0	1	0	2	0	0	8	0	2	17	0	25	50	0	0	0	0	0	0	0	4	0	0	0	2	0	1	1	0	0	7	9	80	0	0	0	1	0	1	1	0	0	0	1	3	0	0	0	1	0	1	0	0	1	0	0	0	0	95	3	0	0	0	5	0	0	1	0	0	0	0	0	86	0	2	1	5	2	3	0	12	0	36	11	17	13	1	2	3	0	1	0	0	0	0	13	1	0	83	25	4	3	0	4	0	0	0	0	0	2	0	0	9	0	25	10	19	26	0	23	3	0	0	0	16	10	43	5	0	0	0	1	0	0	0	0	0	0	4	0	3	0	0	1	2	0	0	0	0	0	1	0	0	0	1	0	1	0	1	1	0	1	15	195	163	0	0	0	1	0	0	0	3	0	0	15	8	0	0	0	0	3	0	0	19	0	2	0	2	0	0	3	2	0	0	36	0	2	1	1	3	0	0	0	0	0	0	14	0	0	0	0	1	14	0	0	10	17	0	38	26	29	3	0	7	0	0	0	43	0	30	7	0	1	0	0	0	15	0	15	0	0	0	0	0	2	0	0	3	0	0	4	0	0	0	1	0	2	1	0	0	0	23	24	0	0	0	0	0	0	2	0	0	0	0	0	0	0	0	0	12	0	0	0	0	15	4	1	2	26	1	0	1	632	0	2	54	86	29	40	1	1	13	11	0	0	0	0	0	4	39	0	1	4	3	3	0	0	0	0	11	0	3	0	0	1	1	32	0	0	14	0	18	1	0	2	0	0	0	4	1	0	0	1	3	4	4	0	3	0	0	2	1	0	31	10	1	5	4	0	0	0	7	16	0	0	1	0	0	0	0	0	3	0	0	1	1	5	113	1	0	0	0	0	2	1	0	3	5	1	5	0	0	0	0	0	0	0	1	0	0	2	0	0	0	0	0	0	0	0	2	0	0	0	0	0	0	14	0	0	3	1	1	1	21	1	9	0	6	1	0	0	0	0	0	3	6	0	0	0	0	0	180	142	153	274	241	102	121	198	20	166	123	220	347	101	29	110	50	305	268	16	30	3	613	457	319	255	243	85	180	66	139	9	105	16	0	1	0	0	0	0	2	0	1	0	87	67	0	0	1	0	0	0	0	0	1	0	0	0	0	0	0	4	0	0	2	1	7	0	7	0	4	1	1	0	1	1	10	0	10	1	2	2	0	1	0	0	0	0	0	0	0	9	1	0	0	0	3	5	1	15	3	1	1	1	0	0	0	13	0	0	2	3	0	1	0	0	90	0	0	16	1	2	0	0	0	1	0	0	1	2	2	7	0	3	0	0	1	0	10	0	0	0	0	0	0	2	1	3	0	1	3	37	1	0	4	6	0	0	0	0	0	2	0	2	1	0	0	1	0	28	5	3	0	0	2	1	0	1	6	4	7	3	0	4	2	0	1	0	1	75	5	3	0	0	0	2	1	1	0	0	18	0	11	21	2	0	0	0	2	15	0	5	0	0	1	0	1	0	0	1	0	1	1	2	0	0	3	0	0	0	0	0	0	1	2	0	0	141	0	7	0	143	1	1	0	1	2	1	0	1	0	1	0	0	0	0	0	0	5	0	25	16	0	3	0	0	11	0	0	76	9	0	15	6	0	31	0	9	4	4	0	0	0	0	2	4	0	5	1	0	0	2	0	0	1	0	8	0	1	2	3	0	0	0	2	0	0	0	0	0	1	0	0	0	0	0	0	0	17	0	0	0	0	26	6	12	76	141	7	0	1	0	0	0	0	0	0	0	0	0	1	0	0	0	0	0	24	2	2	3	0	1	0	5	0	0	0	0	24	7	6	0	0	0	468	0	0	0	0	0	0	0	0	0	1	0	0	0	41	23	0	1	0	0	0	0	0	1	0	1	16	20	4	3	0	1	1	0	13	6	0	4	0	0	1	0	1	0	1	0	0	1	3	0	81	2	0	0	0	0	1	3	0	1	1	1	0	1	0	1	0	1	2	1	1	0	0	1	0	0	0	0	0	4	0	2	0	0	0	0	0	4	2	0	56	0	1	21	0	3	1	0	1	0	7	0	1	13	1	17	17	0	0	0	0	0	0	0	0	43	0	0	0	0	0	0	27	0	15	12	38	12	0	32	35	9	1	17	0	33	0	32	1	13	2	15	3	14	8	5	3	15	1	8	0	13	0	1	0	9	0	9	1	18	26	28	15	14	10	12	1	0	6	4	7	0	71	0	3	0	17	20	1	20	1	2	1	4	12	6	0	0	0	3	0	3	33	1	0	0	0	12	5	0	3	0	1	236	0	0	0	0	0	0	0	0	14	0	0	3	0	4	4	2	2	0	1	0	1	0	0	0	0	2	0	2066	1	3	21	28	13	1	13	0	17	0	0	0	102	0	0	0	0	0	24	0	133	0	7	10	0	0	0	1	0	5	3	0	25	8	0	103	0	15	0	0	0	40	66	0	0	1	2	2	0	0	0	1	9	0	1	1	0	0	57	1	0	0	28	16	0	0	1	0	0	0	328	705	699	4	0	0	0	7	0	10	6	30	0	0	0	0	0	2	34	184	33	1	0	0	0	0	0	0	41	0	2	0	0	0	1	0	0	8	0	0	1	0	0	0	0	0	0	1	0	0	75	131	0	0	1	0	0	0	1	37	14	0	0	0	0	0	35	23	0	0	0	0	0	0	0	37	0	5	1	0	1	6	1	2	9	3	0	7	0	3	0	0	0	0	0	1	0	2288	3	0	1	1	2	0	1	0	0	0	0	1	0	0	0	15	0	6	0	1	0	0	1	1	0	0	0	0	0	0	1	0	0	0	0	0	0	0	0	0	0	2	5	0	8	0	0	0	0	0	0	0	1	0	2	0	0	0	0	52	2	0	0	5	0	0	38	0	0	0	0	0	0	108	1	0	0	0	1	40	21	22	5	1	32	0	0	13	0	0	34	0	0	18	1	0	0	0	2	0	0	0	9	0	1	0	0	0	0	0	0	0	0	0	0	15	0	0	0	0	0	1	0	1	1	0	3	0	0	0	1	0	9	0	0	0	0	0	0	0	0	12	0	12	0	29	16	4	1	3	0	3	0	1	0	5	0	0	4	27	0	3	0	7	0	7	0	0	1	0	0	0	0	0	1	8	1	30	8	15	0	15	0	6	0	0	0	0	11	0	0	0	1	0	4	14	0	34	33	0	21	1	24	864	0	1	0	0	0	0	0	3	6	18	0	0	0	0	0	0	150	180	0	152	0	0	1	10	0	0	0	0	0	0	0	0	2	0	0	14	89	8	0	0	0	0	0	0	1	1	37	1	11	1	0	0	0	0	2	0	7	16	0	0	0	0	9	1	0	0	2	0	3	1	1165	2	0	11	2	0	0	0	24	0	0	1	21	0	2	1	0	0	0	2	158	0	0	1	2	37	0	0	0	0	0	1	5	0	0	0	2	0	1	80	2	0	0	0	0	0	0	29	0	0	0	1	0	1	0	0	0	1	1	0	1	0	1	2	0	0	1	1	1	2	0	0	7	0	4	1	1	0	0	1	0	0	0	0	7	0	6	0	2	0	1	17	0	6	0	1	0	0	0	0	0	0	0	1	0	0	1	0	3	0	0	0	0	1	0	0	0	0	1	0	0	0	0	0	2	0	1	0	0	2	1	0	5	0	0	1	23	0	0	4	2	0	1	2	0	1	0	0	0	1	0	0	0	0	1	27	0	0	0	0	0	0	0	0	0	13	0	0	2	0	132	1	1	0	15	1	0	0	1	1	0	3	0	13	0	1	0	0	15	2	2	0	0	26	1	0	0	4	12	0	0	0	0	2	0	0	0	0	0	0	16	0	0	256	0	0	0	0	12	0	0	0	500	0	0	0	0	1	1	0	0	0	0	1	0	0	15	0	7	0	0	0	0	0	0	3	3	22	1	0	0	0	0	27	0	0	0	0	0	1	0	0	0	9	0	0	0	0	0	0	0	0	1	0	0	0	0	0	0	0	0	0	0	0	0	0	8	0	1	0	0	2	1	0	0	0	1	1	0	0	0	0	0	2	0	0	0	3	1	0	0	0	0	0	13	0	0	0	0	0	0	0	0	0	8	0	1	0	0	0	0	1	0	0	0	0	1	0	0	1	0	0	0	0	0	0	0	1	0	0	0	0	0	0	0	0	32	0	1	15	0	2	2	0	0	7	0	0	13	1	0	7	1	1	2	0	8	1	1	0	0	1	0	126	57	3	0	3	1	227	1	7	0	1	0	3	2	1	0	1	0	0	3	0	0	0	0	3	0	0	0	1	2	0	0	9	0	2	0	0	0	1	0	0	0	0	0	0	0	0	0	1	1	0	1	0	2	1	0	81	0	32	7	0	0	0	0	0	0	0	0	0	25	2	0	0	2	1	0	0	0	1	0	0	1	3	0	4	3	0	3	0	0	3	0	0	0	1	0	0	0	0	16	0	0	0	2	1	0	0	0	1	0	0	1	2	0	0	0	1	0	0	0	0	0	0	29	16	0	0	0	0	23	0	2	24	0	3	1	1	1	0	0	1	1	0	0	0	0	0	0	1	0	1	0	0	0	0	14	0	0	1	0	0	1	22	0	1	0	0	0	1	0	1	0	0	0	0	0	0	0	0	1	1	0	0	0	1	0	0	0	0	7	1	0	0	0	0	0	2	2	0	0	0	0	0	0	1	0	0	0	6	1	1	6	3	24	1	11	0	1	0	1	0	1	0	0	1	0	0	0	0	0	2	0	39	8	0	18	0	2	0	2	0	0	1	0	0	4	1	0	0	1	0	2	1	63	0	2	0	19	0	0	2	0	0	10	6	0	31	0	0	0	0	0	0	0	0	0	0	3	7	0	0	8	1	0	0	0	14	1	0	18	0	0	1	0	0	0	0	0	1	0	0	3	2	0	0	1	0	0	0	0	0	0	2	16	0	13	0	0	1	3	0	0	0	0	1	24	0	1	0	0	3	1	1	0	0	5	14	2	1	1	0	1	0	0	0	2	0	0	4	4	9	0	44	8	3	116	201	0	0	10	0	350	0	30	93	12	0	0	0	58	292	0	62	0	17	27	0	527	0	4	0	4	8	0	0	13	25	1	17	0	1	10	1	31	43	21	0	0	6	3	15	0	30	1	1	19	7	2	2	0	0	0	1	0	9	20	1	0	0	4	16	1	1	49	0	3	0	0	0	3	0	0	0	0	20	1	0	1	21	2	21	8	28	6	0	0	27	3	8	1	0	0	0	0	0	0	0	0	0	107	84	1	0	2	0	2	0	0	7	18	0	0	0	0	0	0	8	9	1	2	0	0	0	0	50	16	0	0	4	0	0	0	0	1	0	0	10	7	0	2	0	0	23	0	0	0	0	3	3	0	3	2	0	0	0	12	0	1	9	0	13	15	2	1	0	0	0	16	4	5	1	34	0	0	0	0	18	2	1	0	71	62	399	2	16	46	23	313	3	148	66	39	6	393	381	199	0	674	81	154	43	160	4	258	16	294	1	11	0	11	0	12	0	1	2	2	1	0	0	0	1	0	6	1	0	0	0	0	0	36	0	0	25	7	0	6	1	0	0	1	6	0	9	5	1	0	0	2	0	1	28	0	1	0	3	0	0	0	47	4	0	1	0	48	3	0	5	3	5	0	58	0	0	0	0	3	0	5	63	4	17	2	38	0	1	0	1	0	0	1	0	0	0	0	0	0	1	3	23	0	0	0	0	1	0	0	0	1	30	1	0	19	0	11	0	0	0	0	4	0	26	9	1879	0	3	1	0	0	0	6	3	1	15	4	0	0	0	0	0	0	0	0	0	0	2	0	106	0	0	80	2	0	0	0	1	0	0	87	0	1	1	0	16	0	0	2	0	12	0	0	21	6	5	2	1	3	0	5	0	0	0	0	0	0	0	2	0	0	0	1	0	0	0	0	0	0	44	0	0	0	5	0	0	0	0	0	0	0	1	91	1	0	0	0	14	2	0	2	16	6	0	0	59	121	86	0	0	1	0	22	2	0	0	1	6	0	0	0	0	0	0	1	0	1	152	5	11	0	30	0	0	0	0	0	0	0	3	6	5	0	2	0	0	1	0	0	0	2	16	1	17	9	0	1	1	30	1	0	7	11	0	0	2	6	1	7	4	0	10	0	0	3	1	43	0	1	16	1	0	1	0	145	0	31	0	0	0	0	0	0	30	0	10	0	0	0	0	1	1	0	0	1	0	0	1	10	1	10	4	1	9	9	0	0	0	13	0	0	1	0	1	0	19	0	0	0	0	0	2	4	3	0	0	0	0	3	0	0	2	8	0	6	0	4	0	1	0	1	0	36	6	2	0	2	0	0	0	14	1	0	0	3	0	0	0	3	0	0	0	1	0	0	12	1	2	13	3	3	0	0	0	0	0	0	0	0	1	3	0	1	0	0	12	7	7	0	1	0	42	73	15	26	0	0	0	0	0	0	0	0	3	1	0	83	9	0	2	0	1	0	27	0	18	8	14	17	11	22	19	6	1	0	0	0	1	15	0	0	10	1	1	5	0	0	0	1	5	0	15	9	1	17	1	8	7	0	0	1	0	128	0	0	0	3	0	0	8	6	1	0	0	0	0	0	0	0	0	0	0	4	0	0	0	5	0	0	60	27	0	0	2	0	11	7	10	3	3	0	0	0	0	13	0	4	0	0	0	2	1191	1	20	0	0	0	3	0	2	10	1	0	0	0	0	0	0	0	3	0	0	29	19	0	0	0	0	0	11	1	1	0	0	1	0	1	2	1	0	0	1	0	0	1	0	3	1	0	10	0	0	0	16	0	0	1	1	7	0	3	0	0	2	29	1	4	1	2	0	1	1	3	3	0	14	2	0	12	0	8	1	0	3	0	3	0	4	0	1	1	2	0	3	1	0	12	7	0	5	0	2	0	1	141	1	7	0	13	1	6	1	1	13	0	0	1	5	0	17	8	0	1	1	0	4	40	0	1	2	0	0	0	64	0	1	0	1	0	0	0	104	6	0	0	0	0	5	0	0	0	0	3	3	1	0	0	0	0	8	0	0	0	0	1	1	0	1	0	1	0	3	0	1	1	0	0	0	0	0	0	0	0	0	0	0	0	0	0	0	0	0	0	1	60	0	1	0	0	0	0	1	1	3	0	0	14	0	0	1	0	1	1	0	0	0	4	0	0	1	0	0	0	3	1	0	0	2	1	1	5	0	1	1	0	87	0	1	0	0	2	18	0	5	0	0	0	0	0	0	7	12	1	1	2	1	0	0	1	13	2	4	49	0	2	42	0	3	0	0	0	0	0	0	19	0	41	0	0	0	0	0	0	0	10	0	0	97	0	0	0	0	2	0	1	1	0	0	0	1	0	0	1	23	0	4	19	0	0	0	0	0	5	0	1	0	1	0	0	0	0	0	0	10	0	5	0	0	797	0	0	0	17	7	1	0	0	0	4	0	0	17	1	0	0	0	0	0	0	0	0	0	0	53	0	1	2	0	3	0	0	2	0	0	0	0	0	0	0	0	1	7	2	0	0	0	0	2	9	11	0	0	0	0	0	15	0	10	6	0	0	0	0	9	0	17	0	5	0	49	0	0	0	0	0	0	0	12	9	1	0	1	0	0	0	0	38	31	23	14	3	2	0	1	1	0	11	0	0	0	2	63	20	17	69	1	43	34	1	16	0	0	0	25	10	0	29	0	0	1	3	1	0	0	0	59	18	4	8	83	933	0	0	0	9	13	32	0	0	0	4	0	0	7	0	20	0	0	5	1	0	0	0	24	0	1	9	1	0	1	0	1	27	1	11	3	4	2	16	9	46	18	1	16	1	2	0	8	11	2	0	0	0	3	0	1	3	5	0	0	0	4	1	14	13	12	0	0	0	43	27	7	2	12	1	70	3	0	0	9	3	1	4	0	0	0	0	0	1	0	0	2	0	0	0	2	0	15	4	126	1	0	3	0	3	13	0	0	0	0	4	0	1	0	0	1	1	0	0	0	0	0	0	0	1	2	0	0	0	1	0	0	0	8	0	1	0	7	0	1	4	0	0	0	0	2	0	11	0	5	3	1	1	2	0	14	3	37	43	2	1	3	0	0	1	0	3	0	0	4	222	0	2	1	1	0	14	9	10	1	3	6	3	2	0	17	1	0	0	10	15	0	0	0	0	1	0	17	0	0	0	0	0	0	0	0	23	3	0	1	42	1	0	25	18	0	1	0	0	0	1	30	1	17	3	61	30	0	0	0	0	0	5	1	0	0	15	16	11	17	1	31	0	0	0	18	2	134	0	0	1	355	1	18	1	0	0	1	0	8	0	0	42	1	35	6	0	18	1	0	0	0	15	0	0	9	1	0	20	46	26	13	12	13	0	0	0	3	0	4	3	0	0	3	1	3	0	0	0	0	0	4	0	0	9	0	0	7	3	2	0	0	0	35	1	15	8	4	28	24	0	0	0	46	0	12	7	3	11	32	5	0	23	19	23	23	48	26	0	0	0	0	19	0	0	19	0	1	1	0	0	0	0	0	0	1	90	12	10	4	144	38	151	0	103	1	19	0	1	1	1	0	0	0	0	0	0	1	1	0	0	5	0	0	13	16	1	0	1	2	5	0	0	0	1	1	0	111	2	0	0	0	0	3	12	1	3	0	0	18	0	0	1	0	31	0	56	14	10	8	11	3	67	0	0	0	27	53	0	1	0	0	4	0	0	61	0	0	0	22	14	15	5	0	0	26	0	1	9	5	1	19	0	3	10	5	0	0	1	0	90	84	41	4	0	10	2	4	5	1	5	0	5	0	1	17	19	0	3	5	4	0	81	80	116	4	2	19	55	0	0	1	0	3	0	4	0	0	1	0	0	4	17	9	2	2	0	19	10	4	0	0	1	0	0	14	8	0	17	11	1	24	0	63	0	34	16	24	16	15	12	0	3	205	84	0	13	2	1	0	14	5	7	2	2	0	0	0	0	0	0	2	2	4	1	0	0	0	12	82	31	269	560	10	33	2	4	0	17	24	20	0	0	8	0	0	0	0	0	0	0	0	0	4	0	5	1	0	0	1	1	1	3	0	0	2	0	0	0	8	5	18	0	11	43	12	11	4	12	33	11	20	13	12	0	1	0	0	26	39	30	0	0	0	17	11	14	0	17	6	0	1	51	13	4	0	2	0	3	0	1	28	7	0	0	0	1	0	5	1	1	3	2	0	0	0	0	72	6	11	10	123	19	0	0	0	1	0	60	0	6927	0	3	0	3	60	59	4	0	0	0	0	0	0	0	0	17	6	5	0	0	0	0	0	0	2	1	3	0	0	44	0	0	1	0	0	2	7	7	0	1	31	4	0	0	1	1	0	0	0	0	5	5	1	0	0	0	0	0	0	0	0	0	0	0	0	0	11	8	0	22	17	0	38	0	0	1	0	8	41	0	0	5	1	0	0	0	0	44	3	0	2	1	0	0	1	1	0	1	0	118	20	0	11	100	0	2	0	0	18	0	99	15	23	9	0	0	0	1	6	2	5	145	3	0	0	0	42	0	0	20	7	0	0	0	0	0	0	0	0	1	1156	24	11	3	9	2412	1	38	30	53	7	0	186	90	123	20	62	18	14	0	37	337	175	243	51	47	0	0	0	561	3	5	6	1	2	51	25	0	0	1168	1	0	0	0	0	2	3	24	0	0	0	6	12	75	37	18	24	15	9	6	0	5	0	27	19	5	19	3	0	0	0	0	0	0	1	0	0	9	0	0	19	3	18	2	6	27	0	2	0	5	4	7	4	5	0	7	0	0	5	42	0	1	0	0	0	7	0	7	0	8	4	23	15	0	17	10	0	0	62	129	133	1	1	24	68	44	6	28	56	1	25	0	22	23	0	89	0	0	7	5	5	61	15	0	25	7	32	28	0	0	14	15	0	0	37	6	7	0	0	2	37	0	3	9	2	5	0	4	7	0	0	30	0	0	10	1	0	0	0	1	0	3	0	0	7	0	1	3	3	0	347	11	1	0	0	3	7	0	41	3	1	6	0	0	1	121	3	1	37	70	0	12	7	7	4	7	3	13	4	5	5	19	16	44	11	99	60	23	1	1	0	0	6	0	0	1	0	3	4	0	27	0	0	0	0	0	8	24	45	0	6	2	0	2	0	0	0	7	5	0	1	0	0	0	0	1	1	1	0	0	0	0	1	0	1	0	0	4	0	0	10	0	0	0	22	4	0	4	0	7	16	0	1	0	0	0	0	0	8	1	0	0	0	0	0	0	33	1	4	3	6	5	0	21	0	0	0	0	0	1	0	0	1	86	2	0	1	0	0	0	9	13	6	0	0	0	0	0	47	0	8	10	9	9	0	0	0	0	0	0	0	1	0	0	74	43	34	21	28	15	13	27	14	19	0	40	43	29	33	52	162	121	96	150	10	17	16	10	0	19	3	1	13	15	8	25	56	94	48	31	77	23	50	39	53	168	36	22	32	28	35	11	35	0	0	4	1	119	118	0	10	5	77	40	3	19	545	222	68	787	0	296	12	0	1	0	0	3	13	6	122	0	24	1	462	893	194	3	0	25	0	0	1	3	1	138	37	92	30	90	25	196	26	7	24	0	27	4	32	21	1	1	0	4	0	26	15	15	6	33	17	12	2	10	21	13	26	0	0	0	3	0	1	2	6	0	0	2	1	0	1	0	15	8	3	0	0	1	19	9	2	1	0	0	1	0	0	1	11	0	0	0	0	0	0	0	0	5	11	0	2	2	0	0	0	2	0	2	0	2	5	1	7	9	3	20	120	0	0	2	0	0	1	4	0	1	0	0	2	0	0	0	0	0	0	0	41	0	0	0	0	1	6	0	0	0	0	0	0	0	0	0	0	0	3	2	1	0	0	12	3	4	0	1	19	0	65	77	13	61	0	41	1	38	1	0	0	0	0	0	0	0	0	0	1	1	0	12	16	26	10	3	0	0	0	0	0	0	1	2	4	7	1	51	1	14	0	0	17	40	0	0	1	12	0	0	11	27	56	52	6	1	0	23	0	1	16	7	86	0	0	0	20	9	12	3	2	4	17	16	24	0	10	31	25	0	2	43	177	13	11	1	3	0	20	3	19	13	0	18	0	0	0	0	8	0	1	0	0	1	0	0	5	1	0	14	1	0	0	0	0	0	14	2	4	0	39	1	0	0	1	0	0	0	0	1	22	12	5	0	1	24	0	12	1	0	6	10	30	0	2	17	6	2	0	27	14	4	0	0	0	3	0	18	5	12	3	1	0	7	0	0	0	0	1	3	9	29	0	1	247	0	0	0	0	0	3	1	7	27	15	5	54	22	22	0	0	66	0	3	7	4	0	2	5	0	0	2	1	1	4	2	3	1	3	0	3	0	0	16	18	2	0	1	0	0	3	1	8	3	3	11	7	0	0	0	0	0	0	7	10	8	3	0	1	46	0	2	3	0	15	51	0	0	32	38	24	0	0	31	0	10	10	20	1321	0	0	28	0	6	0	0	0	0	0	0	0	18	31	0	16	7	15	7	1	1014	0	10	0	0	0	0	0	5	0	0	0	0	0	1	0	2	2	0	0	0	1	0	0	0	0	5	0	7	0	4	8	13	0	0	0	0	20	16	3	0	0	0	97	30	0	3	0	0	6	1	30539	0	0	0	0	1	0	0	1	0	0	1	0	0	0	2	0	6	0	0	0	1	35	12	36	85	1	29	9	21	0	1	0	0	0	0	1	1	12	72	0	67	36	2	1	0	0	4	9	0	2	0	0	17	0	43	4	9	29	37	74	62	21	0	20	3	0	51	0	2	37	4	4	31	1	1	0	1	1	7	0	72	84	52	6	25	0	0	0	0	188	1	0	2	1	36	32	0	14	1	0	6	18	22	2	0	64	36	0	8	1	4	0	0	0	0	0	0	0	60	80	129	79	61	0	30	15	0	28	66	51	112	75	93	21	31	30	111	21	0	7	38	9	0	1	0	0	4	45	29	117	73	37	0	12	0	0	21	12	11	3	10	0	1	0	0	0	0	0	0	0	1	2	4	7	2	4	2	7	1	0	3	18	1	1	0	0	12	17	11	4	6	6	11	12	0	5	1	81	0	1	3	7	5	8	21	6	16	0	5	0	0	0	33	14	0	0	2	3	2	0	0	0	0	0	0	0	0	5	61	2	1	1	10	11	4	0	2	2	0	0	0	1	8	6	15	0	16	0	0	0	41	73	0	3	1	2	12	2	0	11	2	0	3	2	0	0	5	1	1	2	0	0	0	0	0	0	0	0	2	0	0	5	0	2	1	0	0	1	20	0	0	1	2	0	21	0	1	0	0	0	0	0	1	1	0	0	0	4	0	1	0	2	52	0	0	6	0	1	0	1	13	60	0	6	0	20	8	6	0	28	0	1	2	190	14	25	9	4	0	1	9	16	11	0	0	6	3	9	3	9	3	0	0	0	1	0	0	0	0	2	1	21	0	1	35	11	0	0	0	0	94	864	0	0	1	0	0	1	13	9	26	45	19	2	50	0	37	31	7	9	56	13	0	15	16	19	22	3	32	0	0	72	1	58	8	4	2	0	2	0	1	0	6	0	2	96	15	2	1	0	1	6	10	7	1	0	4	0	1	3	0	0	0	0	0	21	2	14	0	23	0	3	10	2	1	2	1	3	28	19	0	1	0	0	0	2	0	49	129	37	9	11	12	43	10	69	0	7	4	5	9	0	5	15	2	4	0	5	7	2	0	0	2	5	1	8	7	0	0	0	10	0	3	5	5	3	11	0	20	6	0	2	1	12	0	1	0	0	4	0	1	0	164	0	5	0	0	1	3	15	1	1	1	1	0	0	0	0	1	0	0	0	0	2	6	18	0	1	1	0	0	6	4	0	0	0	0	4	8	0	1	0	1	0	1	0	0	0	0	0	3	0	0	1	0	0	0	1	0	109	0	10	6	35	73	11	21	0	0	0	0	0	0	0	0	1	0	0	0	0	0	0	1	1	257	0	0	0	0	1	1	0	0	0	0	0	0	2	2	0	0	54	0	0	2	5	3	6	8	0	9	16	5	4	15	2	2	5	42	13	18	43	18	22	44	297	107	141	679	0	0	23	1	0	5	10	10	2	0	0	0	0	0	0	235	0	0	3	0	332	0	0	0	1	2	260	1	21	0	0	0	10	8	0	0	0	0	0	0	0	5	16	0	0	0	0	180	110	0	0	0	2	1	0	0	0	14	0	0	0	0	0	2	33	28	0	0	0	0	9	0	1	0	38	4	0	15	23	2	0	1	0	5	1	12	16	20	6	0	0	2	1	0	37	3	4	7	3	82	20	0	0	19	110	8	21	339	1	0	0	0	0	0	0	36	4	7	0	0	0	3	48	3	28	0	23	0	6	0	0	35	0	2	0	65	28	9	68	4	1	76	96	0	0	2	0	1	4	2	0	0	2	0	9	0	0	4	0	1	0	2	0	0	5	0	0	7	3	0	0	0	18	4	0	1	0	12	50	4	42	0	6	71	4	0	0	0	2	0	13	17	6	25	12	86	54	4	1	36	0	17	26	38	0	1	0	0	3	0	8	0	0	372	0	0	7	33	38	18	0	36	6	0	4	4	7	5	0	127	15	1	2	1	0	10	0	0	47	221	50	0	0	0	0	1	0	0	0	1	2	1	2	4	10	0	0	0	0	0	0	0	0	9	0	0	1	1	0	0	0	0	1	0	0	0	0	0	0	0	0	1	32	0	0	0	0	0	0	0	0	0	0	1	2	3	1	0	0	10	8	15	7	0	8	14	0	4	1	6	0	14	0	1	0	1	12	27	3	20	8	10	55	3	1	8	1	21	6	0	0	0	0	4	3	2	0	0	11	0	1	7	0	19	20	0	0	7	0	0	35	40	0	19	1	3	4	1	0	0	13	15	11	13	29	9	20	24	3	39	11	3	1	0	0	4	0	5	14	45	25	0	38	5	15	1	2	0	5	0	3	1	0	0	1	3	0	0	0	0	0	39	0	0	0	0	0	0	4	0	4	12	22	9	24	1	7	6	24	46	8	22	13	3	47	60	55	0	0	1	0	0	0	0	4	0	37	17	48	24	1	0	8	0	0	1	0	0	0	0	0	0	0	1	0	0	15	36	153	1	16	65	23	7617	41	0	2	0	0	0	0	0	10	1	2	2	0	1	23	0	1	0	4	1	1	0	0	1	1	0	2	262	55	0	12	44	5	5	2	1	0	0	5	0	15	0	3	320	0	0	0	14	0	46	0	1	0	5	5	0	0	0	0	0	1	20	0	0	0	0	0	8	1	0	3	2	0	0	1	1	0	2	2	2	0	1	0	0	0	2	1	0	5	1	215	275	3	23	31	16	17	11	42	20	0	8	0	25	0	0	0	1	0	0	0	0	1	0	0	10	0	0	1	1	25	8	0	0	1	3	0	6	0	0	0	1	9	0	0	0	0	0	0	13	0	1	8	11	0	0	0	0	0	0	0	0	0	0	1	1	2	3	0	45	33	68	17	24	0	0	0	0	0	0	1	1	37	0	46	0	3	6	6	0	24	13	0	1	0	0	3	0	0	0	0	2	0	0	0	1	0	0	0	1	0	1	0	0	0	0	0	0	2	1	0	0	0	0	0	1	0	2	278	0	0	1	0	0	2	0	0	0	13	0	2	0	0	0	0	0	0	0	0	0	0	1	0	0	0	0	0	0	0	3	1	0	0	48	0	0	1	0	0	0	10	0	0	0	0	0	2	1	0	1	4	0	0	10	2	0	0	0	0	3	0	1	0	0	0	2	0	1	5	0	2	3	0	0	0	0	0	0	0	0	0	0	0	4	0	0	0	0	0	0	0	0	4	0	0	0	0	8	2	0	0	0	1	0	0	0	0	0	1	1	1	1	0	2	1	0	1	0	1	0	0	0	3	0	0	0	0	3	0	0	0	1	0	0	0	15	0	0	0	0	0	0	0	1	0	0	0	0	0	3	0	2	0	0	0	0	0	2	4	3	2	0	170	0	0	0	0	0	0	5	27	3	1	3	2	2	172	0	134	23	1	0	0	11	1	14	0	1	9	235	1	42	2	0	241	5	145	0	0	5	0	2	2	9	2	4	9	1	0	8	14	5	8	17	1	8	0	0	6	1	20	0	47	1	10	0	46	4	16	2	92	1	10	10	0	3	8	4	6	35	20	6	6	8	10	1	0	2	19	6	12	72	6	4	6	7	45	24	6	1	0	1	86	37	28	10	7	1	27	1	9	17	3	12	0	9	131	0	0	400	0	2	11	0	11	0	214	6	42	32	9	1	7	4	12	20	27	2	12	3	3	2	4	12	5	37	5	32	74	33	13	92	215	72	19	0	0	12	40	0	17	0	0	0	2	0	0	0	0	12	0	1	1	0	0	0	0	5	0	47	7	59	0	0	0	0	6	32	1	47	0	21	9	0	0	0	14	8	1	1	1	0	0	0	13	0	0	2	9	0	6	2	3	12	1	0	0	5	0	0	0	1	0	0	4	0	0	0	0	0	2	0	0	0	0	3	3	136	0	0	0	1	0	0	3	4	1	0	1	25	0	2	0	0	0	41	1	0	0	3	1	0	0	0	0	13	2	2	0	1	0	0	0	0	1	1	1	3	10	2	2	0	0	1	13	1	69	1	10	0	0	0	0	0	0	0	0	54	0	8	5	0	0	1	2	2	0	0	0	0	0	2	0	0	1	2	0	0	0	3	26	41	2	26	26	0	0	1	0	0	0	2	1	242	1	17	20	179	0	0	4	1	11	27	5	0	0	6	29	2	2	0	2	1	14	23	52	537	0	16	16	12	0	0	0	0	0	0	1	1	0	0	0	0	5	0	0	0	21	7	1	0	16	33	0	3	8	0	1	0	4	0	0	10	26	23	10	37	41	0	24	26	2	0	33	12	9	42	1	3	8	13	0	5	0	0	0	2	20	7	0	0	0	0	53	23	3	0	0	10	0	0	0	0	0	1	0	1	32	27	19	0	0	88	1	0	0	0	0	0	19	1	8	3	3	6	13	9	0	25	0	22	0	53	0	0	0	2	9	0	16	0	26	0	4	14	13	14	7	3	1	32	9	22	10	391	62	0	8	0	0	0	0	0	0	1	2	0	0	0	0	1	0	13	9	24	0	1	1	1	10	6	19	0	9	0	2	10	30	5	13	5	3	0	1	3	20	30	67	30	1	0	0	0	0	45	0	0	2	3	3	0	101	94	75	0	29	0	0	8	9	7	1	1	0	0	1	12	93	15	116	32	13	5	14	215	0	9	5	6	11	2	4	16	21	43	13	3	12	45	50	1	0	0	0	0	0	0	73	1	0	71	0	3	1	1	0	0	0	81	17	6	0	0	2	0	4	0	0	0	2	1	0	2	0	1	0	11	13	4	92	3	7	0	1	0	3	0	6	16	0	0	5	0	1	0	5	2	0	21	14	3	86	0	1	0	10	45	0	0	3	1	0	25	0	0	2	0	0	0	0	2	11	26	0	23	1	6	9	0	5	0	0	1	1	0	83	0	0	0	47	1	0	28	1	15	16	0	13	41	0	0	0	0	0	39	20	0	0	3	5	3	10	0	0	2	4	2	0	0	27	36	8	5	2	1	0	1	6	0	0	0	0	2	0	45	8	1	103	14	7	180	51	85	152	25	21	46	125	154	57	65	44	78	106	23	57	32	0	7	0	1	1	18	0	0	2	1	9	5	6	0	0	0	0	0	0	2	2	0	0	0	0	6	15	0	3	6	0	0	0	0	0	0	0	0	0	0	0	0	0	0	0	0	1	0	0	0	0	0	0	0	0	0	1	15	7	0	0	1	0	0	0	0	0	0	0	0	0	0	0	0	0	0	0	0	0	0	0	0	0	9	10	0	35	11	0	1	8	0	0	0	16	9	18	17	0	18	17	11	0	4	0	5	1	0	0	0	1	0	0	0	9	73	4	35	17	18	0	1	0	19	7	11	7	0	0	0	11	3	0	0	0	0	1	15	4	2	3	5	0	16	14	30	8	8	0	12	8	5	0	19	37	0	0	1	1	0	0	0	11	29	0	0	0	1	2	0	0	1	5	3	0	0	87	5	1	13	1	57	0	0	0	0	15	1	1	1	156	7	5	14	0	2	348	0	0	0	6	6	0	16	0	1	27	0	0	0	11	0	42	14	11	2	11	58	0	0	2	19	0	4	0	1	1	1	7	8	11	10	0	5	1	4	1	10	3	0	2	8	53	5	14	0	6	3	7	32	0	12	1	0	25	2	1	0	0	17	0	0	10	21	6	0	7	9	0	1	0	0	1	8	1	0	0	0	0	1	0	1	0	0	0	0	0	0	1	5	0	0	0	0	0	1	6	4	3	0	26	3	1	0	0	3	5	14	4	12	4	0	56	0	0	200	25	61	16	12	0	5	434	173	0	29	44	2	0	0	9	22	3	1	1	15	0	29	25	17	0	2	2	0	0	8	14	13	0	0	11	21	50	12	0	0	1	0	0	0	121	0	2	3	7	2	0	0	2	0	0	0	3	204	12	112	16	10	0	55	5	3	0	0	0	0	0	5	0	4	0	8	0	14	0	9	12	9	1	32	7	333	48	5	0	0	16	9	22	99	19	12	22	14	157	2	40	159	1	0	1	0	0	3	5	4	283	177	7	0	48	0	5	0	0	18	0	0	2	5	0	0	0	84	169	0	0	0	83	46	104	49	5	16	13	16	51	0	3	90	0	0	31	9	2	0	0	0	2	0	0	0	22	11	1	1	2	2	1	0	1	0	0	0	0	0	0	0	132	1	0	1	1	31	30	17	1	0	2	7	2	6	0	1	0	23	25	20	1	55	0	26	9	0	0	4	47	2	30	21	1	0	54	19	22	15	36	47	57	3	14	5	190	12	82	89	0	0	0	0	0	0	0	0	2	0	1	0	0	0	0	0	0	0	0	0	10	1	1	2	4	8	10	1	1	12	0	8	0	0	1	0	10	0	0	2	52	11	4	21	12	5	36	0	6	0	0	0	0	0	1	0	0	0	0	0	5	0	0	0	0	0	0	0	0	0	0	1	0	0	0	1	5	0	2	2	0	13	0	67	0	0	2	2	1	9	3	0	1	0	0	3	0	0	0	0	0	3	10	19	12	2	0	28	7	45	0	14	0	387	0	155	197	2	2	3	0	1	0	1	0	8	128	539	29	23	27	3	80	14	9	18	19	7	7	1	10	16	0	0	8	46	0	0	0	0	0	1	6	2	0	0	0	0	1	1	27	0	0	0	0	2	1	1	0	0	0	0	0	0	0	1	0	0	0	0	0	0	0	0	0	1	0	3	7	0	23	13	0	40	0	22	32	81	21	0	0	0	3	0	1	5	0	0	17	0	0	26	26	0	0	1	4	0	27	1	7	8	23	0	0	1	0	1	0	2	0	1	0	1	0	0	2	8	1	2	0	6	11	5	6	3	0	0	0	0	1	0	35	46	3	0	4	6	18	0	7	5	0	11	5	0	6	0	24	10	1	0	0	0	9	0	0	0	7	1	0	0	131	2	7	1	2	0	14	0	2	0	0	0	0	0	0	0	1	6	5	0	29	37	0	0	2	0	0	3	0	0	6	0	8	5	2	1
LakWasMet31_HOW6_2_rpkm	3	1	0	0	2	12	11	2	0	0	5	1	1	2	0	0	0	0	8	0	0	3	0	41	0	0	0	0	0	24	0	0	1	16	4	9	3	2	1	0	0	0	0	10	43	85	49	29	0	20	6	7	0	0	0	2	0	2	78	24	131	0	0	0	0	0	0	2	12	39	3	1	7	0	8	0	1	0	0	0	0	11	0	1	0	0	0	6	3	0	0	3	10	0	18	4	0	0	5	0	0	0	0	0	0	0	0	2	0	0	2	0	148	3	54	0	5	35	0	0	0	0	0	4	0	0	8	0	0	0	28	135	3	0	4	0	0	0	2	0	0	0	0	23	5	3	3	0	13	3	3	18	1	8	49	0	5	4	80	0	6	12	0	0	4	0	0	3	1	8	0	0	0	0	0	0	0	0	1	0	0	0	0	5	3	13	0	0	0	5	6	5	25	11	0	0	0	18	66	332	2	0	6	0	1	1	1	0	7	2	66	2	36	36	14	0	2	4	0	1	6	45	4	6	2	5	0	2	28	2	1	2	0	0	0	0	38	3	174	0	0	0	24	0	17	6	0	0	5	4	1	10	20	2	1326	194	0	0	0	0	4	1	2	22	3	0	6	0	1	126	2	0	5	0	0	0	0	0	21	26	4	39	20	75	38	0	0	1	15	3	3	0	0	1	6	0	0	4	2	0	0	23	39	2	3	1	11	85	5	1	9	0	101	62	0	0	4	0	61	0	2	0	0	0	15	2301	1	0	6	0	6	4	1	0	0	0	7	2	0	0	0	0	19	16	191	0	19	4	0	1	5	1	7	0	13	0	0	0	0	25	4	0	2	0	0	31	6	33	7	5	2	115	1	0	18	0	0	9	4	2	0	0	10	1	5	0	119	0	0	1	1	0	365	0	1	11	20	0	0	39	0	13	0	17	15	0	0	0	2	7	0	9	20	282	0	19	48	7	5	1	0	0	0	0	0	0	5	0	12	0	0	4	2	2	0	101	1	2	10	0	28	6	1	1	2	25	0	0	0	1	0	193	5	386	4	10	40	2	0	6	0	0	0	16	0	19	33	0	2	3	13	9	14	12	1	0	12	2	104	0	4	0	9	4	1	1	0	43	22	0	2	2	95	66	0	0	5	3	0	0	0	0	21	5	0	1	1	4	0	3	3	0	0	0	1	2	1	0	5	5	0	0	0	0	0	0	0	0	0	0	3	0	15	10	17	0	12	0	0	27	0	10	0	14	13	0	0	0	5	0	0	1	2	0	0	15	0	1	0	0	0	1	0	2	23	4	4	0	56	0	0	4	0	17	2	13	19	765	17	17	83	79	30	11	93	0	0	4	36	0	0	0	838	1	19	7	3	0	0	1	38	1	0	82	18	36	0	40	0	0	0	307	65	796	4	0	224	1	210	16	94	28	71	14	1	23	0	8	0	12	1	5	0	0	6	0	1	0	0	5	0	147	0	3	0	1	1	18	1	4	63	0	10	15	8	1	4	0	0	1	1	62	1	6	0	0	0	1	2	13	2	35	2	5	8	0	3	0	0	0	1	4	0	0	2	0	0	0	0	21	1	0	9	1	0	0	1	4	0	3	0	0	0	0	2	0	2	0	31	0	0	3	0	0	6	11	0	5	15	0	0	3	13	6	5	2	0	1	27	3	0	0	8	1	0	0	0	1	0	4	0	26	10	12	5	68	3	0	0	11	0	0	1	0	0	1	0	0	37	5	0	5	0	27	0	0	0	1	0	0	0	2	0	0	0	190	0	0	0	0	0	0	23	1	0	0	0	0	0	0	21	7	2	0	0	2	9	0	0	13	0	0	0	1	98	1	42	0	0	0	0	0	2	0	24	0	5	0	0	0	1	19	0	10	10	1	0	2	2	0	9	0	0	0	0	0	2	59	14	0	5	1	0	0	2	0	0	0	32	54	0	0	0	0	0	1	2	0	0	3	31	6	0	3	0	0	0	0	4	2	0	0	0	3	9	0	5	0	0	13	0	0	0	1	8	25	105	1	0	0	0	0	0	0	0	0	1	0	0	0	0	0	2	2	0	6	0	0	0	1	1	0	0	5	14	8	13	5	3	0	0	0	0	1	0	0	0	0	0	0	0	0	1	0	0	0	1	0	0	3	0	0	0	23	15	0	0	10	0	0	0	4	0	0	3	0	1	0	5	1	0	1	1	0	1	0	0	0	0	0	0	2	6	100	2	15	0	18	0	0	44	25	4	0	9	0	0	7	0	0	2	1	0	0	0	0	0	0	0	0	2	2	7	0	0	0	0	0	9	1	0	15	0	0	0	0	0	268	0	0	0	51	6	0	0	24	0	0	17	0	14	0	0	0	0	0	0	0	84	12	0	0	1	0	1	0	0	2	0	0	2	0	0	5	2	0	2	0	0	1	0	2	0	1369	0	0	0	0	18	17	12	0	2	2	2	0	4	3	3	79	0	0	2	0	0	0	0	0	3	60	6	0	0	0	0	0	1	0	2	4	0	0	0	1	23	9	21	0	0	5	1	2	0	0	4	0	0	20	0	0	3	0	0	0	4	0	10	11	9	0	0	0	0	3	0	4	7	0	1	0	0	0	0	0	0	0	0	0	0	0	0	0	0	0	3	0	0	2	0	0	0	0	0	0	0	0	0	0	0	0	67	4	0	0	2	0	11	0	5	0	0	2	15	0	2	0	0	5	0	0	11	7	9	8	51	162	0	0	0	70	13	6	0	1	0	3	48	0	0	1	3	0	4	0	0	0	2	14	0	1	0	3	10	0	2	0	2	0	11	0	0	1	0	0	0	0	0	0	8	0	9	0	128	8	3	3	3	2	4	2	30	0	2	50	197	0	0	0	6	0	9	0	0	24	0	2	1	0	3	0	0	0	1	44	1	17	33	4	0	56	0	1	4	0	0	39	0	0	15	0	0	1	1	0	0	8	0	0	28	1	0	0	0	0	0	3	2	2	1	2	0	4	0	0	0	0	2	0	0	1	0	0	23	0	5	0	3	3	5	0	0	0	0	80	3	0	46	12	49	9	0	2	27	0	1	0	5	1	2	18	0	1	3	0	0	1	26	8	0	2	0	0	3	0	5	0	11	0	0	4	0	0	13	36	3	1	9	0	7	0	0	0	0	1	49	1	18	69	20	31	42	3	41	0	0	24	2	31	0	1	1	13	2	38	19	0	13	0	3	6	3	6	22	21	8	1	24	0	0	0	0	0	0	4	1	1	0	0	72	7	1	45	1	9	9	1	8	10	0	0	0	2	0	8	4	13	0	10	1	3	0	0	0	1271	35	149	47	3	2	1	0	0	0	0	0	39	0	9	0	9	2	0	0	14	275	194	26	61	4	0	56	216	0	2	0	0	0	0	0	0	187	10	78	16	165	31	0	88	0	7	0	0	0	0	0	4	22	108	0	0	0	39	0	11	2	1	0	2	0	12	0	1	0	1	0	0	39	0	0	0	0	2	0	3803	4	3	0	1	4	0	0	0	1	3	0	0	0	0	0	9	0	0	12	0	0	0	0	0	2	15	3	7	1	101	0	0	0	0	0	0	0	0	2	0	0	0	0	0	0	0	0	0	0	0	0	0	0	90	0	0	30	0	6	0	0	129	1	51	187	0	1	76	0	45	8	0	1	0	0	0	40	6	20	0	1	2	0	0	3	0	0	2	3	0	1	0	25	0	0	0	2	0	0	1	0	11	0	6	0	44	2	10	0	0	2	15	0	0	2	3	4	0	0	0	3	0	1	5	0	3	9	5	4	26	14	0	0	23	0	0	1	42	0	11	3	15	0	0	14	0	0	0	0	0	0	0	2	12	42	5	98	119	99	47	51	70	0	0	0	7	1	19	0	2	4	8	52	1	0	0	5	0	12	1	6	35	28	0	17	4	0	28	0	2	0	29	2	0	70	7	8	0	0	0	0	10	0	63	3	6	10	4	0	1	29	6	4	177	3	6	3	3	0	3	1	7	38	131	19	77	0	0	5	29	3	10	0	0	15	0	5	0	49	0	2	0	0	5	0	8	6	14	30	5	0	0	0	0	0	1	0	38	1	0	2	0	2	0	9	0	0	0	24	0	212	0	0	27	102	161	0	6443	2	0	4	0	0	2	1	0	6	3	0	0	0	17	0	0	0	30	0	67	0	0	0	0	0	2	0	42	0	0	0	0	2	0	11	0	0	5	3	0	3	11	0	2	4	0	2	0	4	0	0	0	24	3	0	53	5	0	2	0	85	32	10	9	0	32	196	0	37	0	104	0	31	7	7	2	23	2	0	54	1	0	0	0	4	3	0	2	0	0	0	1	0	0	29	9	0	8	0	8	60	0	0	2	0	0	8	0	0	1	3	0	0	0	0	31	0	5	15	12	4	8	2	1	0	0	4	1	41	0	0	4	28	1	1	1	0	0	0	0	1	0	0	0	0	0	0	8	0	0	2	3	0	0	1	1	0	0	0	0	147	3	21	26	2	3	8	0	16	0	6	20	177	21	0	0	2	0	0	0	0	0	0	10	0	0	2	13	0	0	3	3	0	2	2	0	0	4	0	0	1	2	345	2	25	13	0	17	10	0	24	0	42	66	35	0	5	4	0	0	1	0	0	0	0	0	0	0	2	0	0	0	3	0	0	0	2	0	9	2	0	0	2	0	0	4	1	0	0	0	5	31	22	0	1	0	0	0	0	0	4	2	0	41	0	0	0	0	0	1	0	0	4	0	8	0	6	0	0	227	15	2	0	746	4	1	0	2	0	0	0	0	0	0	0	1845	0	0	0	0	0	37	0	0	11	20	0	17	28	22	2	3	0	0	0	0	31	0	42	2	0	0	0	0	7	3	0	6	0	0	2	0	4	1	0	8	8	0	6	20	0	0	0	0	0	0	0	0	0	1	5	90	0	0	1	196	0	0	7	0	0	0	0	0	0	0	0	0	4	0	1	0	2	1	3	11	0	18	6	0	0	247	0	2	47	100	12	4	0	2	17	1	1	0	0	0	0	2	77	4	5	11	14	0	0	0	0	0	8	15	28	0	0	0	10	9	0	0	6	0	3	0	0	31	0	0	2	5	0	0	0	0	1	2	4	0	3	0	2	6	5	0	13	14	0	14	2	0	0	0	2	14	1	1	0	0	3	0	0	2	20	0	0	4	0	29	27	0	0	0	0	0	1	15	1	0	0	6	0	0	0	1	0	2	0	0	0	1	1	0	1	0	0	0	0	0	0	0	8	0	0	0	3	1	0	42	0	0	5	0	4	2	7	1	13	2	1	2	7	0	0	1	0	9	14	0	0	0	0	4	36	110	16	240	132	19	146	27	11	179	49	95	26	14	4	8	10	99	43	0	14	7	105	105	105	93	198	155	18	18	12	2	14	7	0	4	2	0	0	0	0	0	1	0	6	76	3	0	1	0	0	0	0	0	3	0	0	1	0	0	2	6	0	1	0	1	15	0	16	2	11	4	1	0	0	4	8	8	0	0	0	11	0	0	0	0	0	0	1	0	0	60	3	0	0	0	0	26	1	36	1	0	3	11	0	0	0	2	0	0	15	3	2	1	0	14	42	1	0	14	0	0	0	0	1	1	0	0	1	0	7	10	0	16	0	0	0	1	6	1	0	1	0	0	6	2	4	3	1	6	0	75	4	0	13	10	0	1	0	0	0	0	0	1	2	1	0	1	0	6	27	0	0	0	0	0	4	0	58	17	33	0	0	76	27	19	10	14	2	29	13	14	0	0	0	0	3	0	0	0	21	0	4	4	0	0	0	0	0	3	1	0	0	0	0	0	0	0	0	0	0	0	1	1	0	0	7	0	4	0	0	0	1	0	0	0	1	80	0	56	1	506	8	1	2	4	0	0	1	1	0	0	8	0	0	3	0	3	6	0	40	6	1	1	0	0	76	0	0	28	5	0	8	6	1	71	0	3	3	0	0	0	2	0	3	4	0	10	0	0	0	0	7	0	2	0	2	0	0	3	3	0	0	0	0	0	0	1	2	0	0	0	3	0	7	0	0	0	20	0	3	1	0	8	12	7	134	31	7	7	0	0	1	1	1	3	0	0	0	2	0	3	0	0	1	0	38	3	19	18	0	0	0	13	0	0	0	0	13	55	4	0	0	0	59	0	2	0	0	1	1	0	0	0	0	0	0	0	85	3	0	0	0	0	0	0	1	2	0	21	13	1	7	0	3	0	0	3	39	2	0	20	1	0	2	0	0	0	0	2	2	1	2	2	37	2	0	0	0	0	0	3	0	0	1	5	0	0	3	1	4	2	6	0	2	0	0	4	0	0	2	0	0	17	0	0	0	0	0	0	3	6	5	0	105	0	1	21	0	23	1	2	9	5	0	1	0	22	0	13	7	0	0	0	0	0	0	2	4	9	0	0	0	0	1	0	173	1	0	7	34	3	0	6	9	3	4	3	1	4	11	8	1	4	16	3	2	2	0	8	1	30	0	2	0	1	2	0	0	41	0	11	0	8	35	6	38	47	27	21	24	0	23	20	42	0	8	0	14	0	28	15	0	27	2	28	2	7	70	19	0	0	0	3	0	0	2	0	2	2	0	5	8	0	2	0	4	35	0	0	0	0	0	3	0	0	0	0	0	16	0	1	3	2	18	0	0	47	1	0	1	0	0	0	1	45	4	0	44	44	28	0	12	0	4	0	0	8	80	0	0	3	0	0	1	0	14	0	4	6	1	0	0	0	2	45	2	0	53	2	0	42	5	6	0	0	0	29	29	0	2	0	0	5	5	0	0	0	4	0	12	2	0	2	4	1	0	1	38	9	0	0	5	0	0	0	1738	194	125	3	0	0	0	1	0	6	0	40	0	19	12	2	0	0	844	231	66	3	2	0	17	0	2	0	90	1	0	0	0	2	4	0	0	0	1	0	0	1	0	1	0	2	0	0	16	0	92	60724	1	2	0	0	0	1	1	12	0	1	0	0	0	0	8	11	0	0	0	2	4	5	1	7081	8	123	1	0	2	1	0	0	7	0	0	10	1	0	3	0	0	0	0	0	2	1368	1	0	6	0	0	0	1	1	0	1	0	0	0	0	1	9	0	34	1	0	0	0	0	4	0	0	0	0	0	0	9	0	0	0	0	0	0	2	0	0	0	0	0	0	3	1	5	0	0	0	0	0	0	0	1	3	0	0	1	8	0	0	0	4	0	0	49	0	0	0	1	0	0	126	0	0	0	0	27	7	12	347	6	0	3	2	0	27	1	0	65	0	0	38	0	0	0	1	0	0	0	1	3	0	3	7	0	0	0	0	0	4	0	0	0	0	0	0	0	0	1	0	0	0	8	0	2	1	7	0	0	0	1	0	0	3	0	0	0	0	0	13	0	5	1	5	27	13	1	16	1	1	0	0	0	9	0	12	8	47	1	0	0	14	0	28	0	0	1	0	0	1	0	13	3	0	1	6	16	3	1	2	2	10	0	0	0	1	9	0	0	0	3	0	0	36	0	10	7	0	6	1	63	4	0	2	0	0	0	0	0	4	9	35	4	1	1	0	0	1	40	129	0	35	0	0	2	3	0	0	0	0	0	0	0	9	1	0	3	4	16	5	0	0	0	0	3	0	2	0	57	1	24	1	4	4	0	0	0	2	5	1	0	0	0	0	56	1	0	0	9	0	15	0	5	5	0	40	0	5	1	1	69	0	0	0	30	0	0	0	0	0	5	0	111	0	1	3	10	0	2	1	5	0	3	0	2	0	2	0	5	10	0	134	0	0	0	0	0	0	0	85	0	1	0	24	0	2	0	1	0	0	0	22	15	0	0	0	3	0	0	4	1	0	0	0	0	0	5	0	2	0	0	3	0	0	0	0	0	0	1	0	3	0	3	92	0	3	0	0	0	0	0	2	0	0	0	0	0	1	0	0	2	0	0	1	0	0	0	1	1	0	3	0	0	2	1	0	0	0	0	2	0	0	0	10	19	0	0	0	29	0	0	73	2	0	1	1	0	0	0	0	0	0	0	0	0	0	2	4	2	0	0	0	2	2	0	1	0	6	6	0	14	0	109	3	14	0	0	2	0	0	0	0	0	1	0	38	0	0	0	0	2	0	0	0	0	59	6	0	1	3	2	1	0	0	0	0	0	0	0	2	0	0	5	0	0	30	0	0	2	2	1	0	0	0	32	0	0	0	0	0	3	0	0	0	0	3	0	0	0	0	0	0	0	0	0	0	0	4	4	9	0	0	1	2	0	14	0	5	0	0	0	0	1	0	0	7	0	0	0	0	0	0	0	0	0	0	0	0	0	0	0	1	0	6	0	0	0	0	0	0	0	0	0	0	0	0	2	0	4	26	0	3	0	8	0	0	2	0	0	8	1	0	0	0	0	0	0	10	3	0	0	0	0	0	0	0	0	0	6	0	0	0	0	0	0	0	0	0	0	0	0	0	0	1	0	0	0	13	0	0	0	0	0	0	0	0	0	2	64	0	0	6	32	1	0	0	0	41	0	0	0	0	0	134	3	4	0	0	107	0	2	0	0	9	0	171	87	8	0	2	0	512	0	95	0	0	0	25	0	0	0	0	0	1	0	0	0	0	0	0	0	0	0	0	0	0	0	14	0	0	0	0	0	1	0	0	0	0	0	0	0	0	0	0	0	0	0	0	0	0	0	57	0	49	6	0	6	0	0	0	0	0	0	0	2150	0	0	0	0	0	0	0	2	0	0	0	0	0	0	8	0	0	3	0	0	0	0	0	1	12	0	0	0	2	3	89	0	0	0	0	3	2	0	3	6	0	3	0	0	26	0	0	0	0	2	0	4	0	170	0	0	6	5	2	10	0	0	139	0	0	0	0	0	3	0	0	0	0	0	1	0	0	0	0	0	0	0	0	0	0	0	0	0	0	0	0	0	98	3	0	0	0	0	8	0	0	0	0	0	0	0	0	0	2	0	0	0	0	0	1	0	0	2	0	23	0	0	0	0	0	0	3	0	4	2	2	0	0	0	2	0	0	1	0	1	5	2	7	15	11	0	0	1	0	7	0	0	0	1	0	0	1	0	0	0	0	6	10	6	0	46	0	0	0	0	0	2	6	0	0	2	1	0	0	0	0	0	0	88	0	131	0	4	0	0	4	0	0	0	18	1	30	0	20	0	0	1	1	0	0	0	5	6	51	16	0	15	0	0	0	4	6	1	0	16	0	0	0	1	0	0	2	8	0	0	2	8	0	0	5	0	0	0	0	0	0	0	0	5	0	0	0	4	0	7	0	0	0	0	0	6	0	0	0	0	1	0	14	0	0	13	3	0	6	1	16	0	0	2	0	0	0	0	13	2	3	0	83	36	9	380	492	0	0	0	0	98	0	75	29	2	2	3	0	40	70	0	70	0	6	54	0	292	0	1	0	0	7	0	0	1	7	0	17	0	0	10	0	7	12	46	0	1	12	0	9	0	9	2	4	4	2	0	0	0	3	0	1	0	1	5	0	0	0	3	35	0	1	1	0	3	1	0	1	2	0	2	0	0	7	0	0	0	8	0	3	17	36	8	0	0	7	6	13	2	4	0	1	0	0	1	1	0	0	21	99	0	0	0	0	0	0	0	6	9	0	0	0	2	0	0	18	9	0	0	0	0	0	0	18	12	1	2	9	0	4	3	0	0	0	0	0	3	0	7	0	2	0	0	0	0	0	0	10	0	3	12	0	0	0	19	0	0	15	0	21	5	6	5	2	2	1	3	6	0	2	2	0	0	2	1	7	0	0	0	122	132	182	1	3	13	19	61	10	25	21	14	2	48	286	28	0	171	28	64	6	19	2	173	3	312	1	6	0	15	1	4	0	0	0	0	5	0	0	2	4	0	2	1	0	3	0	0	0	25	2	2	6	9	2	0	4	1	0	0	3	0	6	35	2	0	0	3	0	5	118	2	0	0	0	0	0	0	82	11	1	0	0	0	3	0	38	2	16	0	96	1	0	0	0	1	0	30	130	2	19	28	78	0	1	0	2	2	0	0	0	0	0	0	0	0	0	12	8	0	0	0	0	6	0	0	0	0	34	0	0	3	2	9	0	2	0	15	15	5	0	4	0	0	4	10	0	0	0	3	11	5	21	5	2	4	0	1	0	2	0	0	0	9	3	0	37	2	1	281	1	0	0	0	0	0	0	28	0	7	1	0	6	276	54	0	0	13	0	0	28	9	15	13	0	20	3	7	0	0	0	2	1	0	4	0	1	0	0	1	0	3	0	0	0	0	15	33	0	0	0	12	0	2	0	0	0	0	4	101	0	0	7	1	17	0	5	4	1	1	0	0	58	35	26	0	0	0	0	34	0	0	0	0	16	0	0	0	4	0	0	1	0	0	51	0	5	0	62	0	0	0	1	8	0	0	0	8	2	0	0	0	0	4	0	0	0	6	63	1	0	7	0	2	0	10	0	2	6	8	0	0	5	3	3	11	8	0	26	0	0	0	0	3	0	1	30	2	0	1	3	30	0	8	0	0	0	0	0	0	5	0	15	0	5	0	0	0	1	0	0	18	3	1	4	39	5	13	0	0	66	4	0	18	0	2	0	0	0	0	2	4	34	1	0	0	0	1	0	1	4	0	2	1	0	0	0	0	7	11	0	0	0	0	1	0	0	0	0	55	2	11	0	0	1	9	0	72	0	0	0	8	0	0	0	28	0	0	0	0	16	0	3	0	0	14	0	8	0	3	0	0	0	0	1	0	0	3	0	1	2	0	0	13	0	0	0	0	43	27	33	1	0	0	1	0	0	0	0	0	3	0	0	73	7	1	0	1	0	0	2	0	14	42	1	93	11	29	72	3	1	0	2	0	3	39	1	0	5	15	2	2	0	0	0	1	75	0	30	6	0	26	8	19	71	0	0	0	0	32	0	2	0	13	0	2	0	0	0	1	0	0	0	0	0	8	0	3	0	4	0	0	0	0	0	0	82	5	0	0	2	0	12	28	5	1	0	0	1	1	0	14	0	0	0	2	0	15	17	3	40	4	1	0	4	2	3	10	3	3	0	0	0	0	0	0	0	0	0	26	63	0	0	2	0	0	9	0	2	3	0	0	0	0	11	13	0	1	2	0	0	9	0	0	0	0	0	0	0	5	5	0	0	0	0	4	0	0	3	1	0	30	6	0	2	0	1	2	4	10	86	0	4	9	0	27	0	50	0	2	0	0	4	1	4	3	2	3	0	0	0	0	0	7	8	0	42	0	0	0	6	284	3	3	1	0	0	6	19	0	12	0	3	0	168	0	16	26	0	0	0	3	0	0	1	0	0	0	0	0	17	0	2	4	0	0	0	1	30	8	0	0	5	0	1	0	0	12	0	7	0	1	0	0	0	0	11	0	1	0	0	4	0	2	0	0	0	0	2	0	0	1	0	0	0	0	0	0	0	0	0	0	0	0	0	0	0	0	0	0	0	149	0	0	0	0	0	0	6	1	8	0	0	13	0	0	2	3	1	3	0	0	3	7	0	0	0	1	0	0	3	0	0	0	3	1	2	0	0	2	2	1	19	0	0	0	0	0	5	0	6	0	0	2	4	2	0	0	51	0	0	0	0	0	0	0	1	0	0	25	1	0	15	0	2	0	0	0	0	2	0	200	0	11	0	0	0	0	3	12	4	0	0	0	70495	0	0	4	0	4	0	0	0	0	0	1	0	13	0	0	3	1	9	249	0	0	0	0	5	0	0	0	8	0	6	10	0	0	0	0	0	0	5	0	0	12	0	0	0	2	44	0	0	0	0	14	0	0	22	0	0	0	0	0	0	0	0	0	2	0	4	0	0	0	0	0	0	0	0	0	0	20	0	0	0	0	0	0	0	5	1	0	0	1	4	16	28	0	0	0	0	1	4	0	0	2	3	0	0	0	5	0	29	0	2	0	193744	0	0	0	0	0	0	0	37	4	0	0	2	0	0	0	0	49	19	13	3	7	1	0	0	0	0	22	0	1	0	2	18	44	42	18	0	9	30	0	21	0	0	0	11	219	1	12	2	0	0	1	0	0	0	2	77	11	4	4	12	336	0	0	0	17	6	86	2	6	0	6	7	3	20	28	10	0	0	4	0	0	1	0	4	5	1	11	7	0	3	0	0	57	4	9	0	4	0	31	1	86	12	0	19	0	12	0	2	16	0	0	0	0	1	1	3	0	1	1	0	0	4	4	27	6	8	0	1	5	39	23	6	1	4	7	217	11	0	2	3	2	0	2	2	0	0	0	0	2	0	11	0	2	2	0	20	0	14	2	82	6	1	3	0	0	0	0	0	0	0	4	1	3	0	0	0	1	0	0	0	0	0	1	1	1	4	0	0	0	0	1	0	0	0	8	1	1	0	0	1	11	0	0	0	0	3	0	2	6	1	2	0	0	4	0	2	1	68	12	0	0	26	0	2	12	0	2	4	2	28	52	0	0	3	0	0	23	3	2	2	22	18	16	8	1	28	5	2	1	52	15	0	0	0	1	1	1	111	0	1	0	0	0	0	0	0	22	8	1	2	8	0	0	25	25	0	2	0	0	0	1	7	0	4	1	19	170	2	3	1	0	0	22	0	0	0	10	2	29	13	2	4	0	0	0	4	3	58	3	4	0	350	0	0	31	22	15	37	0	0	15	0	60	8	96	3	0	32	1	1	0	0	13	0	0	12	0	0	32	5	98	4	25	0	0	1	1	28	0	0	0	0	3	2	0	3	0	2	0	1	0	6	1	0	6	0	0	11	1	5	0	0	0	47	6	15	1	0	78	10	2	0	1	13	0	59	6	3	20	47	7	8	19	4	30	5	21	0	2	0	0	2	14	0	0	0	0	1	0	0	0	0	0	0	0	5	0	5	2	6	81	14	31	0	989	22	1	0	7	1	3	0	0	0	0	0	0	0	0	0	0	0	0	0	37	24	3	0	1	6	9	0	8	0	0	0	2	20	0	1	1	5	0	0	1	1	5	0	2	38	1	0	4	3	19	0	94	59	21	13	1	6	3	1	1	0	18	12	0	0	4	2	1	0	1	40	0	0	0	54	19	22	27	0	0	1	0	8	3	0	0	19	0	0	9	4	1	2	4	0	55	45	31	5	3	6	11	15	12	14	22	0	2	0	0	26	7	0	2	7	3	0	46	102	36	2	1	3	64	0	0	1	1	0	1	14	0	0	0	0	0	118	77	2	0	13	4	21	34	0	2	1	1	2	0	8	22	0	6	0	0	0	0	300	0	62	30	81	10	26	30	0	1	281	28	16	71	14	0	0	23	13	3	0	4	1	2	0	3	0	1	2	23	4	0	42	0	0	6	42	17	314	399	7	6	6	31	0	129	49	41	0	0	94	0	0	0	0	0	0	4	4	0	3	0	1	21	0	0	0	0	5	11	2	0	25	0	0	0	2	2	17	0	4	53	2	7	2	24	7	98	22	3	3	0	8	0	0	113	48	15	1	0	1	4	2	33	0	0	6	0	3	66	18	0	2	0	0	0	0	3	10	48	0	0	0	0	1	2	4	1	8	4	3	1	0	0	71	4	35	14	125	18	0	0	0	2	0	4938	0	3250	0	13	0	15	89	20	20	0	0	0	0	0	0	0	0	47	4	15	1	0	0	0	0	1	0	0	0	0	0	170	2	0	10	0	5	3	2	6	0	3	494	0	0	0	1	0	0	0	0	1	7	0	1	8	0	3	2	0	1	0	0	0	0	0	0	0	0	6	0	27	3	1	6	0	1	4	0	6	58	2	0	3	0	1	0	0	0	66	1	0	2	1	0	0	0	1	0	0	0	91	14	4	25	14	0	1	0	1	8	0	76	11	24	4	6	0	0	0	6	0	0	24	0	0	2	0	32	0	0	19	1	0	7	0	0	0	0	0	0	0	2425	6	28	0	8	840	0	19	314	4	198	50	1122	1409	548	64	162	67	110	1	2	199	60	57	32	17	26	2	0	2089	3	0	9	4	0	46	8	0	0	253	38	19	0	1	5	0	0	73	1	2	0	17	14	106	10	15	11	48	2	5	0	3	2	28	7	20	12	0	0	0	2	0	3	0	0	0	0	38	0	0	3	2	41	0	1	212	0	2	0	5	6	37	0	0	0	6	0	1	32	13	0	0	0	4	2	0	0	12	0	1	1	28	10	0	53	3	1	0	20	124	551	2	32	7	17	14	3	11	39	1	12	0	72	13	0	16	0	2	50	3	32	68	3	0	12	8	44	2	0	0	42	0	1	0	23	0	25	0	0	0	108	2	6	4	2	2	0	32	19	0	2	20	0	0	9	0	0	1	0	0	1	1	0	1	98	0	0	2	5	0	142	22	23	0	0	12	4	0	11	2	1	21	0	0	0	20	37	4	35	46	0	6	17	6	1	4	0	2	4	2	0	13	2	6	35	150	39	56	4	0	0	1	0	0	1	4	2	0	0	0	7	0	0	0	0	0	0	42	7	0	17	0	0	3	0	0	0	16	3	2	2	0	0	0	0	0	6	0	1	1	1	0	0	0	1	1	0	14	1	0	3	3	0	0	40	21	9	2	0	15	10	0	1	0	0	0	0	2	21	0	0	8	0	0	0	0	19	0	4	2	8	15	0	11	0	0	0	1	0	0	0	0	10	143	0	0	0	0	0	0	11	0	37	2	0	0	0	0	9	0	25	2	5	15	0	0	1	0	1	86	0	0	1	2	0	107	90	9	32	2	61	58	0	67	0	61	0	8	0	70	117	62	83	137	24	39	26	38	0	32	12	0	13	14	31	3	6	126	19	48	175	4	44	7	111	18	4	55	7	49	50	11	47	0	0	0	7	194	44	10	33	17	63	46	6	3	36	164	99	2011	1	30	31	0	0	0	0	0	19	0	5	0	10	0	506	643	90	12	0	25	0	0	1	0	8	77	24	49	13	12	40	102	23	32	103	0	23	45	45	5	1	2	1	76	17	54	9	4	41	5	13	2	33	6	6	22	1	0	0	0	48	0	4	2	47	0	1	5	1	0	0	0	64	8	41	0	0	1	25	5	16	2	20	0	0	0	2	0	44	1	0	0	0	0	1	0	0	4	2	4	0	2	1	0	1	15	0	0	2	2	10	0	38	81	83	197	57	0	0	1	0	2	0	1	0	1	0	1	1	2	0	1	0	0	0	0	16	3	1	0	0	0	47	0	0	1	0	7	0	0	0	0	0	0	0	0	1	0	0	35	3	5	0	0	6	0	182	36	31	85	0	53	1	83	0	0	0	0	1	0	0	0	1	3	0	1	2	27	6	13	4	0	1	1	2	0	2	0	3	1	11	2	3	15	1	4	1	0	43	40	0	0	3	18	1	0	19	13	116	11	23	0	2	1	0	8	41	2	71	0	0	0	9	25	6	0	11	16	3	28	11	0	0	30	8	0	13	89	104	8	3	1	1	0	1	55	26	15	2	2	1	0	0	1	1	0	2	1	0	3	0	0	10	15	5	20	0	0	0	2	0	0	3	7	4	0	37	0	0	0	2	3	0	0	0	0	67	20	8	0	1	10	0	5	4	2	3	0	2	0	0	5	0	0	0	32	2	4	0	0	1	1	2	12	5	13	4	0	0	6	3	0	0	12	1	7	18	8	1	0	33	0	0	0	0	0	1	3	0	20	3	19	29	50	21	1	0	11	1	2	0	1	2	3	0	0	1	2	8	2	0	2	0	0	0	4	3	0	0	0	45	13	1	1	2	2	0	24	2	18	6	4	16	0	7	1	0	3	0	0	0	22	4	0	0	18	0	0	4	0	45	9	0	1	65	10	2	0	5	59	2	18	1	2	232	0	0	6	0	0	0	0	0	0	4	10	8	39	5	0	29	6	12	0	0	7	0	37	0	2	0	0	0	276	0	4	0	0	0	1	0	2	0	1	0	1	2	0	1	0	2	1	0	8	0	6	25	12	0	0	0	0	58	4	2	0	0	5	31	44	0	5	0	0	575	1	51418	0	0	1	0	0	6	0	0	0	0	0	0	0	0	2	0	38	0	0	0	0	4	2	82	11	1	11	17	5	1	0	0	0	2	0	0	0	11	62	1	22	4	0	3	0	0	0	3	0	8	0	0	15	0	15	98	16	48	79	4	17	33	0	7	0	0	36	0	0	71	20	20	20	2	2	0	4	9	9	0	51	59	4	0	210	0	0	0	1	7	0	9	6	0	44	10	0	0	0	1	1	48	71	1	0	73	4	0	2	0	0	0	0	0	1	0	0	0	22	162	18	207	216	0	3	180	0	202	72	13	242	86	161	124	32	96	71	221	0	26	198	26	88	49	0	0	0	93	136	181	247	125	3	26	0	1	124	33	4	11	2	0	3	0	0	0	0	0	0	0	1	1	24	8	4	5	2	20	0	0	0	22	0	0	1	0	14	34	16	18	1	2	0	4	0	0	3	19	0	6	0	6	1	17	6	26	33	0	5	3	0	1	15	56	0	0	0	0	0	0	1	0	4	0	0	0	0	2	0	0	12	1	7	5	11	47	0	3	0	14	0	1	0	2	38	0	23	0	0	1	77	20	0	7	1	2	48	5	3	7	10	0	2	0	0	0	3	0	0	0	0	0	0	0	5	0	0	0	0	0	0	6	1	1	2	1	0	0	12	1	0	0	0	9	7	0	5	0	0	0	0	0	3	10	0	3	0	2	0	13	0	0	27	0	0	13	0	1	0	0	21	6	0	1	6	5	16	24	3	68	50	0	4	101	41	37	136	43	0	2	7	4	47	0	2	2	0	18	4	13	5	0	1	0	0	2	0	14	0	27	0	2	2	8	4	10	0	0	0	0	8283	76256	2	21	4	31	2	0	0	29	10	50	3	1	12	0	27	23	2	656	3	3	0	28	25	9	22	1	305	0	1	20	2	227	4	0	2	0	0	0	2	0	23	0	2	98	34	49	3	0	36	5	6	4	7	0	3	0	0	7	0	2	4	6	0	5	25	5	2	13	1	66	7	7	0	4	4	4	2	4	0	0	0	0	0	3	41	38	209	29	15	19	44	38	330	0	2	14	11	7	26	2	2	9	7	14	0	4	0	2	5	0	0	21	0	4	4	0	7	0	2	0	6	3	8	26	10	0	9	10	0	0	3	24	0	1	3	0	0	1	2	9	171	1	48	0	0	0	1	1	1	2	0	2	0	0	3	0	3	0	0	0	0	7	8	68	0	0	990	0	3	0	12	0	0	1	4	6	18	0	0	0	0	0	0	1	0	0	0	0	0	4	0	0	0	29	0	0	0	32	0	15	22	281	247	25	71	0	0	0	0	0	2	0	0	1	0	0	0	0	0	1	0	0	62	1	20	0	1	3	0	1	0	0	0	0	2	6	8	0	0	51	0	1	9	36	4	32	0	0	38	0	0	0	12	2	0	14	29	9	151	41	8	26	8	136	71	29	72	1	0	33	3	0	1	5	28	4	0	0	0	0	0	0	151	0	0	0	1	308	0	0	6	0	4	34	1	6	0	1	0	2	2	0	0	0	0	0	0	0	27	14	0	1	5	2	130	25	0	0	0	2	1	0	0	5	34	0	0	0	1	0	6	34	4	1	1	0	0	11	0	9	0	63	1	0	39	15	2	0	6	1	0	19	22	4	79	4	0	2	0	0	0	288	6	2	4	0	8	17	0	0	14	115	24	4	3637	0	16	23	8	3	30	0	207	51	63	43	1	0	0	6	0	0	0	0	1	22	0	18	6	0	1	0	3	8	3	296	2	1	26	352	0	0	1	0	0	17	27	0	0	1	0	19	0	0	17	2	3	0	2	9	0	6	0	0	32	5	5	0	0	4	4	5	0	0	7	13	8	11	0	4	32	2	0	0	0	4	0	4	26	4	18	4	41	25	5	35	32	15	61	88	55	0	0	0	1	0	0	2	0	0	396	2	0	10	44	66	40	5	7	92	0	4	18	6	0	0	46	14	0	0	0	0	0	0	0	15	202	87	6	0	0	0	0	0	0	0	0	3	41	22	2	3	0	2	0	0	0	0	0	0	2	0	0	1	0	2	0	0	0	0	0	0	0	0	2	0	0	0	0	13	0	0	0	0	0	0	0	0	0	0	0	0	6	0	2	0	16	4	9	0	0	2	2	8	0	4	4	2	0	0	0	0	0	12	197	11	30	13	3	8	4	9	0	0	30	20	0	0	0	2	19	0	12	0	1	12	0	3	10	2	3	9	0	1	8	8	0	105	6	1	4	3	0	2	0	0	0	49	6	31	3	43	0	45	6	3	147	6	5	22	1	0	2	1	15	112	97	145	0	116	40	24	0	19	2	5	0	4	3	0	0	4	2	1	0	0	0	0	14	0	25	5	0	0	0	18	3	17	41	0	16	4	2	17	0	33	17	14	43	49	10	80	7	53	0	0	1	1	0	14	0	7	0	79	7	29	8	0	0	23	0	1	0	2	0	0	0	0	0	0	4	2	0	7	137	136	0	36	72	73	6141	12	0	5	3	0	0	0	0	17	7	16	8	0	1	39	0	0	0	7	6	8	1	0	1	0	0	0	395	85	0	16	67	0	2	1	1	1	1	63	0	117	1	2	1460	0	1	0	19	0	11	0	2	0	3	0	0	0	0	1	0	3	6	0	2	2	0	0	9	0	2	0	1	0	0	2	0	2	2	0	6	0	0	0	0	0	12	0	1	56	0	116	87	0	33	31	22	66	12	31	40	0	10	0	2	7	0	0	0	0	0	0	0	0	0	0	12	0	0	0	1	0	1	0	0	5	2	0	15	0	0	0	2	19	1	0	2	0	0	0	4	1	1	20	3	0	0	0	0	0	0	0	0	2	0	8	2	9	5	0	11	4	9	11	37	0	0	0	0	0	0	0	2	14	0	111	0	8	4	3	1	32	74	0	0	0	0	0	0	0	0	0	0	17	0	0	0	1	0	0	9	0	0	0	0	0	0	0	0	0	22	1	0	0	0	0	0	4	0	594	0	0	0	0	0	2	4	0	2	6	0	0	0	49	4	0	4	0	0	0	0	0	0	0	1	0	0	0	0	7	12	5	0	0	87	0	0	0	0	0	0	21	0	0	19	1	0	5	0	0	1	0	0	0	297	0	0	0	0	1	18	0	0	3	0	3	0	0	2	0	0	0	0	0	0	0	0	0	0	0	0	0	2	0	0	0	0	0	0	0	0	0	0	8	0	0	0	0	5	0	0	0	0	1	0	3	2	0	1	3	3	0	0	0	20	0	0	0	0	0	0	0	0	0	0	0	0	0	0	3	0	0	2	1	2	0	60	0	0	0	0	0	0	0	0	1	0	0	0	0	0	0	0	1	0	0	0	1	2	1	0	3	0	35	0	0	0	0	0	0	0	0	2	2	0	0	4	24	0	67	0	0	0	0	5	0	0	0	0	2	42	9	0	0	0	61	2	54	0	0	0	0	0	3	5	3	4	1	0	0	2	2	0	3	12	0	6	1	1	8	0	5	0	11	9	0	0	48	0	3	0	37	0	0	6	0	1	6	0	0	2	5	0	18	0	2	2	0	0	0	7	0	16	0	2	2	0	11	10	3	0	0	1	27	12	5	6	0	5	3	0	7	4	2	2	0	7	18	0	0	105	2	0	13	0	7	0	61	2	16	0	0	0	6	0	5	7	1	0	0	0	0	2	0	23	5	13	4	12	10	0	3	21	296	0	3	2	0	0	43	0	5	0	0	0	0	0	0	0	0	19	0	1	0	0	0	0	7	0	1	170	10	23	0	0	1	0	0	67	2	140	0	39	28	0	4	1	21	1	5	4	1	0	0	0	0	0	0	6	24	0	17	0	1	5	0	0	0	0	0	0	1	1	0	2	6	0	0	0	0	0	1	0	1	0	1	2	2	0	0	0	0	31	1	0	0	0	0	0	4	12	0	1	0	0	0	8	2	0	0	6	5	0	0	8	0	3	0	31	1	2	0	2	0	0	0	0	1	0	6	0	1	0	0	0	1	0	263	0	0	0	2	0	0	2	0	0	0	324	0	10	2	3	0	1	0	0	0	0	0	0	1	0	0	1	0	3	0	1	0	4	47	31	0	54	32	1	0	0	0	1	2	7	2	9653	0	8	3	56	0	0	1	0	7	16	12	0	0	0	4	0	0	0	0	0	36	23	6	376	0	15	11	41	0	0	0	4	1	1	0	2	1	0	1	1	0	0	0	0	3	2	0	25	6	41	2	0	6	6	0	0	2	0	0	8	18	15	48	91	93	3	34	62	635	1	43	8	9	58	0	0	14	10	1	3	3	1	0	1	8	16	0	0	0	0	52	9	4	0	0	18	0	0	1	1	0	0	1	0	9	9	8	19	0	67	0	0	0	0	0	0	0	0	7	0	16	2	8	0	3	0	0	3	0	0	1	1	1	5	23	0	24	0	7	0	3	10	2	4	4	6	0	6	3	3	2	90	52	1	8	0	0	0	0	0	0	0	6	2	0	0	2	0	0	6	40	6	0	13	0	7	83	18	21	1	3	0	1	11	3	14	68	3	2	0	0	14	43	30	48	10	61	11	0	4	5	13	0	0	5	5	2	2	127	34	35	0	3	0	0	0	2	28	14	3	0	0	0	11	19	0	23	20	9	14	0	35	0	3	0	0	12	0	11	25	31	50	3	2	21	28	42	5	0	0	0	0	0	0	10	0	0	111	0	0	0	1	0	0	5	71	24	22	0	3	9	0	3	0	0	1	1	3	3	2	1	1	0	20	13	9	193	1	30	10	8	0	3	1	12	0	6	0	14	0	4	0	24	0	4	30	7	4	15	0	0	0	35	103	0	1	1	1	0	11	0	3	3	0	0	0	0	6	31	4	0	62	2	23	12	1	0	15	0	0	2	0	18	5	2	0	45	0	0	222	1	39	21	0	29	60	0	0	0	0	0	47	3	0	4	2	5	3	2	0	0	8	12	8	0	2	83	8	23	0	0	1	1	1	4	1	0	0	0	8	8	0	39	5	124	0	0	76	70	46	81	164	5	96	209	116	40	146	141	158	121	0	83	6	2	1	1	0	2	1	0	0	6	7	1	1	16	1	0	2	3	0	0	0	0	0	0	0	0	32	3	3	7	6	9	1	0	0	0	0	0	0	1	0	0	1	0	0	1	0	1	0	0	0	0	0	0	0	0	0	0	17	5	0	0	0	0	0	0	0	0	0	0	0	1	0	0	2	0	0	0	3	0	0	0	2	0	42	29	1	55	7	0	0	6	0	0	1	27	35	33	11	2	13	32	9	0	4	0	7	7	1	0	0	4	0	0	0	10	39	6	9	43	66	0	2	2	18	3	18	1	13	0	0	9	9	0	0	1	0	3	2	0	0	1	4	0	16	3	20	4	10	0	14	32	23	0	24	19	7	1	0	0	0	0	0	9	29	1	1	0	0	0	0	0	5	2	28	2	1	163	15	3	42	0	39	0	0	0	0	11	2	0	0	713	20	3	2	2	0	188	0	1	0	4	26	1	6	0	1	4	0	0	0	25	0	5	31	118	1	12	16	0	8	1	29	0	0	0	6	4	7	20	31	3	7	0	0	0	1	0	26	27	0	0	43	4	3	20	5	28	2	14	9	0	10	3	1	5	0	3	0	0	19	1	3	3	41	19	0	34	10	3	13	5	0	0	6	2	22	0	3	1	0	0	0	0	3	0	0	0	0	3	4	0	0	0	0	0	3	1	34	2	0	6	0	2	0	0	0	25	6	0	18	33	0	17	0	0	29	99	42	76	33	0	8	243	125	0	17	69	2	7	0	0	24	12	0	0	22	0	33	22	10	0	0	0	0	2	27	6	5	0	0	47	37	276	6	0	0	6	0	0	0	24	0	1	4	1	37	0	0	3	0	0	5	2	212	4	70	13	29	0	40	4	14	0	0	0	0	4	14	0	0	0	7	2	35	2	5	5	4	2	82	20	323	5	0	0	0	22	11	5	103	20	20	36	13	69	0	11	26	3	0	0	0	1	2	1	7	329	27	5	0	80	0	4	0	0	38	0	2	2	1	0	0	0	182	36	0	0	0	86	20	5	6	2	6	144	59	64	0	1	16	0	2	11	7	15	0	1	0	46	0	0	0	5	10	0	0	2	1	0	2	1	0	0	0	0	0	1	0	119	2	0	1	1	167	10	12	0	0	2	4	2	4	0	0	0	43	30	5	0	22	0	19	0	0	6	2	11	2	0	0	0	0	17	5	8	46	11	12	24	9	2	0	101	14	34	19	0	0	0	0	0	0	0	2	11	1	0	0	8	0	0	0	0	0	0	0	42	0	2	1	20	14	19	3	1	16	2	33	0	1	4	24	6	0	0	0	0	3	70	45	52	20	75	0	177	0	0	0	0	0	0	0	0	0	2	1	21	0	1	0	0	0	0	30	0	0	0	17	0	5	0	0	7	6	7	2	1	118	1	127	0	0	122	0	0	14	1	0	0	0	0	4	38	0	0	0	0	2	0	22	16	5	0	53	5	22	0	6	0	151	0	75	75	1	0	0	1	10	2	0	1	42	44	1079	48	85	36	14	49	15	38	33	49	43	19	0	21	13	0	0	2	7	1	3	0	6	1	9	4	4	0	0	0	0	1	2	4	0	0	0	1	2	0	3	0	1	0	0	0	0	3	0	3	2	0	1	0	0	0	0	0	4	0	0	0	0	19	4	2	139	2	395	141	6	77	0	0	0	4	4	0	12	0	0	21	0	0	62	25	0	0	0	7	0	19	1	30	41	28	0	2	0	0	2	0	1	0	3	0	0	0	2	0	9	2	8	0	79	2	13	12	8	0	0	0	3	2	0	31	0	2	0	1	16	53	0	31	1	3	2	19	0	3	0	35	5	0	0	0	0	14	0	0	0	54	4	2	0	23	15	2	5	2	2	48	1	2	1	1	0	0	0	6	0	2	9	9	5	19	35	0	2	1	0	2	3	0	0	7	0	0	6	3	2
LakWasMet33_HOW6_2_rpkm	0	0	0	0	0	12	9	0	0	0	2	3	0	1	0	0	0	0	4	0	0	0	0	55	0	0	0	0	0	6	0	0	0	7	1	10	0	0	0	0	0	0	0	4	29	63	32	15	0	17	4	19	2	0	0	0	0	8	21	22	67	0	0	0	0	0	0	0	2	18	4	1	0	0	1	0	0	0	0	0	2	4	0	0	0	0	0	0	0	0	1	0	8	0	34	0	0	0	0	0	1	0	0	0	0	0	0	0	0	0	0	0	96	0	17	1	0	4	0	0	0	0	0	5	0	0	11	0	0	0	17	240	3	0	0	2	0	0	0	0	0	0	0	0	13	0	0	0	14	1	10	43	0	8	92	0	2	0	36	0	30	0	0	4	19	0	0	1	0	8	1	0	0	0	0	0	0	1	0	0	0	0	0	3	0	7	0	0	0	2	0	4	6	12	4	0	1	19	16	99	0	0	9	0	0	2	3	0	3	3	17	14	11	13	12	0	6	10	0	1	0	0	2	3	0	2	0	0	26	0	0	0	6	0	0	0	6	3	33	3	0	0	12	0	7	1	0	2	5	2	0	2	13	0	637	76	0	0	2	0	1	0	0	21	0	0	4	0	2	87	8	0	15	0	0	0	0	0	14	6	0	34	8	96	27	0	0	0	9	6	0	0	0	0	0	0	0	5	2	0	0	27	21	0	2	0	16	20	3	0	10	0	95	13	2	0	0	0	7	0	0	0	0	2	4	176	1	0	0	0	1	0	0	0	0	0	4	0	4	0	0	0	10	6	5	9	8	1	0	0	0	0	2	0	0	0	0	3	0	10	4	0	0	0	0	50	2	45	1	4	0	43	0	1	5	0	0	13	1	0	0	0	0	0	8	0	97	0	0	0	0	2	136	0	0	0	12	0	0	29	0	25	0	8	27	0	0	0	0	0	1	1	3	410	0	14	19	16	0	0	0	1	0	3	0	0	0	0	2	1	63	0	0	0	0	1	0	0	3	0	24	3	0	1	0	36	0	0	0	0	0	79	8	179	0	15	69	0	0	3	0	0	5	2	0	9	21	0	1	0	5	3	3	2	0	0	17	1	40	0	4	6	19	2	0	1	0	11	21	0	0	0	63	49	2	0	0	0	0	0	0	2	16	4	0	0	1	2	0	1	0	0	0	0	3	0	7	0	0	15	0	0	0	0	0	0	0	0	0	0	0	0	44	25	12	0	8	0	0	37	0	3	1	24	22	0	0	1	23	0	0	0	0	0	1	4	23	1	0	0	0	2	0	2	28	0	6	1	46	0	0	0	0	0	7	9	0	32	1	5	13	162	3	8	28	1	0	4	46	0	0	0	12	5	5	9	0	0	5	0	38	0	0	1	16	9	0	20	0	3	0	242	24	183	0	0	143	0	258	0	33	18	35	20	0	9	1	30	0	5	2	3	0	0	1	5	0	0	0	3	2	118	1	0	0	1	0	10	0	0	21	2	8	7	2	0	1	0	1	2	2	22	1	0	0	1	0	1	0	7	2	7	0	0	0	0	1	0	0	0	0	1	5	0	0	0	0	0	3	8	0	0	3	1	0	1	0	3	0	0	0	0	0	0	1	3	4	0	82	0	0	0	2	0	24	20	0	0	13	0	1	0	2	4	5	0	29	0	14	0	0	2	6	0	0	0	0	0	0	0	0	2	0	0	4	62	4	0	0	7	0	0	0	0	0	1	0	0	17	2	0	3	0	16	0	0	4	0	0	0	0	0	0	0	0	101	0	0	0	0	0	0	1	2	0	3	0	0	0	8	27	0	1	0	0	0	22	1	0	5	3	0	0	0	43	6	103	0	0	26	0	0	17	0	0	0	2	0	0	0	2	0	0	0	18	0	0	3	2	9	3	0	0	0	0	0	0	33	13	0	0	0	0	0	0	0	0	0	33	144	0	0	0	0	0	0	0	1	0	15	22	2	0	0	0	8	0	0	0	0	0	0	0	2	0	0	0	0	19	9	0	0	0	0	1	0	93	0	0	0	0	0	0	0	4	0	0	4	0	0	1	0	0	0	0	0	0	0	0	0	0	0	0	2	6	4	10	0	0	0	0	0	0	0	0	0	0	0	0	0	31	0	0	0	0	0	0	0	0	9	0	0	0	28	2	0	0	10	0	0	0	0	0	0	0	0	0	0	2	0	0	0	0	0	0	0	0	0	0	0	0	3	11	90	3	8	0	19	0	0	92	15	0	0	7	0	0	0	0	0	0	0	0	0	0	0	0	2	0	0	0	1	0	0	8	0	0	0	0	0	0	0	0	1	0	0	0	184	0	0	0	16	4	0	0	7	0	0	9	3	3	0	0	0	0	1	0	0	9	60	0	0	0	0	0	0	0	2	0	0	0	0	0	1	2	0	0	0	0	0	0	3	0	92	0	0	0	0	0	3	11	0	3	1	0	0	0	0	0	19	2	6	0	0	0	0	0	0	0	20	0	0	0	0	0	0	0	0	0	2	0	0	0	0	0	9	8	0	0	9	0	0	4	0	14	0	0	10	0	0	0	6	0	0	0	0	11	11	21	0	0	0	25	0	0	0	4	0	0	0	0	0	0	0	0	0	0	0	0	0	0	0	0	0	0	0	0	0	0	0	0	4	0	0	0	0	0	0	6	0	28	4	0	0	0	0	0	0	0	0	0	0	24	0	0	0	0	2	0	0	14	6	17	5	33	42	0	0	0	60	2	0	0	0	0	33	3	0	0	0	0	0	0	0	0	0	3	2	0	0	0	0	0	0	0	0	0	0	5	0	0	0	0	0	0	0	0	0	1	0	24	0	82	7	0	1	4	0	0	0	7	0	2	69	95	0	0	0	4	3	8	0	0	18	0	0	0	0	0	0	0	0	1	44	1	14	18	9	0	71	0	3	0	0	0	7	0	0	6	0	0	3	0	0	0	8	0	1	16	1	1	0	11	0	0	0	0	3	1	4	0	2	0	0	0	0	0	0	1	0	0	0	9	0	0	0	1	0	2	0	0	0	0	0	1	0	34	6	37	10	0	1	24	2	0	0	5	2	2	7	1	0	12	0	0	0	24	11	0	11	0	0	1	2	22	0	5	0	1	4	0	0	1	37	0	3	8	4	0	0	0	0	0	0	70	0	19	31	3	19	16	0	10	0	0	15	0	16	0	1	0	5	1	13	2	0	5	0	1	4	0	5	12	4	0	0	19	0	0	0	0	0	1	5	5	0	0	0	3	1	1	37	1	0	3	0	5	0	0	0	2	0	0	8	0	6	0	0	0	0	0	0	22	75	8	121	24	0	2	0	0	0	0	0	6	37	0	71	0	8	3	0	2	3	240	385	9	64	0	1	32	85	0	1	1	0	6	0	0	0	72	6	26	7	52	11	0	12	0	11	0	0	2	0	0	4	23	37	0	0	0	7	0	16	0	1	0	0	0	12	0	3	0	1	0	0	6	0	0	0	0	0	0	4	1	2	0	0	0	0	0	0	0	0	0	0	0	0	5	0	0	0	13	0	0	0	0	0	0	4	0	0	0	15	0	0	0	0	0	0	0	0	0	0	0	0	0	0	0	2	0	0	0	0	0	0	0	48	3	0	10	0	0	11	0	56	0	30	120	0	0	4	0	34	0	0	4	0	0	0	90	3	17	0	0	0	0	0	0	0	0	0	3	0	0	0	26	0	0	2	0	0	0	0	0	0	2	4	0	22	7	0	0	0	10	0	0	0	0	191	1	0	0	0	2	0	0	2	3	0	0	0	0	30	12	0	0	18	0	0	0	22231	2	7	3	0	0	0	2	0	0	0	0	0	0	0	3	0	5	1	13	27	76	23	35	46	0	0	0	3	0	8	0	9	2	1	48	0	0	0	2	0	0	0	1	2	16	0	20	1	0	0	0	17	0	5	28	0	15	2	0	0	0	0	0	0	2	131	0	3	5	2	0	0	5	0	7	188	2	0	1	0	0	1	0	4	0	142	7	286	0	6	0	15	2	6	0	0	4	2	0	0	18	0	5	0	0	8	0	3	5	6	19	6	0	0	0	2	0	0	0	4	0	0	4	0	0	0	13	0	0	0	0	0	57	0	2	0	39	0	0	852	3	0	2	2	0	0	0	0	0	11	0	0	0	16	0	0	0	6	3	2	0	0	0	0	0	1	0	22	0	0	0	2	2	3	13	0	0	0	1	0	0	15	0	0	2	0	1	0	0	0	0	0	15	1	0	43	4	0	1	0	118	27	38	0	0	34	67	0	18	1	68	0	14	2	2	3	8	0	0	25	3	0	0	0	0	0	0	0	0	0	0	0	0	0	18	11	0	0	0	1	21	0	0	0	0	0	2	0	0	0	0	0	0	0	0	0	0	0	5	12	2	11	0	0	7	0	0	1	11	0	0	15	7	0	0	0	0	0	0	0	2	0	3	0	0	0	0	9	0	0	1	22	0	0	0	0	0	0	0	0	83	0	33	16	2	4	0	0	5	0	0	33	231	13	2	0	0	0	0	0	0	0	0	6	0	0	0	0	0	0	0	3	0	0	0	0	1	4	1	0	0	0	4	0	12	5	0	21	2	0	8	0	56	47	35	0	1	0	0	0	0	0	0	0	0	0	1	0	11	0	0	0	3	0	0	0	5	0	4	0	0	2	0	0	0	0	1	0	0	0	4	31	11	0	0	0	2	0	0	0	5	0	0	30	0	0	0	0	0	2	0	0	0	0	0	0	85	0	0	84	1	1	1	57	0	1	0	0	3	0	0	0	1	0	0	134	0	0	0	0	1	30	0	0	2	7	0	255	15	9	5	0	0	0	0	0	5	0	55	1	0	4	0	0	0	4	0	1	0	0	0	0	0	1	0	0	2	0	0	2	0	0	0	3	0	0	0	0	0	1	8	48	0	0	0	224	1	0	1	0	0	0	0	0	20	0	0	0	0	2	0	0	0	0	1	4	0	2	15	0	1	67	0	2	15	15	1	4	0	0	9	1	0	0	0	0	0	0	98	2	1	0	2	0	0	0	0	0	14	42	43	0	5	0	9	6	0	0	0	0	1	0	0	2	0	0	0	0	1	0	0	1	2	0	3	0	6	1	1	2	0	0	11	0	0	25	0	0	0	2	1	6	0	0	6	0	0	0	0	0	15	0	0	3	0	1	13	0	0	0	0	0	3	1	0	10	0	2	0	0	0	0	0	0	0	0	0	0	1	0	0	0	1	0	0	0	0	0	1	0	0	0	0	0	0	4	0	0	0	0	0	0	4	0	8	0	106	4	3	0	0	0	2	14	10	0	0	0	0	0	11	9	15	15	19	9	52	13	4	79	6	50	11	12	0	4	9	20	23	0	7	0	27	31	129	110	69	48	8	11	9	16	3	9	0	3	0	0	0	0	0	0	4	0	9	47	1	0	0	0	0	0	0	0	0	2	0	0	0	0	0	8	0	0	0	0	3	0	19	0	24	12	2	0	3	0	0	0	0	0	0	0	0	17	0	0	0	0	1	0	0	10	0	0	0	0	0	14	1	28	17	0	3	3	0	0	0	0	0	0	4	0	0	0	0	0	18	0	0	2	0	24	0	0	0	1	0	0	0	0	4	15	0	10	0	0	0	0	0	0	1	2	0	0	2	0	0	2	0	2	0	24	2	0	5	9	0	0	0	0	0	1	0	0	1	0	0	0	0	6	7	1	0	0	0	0	0	0	59	40	42	0	0	20	15	11	3	12	1	2	3	4	0	3	0	0	0	0	0	0	3	0	3	4	0	0	0	0	0	0	0	0	0	0	0	0	0	6	0	0	0	0	0	11	0	0	6	0	0	0	0	0	1	0	0	0	0	23	0	1	0	332	6	0	0	0	4	0	0	2	0	0	0	0	0	0	0	0	2	0	0	3	0	0	0	0	16	0	0	15	26	0	3	3	0	33	1	4	3	1	0	0	0	0	1	3	4	2	0	2	0	0	3	0	1	0	0	0	0	0	0	0	0	0	0	0	0	0	1	7	1	0	0	0	0	4	0	0	36	0	3	0	0	6	0	2	95	36	1	0	6	0	0	0	0	1	0	5	0	0	0	0	0	0	0	0	26	5	13	30	0	3	0	14	0	0	0	0	22	45	1	0	0	0	13	0	0	0	0	2	0	0	0	2	2	0	0	1	64	2	0	0	0	0	0	0	0	1	0	5	4	4	0	0	0	0	0	0	27	5	0	21	0	0	0	2	0	0	0	0	6	3	0	0	12	2	0	2	0	10	0	0	0	0	0	0	0	0	3	0	4	0	0	0	1	0	0	4	0	0	0	0	0	2	0	0	0	0	4	0	0	2	10	0	124	0	1	20	0	9594	0	1	0	3	1	0	0	17	3	14	5	0	4	0	0	0	0	0	0	7	0	0	0	0	0	0	87	0	4	0	34	3	0	0	4	5	2	0	0	10	0	8	0	4	0	0	2	10	0	0	0	2	0	3	0	2	0	0	0	50	0	15	0	2	17	14	35	35	20	14	17	0	31	23	22	0	4	3	0	0	15	8	5	8	0	7	0	13	39	16	1	0	0	1	0	0	4	0	1	0	0	5	12	0	0	0	0	28	0	0	0	0	0	0	0	0	0	0	0	3	0	0	5	0	9	0	0	13	1	0	0	0	3	0	0	520	3	0	29	23	44	0	38	0	2	4	0	11	44	0	0	0	0	0	5	0	23	0	0	4	0	0	4	0	0	50	0	0	70	4	0	27	0	2	0	0	2	28	30	7	1	0	8	1	1	3	0	0	0	0	5	0	0	0	0	0	0	0	43	8	1	2	0	1	0	0	1593	91	82	2	0	0	0	1	0	2	0	48	0	10	2	1	0	0	790	147	66	2	0	0	92	0	4	0	89	0	7	0	0	0	3	0	0	0	0	0	0	0	0	0	0	1	0	0	2	2	64	27353	0	2	0	0	3	0	1	2	0	0	0	0	0	0	6	20	0	0	0	0	2	7	0	10562	20	79	1	0	2	0	0	0	0	0	0	22	5	3	0	0	0	0	0	1	2	652	1	0	4	0	0	0	0	0	0	0	0	0	0	0	0	3	0	0	0	0	0	0	0	1	0	0	0	0	0	0	3	0	0	0	0	0	0	0	0	0	0	0	0	2	2	0	7	0	0	0	0	0	0	0	1	2	0	0	1	181	0	0	0	2	0	0	46	0	0	0	0	0	0	99	0	0	0	0	0	4	3	5	3	0	3	0	0	15	0	0	79	0	0	1	0	0	0	0	0	0	0	0	0	2	0	3	0	0	0	0	0	0	0	0	0	255	2	0	0	0	0	0	1	0	0	0	1	0	0	0	0	0	1	0	0	0	0	1	0	0	0	2	0	3	8	1	22	9	31	6	0	0	0	0	0	0	0	18	30	7	0	4	0	10	1	20	0	2	1	0	0	2	0	7	0	4	0	3	3	0	0	1	0	0	0	0	2	8	0	0	0	0	0	0	0	0	0	8	0	0	0	1	62	13	0	0	0	0	0	0	0	0	2	24	0	1	0	0	0	2	43	112	0	61	0	0	0	3	2	0	0	0	0	0	0	0	1	0	1	4	4	2	0	0	0	0	1	0	0	0	60	1	12	2	0	3	0	0	0	0	0	4	0	0	0	0	22	0	0	0	5	0	3	2	242	0	0	34	5	2	0	0	41	0	0	0	15	0	0	0	0	0	0	1	81	0	0	0	0	0	0	1	0	0	0	0	2	0	0	2	0	0	0	160	0	0	0	0	6	0	0	83	0	0	0	25	0	1	0	0	0	0	0	2	23	0	0	0	0	0	0	0	0	2	0	1	0	0	2	0	0	0	0	0	0	0	0	0	5	0	34	0	0	0	0	124	0	0	1	0	6	0	0	0	0	0	0	0	0	4	0	0	0	0	0	1	0	0	0	0	0	0	3	0	0	12	5	0	6	0	0	0	0	0	1	27	2	1	0	0	36	0	2	54	2	0	0	0	0	0	0	0	0	0	0	0	0	0	2	0	0	0	0	0	0	0	0	0	0	3	0	4	0	0	39	0	0	0	0	0	0	2	3	0	0	0	0	0	0	0	0	0	9	0	0	0	0	51	0	0	0	0	5	0	0	0	0	0	0	2	0	0	3	0	1	1	0	16	0	0	0	0	0	0	0	0	21	0	0	0	0	2	0	0	0	0	0	4	0	0	0	0	5	0	0	0	0	0	0	0	0	0	0	0	0	3	0	0	0	0	1	0	0	0	0	0	0	21	0	0	0	0	0	0	0	0	0	2	0	0	0	0	0	0	0	0	0	0	0	6	0	0	0	0	0	0	0	0	0	0	0	40	0	0	0	0	0	0	0	0	0	6	1	0	0	0	0	0	0	0	11	0	0	0	0	0	3	0	0	0	0	0	0	0	0	0	0	0	0	4	0	0	0	0	0	0	0	0	9	15	0	0	0	0	0	0	0	0	0	0	71	0	0	6	34	5	0	0	0	5	0	0	9	0	0	77	0	0	0	0	8	0	4	0	0	6	0	7	74	11	3	0	0	134	0	0	0	0	0	65	0	74	0	0	0	0	0	0	2	0	0	0	0	0	0	0	0	0	0	14	0	0	0	2	0	2	0	0	0	0	0	0	0	0	0	0	0	0	0	0	0	0	0	39	0	24	0	0	0	0	0	0	0	0	0	0	504	0	0	0	0	0	6	0	0	0	0	0	0	0	0	0	0	0	0	0	0	11	0	0	0	4	0	0	0	0	0	9	0	0	0	0	0	0	0	3	22	0	8	2	0	3	0	0	0	0	0	0	0	0	89	0	0	0	0	0	14	0	14	112	0	0	0	0	2	0	0	20	0	0	0	0	0	0	0	0	0	0	0	1	0	0	5	0	0	0	0	0	0	56	0	3	0	0	0	0	0	0	0	1	0	0	0	0	0	0	0	0	0	0	0	2	0	0	5	0	12	0	0	0	0	0	0	27	0	0	0	12	0	0	2	0	0	0	0	0	0	0	2	0	8	0	3	0	0	0	10	0	0	0	3	0	0	0	0	0	0	0	0	6	2	0	0	0	0	0	0	0	2	7	0	0	0	0	0	0	0	48	0	0	11	3	73	0	4	0	3	0	26	0	0	6	0	54	0	0	0	0	0	0	0	0	0	0	3	129	4	0	0	0	0	0	0	14	1	0	27	0	0	2	2	0	1	1	0	0	0	0	8	0	0	6	0	0	9	0	0	0	0	0	5	0	0	0	0	0	24	0	0	0	0	0	6	0	0	0	0	1	1	3	20	0	11	3	0	0	0	0	0	0	0	0	0	0	0	13	2	0	0	34	4	18	71	514	0	0	0	0	72	0	17	16	0	0	0	0	0	39	0	27	0	4	22	0	68	0	0	0	0	6	0	0	3	0	0	4	0	0	0	0	6	11	36	0	0	9	0	1	0	6	7	0	4	5	0	0	0	0	0	3	0	8	5	0	0	0	2	23	15	0	3	0	1	0	0	0	0	0	0	0	0	1	0	0	0	1	0	18	7	63	2	0	0	7	2	19	2	0	0	0	0	1	1	0	0	0	10	32	1	0	0	0	0	16	0	0	4	0	0	0	0	0	0	3	19	0	0	0	3	1	0	0	6	0	0	0	0	0	0	0	0	0	8	0	6	0	0	0	0	0	0	3	0	1	1	10	2	7	2	0	1	0	19	0	0	3	0	15	0	0	1	0	4	6	3	26	0	0	0	0	0	0	0	7	0	0	0	40	59	52	0	2	0	13	15	0	0	12	0	1	18	44	26	0	86	4	23	9	4	3	60	58	30	0	29	0	8	0	2	0	0	0	0	0	0	9	0	0	0	0	4	0	0	0	0	0	6	0	2	0	4	0	13	0	0	0	0	1	1	4	9	0	0	0	2	0	0	82	0	1	0	0	0	0	0	193	5	0	0	0	18	0	0	3	0	9	0	25	0	0	0	0	2	0	19	199	0	40	64	38	0	0	0	2	2	0	0	0	0	0	0	0	0	0	1	4	0	0	0	0	2	0	0	0	3	15	0	0	4	0	6	0	0	0	0	0	5	0	0	3	0	1	1	0	0	1	3	11	0	9	15	2	2	0	0	0	0	0	0	0	2	0	0	23	0	1	45	0	0	1	3	0	0	0	7	0	1	6	0	6	471	130	0	0	8	0	0	14	2	6	11	0	7	0	0	1	0	0	0	0	0	2	0	0	1	0	0	0	0	0	0	0	0	0	34	0	0	23	8	0	0	0	0	0	0	0	39	0	0	4	0	9	0	2	0	8	0	0	0	18	9	12	0	0	0	1	17	0	0	0	0	4	0	0	0	0	0	0	4	0	0	15	0	1	0	28	0	0	0	0	4	0	0	0	8	4	0	2	18	0	0	0	0	0	2	37	2	0	4	0	2	8	22	0	0	7	0	0	0	5	2	0	6	12	1	30	0	0	2	0	0	0	0	61	0	11	1	2	14	0	10	0	0	0	0	0	2	2	0	0	0	2	0	0	0	0	1	0	2	0	0	2	32	0	11	0	0	21	0	0	10	0	7	0	0	0	0	0	2	6	0	0	0	0	2	2	0	1	0	0	0	0	0	0	0	0	7	1	1	0	0	6	0	0	0	0	17	1	5	0	0	0	0	0	5	2	4	0	8	0	0	0	4	2	0	1	2	8	0	3	0	0	8	0	9	0	0	0	0	0	0	2	0	14	1	1	0	6	0	2	4	0	0	0	0	34	5	15	0	0	0	0	0	0	0	0	0	1	0	0	36	5	0	1	0	0	0	6	0	1	20	3	49	3	14	20	1	0	0	0	0	0	27	1	0	4	6	2	1	0	0	0	0	3	0	12	2	2	22	81	14	65	0	0	0	0	36	0	12	0	3	0	0	0	0	0	0	0	0	0	0	0	0	0	0	0	3	0	1	0	0	0	0	75	0	0	0	28	0	17	8	4	0	4	0	0	0	0	8	4	0	0	0	0	0	20	2	29	0	0	11	0	1	0	15	0	2	3	0	0	0	0	7	0	2	0	3	18	0	0	0	0	0	20	0	5	0	0	0	0	0	5	16	0	0	0	0	1	6	6	0	0	0	0	1	0	1	0	0	0	0	0	0	0	0	0	0	0	30	0	11	0	0	0	4	5	0	99	0	3	0	0	28	0	2	0	2	0	0	0	0	3	0	6	0	0	0	0	0	0	0	0	0	23	0	0	0	4	363	0	2	0	0	0	7	0	0	10	0	0	3	270	0	2	8	0	0	0	0	0	0	0	0	4	0	0	0	0	0	4	0	0	0	0	0	11	14	0	0	16	0	0	0	0	0	0	0	0	2	0	0	0	0	1	0	0	0	0	0	0	2	0	0	0	0	5	0	2	0	0	0	0	0	0	0	0	0	0	0	0	0	0	0	0	0	0	0	0	103	0	0	0	0	0	166	5	1	5	0	0	9	0	0	0	0	1	0	0	0	0	6	0	0	0	3	0	0	0	0	0	1	0	0	87	2	0	0	0	0	14	0	0	0	0	0	2	0	2	0	0	1	0	0	0	0	12	0	0	0	0	0	0	0	11	0	0	15	0	0	11	0	0	0	0	0	0	0	0	76	0	8	0	0	0	7	4	0	1	0	0	0	23	0	0	0	0	4	0	0	2	0	0	0	0	23	0	0	13	0	17	58	0	0	0	0	0	0	0	0	5	0	0	26	5	0	0	0	7	0	0	0	0	16	6	0	0	2	0	2	0	0	0	7	0	1	11	2	15	0	0	0	0	0	0	2	0	0	0	0	10	0	0	0	0	0	0	0	0	2	0	0	1	0	0	0	1	25	1	0	0	1	0	7	107	0	0	0	0	0	1	0	5	0	0	0	0	0	9	0	21	0	0	0	9	0	0	0	0	0	0	0	5	0	7	0	0	0	0	0	0	40	4	13	0	0	0	1	0	0	0	7	0	0	0	7	9	9	6	9	0	4	6	0	22	1	0	0	5	41	0	14	1	0	0	3	2	0	0	0	78	4	2	10	0	295	0	0	0	14	4	86	0	19	0	2	0	0	23	15	4	0	0	0	0	17	0	0	0	0	1	17	0	0	0	0	0	10	0	3	0	4	1	13	1	88	4	0	13	0	4	0	0	23	0	0	0	0	0	0	0	0	0	1	1	0	0	1	21	3	2	0	0	1	36	12	3	0	2	1	165	7	1	0	1	1	3	0	0	0	0	0	1	2	1	15	0	2	0	0	9	0	14	0	27	4	0	0	0	0	0	0	0	1	0	0	1	2	0	0	0	0	1	0	0	1	0	1	0	0	0	0	0	0	2	0	0	0	2	2	0	0	3	0	0	4	0	0	0	2	0	0	2	0	4	0	1	0	0	0	2	0	30	7	2	2	0	0	0	0	0	0	0	0	14	33	0	1	2	0	0	8	6	2	2	59	2	2	1	0	5	1	0	0	5	2	0	0	0	0	0	0	1	0	0	0	0	0	0	0	0	4	2	1	0	5	0	0	17	4	0	0	0	0	0	0	2	0	4	1	4	96	4	0	0	0	0	12	0	0	0	32	1	42	40	0	5	0	0	0	0	0	31	3	17	0	117	0	5	0	5	0	0	0	0	0	0	25	5	104	82	0	16	0	0	0	0	6	0	0	13	0	0	40	11	36	2	29	3	0	0	0	6	0	0	0	0	1	4	0	0	0	0	0	0	0	25	0	1	1	0	0	1	1	21	0	0	0	25	0	2	0	0	17	2	0	0	0	11	1	75	8	4	15	39	1	2	29	1	26	9	21	0	3	0	1	1	9	0	0	4	0	1	1	1	0	0	0	0	0	0	0	2	2	2	27	1	9	0	283	58	5	0	8	0	0	0	0	0	0	0	1	0	0	0	0	0	0	0	9	5	1	0	23	4	6	0	15	0	2	0	0	15	1	0	0	0	0	0	0	0	6	0	0	34	0	0	1	1	2	0	92	72	10	14	0	1	9	2	0	0	14	7	0	0	0	0	0	0	2	34	0	4	0	58	9	29	11	0	0	0	0	1	4	0	0	4	0	0	0	0	0	2	10	0	42	18	17	3	0	3	10	2	3	2	2	0	0	0	0	19	4	0	0	3	2	0	30	64	8	7	1	0	23	0	0	0	1	2	0	3	0	0	0	0	0	149	37	1	0	3	0	104	4	4	0	3	0	1	0	0	15	2	0	2	0	0	0	288	0	26	0	51	9	8	6	1	3	126	13	0	44	1	0	0	10	18	2	0	0	0	2	0	1	0	0	4	10	7	0	0	0	0	3	15	0	150	51	1	2	0	22	0	70	56	28	0	0	29	0	0	0	3	0	0	0	0	0	4	4	3	0	0	5	2	9	3	0	0	0	6	0	0	0	14	0	21	0	1	48	1	124	2	9	9	39	15	0	2	0	0	0	0	193	47	0	1	0	0	8	3	31	0	0	8	0	0	6	17	0	0	0	0	0	1	0	10	37	0	0	0	0	0	0	1	1	8	0	0	0	0	0	19	3	9	2	38	0	9	0	0	0	0	1903	0	1113	0	15	0	6	329	6	10	0	0	0	0	0	0	0	0	36	0	10	0	0	0	0	0	2	0	74	1	0	0	125	0	0	0	0	0	3	0	0	0	1	310	0	0	0	0	2	0	2	0	0	6	0	0	0	0	0	0	0	2	0	0	0	0	0	0	0	0	2	0	7	0	0	6	0	9	0	0	0	104	0	0	1	0	1	0	0	0	44	0	0	0	1	0	0	9	0	0	0	0	308	6	0	10	23	0	0	0	0	3	0	21	14	13	5	0	0	0	0	8	0	0	12	3	0	2	0	70	0	0	0	0	1	1	0	0	0	0	0	0	0	1712	0	18	0	4	486	0	11	154	4	93	13	451	378	489	0	335	145	213	0	0	69	32	22	18	10	2	31	0	1595	2	0	186	2	1	59	13	0	0	111	30	15	0	0	0	0	0	20	0	0	0	12	11	16	1	20	23	18	2	7	0	2	0	12	10	25	9	0	0	0	0	0	0	2	0	0	0	30	0	0	1	2	12	0	0	79	0	6	0	0	0	4	0	0	0	4	0	0	3	0	0	0	0	0	0	179	0	19	0	3	0	20	6	0	33	2	0	0	4	72	568	0	10	8	15	57	1	5	15	1	4	0	103	11	0	7	3	0	0	0	6	111	1	0	12	0	47	1	0	0	8	2	0	0	5	0	14	0	0	3	80	0	0	1	6	0	0	6	7	0	0	9	0	0	0	0	1	0	0	2	0	1	0	0	26	0	0	0	14	0	32	19	8	0	4	0	0	0	6	1	0	42	0	0	0	22	20	0	28	67	0	5	8	0	0	2	2	0	0	1	0	0	0	4	21	43	19	16	0	0	0	1	1	0	0	1	0	7	0	0	0	0	0	0	1	0	0	27	4	0	15	0	0	0	0	0	0	21	0	4	1	0	0	0	0	0	0	0	1	0	0	0	0	0	1	0	0	7	0	0	0	0	0	0	16	4	0	0	3	9	7	0	0	0	0	0	0	1	8	0	0	2	0	0	0	0	7	0	1	2	4	7	0	1	0	0	0	1	0	2	0	0	6	64	0	0	114	0	0	0	20	4	21	0	0	0	0	0	3	0	7	1	16	12	0	0	0	0	2	130	2	0	0	0	6	108	132	3	9	6	20	40	0	61	0	26	2	5	0	108	85	99	8	64	78	32	18	6	3	35	1	0	52	0	37	0	4	61	2	58	215	0	35	2	254	8	1	16	3	39	18	0	20	0	0	0	0	258	22	3	30	36	80	60	2	0	55	150	240	2360	0	27	21	0	0	0	0	0	4	0	0	0	4	0	108	224	158	2	0	2	0	0	0	0	0	23	10	12	8	6	3	9	8	43	127	0	12	68	39	1	0	2	0	3	24	23	1	4	37	4	49	0	38	2	3	19	7	0	0	0	23	0	0	0	58	0	0	1	0	0	0	0	35	1	0	0	0	1	12	2	11	0	0	5	0	0	0	0	13	0	0	1	0	0	0	0	0	5	0	0	0	5	0	0	0	4	0	0	0	5	1	0	29	49	23	47	25	0	0	3	0	0	0	3	0	0	0	0	0	0	0	0	0	0	0	0	3	0	1	0	0	0	42	0	0	0	0	0	0	0	0	0	0	0	1	5	1	0	0	27	0	0	0	0	2	0	128	18	21	43	0	82	14	32	1	0	0	0	0	3	0	0	0	0	0	2	0	37	1	17	2	0	0	0	0	0	0	0	0	7	18	0	0	8	0	2	0	0	56	38	0	0	0	8	0	0	8	4	48	6	19	0	0	1	0	0	28	2	7	0	0	0	5	8	0	0	4	4	5	27	2	0	0	10	4	0	1	123	50	4	4	0	0	0	5	33	10	0	0	0	3	0	0	0	2	0	23	0	0	0	0	0	9	7	2	41	0	0	0	3	2	0	3	3	0	0	134	0	0	0	0	0	0	1	0	0	51	11	4	0	10	3	0	3	0	3	9	0	6	0	2	2	0	0	0	3	1	3	0	0	6	0	0	16	1	20	2	1	0	0	0	0	0	3	0	0	9	0	0	0	12	0	0	0	0	0	0	0	0	0	1	0	41	50	14	0	0	13	0	1	2	1	0	0	0	0	0	0	0	0	4	0	0	0	0	0	0	0	0	0	6	13	0	0	0	0	0	2	0	15	2	12	3164	0	0	1	0	0	0	0	0	5	5	0	2	11	0	0	2	0	16	0	0	0	15	4	1	0	0	10	0	5	0	7	223	0	0	3	0	0	0	0	0	0	0	0	0	55	10	0	29	3	13	0	0	2	0	61	0	0	0	0	0	184	0	0	0	0	0	0	0	1	5	1	0	14	0	0	0	0	0	3	0	0	0	0	14	7	0	0	0	0	24	1	1	0	3	0	29	31	0	0	0	0	406	1	27582	0	0	0	0	0	6	0	0	0	0	0	0	0	0	2	0	35	0	0	0	0	0	9	38	2	0	3	10	0	1	0	0	0	0	0	0	0	26	17	3	12	8	0	0	0	0	0	3	5	4	0	0	12	0	4	23	14	56	38	10	10	11	0	0	5	0	0	0	4	66	79	28	28	0	0	0	2	2	2	0	29	121	8	0	121	0	0	0	0	6	0	0	1	0	53	2	0	3	0	0	0	24	40	0	0	31	4	0	2	1	3	0	0	0	0	0	0	0	29	85	6	59	27	3	15	21	0	314	0	7	109	31	75	8	48	21	53	5	5	0	21	0	0	15	0	0	0	32	3	54	61	14	2	9	0	0	80	35	3	8	0	0	0	0	0	0	0	0	0	0	0	0	2	42	1	4	0	10	0	0	0	8	0	0	0	0	6	21	6	8	0	0	2	4	0	0	2	4	0	6	0	2	0	6	10	12	14	0	0	0	0	0	7	43	0	0	0	1	1	0	10	0	0	1	0	0	0	2	0	0	16	1	3	3	17	0	4	0	0	0	0	3	0	1	20	0	12	0	0	0	55	8	0	1	0	4	56	0	0	15	7	0	41	2	0	0	0	0	0	0	0	0	6	0	0	0	0	0	0	0	0	2	0	2	1	0	0	0	8	0	0	0	1	0	0	0	0	0	0	0	0	2	1	0	0	0	0	0	0	0	0	3	11	0	1	4	0	1	0	0	3	0	0	0	4	8	31	17	1	107	1	2	0	51	49	48	13	46	0	0	2	3	6	0	1	4	0	27	0	7	3	0	0	0	0	0	0	1	0	51	0	0	0	9	5	4	0	0	0	0	3545	35780	1	0	0	0	0	0	2	21	0	36	1	3	14	0	39	11	1	30	2	3	0	4	27	0	28	3	280	0	0	13	0	346	4	1	0	0	0	0	0	0	37	3	0	38	24	35	0	12	0	24	2	4	0	0	0	0	43	2	0	0	2	1	0	7	7	4	0	0	0	41	0	0	0	2	0	0	0	3	1	2	0	0	0	0	0	52	86	19	15	16	16	27	23	0	0	12	6	8	17	0	0	3	0	7	0	0	0	0	0	0	0	14	0	4	6	0	1	1	0	0	6	0	6	0	10	0	0	0	4	2	1	33	0	0	0	2	0	0	0	4	47	0	37	0	0	0	1	2	0	0	0	0	0	0	0	0	0	0	3	0	0	0	2	100	0	0	12	0	0	0	15	0	0	0	5	6	12	0	0	0	0	0	4	1	0	0	0	0	0	0	0	3	0	0	4	0	0	9	0	3	26	45	199	22	49	0	0	0	0	0	0	0	0	0	0	0	0	0	0	0	0	0	49	0	5	0	4	2	6	6	0	0	0	0	1	2	28	0	0	75	0	0	1	12	0	12	2	0	11	1	2	0	0	2	2	4	5	16	20	90	2	0	31	22	3	7	24	0	1	19	0	0	3	0	20	22	0	0	0	0	0	0	117	0	0	0	0	311	0	1	0	0	0	27	0	1	0	0	0	0	0	0	1	2	0	0	0	3	11	12	0	0	0	2	140	3	0	0	0	0	1	0	0	0	13	0	0	0	0	0	1	19	4	1	0	0	0	15	0	0	0	47	10	0	49	1	0	0	1	0	0	0	27	0	8	0	0	0	0	0	0	508	0	3	3	2	11	10	0	0	10	68	13	2	2549	0	21	31	6	1	30	0	282	33	58	0	0	0	0	10	0	6	0	7	0	18	0	1	6	0	5	0	5	10	0	24	3	0	10	164	0	0	0	0	0	21	44	1	0	2	0	1	0	1	10	0	0	0	7	8	0	0	0	0	31	4	7	0	0	0	2	0	0	0	4	5	3	7	0	0	19	2	0	4	0	0	0	0	8	6	10	8	39	5	3	19	28	34	25	31	84	0	0	0	0	0	0	2	0	0	543	1	0	2	63	59	43	6	0	185	2	0	14	39	2	0	3	0	0	0	2	1	0	0	0	12	262	50	0	0	0	0	0	0	0	0	0	0	8	3	2	1	0	0	0	0	0	0	0	4	0	0	0	0	3	0	0	0	0	4	3	0	0	0	0	0	0	0	4	4	0	0	0	0	0	0	0	2	0	0	0	0	7	0	0	0	8	1	4	1	0	4	2	3	2	1	2	25	6	0	20	0	0	16	2	5	69	42	1	0	5	0	0	1	7	18	0	0	0	1	10	0	7	0	0	16	0	5	9	0	0	5	0	3	4	9	5	49	7	0	4	1	2	2	1	0	0	35	4	10	1	8	0	39	3	0	35	4	0	18	3	0	0	0	22	38	44	30	0	17	8	30	0	3	1	17	0	4	2	0	0	0	0	2	0	0	0	0	20	1	5	9	0	0	0	9	1	2	18	10	20	4	0	15	2	24	13	7	27	4	6	50	9	56	0	0	1	1	0	2	0	0	3	45	3	286	3	0	0	33	0	3	0	0	0	0	0	0	0	0	1	0	0	1	19	25	2	12	26	24	635	1	0	5	0	0	0	0	0	4	2	0	1	0	2	32	0	1	0	1	2	11	0	0	0	0	0	2	43	21	0	16	29	3	4	0	0	0	0	28	1	216	0	10	191	0	0	0	13	0	6	0	0	0	3	23	0	0	0	1	0	8	4	0	0	0	0	0	0	0	0	0	0	0	0	0	0	0	4	0	0	2	0	0	0	0	0	2	2	1	1	124	26	0	17	28	11	50	11	23	21	0	0	0	3	4	0	0	0	0	0	0	0	0	0	0	19	0	0	0	0	0	0	0	0	0	6	0	12	0	0	0	0	13	0	0	0	0	0	0	1	0	0	11	2	0	0	0	0	0	0	0	0	2	0	3	7	0	6	0	7	0	4	0	19	0	0	0	0	0	0	0	1	25	0	48	0	2	1	9	0	22	31	0	0	0	0	28	0	10	0	0	8	0	0	0	9	0	0	0	12	0	25	0	0	0	0	0	0	0	0	0	1	0	0	0	0	0	0	223	0	0	0	0	0	0	0	0	0	16	0	0	0	93	4	0	2	0	3	0	0	0	4	0	0	1	0	0	0	0	0	0	0	0	45	0	0	0	0	0	0	6	0	0	8	2	0	0	5	0	10	0	0	0	140271	0	0	0	0	0	11	0	0	0	0	0	0	0	2	0	0	0	0	0	0	0	4	0	0	0	0	0	0	0	0	0	0	0	0	0	0	0	0	200	0	0	0	0	14	0	0	0	0	0	0	0	4	0	0	0	0	0	0	0	5	0	0	0	0	0	0	0	0	133	0	0	2	0	0	0	0	0	0	0	0	0	15	0	0	0	1	0	0	2	0	0	3	0	0	0	0	0	7	0	0	0	0	3	3	0	0	0	0	31	0	0	1	0	0	0	0	3	2	0	0	2	2	22	0	20	0	0	0	0	0	0	11	0	0	4	13	0	6	6	0	28	4	29	0	0	0	0	0	0	0	1	1	0	0	0	0	1	0	1	5	0	4	0	0	4	0	2	20	4	0	0	0	22	0	4	0	26	7	0	13	0	0	1	0	0	5	4	0	7	2	3	2	0	0	6	0	10	11	4	2	0	0	5	0	3	0	0	0	7	0	17	5	0	0	0	3	0	12	3	5	0	6	19	0	0	54	0	0	6	0	11	0	18	0	4	3	0	0	0	0	0	4	3	0	2	5	0	2	2	36	0	4	0	4	6	0	1	8	60	9	1	0	0	6	61	0	2	0	1	0	0	0	0	0	0	30	0	41	0	0	0	0	0	0	0	136	9	4	0	0	25	0	0	26	0	31	0	209	20	0	3	0	9	0	0	0	0	0	0	0	0	0	0	0	0	0	11	0	0	4	0	0	5	2	0	2	0	0	0	0	0	0	0	0	0	0	0	0	0	0	0	0	0	0	2	3	0	26	2	0	0	0	3	0	4	36	0	1	0	0	0	0	1	0	0	0	0	0	0	63	0	0	0	2	0	0	0	0	0	0	0	15	0	0	1	0	1	0	5	0	0	0	135	3	2	0	0	0	0	0	0	1	1	231	0	6	3	0	0	0	4	0	0	1	0	0	0	0	0	0	0	0	0	0	0	0	52	55	1	44	40	3	0	0	0	0	0	11	0	2986	2	2	3	37	0	0	0	0	6	7	5	0	0	0	0	0	0	0	0	0	26	15	6	91	0	2	38	50	0	0	0	1	0	0	0	1	8	0	0	1	0	0	0	0	0	0	0	0	4	19	2	0	4	0	0	0	2	0	0	14	9	24	89	33	96	1	16	33	29	0	40	0	19	70	0	0	0	5	0	4	0	0	0	1	29	3	1	0	0	0	66	5	0	1	0	42	0	0	0	0	0	6	0	0	5	3	3	6	0	12	0	0	0	0	2	0	0	0	24	0	5	0	0	3	2	0	0	17	0	12	0	0	1	19	9	4	12	0	2	0	1	1	0	0	0	4	0	1	4	2	1	41	18	0	4	0	0	0	0	0	0	1	1	1	0	0	9	0	0	1	27	8	0	9	1	4	18	26	23	0	1	0	2	12	3	19	59	4	0	3	0	20	7	1	23	5	38	15	0	0	0	5	0	0	0	1	39	1	61	17	30	0	5	0	0	1	5	4	10	0	0	0	0	0	17	0	0	14	5	8	0	23	0	3	2	2	29	1	2	17	5	19	0	2	32	57	10	0	0	0	0	0	0	0	4	1	0	61	0	1	0	1	0	0	3	13	16	6	0	0	0	0	1	0	0	1	3	5	0	0	1	4	0	18	5	7	90	0	19	2	1	0	3	1	0	0	13	0	9	0	0	1	11	0	0	10	6	2	14	0	8	0	13	56	0	0	0	1	0	10	0	2	1	0	0	0	0	10	11	1	0	10	0	18	3	2	0	0	0	1	0	0	51	1	0	0	32	0	0	110	0	26	0	0	8	3	0	0	0	2	0	28	7	0	2	0	0	0	0	0	0	5	9	1	0	2	58	8	7	2	0	0	0	1	0	0	0	0	0	11	4	20	4	0	62	0	0	60	8	0	75	53	0	0	258	56	0	74	194	16	63	34	0	3	0	0	1	7	1	4	0	2	3	0	2	0	22	0	0	1	0	0	0	8	1	0	0	0	0	10	1	12	5	3	0	0	0	0	0	0	0	0	0	0	0	0	0	0	1	1	0	0	0	0	0	0	0	0	0	0	0	30	5	0	0	4	0	0	13	0	0	0	0	0	0	0	0	0	0	0	0	1	0	0	0	1	0	35	17	0	62	3	0	0	6	0	0	0	32	34	35	11	15	0	52	3	0	8	0	2	3	0	0	0	0	0	0	151	10	15	18	3	36	31	0	1	0	2	0	13	1	5	0	0	3	0	0	0	0	0	0	2	1	0	0	0	0	17	1	8	0	7	0	3	4	10	0	15	11	9	0	0	0	0	0	0	7	14	2	1	0	0	1	0	0	6	2	3	3	0	32	4	1	13	0	8	0	1	2	0	3	0	1	0	217	0	1	1	0	3	208	0	0	0	0	19	0	4	0	0	2	0	0	0	38	0	7	6	0	0	3	12	0	0	0	24	0	0	0	0	2	0	1	6	11	39	0	3	0	1	1	32	2	0	8	0	17	0	18	3	12	1	12	0	0	9	0	0	4	0	4	0	0	23	0	1	2	5	7	0	23	2	0	10	0	0	0	0	0	3	0	0	1	0	0	0	0	4	0	0	0	0	0	5	0	0	0	0	0	0	1	2	3	0	0	0	0	0	0	1	10	0	1	27	35	0	6	0	3	18	86	19	47	29	0	2	219	190	0	2	125	0	23	0	0	0	3	1	0	16	0	22	28	5	1	0	18	0	0	2	11	2	0	0	8	10	281	0	0	0	0	0	0	0	22	0	3	1	0	0	0	0	6	0	0	8	0	150	0	36	9	14	0	10	6	6	0	0	0	0	0	15	0	0	0	2	0	37	0	0	20	4	0	36	3	473	5	0	0	0	3	101	0	47	32	12	17	3	26	0	22	3	0	0	0	0	0	4	8	8	1810	58	6	0	6	0	0	0	0	15	0	0	3	7	0	0	0	113	22	0	0	0	103	15	4	2	0	7	69	19	20	1	2	3	0	0	0	10	13	0	4	1	0	0	0	0	7	3	0	0	0	1	0	0	0	1	0	0	0	0	0	0	113	2	1	1	0	164	6	7	1	0	0	4	12	0	0	0	0	20	18	3	2	10	0	9	2	0	0	13	0	0	7	0	0	0	5	0	4	18	12	6	4	26	2	0	95	11	8	22	0	0	0	0	0	0	0	1	3	1	0	0	40	0	0	0	1	0	0	0	17	0	15	4	21	2	9	0	0	19	0	19	0	0	15	4	6	0	0	6	0	8	4	44	53	8	59	0	88	0	0	0	0	0	0	0	0	0	0	3	6	0	2	1	1	0	0	4	0	0	0	33	0	1	15	0	0	1	3	2	1	56	0	88	0	0	77	1	0	5	0	0	0	0	0	4	63	0	0	0	0	2	0	2	9	2	0	17	0	11	0	3	0	41	0	31	24	2	0	3	2	2	3	0	0	54	0	68	39	53	110	27	35	7	16	37	67	39	20	0	43	19	0	0	0	5	0	0	0	0	0	0	94	0	0	0	0	0	4	2	2	0	0	0	0	0	22	2	0	0	0	3	0	0	0	2	0	0	1	0	1	0	0	1	0	2	0	2	0	0	12	2	0	66	0	129	54	4	23	0	4	0	6	0	0	3	0	9	8	4	0	46	10	0	0	2	2	0	6	4	142	25	40	0	0	0	0	0	0	0	0	0	0	1	0	0	0	0	9	6	0	60	2	16	16	0	13	0	4	3	0	0	45	4	18	0	1	7	34	0	25	0	0	0	4	0	0	0	19	3	0	0	0	0	0	0	0	0	32	3	2	0	18	4	1	0	3	0	10	0	2	1	1	0	0	0	0	0	4	2	0	0	5	16	0	2	0	0	0	0	0	0	0	0	0	0	0	2
LakWasMet34_HOW6_2_rpkm	0	0	0	0	0	38	66	0	0	0	0	4	8	0	0	1	0	2	3	0	0	0	0	21	0	0	0	0	0	12	0	1	0	5	6	5	4	0	2	0	0	0	1	7	32	21	20	73	1	0	8	1	1	0	0	7	0	10	29	13	361	0	0	12	1	2	0	0	4	13	4	3	5	0	0	0	0	0	0	0	0	4	0	0	0	0	0	0	0	0	0	0	3	7	9	1	4	0	0	2	0	0	0	0	0	0	0	0	0	0	4	0	92	4	27	4	0	0	0	0	0	2	0	19	0	0	8	1	0	0	0	55	13	1	0	0	0	0	28	0	1	0	0	7	2	0	1	0	7	1	2	8	3	1	4	0	8	6	10	2	4	5	0	6	18	6	0	3	0	18	0	0	0	0	0	0	0	0	0	0	0	0	0	1	0	58	0	0	0	18	2	3	16	3	4	0	1	2	5	738	7	0	53	0	0	1	13	0	32	9	1	1	104	4	1	0	15	3	0	4	1	2	36	5	5	34	0	1	9	0	1	2	5	0	0	1	6	10	185	4	1	0	10	3	37	14	0	1	24	11	21	7	11	0	993	257	0	0	0	0	0	1	1	4	12	0	1	0	6	12	29	1	8	0	0	0	0	0	71	72	0	4	51	6	12	0	0	0	3	0	2	0	0	0	7	1	2	11	3	0	0	15	39	0	44	0	13	39	17	0	42	0	6	6	0	0	0	0	120	0	0	0	25	1	10	3440	3	2	1	0	0	1	0	0	0	1	1	0	2	0	0	3	20	18	12	2	17	0	0	0	0	0	2	0	3	0	0	2	0	22	4	0	0	0	0	15	3	13	50	3	0	12	0	0	16	6	0	2	0	1	0	1	0	2	1	0	154	0	0	0	0	0	23	5	0	7	152	0	0	3	0	9	0	3	13	0	0	0	0	1	0	4	8	2	0	27	21	6	3	0	0	0	0	0	0	0	2	0	6	0	57	1	3	0	0	0	1	0	2	0	8	48	0	0	8	7	0	0	0	0	0	72	43	448	1	26	7	1	0	55	0	0	0	1	2	10	2	0	2	21	9	27	20	3	0	0	1	1	762	0	0	3	1	3	0	0	0	125	9	1	0	1	45	16	2	1	9	0	0	0	1	0	1	0	0	0	1	2	1	2	0	0	0	0	0	0	0	1	1	4	0	0	0	0	0	0	0	0	0	0	0	0	0	0	4	0	1	5	0	5	1	25	1	11	11	0	0	0	0	0	0	0	1	0	1	26	0	0	0	0	0	3	1	1	4	1	10	0	21	0	0	2	0	2	13	33	28	128	2	50	124	77	50	16	2	0	12	1	18	0	0	0	1776	0	7	6	1	0	2	0	3	0	0	0	10	4	0	63	0	48	0	104	247	122	1	0	40	0	278	5	227	59	8	4	0	8	4	9	0	4	1	10	0	0	0	1	0	0	0	1	0	12	0	0	0	8	0	7	1	0	240	0	4	23	2	0	1	0	1	3	5	189	0	17	0	0	0	1	8	16	22	15	0	0	1	0	17	0	2	1	0	2	3	1	0	0	1	0	0	8	1	0	7	0	0	0	0	0	0	4	0	0	0	3	1	0	0	0	0	0	0	0	0	0	9	6	0	2	7	0	4	0	5	3	2	0	0	0	5	0	0	3	0	0	1	0	0	0	0	11	1	11	6	0	20	18	4	0	0	186	0	0	3	0	0	18	1	0	158	3	0	16	0	15	0	2	0	0	0	0	0	0	0	0	0	36	0	0	0	0	0	1	6	0	0	1	0	0	1	4	0	3	1	0	1	4	5	0	1	17	0	0	0	0	402	4	3	0	1	0	0	0	2	0	0	0	19	0	0	0	0	0	0	50	0	0	0	3	2	0	1	0	0	0	0	0	3	52	5	0	0	0	0	0	0	0	0	14	27	27	0	0	5	0	0	0	5	4	1	24	19	8	0	0	0	2	1	0	2	3	0	0	0	1	1	0	1	26	2	159	0	0	1	10	1	1	0	0	0	0	0	0	0	0	0	0	1	1	0	1	0	0	2	0	0	0	0	0	1	0	0	0	0	4	17	22	82	17	7	1	0	0	0	1	0	0	0	0	0	0	7	0	1	1	0	0	0	0	0	59	0	0	0	5	7	0	12	0	0	0	0	1	3	0	1	0	0	0	1	0	0	0	0	0	0	2	0	0	0	1	4	12	6	382	0	25	2	0	0	0	7	10	21	1	24	1	0	4	0	0	0	0	0	0	0	1	0	10	12	1	0	2	0	0	1	0	0	1	0	1	0	6	0	0	0	0	0	97	0	0	0	54	13	1	3	7	0	0	24	2	0	1	0	0	5	0	0	2	418	1	0	0	0	0	0	0	0	11	0	0	0	0	0	8	1	1	0	0	0	1	4	4	0	4412	0	0	0	2	212	2	15	0	3	0	3	0	15	0	6	17	1	0	5	0	0	0	0	0	0	8	3	4	0	0	0	0	1	1	1	0	0	0	0	1	5	0	38	0	14	41	0	2	0	0	11	0	0	4	3	2	0	0	0	0	0	4	43	35	5	0	20	0	15	0	0	8	5	0	23	0	0	1	0	0	0	0	1	0	0	0	1	0	0	0	14	0	0	0	0	3	0	1	0	0	1	0	0	0	0	1	19	9	0	0	1	0	2	0	4	0	0	0	1	0	0	0	0	5	0	0	0	0	1	2	5	159	0	0	0	11	6	0	0	6	0	83	8	0	0	1	0	0	15	1	0	0	16	0	0	1	0	0	4	0	1	0	0	0	15	0	0	0	0	0	1	0	0	23	2	0	3	0	9	7	0	0	1	4	0	1	4	0	2	54	14	0	0	1	1	12	20	0	0	17	0	3	0	0	0	1	0	0	10	8	5	4	8	6	0	29	0	3	2	3	0	10	1	0	1	1	0	2	1	0	0	0	0	0	56	4	1	0	1	0	0	0	2	2	0	5	0	1	0	0	1	0	0	0	0	0	0	0	138	0	0	0	3	0	4	0	0	1	0	3	3	0	9	68	14	19	0	0	8	0	0	0	3	5	3	17	5	1	3	0	0	0	35	11	0	3	0	1	92	1	4	0	5	2	3	22	0	0	10	9	9	3	0	3	12	0	0	0	6	0	19	0	6	4	13	79	5	2	56	0	0	7	4	28	1	9	0	2	3	7	3	0	5	1	2	17	3	18	41	4	0	0	4	0	0	0	0	0	0	3	10	0	0	0	8	2	4	15	1	4	23	0	2	2	4	2	0	3	3	19	22	44	0	0	0	0	0	0	5	113	46	18	10	1	0	1	0	0	0	0	0	37	3	3	0	11	0	0	1	3	171	66	67	12	1	1	0	90	1	0	1	0	2	0	0	0	41	58	17	75	136	117	14	2	15	4	0	0	14	0	0	1	49	2	0	0	0	2	0	4	0	0	0	1	0	9	0	0	0	0	0	1	12	0	0	0	0	0	0	2	10	43	0	0	0	0	0	3	0	1	0	0	0	0	4	2	2	0	7	0	0	0	0	0	1	5	0	0	0	120	0	0	0	0	0	0	0	0	0	0	0	0	0	0	0	0	0	0	1	0	0	0	0	482	0	0	174	0	7	0	0	29	4	25	11	0	2	61	0	16	4	4	0	0	1	0	26	10	33	0	1	4	0	0	1	0	1	11	9	0	0	0	11	2	1	4	7	1	0	0	0	0	0	7	1	39	9	62	0	0	8	60	0	0	0	15	1	0	0	1	1	1	0	5	5	0	3	0	4	16	13	0	2	11	1	1	1	6758	1	7	5	2	4	0	13	0	2	0	3	0	0	5	19	0	11	3	8	45	15	7	9	1	0	0	0	11	0	46	0	4	0	24	50	0	0	0	9	1	2	0	0	24	31	0	16	16	1	7	0	1	3	18	1	0	14	6	0	0	0	0	0	3	1	142	0	1	52	5	2	1	11	23	2	16	2	1	5	1	1	2	0	3	51	1511	23	42	0	20	12	8	15	2	0	0	32	0	0	0	537	1	3	2	0	0	1	4	9	1	54	4	0	0	0	1	0	0	0	20	0	0	1	0	0	1	13	0	0	0	11	0	1411	0	0	21	591	334	2	48625	8	0	3	0	0	0	0	0	0	1	1	0	0	4	2	1	0	9	0	0	0	0	0	0	0	24	0	13	0	16	0	1	0	25	4	0	0	0	14	0	7	6	4	0	4	0	1	0	0	0	0	0	20	0	1	17	53	0	0	0	6	130	4	33	1	30	42	0	42	5	53	1	13	20	12	9	97	13	0	16	0	0	0	0	7	0	0	0	0	0	0	0	0	0	1	0	9	19	0	20	31	0	0	0	0	0	0	0	0	0	0	0	3	0	0	0	0	0	0	8	41	0	0	0	1	0	1	0	0	0	0	5	9	0	0	1	0	0	0	0	0	0	0	0	0	0	2	1	0	0	2	2	0	0	0	0	0	0	0	0	374	0	15	18	1	1	0	0	15	0	21	16	16	8	0	3	1	0	0	0	0	0	1	8	0	1	22	2	1	0	0	4	1	0	0	0	0	3	0	0	8	4	18	14	11	82	0	20	1	0	2	0	11	42	34	5	0	0	0	0	0	1	0	0	0	0	2	0	3	0	0	4	0	0	0	0	0	0	0	4	0	0	4	0	0	0	1	1	0	0	8	331	21	1	0	0	1	0	0	0	0	0	0	4	0	0	0	0	5	1	0	0	0	0	3	0	0	0	0	4	22	0	0	10	0	1	0	0	5	0	0	0	3	0	0	6167	0	0	0	0	8	7	0	0	10	6	0	19	37	35	9	0	6	0	0	0	42	0	16	4	0	0	0	0	2	10	3	19	0	0	0	0	0	0	0	0	2	1	0	6	0	1	0	3	0	3	0	0	0	0	5	20	0	0	0	0	0	0	4	0	0	0	0	0	0	0	0	0	9	0	0	0	0	10	6	1	1	38	2	0	0	1257	0	0	136	326	102	0	2	0	18	12	1	0	0	0	4	3	45	0	5	11	4	4	0	1	1	0	0	0	7	0	0	2	5	40	0	0	1	0	32	0	0	4	0	0	0	9	1	0	0	0	0	5	7	1	2	1	1	2	1	1	42	27	0	3	9	0	0	0	5	12	0	0	0	1	3	1	1	0	1	1	1	0	0	1	46	0	0	0	0	0	14	12	0	1	2	8	2	0	0	0	0	1	0	0	0	2	0	2	0	0	1	0	0	0	0	0	4	1	0	0	0	0	0	31	0	0	3	1	1	0	24	0	5	0	0	0	1	0	0	1	1	7	2	2	0	0	0	0	119	61	85	50	75	61	150	88	6	64	104	308	67	84	10	44	27	68	53	36	17	3	143	138	121	40	296	60	53	34	46	10	46	2	0	14	0	0	0	0	1	0	3	0	70	48	0	0	0	0	0	0	1	0	2	0	0	0	2	0	0	2	0	0	1	1	7	0	2	0	4704	1	3	0	2	0	3	0	10	5	0	2	0	0	0	1	0	0	0	0	0	8	0	0	0	0	8	5	3	6	4	0	3	1	0	0	0	6	1	0	3	4	0	0	0	1	183	1	0	33	0	0	0	0	0	2	0	0	0	0	5	1	0	4	0	0	0	0	0	0	0	0	0	1	0	2	0	1	0	10	0	20	2	0	4	3	0	0	4	0	0	1	0	1	1	0	0	0	0	35	13	0	0	0	0	0	4	0	2	0	5	0	2	4	1	0	1	0	1	19	2	2	0	3	1	0	0	0	0	1	8	0	3	19	2	0	0	0	0	5	0	0	1	0	1	0	3	0	0	2	0	0	0	1	1	0	2	0	1	0	1	0	4	0	0	0	0	22	0	0	1	174	17	3	0	0	0	0	1	0	0	1	0	0	0	0	0	1	6	0	1	16	0	0	0	0	13	0	0	14	39	0	40	3	1	33	0	8	14	6	0	0	0	0	0	1	0	2	0	0	0	0	1	1	1	0	9	0	0	5	7	0	0	0	0	0	0	0	1	0	1	0	0	0	2	0	0	2	17	0	1	0	0	12	0	6	34	123	6	0	6	0	2	0	0	1	0	3	0	0	0	2	0	0	0	0	8	7	3	1	1	0	3	3	0	0	1	0	9	32	1	0	1	0	263	0	0	0	1	6	0	0	0	0	1	0	0	1	39	46	0	0	0	1	0	0	0	0	0	5	8	7	0	2	1	14	0	0	15	5	0	1	3	0	0	0	0	0	0	0	1	1	1	2	9	1	0	0	0	7	2	0	0	0	0	2	0	0	2	1	1	0	11	0	4	0	0	2	0	0	0	0	0	3	1	0	0	1	0	0	0	8	1	0	94	0	0	6	1	2219	0	0	1	0	0	1	3	5	6	16	12	0	0	0	0	0	0	1	0	35	0	0	0	0	0	0	17	0	15	14	25	5	0	21	23	9	1	9	0	13	0	26	0	17	4	11	0	8	4	3	1	12	1	9	0	8	1	0	0	15	0	3	0	1	4	3	4	2	0	3	1	0	0	3	2	0	61	1	3	0	24	10	2	7	0	1	0	7	13	10	0	0	0	0	0	3	9	0	0	0	0	4	3	0	0	0	3	387	0	0	0	0	0	0	0	0	1	0	0	1	0	0	2	4	3	0	1	0	0	0	0	0	0	1	0	129	3	0	17	19	19	1	22	0	9	1	0	23	84	0	0	0	0	11	4	0	294	0	32	8	0	0	0	0	0	4	1	0	15	5	0	258	0	17	0	0	0	11	90	0	0	0	0	8	2	0	0	1	8	1	3	3	1	0	32	4	0	0	36	59	1	28	0	0	0	0	98	996	795	1	0	0	0	3	0	26	4	20	0	0	1	2	0	1	78	235	5	3	0	0	0	0	0	0	25	2	0	5	0	0	1	0	0	9	0	0	5	0	0	0	0	0	0	0	9	0	55	13845	0	1	2	0	0	0	0	36	11	0	0	0	0	0	5	4	0	0	1	0	0	0	0	60	2	0	2	0	1	8	1	0	0	1	0	4	0	6	0	0	0	0	0	1	0	2844	1	1	3	0	1	0	0	0	1	0	0	1	0	0	0	27	0	3	0	0	0	0	0	0	0	0	2	0	0	0	1	0	0	0	1	0	0	0	0	1	0	0	5	0	0	1	0	0	0	0	0	0	0	0	10	0	0	0	0	44	0	0	0	7	1	0	32	0	0	0	0	0	0	132	1	0	0	0	2	29	2	57	8	0	12	0	0	16	6	0	15	0	0	151	1	0	0	0	0	0	0	0	32	0	4	0	0	0	0	0	0	0	0	0	0	3	0	0	0	0	0	0	0	0	3	0	0	0	2	2	2	0	1	0	0	7	0	0	0	0	0	4	3	10	0	17	3	3	0	3	1	0	0	0	0	0	0	0	4	171	0	0	0	2	0	6	0	0	0	0	0	0	0	0	5	0	0	62	3	6	0	15	2	5	0	0	0	0	2	0	0	1	0	0	0	3	0	14	33	0	2	0	33	47	0	0	0	0	0	1	0	2	1	34	0	3	0	0	0	0	11	31	0	8	0	0	0	8	0	0	0	1	0	1	0	1	1	0	4	9	24	6	0	0	0	0	0	0	0	0	35	0	21	0	0	0	0	0	3	1	3	2	0	2	0	0	17	0	0	0	0	0	1	4	6	6	0	7	2	2	1	0	14	0	1	0	5	0	0	0	0	0	0	3	174	0	0	0	0	0	0	0	0	1	0	1	3	0	0	0	2	1	0	70	2	0	0	0	0	0	1	23	0	1	0	0	0	2	0	0	0	0	0	4	2	0	0	1	1	0	0	3	18	1	0	0	56	0	0	0	1	0	0	0	0	0	0	0	4	1	2	0	0	0	5	5	1	7	0	0	2	0	0	1	0	0	1	0	0	0	1	0	1	0	0	1	5	0	0	0	0	0	7	0	5	0	1	0	0	0	5	0	0	0	0	0	4	2	1	1	18	1	0	25	1	0	0	1	0	0	0	0	0	0	0	0	0	0	4	1582	0	0	0	1	0	0	0	0	0	8	0	97	3	0	184	0	0	0	4	0	0	0	0	0	1	0	0	6	0	0	0	1	7	0	0	0	1	13	3	0	2	5	7	8	0	0	0	0	0	0	0	1	1	0	7	0	0	298	0	0	0	0	0	0	0	0	18	1	0	0	0	0	0	2	0	0	0	3	0	2	12	0	11	0	0	0	1	0	0	13	10	39	0	0	0	1	2	3	0	0	0	0	0	0	0	0	0	1	0	0	0	0	0	1	0	0	1	2	1	0	0	0	0	0	0	0	0	6	0	8	0	0	0	0	0	0	0	0	0	0	0	0	0	0	0	3	0	0	3	0	0	0	5	0	0	0	0	0	1	0	0	0	0	0	0	0	1	0	0	0	0	0	0	0	0	1	1	0	0	0	0	0	0	0	3	0	0	0	0	0	0	1	0	0	0	0	0	0	0	0	3	0	0	15	0	1	1	0	0	4	0	0	6	0	2	4	5	0	0	1	20	0	2	1	0	0	0	471	20	0	2	1	0	649	0	47	3	1	0	0	1	0	0	0	0	6	0	0	0	2	0	0	1	0	0	0	0	0	0	2	0	0	0	0	0	0	1	2	0	0	0	0	2	2	0	6	0	0	0	2	0	0	0	44	0	17	7	0	2	0	0	6	0	0	0	0	47	0	0	0	1	1	0	0	0	0	0	0	0	4	0	0	7	0	0	0	0	0	0	0	0	0	0	0	0	0	9	0	2	0	0	0	2	1	0	0	11535	0	0	1	0	0	0	0	0	0	0	2	0	0	16	1	0	2	0	2	3	0	0	3	0	0	0	0	0	0	0	0	0	0	0	0	0	0	0	0	0	0	2	0	0	0	2	0	0	0	0	0	0	12	0	0	1	0	0	1	0	0	1	103	0	0	0	0	0	0	0	26	0	0	0	2	0	0	9	0	20	0	0	0	0	0	0	2	0	0	3	0	0	0	0	0	0	0	1	0	1	0	1	1	5	0	2	0	0	0	2	0	2	0	2	0	0	4	0	0	0	0	0	110	5	0	16	0	0	0	0	0	0	8	0	0	0	0	0	0	2	0	0	0	222	0	0	0	49	0	0	2	1	0	1	21	0	53	0	0	0	0	0	0	0	0	0	0	6	28	3	1	2	0	2	0	3	16	0	0	7	1	0	0	0	0	0	1	0	0	0	0	0	0	0	0	0	0	0	0	0	0	0	0	1	0	2	0	2	0	3	0	2	0	0	1	29	0	0	0	0	3	2	6	1	0	2	14	0	1	0	0	0	0	0	0	5	1	0	5	2	2	0	10	5	3	36	201	1	0	9	0	473	1	13	57	2	0	0	0	82	616	0	40	1	28	18	0	550	0	1	0	0	4	0	0	10	39	0	39	0	1	4	0	29	41	21	0	1	8	2	23	0	16	1	0	21	8	1	0	0	0	0	1	0	13	18	1	0	0	16	6	0	0	148	0	0	1	0	0	2	0	2	1	0	36	0	0	0	6	0	0	20	19	1	0	0	7	0	10	0	0	1	5	0	0	0	0	0	0	108	39	0	0	44	0	0	0	0	2	15	0	0	0	0	0	1	17	0	0	2	0	0	0	0	117	4	1	1	12	0	0	0	0	0	0	0	0	2	0	1	0	1	10	1	3	0	0	2	12	1	9	3	0	0	0	9	0	0	5	0	13	29	1	1	0	0	1	3	6	8	0	66	0	0	0	0	12	1	0	0	43	17	100	2	12	10	27	94	1	152	19	11	2	90	177	61	0	1434	48	88	25	36	4	86	15	63	5	1	0	51	1	2	0	1	0	0	4	1	0	0	0	1	12	4	0	0	0	0	0	104	0	4	16	1	0	0	0	3	0	2	0	0	6	10	0	1	0	1	0	0	22	0	0	0	9	0	0	0	72	5	0	0	0	17	2	0	13	0	8	0	99	0	2	0	0	2	0	0	25	20	4	0	59	0	0	0	0	0	0	3	0	0	0	0	0	0	0	0	17	0	0	0	0	8	1	0	1	0	27	0	0	14	0	5	0	0	0	2	0	0	10	4	1	0	2	5	0	0	1	0	6	0	20	7	1	0	0	0	0	0	1	0	0	0	6	0	299	0	0	37	2	0	0	1	0	0	0	49	0	5	10	0	0	0	0	0	0	10	0	0	17	3	0	4	0	2	0	2	0	0	0	2	0	0	0	1	0	1	0	0	0	0	0	0	0	0	42	5	0	0	9	2	0	0	0	3	0	0	1	139	0	0	0	0	7	1	1	1	2	1	0	0	43	225	242	0	0	1	0	34	6	0	0	0	16	0	0	1	1	0	0	1	0	2	359	1	20	0	46	0	4	2	3	3	0	0	0	13	1	0	0	1	0	0	0	0	0	2	6	0	23	1	0	3	6	19	0	1	1	43	0	0	1	29	4	6	2	0	3	0	0	0	2	17	0	2	8	0	0	2	170	110	0	33	0	0	0	0	0	1	10	0	10	1	0	0	41	0	4	0	0	5	0	1	2	4	1	6	0	0	11	13	0	0	0	10	0	0	2	0	0	6	12	1	0	0	0	0	3	1	3	0	0	0	0	0	0	0	2	10	2	4	0	3	0	0	0	0	1	9	0	1	0	2	0	7	0	0	3	2	0	3	0	0	0	0	0	0	0	0	1	1	4	0	0	22	2	1	0	1	0	0	0	0	0	0	1	3	0	0	2	0	224	2	1	1	1	0	53	120	4	18	0	0	0	0	0	0	0	1	1	0	0	65	3	0	1	0	6	0	30	0	23	11	14	51	20	12	45	10	0	0	0	0	0	25	1	1	33	0	1	0	0	0	0	0	4	0	12	10	2	7	27	11	21	0	0	0	0	266	0	4	0	4	1	0	13	0	0	0	4	0	0	0	0	0	0	2	2	2	0	1	0	0	0	0	80	2	0	0	2	0	5	19	0	1	3	0	0	0	0	3	3	0	0	0	0	0	54	1	9	0	0	0	1	0	0	7	0	2	3	0	0	0	0	5	0	0	0	1	4	0	6	6	0	0	20	0	3	0	0	0	0	0	5	9	0	0	0	0	0	2	1	4	0	1	0	0	0	3	8	0	0	1	0	6	1	0	3	0	0	37	0	1	1	0	0	4	1	2	13	0	7	1	0	0	0	4	1	1	0	0	2	0	2	5	1	2	0	0	0	0	0	5	5	0	27	0	1	0	0	90	0	1	0	0	2	3	4	0	6	0	0	1	17	1	57	3	0	0	1	0	1	2	0	0	0	0	0	0	16	0	1	1	0	0	0	1	223	6	0	0	0	1	3	0	0	1	0	2	1	0	0	1	0	0	4	0	0	0	0	0	0	2	0	0	0	1	3	0	1	0	0	0	0	0	0	0	0	0	1	0	0	0	0	0	0	0	0	0	0	23	0	0	1	0	0	96	24	0	1	0	0	3	0	0	1	0	2	0	0	0	2	2	1	2	2	0	0	0	0	1	0	1	0	0	1	0	0	6	1	0	208	0	0	0	0	0	10	0	3	0	0	0	4	0	0	3	123	1	0	0	0	0	2	0	30	0	0	77	0	0	110	0	8	0	0	0	0	0	0	30	0	45	0	0	0	2	0	0	1	2	0	0	33	6	0	0	0	0	0	0	0	0	0	1	0	0	0	1	57	1	8	12	0	0	0	0	0	3	0	18	1	0	0	0	2	0	0	0	3	0	4	0	0	74	0	0	0	9	7	3	0	0	3	1	0	0	2	0	0	0	0	0	0	0	0	0	0	0	90	5	1	4	0	0	0	2	0	1	0	1	0	0	0	0	0	0	7	3	0	0	1	0	0	3	8	0	0	0	1	0	15	1	3	10	1	0	0	0	20	0	20	0	2	1	5	0	0	0	0	0	0	0	11	5	1	2	0	0	0	0	0	11	30	23	5	9	0	0	0	0	1	10	0	0	0	1	32	6	9	57	0	24	15	1	8	0	0	22	41	1	0	10	1	0	0	1	2	1	0	0	62	15	0	6	5	243	4	0	0	29	6	35	0	1	0	6	7	0	8	3	23	0	0	2	1	10	1	0	9	0	0	7	0	0	2	14	1	88	3	3	5	5	3	55	25	72	9	0	9	0	18	0	4	5	1	0	0	2	6	0	2	9	1	0	0	0	1	0	12	2	10	0	0	8	30	15	19	0	3	2	30	12	1	0	14	2	0	7	0	0	0	0	0	0	0	0	3	0	0	0	17	0	9	0	530	1	0	2	0	3	12	0	0	1	0	2	0	2	0	0	0	0	0	0	0	1	0	0	0	0	0	0	1	0	0	1	0	0	0	2	1	0	1	0	0	12	0	0	0	11	0	0	6	0	4	0	1	0	2	1	18	3	31	76	0	7	4	0	0	1	0	1	3	0	13	113	0	0	0	0	0	10	2	15	2	20	2	13	1	0	49	2	0	0	10	10	0	0	0	0	0	0	16	0	0	0	0	0	1	0	0	22	1	0	7	56	0	0	7	21	0	0	0	0	0	0	14	0	3	11	81	18	1	0	0	1	0	20	0	1	0	2	17	7	8	1	44	1	0	0	36	7	514	0	2	0	265	0	2	0	0	0	0	0	2	0	4	15	1	71	9	0	13	0	0	0	1	5	0	0	6	0	0	7	34	10	11	22	11	0	0	0	13	0	0	0	0	2	0	3	0	0	0	0	0	0	9	0	0	13	0	0	66	1	3	0	0	0	8	1	11	7	0	15	15	0	0	0	33	0	2	9	3	9	31	3	7	25	19	14	25	58	66	3	1	0	0	19	0	0	17	0	0	6	1	0	0	0	0	1	2	17	10	2	3	36	68	125	0	54	4	12	0	0	0	0	0	0	0	0	0	0	1	0	0	0	0	0	0	8	18	1	0	1	2	9	0	0	0	0	0	0	120	0	0	0	8	0	3	14	0	105	0	0	9	1	1	1	0	30	0	13	21	1	0	3	1	23	2	0	0	10	12	0	7	0	0	8	0	1	116	0	0	0	9	7	25	15	0	2	0	0	1	1	1	1	8	0	0	4	2	1	0	6	0	64	22	45	1	1	9	6	14	6	7	1	0	8	1	0	47	55	0	2	2	1	0	48	41	142	2	1	9	55	0	0	0	1	0	0	20	1	0	0	0	0	9042	24	15	1	2	0	8	23	2	1	0	0	0	0	2	3	2	6	7	0	12	0	56	0	51	15	10	10	16	4	1	6	342	40	0	26	1	4	0	4	2	11	1	2	0	1	0	3	0	0	2	1	1	1	4	0	0	14	97	102	213	1031	3	34	0	1	0	2	23	47	0	0	16	0	0	0	0	1	0	0	0	0	2	4	10	0	0	0	0	5	3	1	0	0	14	1	0	0	3	6	11	2	7	23	7	6	3	3	17	13	12	10	11	1	0	1	0	16	21	29	0	0	7	14	3	11	0	19	4	0	6	114	4	2	11	0	0	3	0	3	8	10	0	0	0	1	0	8	1	0	0	1	0	1	0	0	118	3	5	8	18	21	2	0	0	0	0	93	0	3735	0	3	0	2	27	24	3	0	0	0	0	0	0	1	0	20	3	9	0	0	0	0	0	1	0	2	0	0	0	30	0	0	1	0	3	2	4	7	0	4	21	0	0	0	0	0	0	0	0	0	8	4	0	0	0	0	0	0	0	0	0	0	0	0	0	0	0	4	0	34	3	1	32	0	0	2	0	6	43	0	0	1	0	2	0	0	0	20	0	0	1	1	0	1	0	0	0	2	0	31	70	1	136	36	0	6	1	0	34	0	532	26	13	9	0	0	0	2	6	0	4	64	0	0	0	1	7	0	0	7	4	0	6	0	0	1	0	0	0	0	1132	192	8	0	11	2336	0	50	31	56	0	1	71	45	36	8	129	51	12	0	14	335	289	274	37	35	6	0	0	196	3	4	4	5	0	68	18	1	0	1244	1	0	0	0	1	0	2	22	0	1	0	4	58	95	6	2	43	8	6	4	0	6	0	15	28	3	12	3	0	1	0	1	0	0	0	0	1	26	1	0	14	0	20	0	4	112	0	2	0	5	0	3	3	6	1	1	0	0	0	43	0	0	0	0	0	1	0	1	0	5	1	35	10	0	29	15	0	0	27	264	116	1	1	37	158	45	2	25	63	0	54	0	12	38	1	113	0	0	4	2	6	55	37	1	35	37	19	32	1	0	23	12	0	0	13	4	4	0	0	0	47	0	22	10	0	2	0	1	4	2	0	27	0	0	13	1	0	0	1	2	1	2	0	0	14	0	0	0	9	1	674	3	4	0	0	3	8	0	40	3	1	17	4	0	0	102	16	2	67	179	0	7	4	2	0	4	2	3	8	6	2	14	23	61	10	37	10	5	0	0	0	1	0	0	0	1	0	2	0	3	25	0	0	0	0	0	2	9	23	0	5	0	0	0	4	0	0	2	1	1	0	0	1	0	0	1	0	0	0	1	0	0	1	0	3	2	0	7	0	1	17	0	0	0	9	3	2	0	0	16	1	0	0	0	2	1	0	0	2	1	0	2	0	0	0	0	6	0	6	1	51	4	0	9	0	0	0	2	0	1	0	0	3	16	0	0	18	0	0	2	5	12	11	0	0	3	0	1	117	0	5	19	8	5	0	0	0	0	2	0	0	1	0	0	49	16	10	11	11	6	1	52	18	13	0	26	14	69	16	4	67	43	32	50	7	11	6	3	4	5	4	0	8	2	10	11	11	19	74	10	56	12	8	30	9	89	16	12	39	18	8	8	25	0	0	18	0	44	142	17	5	1	33	23	1	7	166	71	5	269	0	660	8	0	1	0	0	0	12	5	7	0	92	0	1944	5240	73	6	0	104	1	0	0	0	0	250	45	173	22	49	92	392	29	7	12	0	0	2	37	27	0	1	0	8	1	6	15	13	15	63	55	16	3	17	17	7	25	0	0	0	5	0	0	1	7	0	2	0	1	0	0	1	22	3	2	0	0	0	26	14	14	2	1	3	8	0	1	2	15	0	0	1	0	0	0	1	0	1	0	2	0	0	0	1	1	3	0	6	1	1	0	0	13	22	0	8	101	0	3	1	0	1	0	3	0	0	0	0	0	0	0	0	0	0	0	0	39	1	1	1	0	0	10	0	0	0	0	2	0	0	0	0	0	0	4	1	0	0	3	5	0	0	0	0	9	1	75	155	11	56	0	27	1	17	0	0	0	0	0	0	0	0	0	1	0	4	0	3	11	13	2	0	0	0	0	0	0	4	0	4	12	5	0	34	0	10	0	0	6	38	0	0	0	16	0	0	4	33	191	125	3	0	0	59	1	1	10	1	46	0	0	0	11	10	5	1	4	3	16	6	24	0	0	20	17	0	3	24	203	11	14	2	0	0	0	15	30	5	0	7	1	0	0	0	4	0	8	0	0	0	0	0	3	0	1	12	1	0	0	1	0	0	4	3	3	0	64	2	0	0	0	1	0	0	2	0	9	2	15	0	4	46	0	21	1	0	4	15	27	0	0	10	4	2	0	12	7	0	0	0	0	0	0	4	3	7	0	0	0	2	1	0	0	1	0	7	11	12	2	7	14	2	1	1	0	3	0	0	10	6	9	2	16	17	15	0	0	28	0	0	7	4	0	1	2	5	0	0	1	5	1	0	1	0	0	0	2	0	1	6	14	4	0	0	0	0	0	1	3	7	1	0	656	0	1	1	0	1	0	3	0	15	2	0	4	56	0	0	2	0	7	26	0	0	30	14	5	0	1	22	0	11	7	7	779	0	0	59	0	11	0	1	0	0	5	0	1	10	57	0	16	3	14	5	6	7	0	8	0	0	0	0	0	2	0	0	0	0	0	0	0	0	0	1	0	2	0	0	1	0	0	5	0	4	1	1	4	21	0	0	1	0	27	15	1	1	0	0	52	23	3	9	2	1	1	0	60739	0	0	0	0	0	4	0	0	0	0	0	0	0	0	0	0	2	0	0	0	0	28	18	17	74	0	25	5	19	2	2	0	0	0	0	3	2	8	15	1	44	20	1	0	0	0	6	14	0	19	0	0	5	0	58	8	12	0	7	49	74	21	0	6	2	0	29	0	0	37	8	17	25	0	0	0	0	1	1	0	119	14	147	5	6	0	0	0	0	42	0	0	2	0	17	28	0	6	0	0	3	45	16	0	0	21	11	1	8	0	2	0	1	0	0	0	0	0	26	96	138	68	12	4	4	10	0	9	20	13	59	42	7	6	15	17	38	4	0	5	9	3	0	0	0	3	0	11	2	57	70	5	0	6	0	0	26	6	13	5	11	0	12	0	0	0	0	0	0	1	1	1	4	6	1	2	25	7	0	0	0	22	1	0	0	0	10	15	8	3	4	16	11	12	0	1	2	203	0	3	0	12	3	282	0	4	29	0	7	0	0	0	60	5	0	0	0	1	0	0	5	0	0	0	1	0	0	6	1	0	0	2	5	12	9	0	3	1	0	0	0	0	8	1	7	0	21	1	0	0	49	99	2	5	3	7	12	1	0	5	3	0	1	8	0	0	2	0	0	0	0	0	0	0	0	0	2	0	1	1	0	1	0	2	1	0	0	0	42	1	0	0	1	2	0	0	1	0	0	0	0	1	2	0	0	0	0	6	0	1	0	2	26	0	0	5	0	0	0	0	20	37	1	5	0	0	2	2	3	9	0	0	0	493	6	8	2	4	0	1	5	8	22	0	11	4	5	7	3	3	1	1	0	0	0	0	0	0	0	3	0	1	0	5	33	14	0	0	0	0	42	226	0	0	0	0	0	1	7	4	24	40	10	2	48	0	50	19	7	2015	27	0	0	5	7	20	12	1	22	0	0	63	1	57	2	2	4	0	1	0	1	0	7	0	14	63	5	4	1	5	1	2	8	5	1	0	0	0	7	0	0	0	0	2	0	25	1	11	0	40	5	10	18	6	4	4	5	2	27	18	0	2	0	0	0	6	0	58	148	13	5	1	3	17	2	0	1	9	5	3	4	1	6	3	1	3	0	2	8	1	0	0	0	2	5	1	2	0	2	0	5	0	0	11	5	5	15	0	31	0	1	0	0	8	0	0	1	0	0	0	7	6	244	0	5	0	0	0	1	18	0	0	1	0	0	0	1	4	5	0	2	0	0	0	1	12	0	0	2000	0	5	3	6	0	0	0	1	1	5	0	1	0	1	0	0	0	0	1	0	0	0	0	0	1	0	2	0	1	0	229	1	26	5	8	11	4	17	0	0	0	0	0	0	0	0	0	0	0	0	0	1	0	0	0	11	0	0	1	1	0	4	3	0	0	0	0	0	0	0	0	0	36	0	0	16	3	7	10	4	0	6	12	6	1	8	1	4	3	4	1	0	12	7	7	29	219	9	189	489	0	0	6	3	0	2	12	7	3	0	1	0	0	0	0	339	0	0	6	0	265	0	1	0	0	0	410	0	2	0	1	0	1	6	0	0	1	0	0	0	1	7	24	0	0	1	4	109	188	0	0	0	3	1	0	0	7	7	0	0	0	0	0	1	24	25	0	0	0	0	7	3	3	0	22	3	0	13	12	7	0	4	0	5	1	2	7	21	2	0	1	1	0	2	125	0	1	9	0	19	75	0	0	13	88	2	14	150	0	2	1	1	0	0	0	14	17	18	0	0	1	1	24	0	9	2	8	0	40	0	0	31	0	0	0	46	7	7	544	1	0	94	205	0	0	3	0	0	12	3	0	0	4	0	45	0	0	2	1	0	0	0	1	0	0	0	0	12	1	0	0	0	5	2	1	0	0	3	75	1	14	0	8	120	4	0	0	0	2	0	7	12	2	8	10	51	102	6	5	44	0	9	15	42	0	0	0	0	2	0	7	0	0	175	2	0	1	9	16	6	0	11	2	0	6	2	20	1	1	208	7	2	0	0	1	6	0	0	23	77	57	0	0	0	0	0	0	2	0	5	2	1	0	3	0	0	0	1	0	0	0	0	0	1	1	0	0	1	0	0	0	0	0	0	2	0	0	0	0	2	0	1	2	0	0	0	0	0	0	0	1	0	0	0	2	0	0	0	0	6	4	1	4	0	4	3	2	2	0	6	0	8	0	3	0	0	10	521	2	5	24	5	39	3	4	14	1	18	3	0	0	0	0	3	10	0	0	0	18	2	1	1	0	13	8	6	5	5	0	0	21	30	0	17	0	4	1	0	0	0	5	11	18	13	71	7	42	36	0	33	8	1	0	2	0	6	1	7	10	9	4	0	13	9	9	1	2	0	3	0	15	2	0	0	4	1	0	0	0	0	0	17	0	0	0	0	0	1	0	1	1	7	28	8	24	2	5	2	20	66	5	13	8	3	40	71	66	0	3	0	0	0	5	0	1	3	21	7	43	29	0	0	3	0	0	0	0	0	0	0	0	0	0	0	3	0	36	26	552	9	36	133	12	29524	26	0	6	0	0	0	0	0	12	7	3	17	0	0	18	0	0	2	2	0	0	0	0	3	5	0	0	759	155	0	14	17	0	4	2	1	0	0	8	0	65	0	1	163	0	2	0	3	0	33	0	0	0	2	5	2	0	1	0	1	0	8	0	0	1	0	0	7	0	0	0	0	0	0	0	0	0	2	1	0	0	0	1	0	0	0	2	1	4	0	362	120	1	8	6	5	1	5	4	3	0	0	0	21	2	0	0	0	0	0	1	0	0	0	0	3	1	0	0	1	2	7	0	0	10	4	3	19	2	0	0	0	4	0	0	0	0	0	0	7	0	0	8	11	1	0	0	0	0	0	0	1	0	0	0	22	3	2	0	23	37	42	2	6	0	0	0	0	0	0	0	1	24	0	16	1	1	3	0	0	17	73	0	0	1	0	3	0	0	0	0	0	2	0	0	0	0	0	0	0	0	2	0	0	0	0	0	0	0	1	0	0	0	0	0	0	0	0	81	0	0	0	0	0	0	0	0	2	4	0	0	0	0	0	0	1	0	4	5	0	0	2	0	0	0	0	0	0	0	2	0	0	0	17	0	2	0	0	0	2	8	0	0	0	1	0	4	0	2	4	0	0	1	43381	0	0	0	0	0	1	0	0	0	1	1	2	0	0	1	0	0	0	1	0	0	0	0	0	0	3	0	2	0	0	0	2	0	0	0	0	0	0	55	0	0	4	0	32	0	0	0	0	0	0	0	0	0	0	0	0	1	0	0	2	0	0	2	4	18	0	0	0	7	1	0	0	0	0	0	0	6	1	0	0	0	8	0	0	3	0	0	0	0	0	0	0	0	0	0	0	0	2	0	0	0	0	15	3	1	0	1	0	719	0	0	0	0	0	0	1	10	1	0	1	6	9	325	0	411	25	1	0	0	4	0	18	0	0	10	1437	1	7	0	0	255	4	47	0	0	3	0	3	7	2	3	14	14	3	0	8	27	0	2	34	0	13	0	0	5	1	32	1	52	0	0	0	3	0	24	3	286	4	19	12	0	2	3	14	5	3	15	5	5	5	17	0	2	4	14	1	13	89	1	4	3	4	64	15	6	0	1	0	170	68	31	7	3	1	4	0	23	3	3	40	2	5	64	0	0	1719	2	0	26	0	5	0	281	4	125	18	13	0	13	3	7	21	69	3	23	6	1	3	2	22	6	52	0	19	29	4	7	353	412	63	13	0	0	7	39	0	11	0	0	0	0	0	0	0	0	8	0	2	0	0	0	0	0	4	0	17	6	62	0	0	2	0	0	3	0	40	3	19	11	1	1	1	2	9	0	1	1	0	0	0	18	0	0	1	3	0	2	3	1	15	0	0	0	5	0	1	0	1	1	0	0	0	0	0	0	0	2	0	2	0	0	2	0	18	0	1	1	4	1	0	1	9	2	0	3	24	1	3	0	2	0	60	4	0	0	10	1	0	0	1	4	0	0	4	0	0	0	4	2	0	0	1	0	0	3	0	2	0	0	0	31	0	24	0	5	0	0	1	0	1	0	0	0	33	1	64	8	0	0	0	0	0	3	0	0	1	0	0	0	0	0	0	0	0	1	5	16	26	0	60	6	6	0	0	7	0	0	9	5	67	1	17	25	219	0	0	6	0	6	25	1	0	0	2	8	0	0	0	1	1	8	11	120	1661	0	11	18	6	0	0	0	1	0	0	0	3	0	0	0	0	1	0	1	0	23	2	0	1	76	86	1	5	8	0	0	1	1	0	0	4	120	1	7	35	28	1	13	19	1700	0	27	1	22	32	1	0	6	34	0	0	0	1	0	0	8	0	0	0	0	2	30	27	1	0	0	4	0	0	1	0	0	3	0	0	24	9	17	0	1	63	0	0	0	0	1	0	24	0	14	0	1	7	5	14	1	21	0	35	0	4	0	0	0	17	2	1	3	0	51	0	5	9	2	9	12	1	0	29	9	10	8	370	11	0	1	0	0	1	0	1	0	0	2	0	0	0	0	0	0	20	1	63	0	1	0	2	29	8	12	0	6	0	2	0	1	1	2	20	2	2	0	3	35	26	56	27	0	0	0	4	0	150	0	1	0	0	2	0	103	180	21	0	35	0	0	5	5	2	2	0	0	0	1	9	46	10	23	1	16	8	11	74	0	4	3	3	66	1	1	10	4	15	6	1	4	38	101	1	1	0	0	0	0	1	79	0	0	46	0	2	0	0	0	0	1	23	20	5	0	1	15	0	10	0	0	0	1	2	0	6	1	1	0	7	3	1	69	8	1	0	1	0	0	0	3	0	0	0	3	0	1	0	5	1	1	14	8	4	135	0	0	0	7	19	0	0	2	1	0	19	1	1	1	0	0	0	4	5	4	14	0	6	3	4	8	0	1	3	0	0	1	0	165	10	0	0	9	0	0	3	2	10	25	0	58	290	0	2	0	0	0	44	24	0	0	4	1	11	5	2	0	8	0	2	0	0	25	41	4	7	0	0	0	0	2	0	0	0	0	4	2	128	2	0	51	0	0	27	10	2	24	6	4	18	186	3	7	26	6	23	10	0	29	6	0	1	0	1	0	7	0	1	1	7	3	3	4	1	0	0	0	0	0	0	1	1	0	1	0	5	3	2	6	3	8	0	0	0	0	0	0	0	0	0	0	0	0	0	0	0	0	0	0	0	0	0	0	0	0	0	0	12	4	0	0	1	0	0	0	0	1	0	0	0	0	0	0	0	0	0	0	1	0	0	0	1	0	5	4	0	27	6	0	0	4	0	0	0	6	2	16	9	5	8	69	4	0	0	0	5	0	0	0	0	3	0	0	0	15	120	3	33	9	10	0	0	0	14	6	6	2	0	0	0	1	0	0	0	1	0	0	23	6	13	13	6	1	4	7	17	8	6	0	8	9	5	0	9	100	2	0	1	0	0	0	0	3	31	0	0	0	0	0	0	0	4	1	6	12	0	913	11	0	0	0	81	0	0	0	0	6	1	0	1	175	2	3	6	0	1	250	0	0	0	1	4	0	7	0	2	21	0	0	1	3	0	33	9	6	0	10	17	0	0	0	27	1	2	0	10	0	1	2	3	16	5	0	2	0	8	0	6	3	0	1	3	6	8	10	8	6	3	11	1	0	12	0	1	10	1	0	0	0	2	0	0	8	9	0	0	12	4	2	6	0	0	0	14	0	2	0	0	0	0	1	0	1	3	0	0	0	0	0	6	0	0	0	0	0	1	0	4	5	0	10	2	0	0	0	0	9	20	5	11	1	0	43	0	0	88	7	8	3	17	0	0	105	105	0	29	37	7	30	0	16	41	5	0	0	11	0	22	10	7	3	2	3	0	0	7	2	10	0	0	34	38	22	9	0	0	0	0	0	0	55	0	1	2	0	2	0	0	0	0	1	7	0	68	10	21	8	11	0	9	8	3	0	0	0	0	2	5	0	13	0	15	0	5	0	0	26	5	2	36	5	241	63	1	0	0	45	7	36	65	34	21	7	16	265	0	13	63	0	0	0	0	0	25	5	0	255	30	10	0	19	0	1	0	0	26	0	0	0	8	0	1	0	60	128	0	0	0	17	45	30	22	2	19	2	19	11	0	1	100	0	0	21	2	39	0	3	0	182	0	0	0	15	5	0	0	0	0	0	1	0	0	0	0	0	0	1	2	46	1	0	0	0	26	23	2	0	0	0	3	4	2	1	0	1	3	2	8	0	43	0	6	4	0	1	3	15	2	62	17	1	0	51	4	13	6	15	43	15	0	5	8	138	14	51	43	1	0	0	0	0	0	0	1	0	0	0	0	2	0	0	0	2	0	0	0	8	0	2	3	12	14	11	0	1	5	0	3	0	0	0	0	6	0	0	12	3	0	3	14	74	0	200	0	4	0	1	0	0	4	3	0	0	0	1	3	5	0	0	0	0	0	0	0	0	0	0	7	0	1	0	1	3	5	3	0	0	11	0	12	1	0	1	0	0	8	0	0	0	0	0	4	0	0	0	1	3	1	9	8	5	2	0	17	17	28	1	9	0	1055	0	425	506	0	2	0	1	3	0	0	1	3	689	64	19	28	10	2	42	6	3	27	11	3	4	2	5	18	0	2	3	20	0	9	2	4	0	3	4	0	0	0	0	0	1	0	16	0	0	0	0	0	0	2	0	0	0	0	0	0	0	0	1	2	3	1	0	0	0	0	1	5	0	1	8	2	8	18	0	18	8	8	11	26	33	0	0	0	2	0	0	3	0	3	2	0	0	30	22	2	0	0	2	1	12	23	12	1	19	0	0	1	0	1	0	1	0	0	0	0	0	0	0	9	2	3	0	31	1	7	4	0	4	1	0	1	0	1	8	17	3	0	0	3	15	0	5	3	1	14	3	0	5	0	23	8	0	0	0	0	0	0	0	2	5	1	0	0	118	5	8	3	2	2	10	0	0	0	0	1	0	0	0	0	2	20	17	0	44	20	0	1	0	1	0	6	0	0	16	0	5	3	2	1
LakWasMet37_LOW7_2_rpkm	0	0	0	0	0	14	22	2	0	0	2	2	2	0	0	0	0	0	9	0	0	0	0	27	2	0	0	0	0	10	0	8	0	5	0	3	3	0	0	0	0	0	0	2	23	43	67	8	0	6	0	12	0	0	0	2	2	18	48	20	52	0	0	0	0	0	0	0	10	66	0	1	0	0	0	0	0	0	0	0	0	8	0	0	0	0	0	0	0	0	0	0	23	1	19	0	0	0	0	0	0	0	0	0	0	0	0	0	0	0	0	0	107	2	20	0	0	0	0	0	0	0	0	1	0	0	0	0	0	0	0	30	8	0	1	0	0	0	15	0	0	0	0	1	0	1	0	0	3	1	2	10	3	3	18	0	2	17	15	0	9	1	0	1	9	1	0	2	0	3	0	0	0	0	0	0	0	0	0	0	0	0	0	0	0	1	0	0	0	4	0	4	8	10	0	0	1	16	24	62	23	0	6	0	0	0	21	0	15	2	9	6	53	16	20	0	1	0	0	3	2	6	6	0	1	4	0	1	5	0	0	0	4	0	1	0	7	9	22	3	0	0	23	5	32	6	0	0	5	18	2	4	14	0	837	128	0	0	0	0	1	1	0	16	7	0	0	3	2	54	30	0	0	0	0	0	0	0	34	11	0	52	12	98	52	0	0	0	8	0	0	0	0	0	0	0	0	2	3	0	0	10	38	0	10	0	26	20	15	0	10	0	46	7	0	0	0	0	1	0	0	0	0	0	19	71	2	0	5	0	0	0	0	0	0	1	1	0	0	0	0	0	40	11	6	3	22	0	0	0	1	0	3	0	1	0	0	0	0	31	8	0	6	0	0	12	3	32	6	4	0	27	0	0	5	2	0	4	0	0	0	0	2	3	1	0	40	0	1	0	0	1	206	1	0	0	14	0	0	61	0	15	0	1	45	0	11	0	0	0	0	22	18	0	1	30	43	3	2	0	0	0	0	0	0	0	0	0	0	0	2	0	0	1	0	0	0	0	13	0	50	4	0	0	0	32	0	0	0	0	1	84	10	96	0	16	17	3	0	3	1	0	1	6	3	34	9	0	0	1	11	16	15	0	0	0	4	1	38	0	7	0	1	0	0	0	0	26	35	5	0	0	91	46	1	0	0	0	0	0	0	1	2	1	0	0	0	0	0	1	0	0	0	0	1	0	0	0	0	0	0	0	0	0	0	0	0	0	0	2	0	0	0	2	20	0	17	0	0	27	0	6	0	17	12	1	0	0	2	0	1	0	0	0	1	7	0	0	0	0	1	0	0	0	15	0	8	0	19	0	0	0	0	0	8	6	7	46	0	25	21	88	23	5	40	0	2	0	8	0	0	0	4	0	7	2	0	0	3	0	17	1	0	0	4	7	0	59	0	11	0	100	30	153	0	0	48	0	71	1	42	29	69	5	0	2	0	8	0	0	2	9	0	0	0	0	0	0	0	1	0	134	0	0	0	0	0	5	2	0	17	0	1	9	0	0	0	0	0	2	2	43	0	39	0	0	0	1	4	9	4	15	0	0	2	0	2	0	0	0	2	0	25	0	0	0	2	0	0	12	0	0	6	0	0	0	0	1	0	1	0	1	0	1	0	0	1	0	27	0	1	0	0	0	3	4	0	1	2	2	1	1	1	5	1	0	5	0	6	0	0	1	0	0	0	0	0	0	0	8	0	21	4	0	11	19	6	0	0	12	0	0	0	0	0	7	0	0	23	1	0	7	0	14	0	0	1	0	0	0	0	0	0	0	0	36	0	0	0	0	0	0	1	0	0	0	5	0	0	5	2	1	0	0	0	0	8	0	0	11	0	0	0	0	42	0	18	0	0	3	0	0	0	0	0	0	6	0	0	0	0	0	0	9	11	0	0	3	0	0	0	0	0	0	0	0	0	16	22	0	0	0	0	0	0	0	0	4	83	3	0	0	12	1	0	0	0	1	0	8	17	4	0	0	0	0	0	0	1	1	0	0	0	0	0	0	1	0	3	12	0	0	0	0	0	6	1	0	0	0	0	0	0	1	1	0	0	1	0	0	0	0	0	0	0	1	0	1	0	0	0	0	0	1	25	23	77	12	14	0	0	0	0	0	0	2	0	0	0	0	3	0	0	0	0	0	0	0	0	13	0	0	1	10	9	0	6	6	0	0	0	0	0	0	0	0	0	0	0	0	0	0	1	0	1	3	0	0	0	0	0	2	6	25	10	46	12	0	1	0	45	17	11	0	34	0	0	1	0	0	0	0	0	0	0	0	0	2	3	0	0	0	0	0	3	0	0	0	0	0	0	0	0	0	0	0	0	63	0	0	0	51	5	0	3	2	0	0	4	24	0	0	0	0	0	0	0	0	24	0	0	1	0	0	0	0	0	7	0	0	1	0	0	1	3	0	1	0	0	0	0	1	0	2	0	0	0	0	5	5	31	0	1	0	1	0	6	0	5	18	0	2	0	0	0	0	0	0	0	12	1	0	0	0	1	0	0	0	0	0	0	0	0	0	0	15	28	0	1	12	0	1	0	0	7	0	0	1	1	0	1	6	0	0	0	0	7	17	6	0	1	0	0	0	0	13	1	0	0	0	0	0	0	3	1	0	0	0	0	0	0	0	0	0	5	0	1	0	0	11	0	1	0	0	0	0	0	0	0	0	17	5	0	0	0	0	0	5	0	0	0	0	7	0	1	0	1	0	0	0	0	0	9	12	158	67	2	0	0	17	0	0	0	10	0	1	4	0	0	0	1	0	3	0	0	0	0	6	0	0	0	0	6	0	0	0	0	0	13	1	0	0	0	0	1	0	0	0	99	0	1	1	294	5	0	0	0	0	0	0	2	0	0	130	123	0	0	1	4	0	9	0	0	53	0	0	0	0	0	0	0	1	17	5	1	5	6	10	0	31	2	0	0	3	0	5	0	0	3	0	0	1	0	0	0	2	0	0	3	4	1	0	4	0	0	1	0	2	0	9	0	2	0	0	0	0	0	0	0	0	0	0	9	0	0	0	0	0	0	0	0	0	0	31	5	0	76	19	34	9	0	0	9	0	0	0	0	2	2	4	0	2	1	0	0	0	9	7	0	2	0	0	3	1	24	0	6	0	0	11	0	0	15	14	5	1	5	1	1	1	0	0	2	0	33	0	9	13	3	62	11	9	25	0	0	1	29	19	0	0	0	0	0	16	4	0	9	0	0	1	0	5	16	8	0	0	21	0	0	0	0	0	2	5	5	0	0	0	8	2	10	27	2	1	15	0	1	5	2	0	0	0	1	8	12	4	0	0	0	0	0	0	1	1224	33	6	26	1	2	0	0	0	0	0	1	37	2	0	1	9	1	0	0	0	69	27	47	4	0	0	0	117	0	0	0	0	1	0	0	0	131	14	21	17	51	11	0	10	57	19	0	0	0	0	0	0	31	1	0	0	0	31	0	11	1	0	0	0	0	6	0	1	0	0	0	0	8	0	0	0	0	0	0	1	4	8	0	0	0	0	0	7	0	0	0	0	0	0	1	0	0	0	4	0	0	0	0	0	0	2	0	0	0	2	0	0	0	0	0	0	0	0	1	0	0	0	1	0	0	0	0	0	0	0	1	1	0	86	0	0	18	0	1	0	1	259	0	28	7	0	0	80	0	30	0	1	1	0	1	0	21	0	8	0	0	1	0	0	0	0	0	2	18	0	0	0	4	0	0	0	0	0	1	0	0	0	0	0	0	105	3	6	0	0	1	9	0	0	0	37	1	0	0	0	2	0	0	0	1	1	1	0	2	12	13	0	5	3	0	0	0	5	1	4	5	4	1	0	9	0	0	0	0	1	0	0	5	0	51	4	48	43	67	11	55	3	0	0	0	1	3	19	0	1	4	3	79	0	0	0	4	2	1	0	0	11	47	0	31	8	0	2	0	2	1	0	10	0	381	5	17	0	0	0	0	1	0	63	0	24	39	0	0	0	20	2	0	44	1	21	5	0	6	8	0	10	18	96	24	28	0	3	1	15	5	6	0	0	2	6	14	0	39	0	0	1	0	0	0	3	3	1	6	6	0	0	0	0	0	0	0	39	0	0	1	0	0	0	2	0	0	0	6	0	52	66	0	3	16	5	0	1322	3	0	2	0	0	0	0	0	0	0	0	0	0	1	0	0	0	56	1	0	0	0	0	0	0	1	0	20	0	0	0	1	1	5	0	0	0	0	4	0	1	7	5	0	21	0	0	0	1	0	0	0	19	0	0	20	3	0	0	1	130	74	1	5	0	40	109	0	9	2	48	0	14	5	6	7	14	2	0	6	0	0	0	0	1	1	0	0	0	0	1	0	0	0	20	0	0	7	0	7	193	0	0	0	0	0	0	0	0	0	0	0	0	0	4	0	0	0	24	7	17	0	1	0	2	0	0	0	0	0	0	0	1	0	0	0	0	0	0	0	0	0	0	0	0	0	1	3	0	0	2	0	0	0	3	0	0	0	0	0	52	0	2	0	0	1	1	0	4	1	5	6	60	8	0	0	0	0	0	0	0	0	0	8	0	1	5	1	1	0	0	1	0	0	0	0	0	0	0	0	1	0	6	1	12	4	0	19	1	0	0	0	14	20	47	1	0	0	0	0	0	0	0	0	0	0	0	0	2	0	0	2	1	0	0	1	0	0	0	0	0	0	2	0	0	0	0	0	0	0	3	26	10	0	0	0	0	0	0	0	4	0	0	2	3	0	0	0	3	5	0	0	1	0	0	50	53	0	0	3	2	0	0	30	1	2	0	0	0	0	0	0	0	1	0	39	0	0	0	0	0	16	0	0	0	15	0	31	27	24	1	0	0	0	0	0	18	0	65	4	0	0	0	0	0	3	0	4	0	0	0	0	1	0	0	0	1	2	0	2	0	0	0	0	0	0	0	0	0	0	3	58	0	0	0	0	0	0	0	0	0	0	0	0	1	0	0	0	5	0	2	2	1	1	3	0	0	7	0	0	0	437	0	4	27	100	4	4	2	0	13	4	0	0	0	0	0	2	75	0	0	0	0	0	0	0	0	0	7	0	13	0	0	0	0	9	0	0	21	0	5	0	0	0	0	0	2	12	0	0	0	0	1	1	1	0	0	0	0	1	0	0	10	1	0	4	3	0	0	0	4	10	0	0	5	0	0	1	0	0	7	1	0	0	0	0	72	0	0	0	0	0	0	1	0	2	0	0	0	0	0	0	0	0	0	0	1	0	0	0	0	0	0	0	0	0	0	0	1	0	0	0	0	0	0	3	0	0	1	0	1	0	6	0	21	0	24	0	1	0	0	0	0	1	2	0	0	0	0	0	27	69	45	90	156	34	120	120	3	60	30	48	79	34	13	34	5	116	134	2	24	4	401	174	183	151	270	42	49	21	80	4	39	10	0	0	0	0	0	0	0	0	1	0	15	83	0	0	1	0	0	0	0	0	1	0	0	0	1	0	0	3	0	0	0	0	10	0	2	0	3	2	0	0	1	0	181	0	5	1	0	1	0	0	0	0	1	0	1	0	0	15	0	0	0	0	4	4	0	13	7	0	0	6	0	0	0	5	0	0	0	0	0	0	0	1	81	0	0	4	0	2	0	1	0	0	0	0	0	0	1	6	0	0	0	0	1	0	4	0	0	1	0	0	0	0	0	0	0	3	1	79	0	0	4	3	0	0	0	0	0	0	0	0	0	0	0	0	0	3	3	1	0	0	3	0	1	0	2	7	9	2	2	5	1	1	5	1	1	54	2	1	0	0	0	0	0	0	0	0	5	0	9	7	1	0	0	0	2	0	0	0	1	0	0	0	1	0	0	0	0	10	0	1	0	0	4	0	0	0	0	0	1	0	1	0	0	7	0	2	0	967	1	0	0	1	0	0	0	1	0	0	0	0	0	1	0	1	10	0	20	19	0	0	0	0	10	0	0	58	8	0	1	3	0	21	1	1	0	1	1	0	0	0	0	0	0	5	0	0	0	0	0	0	0	0	2	0	0	0	7	0	0	0	0	0	0	0	0	0	1	0	0	0	0	0	0	0	12	0	1	0	0	9	0	1	59	176	3	1	1	0	0	0	0	0	0	0	0	0	0	0	0	0	0	0	36	1	1	2	0	0	1	9	0	0	0	0	20	19	1	0	0	0	58	0	0	0	0	0	0	0	0	0	0	0	0	0	87	10	0	0	0	0	0	0	0	1	0	1	20	3	4	1	0	1	0	0	12	3	0	4	0	0	0	0	0	0	0	0	1	0	0	0	703	0	0	0	0	1	0	1	0	0	0	0	0	0	0	0	0	0	0	1	0	0	0	1	0	0	0	0	0	6	1	0	0	0	0	0	0	0	4	0	66	1	1	14	0	1	0	0	1	0	6	0	1	28	0	12	2	0	0	0	0	0	0	0	0	8	0	0	0	0	0	0	40	0	0	6	66	4	0	9	16	4	0	5	0	11	0	13	1	11	0	11	4	22	7	2	1	5	1	6	0	9	0	0	0	4	0	18	0	62	41	25	32	25	10	7	1	0	11	6	3	0	42	1	0	0	0	48	0	32	0	0	0	0	17	9	0	0	0	0	0	0	4	0	0	0	0	1	7	0	0	0	0	31	0	0	0	0	0	0	0	0	10	0	0	8	1	1	3	0	0	0	3	0	0	0	0	0	0	0	0	2417	0	0	15	11	9	0	29	0	8	1	0	0	544	0	0	0	0	2	102	1	29	0	0	1	0	0	0	0	0	0	1	0	10	16	0	67	0	2	0	1	0	25	10	2	0	0	0	2	0	1	0	1	4	0	3	0	0	0	34	0	0	0	67	13	0	0	0	0	0	0	1361	252	239	2	0	0	0	0	0	0	1	8	0	0	0	1	0	3	14	312	49	0	0	0	0	0	0	0	268	0	2	2	0	0	0	0	0	4	0	0	0	0	0	0	0	0	0	0	1	0	50	152	1	1	0	0	0	0	0	5	5	0	0	0	0	0	51	6	0	0	0	0	0	0	0	14	0	1	0	0	0	3	1	0	6	0	0	2	1	3	0	0	0	0	0	0	0	979	1	0	2	1	1	0	0	0	0	0	0	0	0	0	0	1	0	17	0	0	0	0	0	0	0	0	0	0	0	0	0	0	0	0	0	0	0	0	0	0	0	3	1	0	18	0	0	0	0	0	0	0	0	0	0	0	0	0	0	84	0	0	0	0	0	0	44	0	0	0	0	0	0	71	0	0	0	0	0	7	6	13	4	1	4	0	0	11	0	0	77	0	0	3	1	0	0	1	0	0	0	1	13	1	0	2	0	0	0	0	0	0	0	0	0	43	1	0	0	0	0	0	0	0	2	0	11	0	0	0	0	0	1	0	0	2	0	0	0	0	1	20	0	1	0	8	45	5	20	10	0	0	0	0	0	0	1	0	6	1	0	1	0	7	0	13	0	0	0	0	0	1	0	1	0	59	0	9	10	6	0	10	0	4	0	0	0	0	3	0	0	0	0	0	0	9	0	3	15	0	19	0	7	400	5	0	0	0	0	1	0	1	1	33	0	0	0	0	0	0	1212	494	0	19	0	0	0	1	0	0	1	1	0	0	0	0	0	0	0	6	21	3	0	0	0	0	0	0	0	2	27	3	15	0	0	0	0	0	0	2	7	6	0	0	0	0	15	0	0	0	1	0	5	0	1732	6	0	11	24	1	0	0	36	0	1	0	22	0	2	2	2	0	0	0	47	0	0	1	2	13	0	0	1	0	0	0	2	0	0	0	0	0	0	73	0	0	0	2	0	0	0	26	0	0	0	0	0	0	0	0	0	0	0	0	0	0	0	0	0	1	4	4	0	3	0	0	0	0	17	0	0	0	0	0	1	0	1	0	3	8	7	0	0	0	2	17	0	8	1	0	1	0	0	0	0	0	0	0	0	1	1	1	0	0	0	0	0	0	1	0	0	0	0	0	0	0	0	0	1	0	0	0	0	0	1	0	2	1	0	0	18	0	0	1	5	0	5	15	0	0	0	0	0	0	0	0	0	0	1	2	0	0	0	0	0	3	0	0	0	36	0	0	0	0	14	1	1	0	15	0	0	0	0	0	2	0	0	26	0	1	0	0	21	0	1	0	0	26	1	0	0	39	2	0	0	0	0	0	0	1	0	0	0	0	1	0	0	15	0	0	0	0	1	0	1	1	16	0	0	0	0	0	0	0	0	0	0	0	0	0	73	0	0	0	0	0	0	0	0	2	0	21	0	0	0	0	0	2	0	0	0	0	0	0	0	0	0	4	0	0	0	0	0	1	0	0	0	0	0	0	0	0	0	0	0	0	1	1	0	1	0	0	0	2	0	0	0	0	0	0	2	6	0	0	0	0	0	0	0	0	0	1	0	0	0	1	0	0	0	0	0	0	0	0	0	0	0	0	0	0	0	0	0	0	1	1	0	0	0	0	1	0	0	3	0	0	0	0	1	0	0	0	0	0	0	0	0	0	0	0	132	0	0	16	0	0	1	1	0	29	0	0	12	0	0	1	0	0	0	1	0	0	1	0	1	11	0	65	62	5	2	0	11	27	0	0	0	0	0	3	3	2	0	0	0	0	2	0	1	0	0	0	0	0	0	0	0	0	0	17	0	0	1	0	0	0	1	0	0	0	0	0	0	0	0	0	0	0	0	0	0	0	0	170	0	69	6	0	0	0	0	0	0	0	0	0	72	0	0	0	0	0	0	0	0	0	0	0	0	2	0	6	0	0	0	0	0	0	0	0	0	13	0	0	0	0	15	0	0	0	0	0	0	0	0	18	0	0	0	0	0	0	0	0	0	0	0	0	0	0	46	10	0	0	0	0	87	0	3	89	0	0	0	0	0	0	0	1	0	0	0	0	0	0	0	0	0	1	0	0	0	0	2	0	0	0	0	0	2	19	0	0	0	0	0	0	0	0	0	2	0	0	0	0	1	0	0	0	0	0	0	1	0	0	0	0	12	0	0	0	1	0	0	0	0	0	0	0	0	0	0	0	2	0	0	1	0	0	8	0	2	0	3	0	0	0	7	0	0	0	0	0	0	0	0	5	0	0	0	5	16	0	4	0	1	0	0	1	0	0	5	0	2	0	0	0	0	0	0	0	10	0	0	0	2	0	0	0	1	0	1	0	0	31	0	0	0	0	0	0	0	0	0	2	2	2	4	0	2	3	0	0	0	16	0	0	31	0	0	0	0	0	0	0	0	1	0	0	0	2	0	0	0	0	0	0	0	0	0	0	29	0	3	1	0	0	1	0	0	0	0	0	11	0	0	0	0	2	0	0	0	0	34	2	5	1	0	1	0	0	0	0	0	0	0	6	1	0	0	56	12	0	329	520	1	0	2	0	153	0	16	26	4	0	1	0	13	109	0	45	0	8	32	0	177	0	4	0	0	1	0	0	5	7	2	9	0	0	11	0	18	15	12	0	0	1	0	3	0	8	1	0	6	3	0	1	0	0	0	1	0	9	3	0	0	0	0	11	1	0	5	0	1	0	0	0	0	0	0	0	0	4	0	0	1	5	1	24	9	23	1	0	0	2	2	21	1	0	0	0	0	0	0	0	0	0	22	124	0	0	0	0	0	0	0	1	1	0	0	0	0	0	0	4	19	0	1	0	1	0	0	8	0	0	0	1	0	0	0	0	0	0	0	5	5	0	1	0	0	3	0	0	0	1	1	3	0	0	0	0	0	0	28	0	0	10	0	14	4	0	0	0	1	0	5	3	0	0	3	0	0	0	0	28	0	0	0	22	116	183	0	9	12	26	143	1	51	28	12	8	54	140	70	0	70	14	99	30	26	1	162	8	78	0	40	0	1	0	25	0	0	0	0	0	1	0	0	1	2	1	2	0	0	0	0	0	13	0	0	41	2	0	1	0	0	0	0	11	0	6	4	1	0	0	0	0	0	26	0	0	0	0	0	0	0	50	2	0	0	0	8	0	1	6	1	8	2	41	0	0	0	0	2	0	12	195	4	33	1	153	0	0	0	0	0	0	3	0	0	0	0	0	0	0	1	10	1	0	0	0	10	0	0	0	0	37	0	0	5	0	8	0	0	0	0	0	0	4	0	0	0	12	0	0	0	0	0	4	0	6	1	0	0	0	0	0	0	0	0	0	0	0	0	13	0	1	59	2	0	0	0	0	0	0	55	0	0	0	0	6	0	0	0	0	7	0	0	61	4	3	3	0	1	0	1	0	0	0	0	1	0	0	4	0	0	0	0	0	0	0	0	0	0	43	0	0	0	3	0	0	0	0	0	0	0	3	40	0	0	0	0	2	2	1	0	7	6	0	0	25	23	12	0	0	1	0	21	1	0	0	0	1	0	0	0	0	0	0	0	0	0	26	1	2	0	41	0	0	0	0	1	0	0	2	5	0	0	2	0	0	0	0	0	0	0	33	0	5	1	0	1	1	29	1	0	0	0	0	0	0	2	0	6	3	0	36	0	0	3	1	12	0	0	27	1	0	0	0	18	0	4	0	0	0	0	0	0	4	0	17	0	0	0	0	0	0	0	0	3	1	0	1	10	0	2	0	0	7	1	2	0	0	52	0	0	0	0	0	0	7	2	0	0	0	0	0	11	1	0	1	0	0	1	1	0	3	1	0	6	0	0	0	0	0	0	0	39	2	6	0	0	0	0	0	25	0	0	0	0	0	0	0	0	0	0	0	0	1	0	3	0	0	13	1	0	0	0	0	0	1	0	0	0	2	0	0	0	0	0	2	3	2	0	0	0	84	28	20	6	0	0	0	0	0	0	0	0	2	0	0	65	9	0	4	0	0	0	10	0	1	4	4	16	2	18	14	2	1	0	0	0	0	9	0	2	2	0	1	0	0	0	0	0	0	0	28	13	0	52	7	6	1	0	0	0	0	49	0	2	0	0	0	0	5	0	0	0	1	0	0	0	0	1	0	0	1	3	0	0	0	7	0	0	56	17	0	0	3	0	9	8	5	1	0	0	2	0	0	18	2	0	0	0	0	0	2461	0	38	0	0	0	3	0	1	15	3	0	1	0	0	0	0	0	0	0	0	40	2	1	1	0	0	0	2	0	1	0	0	0	0	0	1	0	0	1	1	0	0	0	5	1	0	0	107	0	0	0	11	0	0	0	0	0	0	0	0	0	0	17	1	4	0	0	0	1	0	0	1	0	73	9	0	16	0	26	0	8	0	0	0	0	8	0	0	0	0	0	0	0	0	20	8	0	3	0	0	0	3	157	0	1	0	20	0	2	0	0	32	0	0	0	5	0	42	3	0	0	0	0	0	25	0	0	1	0	0	0	73	0	0	0	0	0	0	0	250	3	0	0	0	0	5	0	0	1	0	0	0	1	0	0	0	0	9	0	0	0	0	0	0	0	0	0	0	0	4	0	0	3	0	0	0	0	0	0	0	1	0	0	0	0	0	0	0	0	0	0	1	66	0	0	1	0	0	0	0	1	3	0	0	18	0	0	0	0	0	0	0	0	0	5	0	0	0	0	0	0	1	0	0	0	3	0	0	0	0	0	1	0	84	0	0	0	0	0	5	0	6	0	0	1	3	2	0	1	8	1	0	0	1	0	0	0	2	0	0	9	0	2	14	0	0	0	0	0	1	0	0	0	0	10	0	0	0	1	0	0	0	5	0	0	26	0	0	0	0	1	0	0	0	2	0	1	0	1	0	1	3	0	6	34	0	0	0	2	0	1	0	1	0	1	0	0	0	0	0	0	0	0	0	0	0	365	0	0	0	4	1	0	0	0	0	4	0	0	17	1	0	0	0	0	3	3	0	0	0	1	81	1	2	0	0	0	0	0	0	0	1	0	0	1	1	0	0	0	1	4	0	0	0	0	0	8	47	0	0	0	0	0	1	0	6	8	0	0	0	0	3	0	11	0	1	0	5	0	0	0	0	0	0	0	5	5	0	0	0	0	0	0	0	79	6	24	2	0	1	0	0	0	0	8	0	1	0	1	26	27	19	53	0	12	13	0	22	0	1	0	21	37	0	35	0	0	0	1	5	0	0	0	68	12	1	3	62	571	0	0	0	2	6	7	0	0	1	6	0	0	13	1	18	0	0	0	0	0	0	0	191	1	0	2	0	0	0	0	0	14	0	3	1	5	0	22	6	14	4	0	25	0	0	0	1	14	1	0	0	0	1	0	2	2	0	0	0	0	3	2	30	1	2	0	0	0	52	23	2	0	2	0	143	0	0	0	10	4	2	5	0	0	0	0	0	0	0	0	0	0	0	0	0	0	15	1	27	0	0	0	0	0	0	0	0	0	0	1	0	0	0	0	1	0	0	0	0	0	0	0	1	0	0	0	0	0	0	0	0	0	2	3	0	0	2	0	0	0	0	0	0	1	0	0	2	0	3	0	0	1	0	0	4	1	54	10	2	0	1	1	0	1	0	0	0	0	5	85	0	0	0	0	0	1	2	3	0	2	0	2	0	0	1	0	0	0	3	3	0	0	0	0	0	0	2	0	0	0	0	0	0	0	0	4	0	0	0	16	0	0	13	6	0	0	0	0	0	0	10	0	2	1	21	52	0	0	0	0	0	4	1	0	0	12	6	38	45	0	23	0	0	0	8	0	44	0	1	0	86	0	10	0	1	0	1	0	1	0	0	52	1	10	17	0	23	0	0	0	0	13	0	0	12	0	0	28	31	34	3	21	2	0	0	0	33	0	2	2	0	0	1	1	8	1	0	0	0	0	6	0	0	3	0	0	0	0	11	0	0	0	20	0	6	1	0	23	2	0	0	0	26	0	34	2	3	6	20	3	0	43	8	50	6	57	7	0	0	0	0	8	0	0	2	1	0	1	1	2	0	0	0	0	3	28	4	1	0	58	10	26	0	170	0	3	0	0	1	0	0	0	0	0	0	0	0	0	0	0	2	0	0	18	18	1	0	4	1	0	0	0	0	0	1	1	46	0	0	0	0	0	2	2	0	2	0	0	36	0	0	0	0	7	0	292	45	29	6	2	0	47	0	0	0	66	9	0	0	0	0	1	0	0	26	0	0	0	64	2	5	1	0	0	7	0	0	6	24	0	16	0	1	3	1	0	0	0	0	31	33	53	0	0	4	3	2	1	3	1	0	1	0	0	16	9	0	0	1	4	0	24	72	27	0	1	9	74	0	0	0	0	0	0	2	0	0	0	0	0	21	14	5	0	0	0	54	7	7	0	0	0	0	0	20	16	0	8	5	0	3	0	247	0	15	12	27	18	5	7	0	2	95	72	0	7	0	2	0	13	10	2	0	1	0	0	0	0	0	0	1	0	1	0	0	0	0	2	11	7	194	267	15	4	0	5	0	18	37	13	0	0	17	0	0	0	0	0	0	0	0	0	1	0	0	0	0	0	1	0	0	9	0	0	0	0	0	0	5	1	21	1	2	40	0	54	1	10	7	10	14	13	22	0	0	0	0	73	59	7	0	0	1	2	6	4	0	2	1	0	0	3	8	0	0	0	0	0	0	0	37	20	0	0	0	0	0	1	0	0	2	0	0	0	0	0	12	1	1	3	128	3	0	0	0	0	0	12	0	5874	0	4	0	3	14	34	0	0	0	0	0	0	0	0	0	15	2	4	0	0	0	0	0	0	1	1	1	0	0	41	0	0	0	0	1	0	2	0	0	1	28	2	0	0	0	0	0	0	0	0	4	1	0	0	0	0	0	0	0	0	0	0	0	0	0	0	1	17	0	23	1	0	11	0	0	1	0	4	33	0	0	1	0	0	0	0	1	35	0	0	1	1	0	0	1	0	0	0	0	300	3	0	14	105	0	0	0	0	16	0	47	23	48	5	0	0	0	0	3	0	2	57	4	0	0	0	104	0	0	0	1	2	0	0	0	0	0	0	2	0	1154	7	35	0	3	487	0	5	36	9	9	1	352	230	227	119	34	17	7	0	5	128	48	33	12	6	0	0	1	1676	1	1	41	1	1	77	10	0	0	217	2	0	1	0	0	0	0	44	0	0	1	11	29	38	28	15	10	9	6	20	0	6	0	33	5	7	17	0	0	0	0	0	0	0	0	0	0	13	0	0	5	1	21	1	1	17	0	0	0	0	0	2	1	0	0	6	0	0	15	18	0	0	0	0	0	46	0	0	0	3	4	7	17	0	28	5	0	0	19	25	131	0	0	3	9	16	1	4	10	0	5	0	10	0	0	23	0	0	1	3	10	63	6	0	14	2	30	14	0	0	23	5	0	0	41	1	5	0	0	0	26	0	0	5	3	0	0	3	10	0	0	16	0	0	1	1	0	0	0	0	0	5	0	0	10	0	0	0	1	0	111	36	21	0	0	1	8	0	23	3	1	4	0	0	1	31	1	1	13	16	0	21	8	4	6	8	2	5	6	3	1	5	1	9	10	103	35	17	1	0	0	0	1	0	0	1	0	2	1	2	2	0	0	0	0	0	2	61	13	0	5	0	0	0	0	0	0	7	9	0	0	0	0	0	0	0	2	0	0	0	0	0	0	0	0	0	0	2	0	0	4	0	0	0	31	11	0	1	0	8	1	0	0	0	0	0	0	0	12	0	0	0	1	0	0	0	6	0	2	1	5	8	2	2	0	0	0	0	0	1	0	0	1	134	1	0	43	0	0	0	31	13	8	0	0	1	0	0	8	0	20	3	28	20	0	0	0	0	0	0	0	0	0	0	12	22	48	12	22	2	10	16	4	7	0	28	10	6	5	45	74	47	24	39	7	7	9	6	0	6	0	0	7	4	3	4	15	55	10	28	72	3	25	4	20	14	9	30	4	13	15	2	16	0	0	0	0	94	8	0	3	9	39	53	1	5	181	588	261	348	0	34	11	0	0	0	0	6	13	1	31	0	3	0	554	113	103	0	0	11	0	0	0	0	1	156	15	112	45	60	15	138	10	13	164	0	22	0	43	8	0	0	0	0	0	24	8	5	10	7	6	3	1	5	21	43	12	0	0	0	1	1	1	4	5	0	0	0	0	0	0	0	5	3	0	1	0	0	10	3	0	1	0	0	0	0	0	0	6	0	0	0	0	0	0	0	0	3	1	1	0	0	0	0	0	1	0	1	1	0	0	0	16	12	0	5	17	0	0	1	0	0	0	1	0	0	0	0	0	1	0	0	0	0	0	0	11	0	0	0	0	0	9	0	0	0	0	1	0	0	0	0	0	0	0	1	0	0	0	13	0	0	0	0	4	0	107	2	12	44	0	37	0	41	0	1	0	0	0	0	0	0	0	1	0	0	0	41	5	27	4	1	0	0	0	0	0	0	0	2	11	2	0	14	0	12	0	0	47	44	0	0	0	16	0	0	16	21	27	10	10	0	0	4	0	0	29	2	45	0	0	0	18	15	2	1	3	14	1	51	13	0	0	45	15	4	1	66	99	8	1	1	0	0	7	0	13	15	0	2	0	0	0	0	7	0	1	1	0	0	0	0	22	0	0	23	1	0	0	0	0	0	7	0	0	0	59	0	0	0	0	0	0	0	0	0	55	10	2	0	1	20	0	8	0	0	6	1	6	0	0	1	0	0	1	0	1	0	0	0	2	0	0	11	2	4	0	0	0	0	0	0	1	0	0	5	32	6	0	0	47	0	0	0	0	0	1	0	0	0	2	1	68	12	6	0	0	12	0	1	3	1	0	1	0	0	0	0	0	0	1	2	1	1	1	0	0	0	0	1	30	0	0	0	0	0	0	0	2	0	3	9	5	0	0	0	0	0	0	0	6	1	1	0	1	6	0	0	1	0	18	16	0	0	30	16	7	0	1	30	0	13	2	5	164	0	0	10	0	1	0	0	0	0	0	0	0	59	15	0	15	2	27	3	0	183	0	40	0	0	0	0	0	3	0	0	0	0	0	0	0	1	0	0	0	0	0	0	0	1	0	1	0	6	0	1	4	6	0	0	0	0	49	5	2	0	0	0	63	45	0	4	0	0	1	0	21147	0	0	0	0	0	7	0	0	0	0	0	0	0	0	0	0	7	0	0	0	0	22	8	41	18	1	5	12	2	0	0	0	0	0	0	1	0	22	35	0	36	8	0	0	0	0	1	1	0	3	0	0	3	0	3	5	7	29	113	9	6	18	0	12	1	0	5	1	0	53	2	7	8	0	0	0	0	1	2	0	117	152	15	3	7	0	0	0	0	63	0	0	2	0	49	9	0	46	0	0	0	77	49	0	0	60	16	0	3	0	1	0	0	0	0	0	0	0	23	46	63	50	117	0	10	32	1	68	41	36	108	299	56	39	47	34	49	10	0	21	36	11	0	9	0	0	0	92	38	107	89	43	0	10	0	0	42	36	6	8	3	0	0	0	0	0	0	0	0	0	0	0	0	3	0	2	0	3	1	0	0	1	0	0	0	0	17	24	15	8	0	2	2	7	0	0	1	7	0	6	1	3	2	17	4	20	12	0	3	0	0	0	25	8	0	0	0	0	0	0	0	0	0	0	0	0	0	2	31	0	1	0	17	5	1	0	2	0	0	0	0	0	1	2	9	0	15	0	0	0	37	22	0	0	3	0	36	1	0	4	1	0	8	1	0	0	1	0	0	0	0	0	1	0	0	0	0	0	0	0	0	5	0	4	0	0	0	0	0	0	0	0	0	0	7	0	0	0	0	0	0	0	0	0	0	0	0	1	0	1	0	2	14	0	1	2	0	0	0	0	1	2	0	0	0	27	14	39	0	104	0	0	0	65	17	52	8	4	0	0	1	0	19	0	0	9	1	9	5	6	2	0	0	0	0	0	0	0	0	2	0	10	0	4	13	43	0	0	0	0	672	1269	0	1	1	2	0	0	0	25	8	50	10	0	18	0	33	21	4	5	0	2	0	39	46	9	31	4	17	0	0	10	1	24	8	9	0	0	0	0	0	0	12	0	2	51	15	2	0	0	0	5	8	0	1	0	1	0	1	0	0	0	2	0	0	16	6	7	0	1	0	2	1	1	0	1	1	0	12	11	0	0	0	0	0	0	0	56	204	30	30	67	13	40	0	27	0	5	9	3	12	0	0	6	0	2	0	0	3	0	0	0	1	16	2	0	1	0	0	0	1	0	2	2	6	0	3	0	4	6	2	1	0	23	0	0	0	0	0	1	0	0	133	0	12	0	0	0	1	2	0	6	2	9	0	0	2	0	0	0	0	0	0	0	3	84	0	0	0	0	0	2	6	0	0	0	3	1	1	0	2	0	1	1	1	0	0	0	0	0	0	1	0	0	0	0	6	0	0	29	0	13	5	42	138	8	21	0	0	0	0	0	0	0	0	0	1	0	0	0	0	0	0	0	107	0	0	0	1	0	0	7	0	0	0	0	0	0	0	0	0	115	0	0	1	16	1	20	2	0	3	3	3	2	18	3	1	7	24	3	2	47	7	13	18	188	211	27	72	0	0	31	0	0	3	1	8	6	0	1	0	0	0	0	536	0	0	0	0	103	0	0	0	0	3	65	3	95	0	1	0	4	2	0	1	0	0	0	0	1	2	2	0	0	0	0	113	33	0	0	0	0	0	0	0	0	32	0	0	0	0	0	0	29	11	0	0	0	0	7	0	2	0	62	12	0	46	8	0	0	0	0	0	0	7	3	11	3	0	0	2	0	0	6	0	0	3	0	16	3	0	0	3	71	12	2	1147	0	0	0	0	0	2	0	132	33	32	0	0	0	1	15	1	9	0	5	0	1	0	0	11	0	1	0	12	7	2	15	3	0	20	144	0	0	1	1	0	8	0	0	0	0	0	2	0	0	7	0	1	0	2	0	0	3	0	0	14	0	0	0	0	6	2	1	0	0	2	13	2	14	0	1	24	1	0	1	0	0	0	6	3	5	20	6	43	15	4	5	14	0	8	20	22	0	1	0	0	0	0	3	0	0	225	0	0	4	13	41	30	0	2	3	0	2	6	5	3	0	66	9	0	0	1	0	3	0	0	95	154	55	0	0	0	0	0	0	0	0	0	1	1	2	1	0	0	0	0	0	0	0	0	0	5	0	0	0	0	0	0	0	0	1	0	0	0	0	0	0	0	0	0	45	0	0	0	0	0	0	0	0	0	0	1	1	2	0	0	0	8	3	10	3	0	5	1	0	0	2	3	5	3	0	1	0	0	11	14	7	33	7	5	7	0	0	3	1	14	9	0	0	0	0	13	1	11	0	0	13	0	2	13	0	9	12	0	0	2	0	0	100	9	0	8	0	0	2	1	0	0	34	8	24	3	33	4	23	8	4	59	1	5	0	0	0	1	0	9	57	71	37	0	33	26	20	3	1	0	2	0	0	0	0	0	5	1	0	0	0	0	0	47	0	0	0	0	0	0	4	1	9	11	8	10	3	1	2	4	62	19	15	12	3	7	151	31	51	0	0	0	0	0	0	0	1	1	57	7	83	17	0	0	9	0	1	0	0	0	0	0	0	0	0	0	0	0	3	8	11	1	3	6	34	378	28	0	11	0	1	0	0	0	4	0	0	0	0	2	13	0	0	0	1	4	0	0	0	1	0	0	0	18	71	0	16	28	0	2	1	0	1	0	1	0	36	0	1	1964	0	0	0	25	0	36	0	3	0	1	5	0	2	0	0	0	0	7	0	0	0	0	0	14	0	0	0	0	0	0	0	1	0	1	1	0	1	1	0	0	0	0	2	0	15	0	29	412	0	20	38	10	75	31	73	12	0	3	0	13	0	0	0	0	0	0	0	0	0	0	0	6	0	0	0	0	14	5	0	0	1	1	0	2	0	0	0	0	7	0	0	0	0	0	0	1	0	0	10	3	0	0	0	0	0	0	0	0	0	3	1	0	0	6	0	12	11	19	5	29	0	0	0	0	0	0	0	0	78	0	89	0	1	2	25	0	31	61	0	0	0	0	0	0	0	0	0	5	0	0	0	0	0	0	0	1	0	0	0	0	0	0	0	0	0	4	0	0	0	0	0	1	0	0	357	0	0	0	0	0	0	0	0	0	1	0	0	0	0	0	0	0	0	1	0	0	1	0	0	0	2	0	0	0	0	0	0	0	0	108	0	0	2	0	0	0	30	0	0	0	1	0	0	1	0	0	2	0	0	1	0	0	0	0	0	5	0	0	0	0	0	0	0	0	12	0	0	0	0	0	0	0	0	0	0	0	0	0	0	1	0	0	0	0	0	0	1	0	98	0	0	0	0	27	1	0	0	0	0	0	0	0	0	0	0	3	3	0	0	3	0	0	0	0	0	0	0	0	44	0	0	0	0	0	0	0	0	0	0	0	0	13	0	0	0	0	0	0	0	1	0	0	0	0	0	0	0	0	0	0	0	0	0	1	3	1	0	0	24	0	1	0	0	0	0	0	3	1	1	2	0	1	85	0	13	8	0	0	0	6	0	7	0	0	3	11	1	2	1	0	218	4	20	0	0	1	0	0	2	0	0	3	1	0	0	2	6	0	1	4	0	0	0	0	8	0	11	1	8	0	2	0	8	0	6	0	15	2	0	1	1	0	1	1	2	81	4	1	1	2	0	0	0	0	3	2	3	18	0	3	0	1	12	18	1	0	0	0	10	8	16	3	3	0	1	1	3	3	0	3	0	2	15	0	0	48	0	0	2	0	2	0	28	0	4	10	3	0	1	1	1	3	6	7	2	2	0	3	0	10	11	4	19	11	25	10	4	20	133	24	7	0	2	3	66	0	3	0	1	0	2	0	0	0	0	4	0	0	0	0	0	1	0	1	0	29	9	12	0	0	0	0	3	40	0	137	0	38	17	1	0	0	14	2	0	0	0	0	0	0	3	0	0	0	15	0	9	0	0	7	0	0	0	3	0	0	0	0	1	0	0	0	2	0	0	0	1	0	1	0	0	1	1	7	0	0	0	0	0	0	0	0	1	0	2	23	0	0	0	3	0	6	0	0	0	3	0	0	0	0	0	8	0	8	0	0	0	0	0	0	0	8	0	0	1	0	1	0	0	0	1	1	44	0	1	0	0	0	0	0	0	0	0	71	0	9	1	0	0	0	0	0	0	0	0	1	0	1	0	0	1	0	0	1	0	0	50	41	1	43	38	0	0	0	0	0	0	1	0	1205	1	3	2	18	0	0	1	0	3	6	4	0	0	2	4	0	0	1	0	0	8	3	3	78	0	25	15	17	1	0	0	0	0	0	1	1	0	0	0	0	16	0	0	0	6	3	0	1	4	44	0	0	4	0	0	0	0	0	0	17	4	9	14	32	33	0	20	36	6	0	32	8	4	29	0	0	15	5	0	1	0	0	0	0	20	8	0	0	0	0	46	8	1	0	0	7	0	0	0	0	0	2	0	0	12	40	9	0	0	56	0	0	0	0	0	0	1	3	6	0	3	0	20	1	1	6	0	5	0	46	0	0	0	3	8	0	28	0	8	0	2	18	6	11	5	0	1	7	0	5	1	88	21	1	0	0	0	1	0	0	0	0	1	0	0	0	0	0	0	6	49	3	0	0	0	0	7	7	45	0	2	0	1	1	12	6	33	0	0	0	0	21	10	2	86	17	0	0	0	0	0	3	0	0	1	1	1	1	61	23	22	0	11	0	0	5	3	7	1	0	0	0	0	6	22	3	12	11	17	5	4	27	0	5	2	1	3	1	12	12	13	16	1	0	4	62	24	1	0	0	0	0	0	0	24	0	0	91	0	1	0	0	0	0	1	64	2	1	0	0	0	0	0	0	0	0	0	0	0	0	0	1	0	14	19	5	90	0	3	0	0	0	0	0	22	8	0	0	10	0	0	0	7	0	0	31	11	1	47	0	1	0	17	42	0	0	0	1	0	9	0	0	3	0	0	0	0	0	22	5	1	13	3	11	1	0	0	0	0	5	1	0	21	0	0	0	46	0	0	225	1	13	3	0	9	5	0	0	0	1	0	38	6	0	0	3	1	0	0	0	0	1	0	3	0	0	53	50	8	1	0	0	0	0	4	0	0	0	0	2	1	6	35	0	166	2	3	73	90	39	178	50	4	25	94	92	126	75	418	47	79	16	58	10	0	1	0	0	0	3	0	1	0	1	0	2	17	0	0	0	0	1	0	1	2	0	0	0	0	7	3	2	2	2	0	0	0	0	0	0	0	0	0	0	0	0	0	0	0	0	0	0	0	0	0	0	0	0	0	0	2	17	4	0	0	0	0	0	5	0	0	0	0	0	0	0	0	0	0	0	1	0	0	0	0	0	0	20	21	0	133	3	0	0	12	0	0	0	10	32	25	11	0	6	56	7	0	11	0	1	0	0	0	0	0	0	0	0	12	18	1	26	19	24	0	0	0	15	2	7	1	0	1	0	2	3	0	0	1	0	0	2	0	1	1	1	0	14	5	14	3	10	0	6	13	6	0	21	10	0	0	0	0	0	0	0	0	31	0	0	0	0	0	0	0	2	0	2	0	0	61	5	0	17	0	22	0	0	0	0	3	1	1	0	236	42	1	2	0	0	323	0	0	0	1	2	1	7	0	0	13	0	0	0	15	0	9	51	10	0	15	22	0	0	5	14	0	0	0	2	3	0	7	3	5	27	0	3	0	0	0	8	3	0	2	15	24	14	30	8	5	2	10	11	0	7	0	0	5	3	0	0	0	37	0	0	1	4	7	0	3	2	0	1	0	0	0	30	1	0	0	0	0	1	0	0	0	1	0	0	0	0	0	10	0	0	0	0	0	0	2	1	2	0	3	1	1	0	0	0	7	9	1	5	8	0	31	0	0	98	22	111	10	9	0	4	440	749	0	25	117	0	0	0	12	8	0	0	0	14	0	34	27	4	0	0	4	0	0	0	9	8	0	0	4	2	29	3	0	0	0	0	1	0	30	0	4	8	16	4	0	0	1	0	0	0	7	145	2	55	7	8	0	21	0	2	0	0	0	0	0	1	0	0	0	0	0	201	0	4	12	1	0	14	0	357	22	1	0	0	30	35	3	49	26	4	8	5	27	0	4	17	1	0	0	0	0	0	5	10	695	102	1	1	4	0	2	0	0	31	1	0	2	1	1	0	0	172	94	0	0	0	38	30	6	14	2	17	3	16	65	1	3	13	0	0	3	4	4	4	0	0	0	0	0	0	9	5	0	0	0	0	0	0	0	0	0	0	0	0	0	0	81	0	0	0	0	43	16	5	0	0	1	5	9	1	0	0	0	57	31	3	0	20	2	26	6	0	1	6	34	0	6	13	0	0	13	19	72	10	43	104	28	2	2	0	103	5	12	15	0	0	0	0	0	0	0	0	3	0	0	0	0	0	0	0	0	0	0	0	24	1	0	0	9	1	8	0	0	11	2	3	0	0	1	0	6	0	0	1	32	4	4	30	11	3	3	0	4	0	0	0	0	0	0	0	0	0	0	0	2	0	0	0	0	0	0	1	0	0	0	2	0	0	2	0	4	0	0	18	0	11	0	56	0	1	1	0	0	8	4	0	1	0	0	5	0	0	0	1	0	2	3	9	7	0	0	64	2	13	0	11	0	38	4	32	23	1	2	0	0	10	1	0	0	87	9	170	25	29	119	8	31	7	14	13	10	41	87	0	11	11	0	0	1	7	0	0	0	1	0	1	35	0	0	1	0	0	0	0	8	0	0	0	0	0	0	0	0	0	0	0	0	0	0	0	0	0	0	0	0	0	0	0	0	0	0	3	1	0	30	2	0	47	0	24	78	10	60	0	0	0	5	0	0	1	0	1	39	0	0	30	46	0	0	0	3	0	32	0	16	10	20	0	0	0	0	0	0	0	0	0	0	0	0	0	0	0	1	0	0	2	5	4	1	2	3	0	0	1	0	0	29	6	2	0	4	1	18	0	19	0	0	1	6	0	9	0	41	3	2	0	1	0	0	0	0	0	5	0	0	1	61	4	1	0	2	1	9	0	0	0	0	0	0	0	0	0	0	6	4	0	25	54	1	0	0	0	0	0	0	0	9	0	2	2	2	0
LakWasMet38_LOW7_2_rpkm	0	0	0	0	0	8	10	0	0	0	0	1	4	0	0	0	0	0	7	0	1	0	0	14	0	1	0	0	2	1	0	0	0	1	1	3	2	0	0	0	0	0	0	0	10	7	9	5	0	2	1	4	0	0	0	5	0	9	35	5	129	0	0	1	0	1	0	0	4	33	1	1	0	0	0	0	0	0	0	0	0	16	0	0	0	0	0	1	0	0	0	1	4	4	0	0	0	0	0	1	0	0	0	0	0	0	0	0	0	0	0	0	37	4	13	1	0	0	0	0	1	1	0	2	0	0	1	0	0	0	2	12	9	0	0	0	0	1	4	0	0	0	0	2	0	0	0	0	5	3	0	16	7	4	10	0	4	6	1	1	3	3	0	2	11	0	0	2	0	4	0	0	0	0	0	0	0	0	0	0	0	0	0	0	1	3	0	0	0	6	0	0	0	2	0	0	0	9	1	15	11	0	8	0	0	0	16	1	9	1	2	1	14	1	4	0	8	0	0	4	2	0	2	1	2	6	0	0	1	0	1	0	4	0	0	0	7	8	4	3	0	0	3	6	7	11	0	0	9	7	9	1	5	0	556	320	0	0	0	0	0	0	0	4	6	0	1	0	1	11	22	0	0	0	0	0	0	0	25	20	0	5	14	5	11	0	0	0	4	0	0	0	0	1	0	0	0	3	1	0	0	56	20	0	8	0	15	4	11	0	8	0	16	1	0	0	1	2	57	0	0	0	1	0	3	22	3	0	6	0	0	0	0	0	1	0	0	0	0	0	0	0	2	9	1	1	4	0	0	0	2	1	2	0	4	0	0	0	0	28	12	0	7	0	1	7	9	5	8	0	1	1	0	0	3	0	1	0	0	2	0	0	2	3	1	0	31	0	1	0	0	0	18	1	0	5	33	0	0	4	0	14	0	1	8	0	1	0	0	0	0	3	16	0	0	10	11	2	1	0	0	0	0	0	0	0	0	0	2	0	0	0	0	0	0	0	0	0	3	0	10	29	0	0	8	30	1	0	0	0	1	31	11	226	0	33	7	2	0	11	1	1	1	1	0	11	1	0	0	5	4	16	6	1	0	0	2	2	141	0	25	0	1	0	0	0	0	64	17	9	0	0	30	10	4	0	0	0	0	0	0	0	0	0	0	0	0	0	0	0	0	0	0	1	1	0	0	0	0	0	0	0	0	0	0	0	0	0	0	0	0	0	0	1	4	0	2	0	0	2	0	6	0	4	4	1	0	0	0	0	3	0	0	0	0	6	0	0	0	0	0	2	0	0	3	0	11	0	7	0	0	0	0	1	17	23	24	74	0	27	66	76	44	28	12	0	13	0	4	0	0	0	783	0	3	1	1	0	2	0	5	1	0	0	1	4	0	19	0	6	0	45	53	20	0	0	19	0	57	3	79	28	3	1	0	0	1	3	0	0	5	7	0	0	0	0	0	0	0	0	1	11	0	0	0	0	0	1	1	0	26	0	1	3	1	0	0	0	0	0	2	65	0	120	0	1	0	0	8	12	11	4	1	0	2	0	7	2	0	1	2	0	9	2	0	0	1	0	0	6	0	0	7	1	1	0	0	1	0	1	0	0	0	1	0	0	1	1	2	1	0	0	0	0	1	3	0	0	0	0	0	0	1	2	0	0	8	0	3	0	0	0	1	0	0	0	0	0	0	4	0	7	5	1	7	16	7	0	0	11	0	0	0	0	1	9	0	0	41	0	0	6	0	18	0	3	0	0	0	0	0	0	0	0	0	7	0	0	0	0	0	0	0	0	0	0	0	0	0	3	1	2	1	0	0	0	1	0	0	10	0	0	0	0	131	2	10	0	0	0	0	0	1	0	0	0	9	0	0	0	0	0	0	25	1	1	0	0	1	0	0	0	0	0	0	0	0	8	28	0	0	0	0	0	0	0	0	5	11	5	1	0	2	0	0	0	2	0	0	15	7	0	2	0	0	1	1	0	2	1	0	0	0	1	0	0	1	3	4	17	0	1	0	2	0	1	1	1	0	0	0	0	0	0	1	0	0	0	0	0	0	0	0	1	0	0	0	0	0	0	0	0	0	1	13	17	18	11	4	0	0	0	0	0	0	0	0	0	0	0	4	0	0	0	0	0	0	0	0	30	0	0	0	4	5	0	14	0	0	0	0	0	0	0	0	0	0	0	1	0	0	0	1	0	1	3	0	0	0	0	0	4	2	127	0	8	2	0	0	0	2	2	8	0	13	0	0	4	2	0	0	0	2	0	0	0	0	7	3	0	0	0	0	0	1	0	0	0	0	0	0	0	0	0	0	0	0	22	0	0	0	16	7	0	1	0	0	0	7	7	0	0	0	0	0	0	1	1	34	2	0	0	0	0	0	0	0	5	0	0	0	0	0	2	1	122	0	0	0	1	4	1	0	1773	0	0	0	0	43	4	10	0	0	0	2	0	4	2	4	3	0	0	0	0	0	0	0	0	0	1	0	0	0	0	0	0	1	0	0	0	0	0	0	0	0	12	26	0	4	33	0	0	0	0	3	0	0	4	1	0	3	4	0	0	0	0	12	60	3	0	1	0	0	0	0	0	1	0	0	0	1	0	0	5	1	0	0	0	0	0	0	0	0	0	4	0	1	0	0	0	0	1	0	0	0	0	0	0	0	0	5	10	0	0	0	0	1	1	2	0	0	0	1	0	0	0	0	0	0	0	0	2	10	2	29	34	0	0	0	1	0	0	0	4	0	5	0	1	0	0	0	0	4	0	0	0	0	4	0	1	0	0	0	0	0	0	0	0	19	1	0	0	0	0	1	0	0	9	1	0	0	0	272	6	0	0	2	0	0	0	1	0	0	24	22	0	0	1	0	2	24	0	0	2	0	0	0	0	0	0	0	0	9	3	2	5	1	35	1	11	1	1	2	2	0	7	0	0	1	0	0	3	0	0	0	2	1	0	5	1	0	0	4	0	0	0	0	0	0	3	1	1	0	0	0	0	0	0	0	0	0	0	29	0	0	0	0	0	1	0	0	0	0	1	6	0	7	16	11	9	0	0	3	0	0	0	0	2	0	1	0	1	1	0	0	0	6	4	0	2	0	0	8	1	25	0	1	2	0	7	0	0	17	5	6	3	1	2	4	0	0	0	2	0	8	0	4	2	0	12	2	2	15	0	0	1	11	7	0	0	0	1	2	4	3	0	1	0	1	2	0	2	8	9	0	0	3	0	0	0	0	0	0	4	6	0	0	0	11	0	15	17	2	2	10	0	1	2	1	2	0	4	0	5	1	2	0	0	0	0	0	0	0	406	27	5	14	0	1	0	0	0	0	0	1	49	1	2	0	38	0	2	0	0	38	17	10	12	0	0	0	33	0	0	0	0	1	0	0	0	60	32	8	26	29	20	0	8	57	2	0	0	0	0	0	0	46	1	0	0	0	9	0	2	0	0	0	1	0	1	0	3	1	0	0	0	7	0	0	0	0	0	1	2	7	7	0	0	0	0	0	7	0	0	0	0	0	0	3	0	0	0	1	0	0	0	0	0	1	0	0	0	0	0	0	0	0	0	0	0	0	0	0	0	0	0	0	0	0	0	0	0	0	0	0	0	0	129	1	0	47	0	0	0	0	54	0	3	2	0	0	62	0	21	2	2	1	0	1	0	6	0	5	0	0	0	0	0	0	0	0	4	14	0	0	0	2	0	0	2	0	0	0	0	0	0	0	3	1	29	5	31	0	0	2	15	0	0	0	14	0	0	0	3	2	0	0	1	4	0	1	2	4	2	5	0	9	0	0	0	0	5	0	1	7	6	1	0	11	0	0	0	1	0	0	0	7	0	22	4	40	45	74	23	32	1	0	0	0	1	8	19	0	0	1	6	20	0	0	0	11	6	1	0	0	6	5	0	28	5	0	1	0	2	7	0	2	0	12	2	0	0	0	0	0	1	0	38	0	2	23	2	0	0	6	3	0	23	0	0	5	0	2	1	0	4	16	123	6	55	0	3	0	5	4	3	0	0	4	1	0	0	120	0	0	0	0	0	0	2	5	0	5	0	0	0	0	0	0	1	0	5	0	0	0	0	1	0	9	0	0	0	18	0	200	57	0	7	17	63	0	9725	6	0	3	0	0	0	0	0	1	0	0	0	0	0	0	0	0	11	0	0	0	0	0	0	0	1	0	14	0	0	1	1	0	6	1	0	0	0	5	0	3	4	1	0	11	0	0	0	0	2	0	0	14	0	0	2	4	0	0	0	11	80	0	14	0	8	35	0	17	1	12	0	6	8	11	4	26	14	0	6	0	0	0	0	0	0	0	0	0	0	0	0	0	1	1	0	0	8	0	8	50	1	0	0	0	0	0	0	0	0	0	0	1	0	1	0	0	0	3	1	21	0	0	0	0	0	0	0	0	1	0	0	1	0	0	0	0	0	0	0	0	0	0	0	0	0	0	2	0	0	0	2	0	0	0	0	0	0	0	0	31	0	2	0	2	0	1	1	7	0	7	8	42	1	1	0	0	1	0	0	0	0	0	8	0	0	18	0	1	0	0	4	0	0	0	0	0	2	0	0	1	0	5	3	9	8	0	3	3	0	0	0	3	3	7	1	0	0	0	0	0	0	0	0	0	0	2	0	0	0	0	2	0	0	0	0	1	0	0	0	0	0	1	0	1	0	0	0	0	0	2	90	29	0	0	0	0	0	0	0	0	0	0	6	7	0	0	0	1	2	0	0	0	0	0	0	3	0	0	3	0	0	1	32	1	0	0	0	2	0	0	0	0	0	0	25	0	0	0	0	0	4	0	0	1	6	0	21	15	9	1	0	1	0	0	0	30	0	18	4	0	1	0	0	0	5	0	4	0	0	0	0	0	0	0	0	0	0	0	2	0	0	0	0	0	0	1	0	0	0	10	3	0	0	0	0	0	0	0	0	0	0	0	0	0	0	1	0	3	0	0	0	0	5	0	2	0	8	1	0	0	216	0	1	18	47	9	6	0	0	4	3	0	0	2	0	0	3	21	0	0	2	0	0	0	0	0	0	8	0	7	0	0	0	0	13	0	0	6	0	11	0	0	0	0	0	0	2	0	0	0	0	0	3	2	0	0	0	0	0	0	1	17	12	0	1	2	0	0	0	10	15	0	0	2	0	0	0	0	0	2	1	0	1	1	2	53	0	0	0	0	0	0	0	0	1	1	2	0	0	0	0	0	0	0	0	0	0	0	1	0	0	0	0	0	0	0	0	1	0	0	0	0	0	0	5	1	0	0	1	1	0	6	0	1	0	14	0	0	0	0	0	0	2	0	0	0	0	0	0	95	73	79	68	106	53	141	106	13	69	55	82	120	51	18	51	14	113	133	7	20	2	136	139	69	94	206	53	71	26	63	8	50	6	0	0	0	0	0	0	0	0	0	0	40	16	0	0	0	0	0	0	0	0	1	0	0	0	0	0	0	4	0	0	1	0	1	0	5	0	1	0	0	0	0	0	6	0	3	0	0	1	0	2	0	0	0	0	1	0	0	1	0	0	0	0	1	1	0	5	8	0	0	0	0	0	0	6	0	0	5	0	0	0	0	0	58	0	0	10	0	0	0	0	0	0	0	0	0	0	1	2	0	0	0	0	0	0	9	0	0	1	0	0	0	0	0	0	0	0	1	17	0	0	1	0	0	0	0	0	0	0	1	1	0	0	0	0	0	9	2	1	0	0	1	0	0	0	1	1	1	0	0	0	0	0	0	0	0	14	0	0	0	0	0	0	0	0	0	0	3	0	10	29	0	0	0	0	0	3	0	4	0	0	0	0	8	0	0	0	0	0	0	1	0	0	4	0	0	0	0	0	1	0	1	0	0	8	0	16	0	161	1	0	1	6	0	0	0	0	0	0	0	0	0	0	0	1	1	0	10	9	0	0	0	0	6	0	0	77	4	0	7	2	0	15	0	2	2	2	1	0	0	0	0	0	0	2	0	0	0	0	0	0	1	0	3	0	0	0	0	0	0	0	0	0	0	0	0	0	0	0	1	0	0	0	0	0	8	0	0	0	0	16	0	8	17	68	2	0	2	0	0	0	0	0	0	0	0	0	0	0	0	0	0	0	19	0	1	0	0	1	0	1	0	0	0	0	3	5	16	0	0	0	122	0	0	0	0	0	1	0	0	0	0	0	0	0	22	14	0	0	0	0	0	0	1	2	0	0	10	6	2	1	0	2	0	0	10	5	0	1	0	0	0	0	0	0	0	0	1	1	1	0	37	1	0	0	0	1	0	0	0	0	0	0	0	0	0	1	0	0	0	0	0	0	0	0	0	0	0	0	0	1	0	0	0	0	0	0	0	2	2	0	24	0	1	13	0	0	0	0	1	0	0	0	0	4	0	4	4	0	0	0	0	0	0	0	0	13	0	0	0	0	0	0	11	0	1	12	18	6	0	14	16	4	0	7	0	12	0	18	0	9	0	4	0	13	6	5	0	8	0	5	0	7	1	0	0	3	0	3	0	5	8	9	3	7	3	6	1	0	6	2	4	0	114	0	0	0	3	6	0	5	2	2	0	1	9	0	0	0	0	1	0	0	12	0	0	0	0	4	2	0	0	0	0	54	0	0	0	0	1	0	0	0	22	0	0	1	0	10	1	1	0	0	1	0	0	0	0	1	0	0	0	734	0	3	17	22	7	0	6	0	6	0	0	0	30	0	0	0	0	1	42	0	38	0	0	2	0	0	0	0	0	3	0	0	9	4	0	130	0	3	0	0	0	16	25	0	0	0	0	0	0	0	0	0	3	0	2	0	0	0	51	0	0	0	15	12	0	0	0	3	0	0	166	322	305	1	0	0	0	2	0	4	1	9	0	0	0	1	0	0	17	152	12	0	0	0	0	0	0	0	18	0	2	0	0	0	0	0	0	3	0	0	0	0	0	0	0	0	0	0	0	0	25	26	1	1	2	0	0	0	1	11	8	0	0	1	0	0	10	6	0	0	0	0	0	0	0	66	1	0	0	0	2	2	0	2	8	0	0	2	1	3	0	0	0	0	0	0	0	1565	0	0	0	0	1	0	0	0	0	0	0	0	0	0	0	7	0	1	0	0	0	0	0	0	0	0	0	0	0	0	0	0	0	0	0	0	0	0	0	0	0	1	0	0	11	0	0	0	0	0	1	0	0	0	0	0	0	0	0	54	0	0	0	1	0	0	14	0	0	0	0	0	0	22	1	0	0	0	0	11	3	51	3	0	10	0	0	3	2	0	13	0	0	12	1	0	0	0	0	0	0	0	1	0	0	0	0	0	0	0	0	0	0	0	0	38	0	0	0	0	0	0	0	0	2	0	18	1	0	0	0	0	7	0	0	1	0	0	0	0	0	5	0	0	0	8	8	1	1	2	0	1	0	0	0	0	0	0	3	1	0	1	0	1	0	4	0	0	0	0	0	0	0	0	0	17	0	3	3	8	0	4	0	2	0	0	0	0	5	0	0	0	0	0	0	2	0	17	5	0	13	0	19	538	0	0	0	0	0	0	0	2	0	3	0	0	0	1	0	0	112	47	0	20	0	0	0	3	0	0	0	0	0	0	0	0	0	0	1	4	40	4	0	0	0	0	0	0	0	0	7	1	4	0	0	0	0	0	0	0	5	3	0	0	0	0	1	0	0	0	2	0	0	0	921	1	0	4	1	2	0	0	7	0	0	0	5	0	0	1	0	0	0	0	70	0	0	0	2	23	0	0	1	0	0	0	1	0	0	0	0	0	0	55	0	0	0	0	0	0	0	12	0	0	0	0	0	0	0	0	0	0	0	0	0	0	0	1	0	0	0	0	0	1	0	0	0	0	0	1	0	0	0	0	0	0	1	0	1	1	2	0	1	0	0	6	0	1	0	0	1	0	0	0	1	0	0	0	0	0	0	0	0	0	0	0	1	0	0	0	0	0	0	0	0	1	0	0	0	1	0	0	0	0	0	0	1	0	0	0	12	0	0	1	1	0	0	0	0	0	0	0	0	0	0	0	0	0	0	0	0	0	0	0	0	1	0	1	0	4	0	1	0	0	13	0	0	0	9	0	0	0	0	0	0	0	0	7	0	0	0	0	1	1	0	0	0	5	2	0	2	42	5	0	0	0	0	0	0	0	0	0	0	0	6	0	0	44	0	0	0	0	1	0	0	0	63	0	2	0	0	0	0	0	0	0	0	1	2	0	18	0	0	0	0	0	0	0	0	1	2	10	0	2	0	0	0	1	0	2	0	0	0	1	0	0	0	1	0	0	0	0	0	1	0	0	0	0	0	0	0	0	0	0	0	0	0	0	0	0	1	0	0	0	0	0	0	0	0	0	1	1	0	0	0	0	0	0	1	0	0	1	0	0	0	0	0	0	0	0	0	0	0	0	0	0	0	0	0	0	0	0	0	0	0	0	0	0	0	1	1	0	0	0	0	0	0	0	0	0	0	0	0	0	0	0	0	0	0	0	11	0	0	11	0	0	1	0	1	3	0	0	4	0	0	4	0	0	1	0	1	0	1	0	0	0	0	27	18	0	0	0	3	32	0	0	0	0	0	2	7	1	0	0	0	0	8	0	0	0	0	1	0	0	0	1	0	0	0	2	0	0	0	0	0	0	0	0	0	0	0	0	0	0	0	0	0	0	0	0	0	1	0	9	0	11	4	0	1	0	0	0	0	0	0	0	11	0	0	0	1	0	0	0	0	1	0	0	0	0	0	1	1	0	1	0	0	1	0	0	1	2	0	0	0	0	1	0	0	0	1	0	0	0	0	0	0	0	0	1	0	0	0	0	0	0	0	0	1	0	8	0	0	2	0	0	4	0	2	9	0	1	0	0	0	0	0	0	0	0	0	0	2	0	0	0	9	0	0	0	0	2	2	0	0	0	0	0	0	8	0	0	0	0	0	1	0	0	0	1	0	0	0	0	0	0	0	0	0	0	0	1	0	0	0	0	0	1	0	0	0	0	0	0	0	0	0	0	0	0	0	0	0	1	0	3	0	0	3	1	3	2	2	0	0	0	1	0	0	0	0	0	0	0	0	3	0	0	0	16	10	0	13	0	0	0	2	1	0	0	0	0	6	0	0	0	0	0	0	0	13	0	5	0	3	0	0	0	2	0	2	1	0	8	0	0	0	0	0	0	0	0	0	1	2	1	1	0	3	0	0	0	0	18	0	0	6	0	0	0	0	0	0	0	0	0	0	0	0	1	0	1	0	0	0	0	0	0	0	0	2	0	2	1	0	1	2	0	0	0	0	0	17	0	0	0	0	0	0	0	0	0	1	4	0	1	0	0	0	0	0	0	0	0	0	2	1	3	0	9	1	0	14	71	0	0	7	0	114	0	9	34	1	0	0	0	22	167	0	35	0	3	4	0	199	0	5	0	0	1	0	0	5	12	0	12	0	1	5	0	9	31	10	0	0	0	1	4	0	14	0	0	6	5	0	1	0	0	0	1	0	4	6	0	0	0	0	4	0	0	9	0	1	0	0	0	0	0	0	0	0	5	0	0	0	13	0	2	6	17	0	0	0	15	1	4	1	0	0	1	0	0	0	0	0	0	30	23	0	0	0	0	0	1	0	5	6	0	0	0	0	0	0	5	7	0	2	0	1	0	1	10	1	0	1	0	0	0	0	0	0	0	0	2	7	0	0	1	1	10	0	0	0	1	1	2	0	3	1	0	0	0	2	1	0	1	0	2	5	0	0	0	1	0	5	1	2	0	8	0	0	0	0	12	2	1	0	56	26	140	0	9	18	39	135	2	66	25	11	4	107	178	79	0	240	29	102	30	73	0	97	6	96	0	3	0	2	0	56	0	1	0	1	0	0	0	1	1	1	3	2	0	0	0	0	0	14	0	0	3	1	0	0	0	0	0	0	2	0	2	2	1	0	0	0	0	0	19	0	0	0	1	0	0	0	22	2	0	0	0	9	0	0	5	4	2	0	14	0	0	0	0	1	0	0	36	1	9	0	11	0	0	0	1	0	0	0	0	0	0	0	0	0	0	0	11	0	0	0	0	3	0	0	0	1	8	0	0	10	0	2	0	1	0	0	0	1	6	2	766	0	3	2	0	0	0	1	1	0	8	1	0	1	0	0	0	0	0	0	0	0	1	0	23	0	0	23	3	0	0	0	0	0	0	53	0	0	0	0	7	0	0	0	0	6	0	0	10	1	2	1	1	0	0	0	2	0	1	0	0	0	0	0	0	0	0	0	0	0	0	0	1	0	3	0	0	0	2	0	0	1	0	0	0	0	0	35	0	0	0	0	1	5	1	1	6	10	0	0	23	87	8	0	0	1	0	7	1	0	0	0	2	0	0	0	0	0	1	0	0	0	69	2	6	0	13	0	0	1	0	0	0	1	3	1	1	0	1	0	0	0	0	1	0	0	6	0	8	0	0	2	1	28	0	0	0	0	0	0	1	1	0	0	4	0	3	0	0	1	0	13	1	0	6	0	0	1	0	80	0	8	0	1	0	0	0	0	8	0	2	0	0	0	0	0	0	0	0	1	1	0	0	3	2	2	0	0	0	0	0	0	0	17	0	0	0	0	0	0	6	0	0	0	0	1	0	2	1	0	0	0	0	2	0	0	1	3	0	2	0	1	0	0	0	0	0	13	1	0	0	0	0	0	0	1	0	0	0	0	0	0	0	1	0	0	0	0	0	0	1	1	0	1	0	2	0	0	0	0	0	0	0	0	1	0	0	0	0	0	7	3	2	0	0	0	33	29	3	6	0	0	0	0	0	0	0	0	1	0	0	22	4	0	1	0	0	0	6	0	1	2	5	8	10	6	12	4	0	0	0	0	1	9	0	0	5	0	0	0	0	0	0	0	1	0	6	1	0	4	0	4	0	0	0	0	0	28	0	0	0	0	0	0	2	1	0	0	2	0	0	0	0	0	0	0	1	1	0	0	0	0	0	0	27	8	0	0	0	0	3	4	7	0	1	0	0	0	0	6	0	0	0	0	0	1	403	0	5	0	0	0	1	0	0	4	1	1	0	0	0	0	0	0	0	0	0	1	4	1	0	2	0	0	1	0	0	0	0	0	0	0	0	1	0	0	0	0	0	0	1	4	0	0	4	0	0	0	8	0	0	0	0	1	0	1	0	0	0	12	1	2	2	2	0	0	0	0	1	0	13	3	0	2	0	5	0	0	1	0	0	0	0	0	0	0	0	0	0	0	0	2	2	0	1	0	0	0	0	58	0	4	0	26	0	1	0	0	1	0	0	0	18	1	9	2	0	0	0	0	0	24	0	0	2	0	0	0	30	0	0	0	0	0	0	0	65	1	0	0	0	0	0	0	0	0	0	0	0	0	0	0	0	0	12	0	0	0	0	0	0	0	0	0	0	0	2	0	1	0	0	0	0	0	0	0	0	0	0	0	0	0	0	0	0	0	0	0	0	21	0	0	1	0	0	0	1	0	2	0	0	8	0	0	0	0	0	0	0	0	0	3	0	0	0	0	0	0	1	0	0	0	3	0	0	0	0	0	0	0	55	0	0	0	0	0	3	0	1	0	0	0	1	0	0	2	50	1	0	1	1	0	0	0	4	0	0	16	0	1	15	0	1	0	0	0	0	0	0	0	0	14	0	0	0	0	1	1	0	10	0	0	55	0	0	0	0	0	0	0	0	0	0	0	0	0	0	2	4	0	3	6	0	0	0	0	1	2	0	0	0	0	0	0	0	0	0	0	4	0	0	0	0	974	0	0	0	6	2	2	0	0	0	3	0	0	5	0	0	0	1	0	0	0	0	1	0	0	18	0	0	0	0	0	0	0	3	0	1	0	1	0	0	0	0	3	4	1	0	0	0	0	0	4	21	1	0	0	0	0	3	0	7	6	0	0	0	0	3	0	8	0	3	0	3	0	0	0	0	0	0	0	1	1	0	0	0	0	0	0	0	25	13	8	8	0	2	0	4	0	0	2	1	1	0	0	24	1	10	33	0	14	14	0	13	0	0	0	15	1	0	16	0	0	0	1	1	0	0	0	26	6	0	4	100	363	0	0	0	4	1	11	0	0	0	2	0	0	1	0	5	0	0	2	1	0	0	0	11	0	3	5	1	0	0	0	0	4	0	1	0	2	0	5	3	7	5	0	5	0	0	0	3	2	0	0	0	1	2	0	1	1	2	0	0	0	1	0	6	2	3	0	0	1	9	8	3	1	1	0	49	1	1	0	8	2	0	1	1	0	0	0	0	0	0	1	0	1	0	0	2	0	10	4	45	1	0	0	0	1	2	0	0	0	0	1	0	0	0	0	2	0	0	0	0	0	0	0	0	0	0	0	0	0	0	0	0	0	4	0	0	0	5	0	0	0	0	0	0	1	1	0	5	0	2	0	0	0	0	0	5	0	19	22	0	0	0	0	0	0	0	0	0	0	2	106	0	0	0	0	0	3	1	5	0	1	0	3	0	0	6	0	0	0	7	3	0	0	0	0	0	0	5	0	0	0	0	0	0	0	0	10	0	0	0	16	0	0	13	12	0	0	0	0	0	0	14	0	2	0	30	15	0	0	0	0	0	1	0	0	0	3	7	3	6	0	11	0	0	0	9	0	71	0	2	0	160	0	8	0	3	0	2	0	0	0	0	17	1	8	15	0	9	0	0	0	1	11	0	0	5	0	0	3	19	9	3	4	2	0	0	0	4	0	2	2	0	0	1	0	1	0	0	0	0	0	1	0	0	2	0	0	1	0	3	0	1	0	9	0	5	1	0	13	7	0	0	0	27	0	3	9	1	3	12	3	0	12	6	20	5	18	12	0	1	0	0	6	0	0	6	0	0	1	0	0	0	0	0	0	1	9	5	4	0	42	14	32	0	22	1	2	0	0	0	1	0	0	0	0	0	0	0	1	0	0	5	0	0	4	5	0	0	1	0	0	0	0	0	0	0	0	103	0	0	0	0	0	2	2	0	3	0	0	7	0	0	0	0	8	0	16	9	5	1	2	0	26	0	0	0	11	18	0	0	0	0	4	0	0	54	0	0	0	10	4	5	4	0	0	20	0	0	4	0	0	9	0	0	0	2	0	0	0	0	30	28	17	0	0	4	1	0	0	1	1	0	0	0	0	9	7	0	0	0	1	0	25	27	67	0	0	9	14	0	0	0	1	0	0	0	0	0	0	0	0	2	3	16	0	1	0	4	5	3	0	0	0	0	0	10	4	0	4	4	0	5	0	14	1	12	9	11	6	9	0	0	2	99	41	0	5	1	0	0	3	1	4	0	0	0	0	0	0	0	0	1	1	2	0	0	0	0	4	32	17	114	134	5	11	2	1	0	3	4	5	0	0	1	0	0	0	0	1	1	0	0	0	0	0	0	0	0	0	0	1	0	13	0	0	2	0	0	0	5	3	9	0	5	11	4	13	1	1	8	5	14	3	6	0	1	0	0	33	15	9	0	0	1	2	2	3	0	6	1	0	0	1	9	1	1	0	0	0	0	0	26	4	0	0	0	0	0	1	0	0	2	0	0	0	0	0	44	2	6	6	111	7	0	0	0	0	0	6	0	3481	0	1	0	1	14	13	1	0	0	0	0	0	0	0	0	9	1	3	0	0	0	0	0	0	2	0	3	0	0	19	0	0	1	0	0	0	2	0	0	1	23	0	0	0	0	1	0	0	0	0	3	3	0	0	0	0	0	0	0	1	0	0	1	0	0	0	4	4	0	7	3	0	20	0	0	1	0	1	14	0	0	22	0	0	0	0	1	17	0	0	0	0	0	0	0	0	0	0	0	34	5	0	2	51	0	0	0	0	6	0	30	2	12	3	0	0	0	0	1	0	4	122	0	0	0	0	26	0	0	0	1	1	0	0	0	0	0	0	0	0	386	11	4	1	4	900	0	14	16	19	8	1	105	96	79	33	11	8	7	0	20	158	94	104	29	19	0	0	1	255	1	1	7	0	0	22	13	0	0	363	1	0	0	0	0	1	2	12	0	1	0	3	3	49	43	9	11	4	3	1	0	1	0	10	11	1	8	2	1	0	0	0	0	0	0	0	0	87	0	0	7	4	4	0	2	4	0	0	0	3	0	0	0	1	0	1	0	0	0	10	0	1	0	0	0	19	0	13	0	5	0	1	7	0	7	5	0	0	21	43	40	0	0	6	26	26	2	7	22	0	12	0	6	3	0	29	0	0	1	4	3	16	6	0	9	4	13	11	0	0	4	2	0	0	26	5	0	0	0	0	8	0	0	3	3	3	0	1	0	0	0	13	0	0	1	0	0	0	3	0	0	1	0	0	7	0	0	0	0	0	129	5	5	0	0	1	5	0	13	0	0	2	0	0	2	44	0	0	15	22	0	4	1	2	0	6	1	5	1	2	1	6	16	17	4	43	33	9	1	0	0	0	4	0	0	1	0	4	2	2	8	0	0	0	0	0	2	12	31	0	4	0	0	0	0	0	0	3	1	0	0	0	0	0	0	0	2	0	0	0	0	0	0	0	0	0	0	1	0	0	5	0	0	0	9	4	0	1	0	3	1	0	0	0	0	0	0	0	1	0	0	0	0	0	0	0	5	0	2	2	1	2	0	3	0	0	0	0	0	0	0	0	0	53	0	0	17	0	0	0	5	7	6	0	0	1	0	0	14	0	1	5	5	3	0	0	0	0	1	0	0	0	0	0	12	31	7	8	5	13	7	11	10	7	0	12	35	27	16	14	84	50	42	61	7	8	5	4	0	4	1	0	3	4	3	23	40	25	45	8	29	15	16	26	16	62	26	5	7	16	14	4	6	0	0	4	0	25	81	0	4	1	51	19	1	9	328	115	18	300	0	240	7	0	1	0	0	1	9	3	90	0	10	0	134	184	50	0	0	17	0	0	0	0	0	66	14	33	17	52	16	75	9	7	246	0	10	0	11	13	0	0	0	3	1	25	3	6	1	10	3	5	0	3	6	7	9	0	0	0	1	0	0	0	1	0	0	1	0	0	0	0	9	3	0	0	0	1	6	3	0	1	0	0	4	0	0	1	1	0	0	0	0	0	0	0	0	1	2	0	0	1	0	0	0	0	0	1	0	2	1	0	3	3	0	3	69	0	0	3	0	0	0	1	0	0	0	0	0	0	0	0	0	0	0	0	27	0	0	0	0	0	2	1	0	0	0	0	0	0	0	0	0	0	0	1	0	0	0	2	1	0	0	0	8	0	27	1	9	17	0	20	1	11	0	0	0	0	0	0	0	1	0	0	0	0	0	4	8	7	5	2	0	0	0	0	0	0	0	1	3	2	0	24	0	5	1	0	5	22	0	0	2	2	0	0	2	13	10	17	2	0	0	9	0	0	11	3	28	0	0	0	10	5	3	0	0	3	7	3	8	0	1	14	7	0	0	24	85	4	5	1	0	0	29	1	5	6	0	14	0	0	0	0	6	0	4	0	0	0	0	0	2	0	0	7	0	0	0	1	0	0	8	1	2	0	23	0	0	0	0	0	0	0	0	0	4	5	4	0	1	13	0	5	0	0	0	4	7	0	0	8	4	1	0	1	3	0	0	0	1	0	0	5	1	4	1	0	0	0	0	0	0	0	0	0	2	9	0	2	44	0	0	0	0	0	0	0	1	7	10	0	9	8	8	0	0	9	0	1	3	2	0	0	0	0	0	0	0	0	1	1	1	0	1	0	1	0	0	6	9	0	0	2	0	0	3	2	4	0	7	0	1	0	1	0	0	0	0	0	17	2	4	0	2	16	0	1	0	0	5	41	0	0	1	12	6	0	0	10	0	5	5	9	422	0	0	11	0	8	0	0	0	0	0	0	0	8	11	0	8	3	5	2	0	186	0	4	0	0	0	0	0	0	0	0	0	0	0	0	0	0	0	0	0	0	0	0	0	1	1	3	0	2	0	0	3	4	0	0	0	0	6	10	1	0	0	0	39	12	0	2	0	0	0	0	20781	0	0	0	0	0	0	0	37	0	0	0	0	0	0	0	0	4	0	0	0	0	15	11	9	21	0	6	2	9	0	0	0	0	0	0	0	0	5	23	0	35	11	0	0	1	0	2	1	0	2	0	0	1	0	8	1	4	12	46	20	26	7	0	6	3	0	8	0	0	34	0	1	15	0	1	0	1	0	4	0	74	19	25	2	11	0	0	0	0	92	0	0	2	2	16	10	0	28	0	0	0	16	8	0	0	21	23	0	3	0	2	0	0	0	0	0	0	0	28	43	31	21	35	0	24	4	0	11	29	31	55	43	8	5	9	3	45	24	0	9	17	11	0	3	0	0	0	23	12	58	64	8	0	1	0	0	5	5	3	2	6	0	0	0	0	0	0	0	0	0	0	1	2	8	0	0	2	2	2	0	2	5	1	0	0	0	9	3	3	1	1	3	3	4	0	2	2	21	0	0	0	4	2	26	2	5	3	0	2	0	0	0	17	1	0	0	0	1	0	0	0	0	0	0	0	0	0	2	50	0	0	0	5	6	3	0	2	0	0	0	0	1	4	1	6	0	3	0	0	0	16	36	0	1	1	0	22	0	0	5	2	0	3	0	0	0	1	0	0	1	0	0	1	0	0	1	2	0	0	0	0	7	1	2	0	0	0	0	0	0	0	0	0	1	10	0	1	0	0	0	0	0	0	0	0	0	0	0	0	0	0	3	12	0	0	2	0	0	0	0	0	8	0	2	0	3	4	1	0	8	0	0	0	66	4	3	3	0	0	0	2	4	6	0	1	0	1	3	3	3	0	0	0	0	0	0	0	1	0	2	0	16	0	0	13	16	0	0	1	0	144	311	0	0	1	0	0	0	1	1	17	16	9	1	22	0	17	21	3	871	2	3	0	1	3	12	19	2	19	0	0	26	0	20	1	0	1	0	0	0	0	0	5	0	0	20	8	1	0	0	0	7	17	1	0	0	0	0	1	1	0	0	1	1	0	7	0	6	0	10	1	2	5	1	0	0	1	0	8	10	1	0	0	0	0	0	0	15	48	10	2	5	2	11	0	65	0	3	4	9	5	1	1	8	0	0	1	3	3	1	0	0	1	5	0	3	2	0	0	0	4	0	0	3	1	1	3	0	5	0	0	0	1	10	0	0	0	0	0	0	0	0	59	0	1	0	0	0	1	3	0	0	1	0	0	0	0	0	9	0	0	0	0	0	1	8	0	0	823	0	0	2	3	0	0	0	1	1	1	0	0	0	1	0	0	0	0	0	0	0	2	0	0	0	0	2	0	0	0	39	0	1	1	6	22	0	8	0	0	0	0	0	0	0	0	0	0	0	0	0	0	0	0	0	26	0	0	0	1	0	1	0	0	0	0	0	0	0	0	0	0	8	0	0	0	5	2	4	4	0	4	6	2	2	2	3	1	3	61	6	0	4	10	14	26	123	45	70	273	0	0	15	0	1	1	9	8	3	0	0	0	0	0	0	45	0	0	2	1	90	0	0	0	1	1	118	0	5	0	0	0	4	3	0	0	0	0	0	0	1	1	0	0	0	0	1	56	21	0	0	0	0	1	0	0	0	4	0	0	1	0	0	0	7	22	0	0	0	0	4	0	0	0	11	2	0	9	8	1	0	0	0	1	0	5	4	10	3	1	0	0	0	0	13	0	1	1	0	19	4	0	0	3	35	3	8	204	0	0	1	0	0	1	0	24	1	4	0	0	0	0	12	0	13	0	6	0	0	0	0	18	0	1	0	30	17	3	56	1	0	35	43	0	0	0	0	1	2	0	0	0	1	0	15	0	0	2	0	0	0	0	0	0	6	0	0	2	0	0	0	0	6	3	0	0	0	5	45	2	20	0	3	31	2	0	1	0	1	0	9	5	1	7	4	15	40	4	3	17	0	9	9	17	0	0	0	0	0	0	3	0	0	159	0	0	3	7	6	9	0	18	2	0	2	2	3	2	0	43	7	0	0	1	0	4	0	0	59	182	13	0	0	0	0	1	0	0	0	0	0	0	0	4	0	0	0	0	0	0	0	0	0	12	0	0	1	0	0	0	0	0	0	0	1	0	0	0	0	0	0	0	30	0	0	0	0	0	0	0	0	0	0	0	0	1	0	0	0	3	5	8	2	0	9	5	0	2	0	2	1	4	0	1	0	0	5	247	0	9	3	4	21	0	1	5	0	5	4	0	0	0	0	2	2	0	0	0	5	0	0	2	0	14	3	0	0	2	0	0	17	12	0	9	0	0	1	1	0	1	5	7	2	6	18	6	10	9	1	16	4	0	3	0	0	1	0	1	4	12	8	0	16	4	11	1	0	0	3	0	0	1	0	0	2	22	0	0	0	0	0	14	0	0	0	0	0	0	0	1	1	6	8	5	9	0	2	2	13	9	4	9	4	0	31	13	23	1	0	1	0	0	0	0	1	0	12	5	42	9	0	0	25	0	0	0	0	0	0	0	0	0	0	0	0	0	3	8	44	0	11	22	10	656	23	0	3	0	0	0	0	0	5	0	0	0	0	0	10	0	0	0	3	2	0	0	0	0	0	0	0	10	20	0	6	19	1	2	2	0	0	0	1	0	26	0	1	503	0	0	0	8	0	26	0	0	0	1	2	0	0	0	0	0	0	10	0	0	0	0	0	11	0	0	0	0	0	0	0	0	0	1	1	0	0	0	0	0	0	0	1	0	2	0	46	98	0	2	2	2	7	4	5	4	0	3	0	9	0	0	0	0	0	0	0	0	0	0	0	8	0	1	0	0	31	0	0	0	0	0	0	1	0	0	1	0	3	0	0	1	0	1	0	2	0	0	2	4	0	0	0	0	0	0	0	0	0	1	0	1	2	4	0	18	19	24	1	8	0	0	0	0	0	0	0	0	11	0	28	0	0	3	2	0	9	27	0	0	0	0	4	0	0	0	0	2	1	0	0	0	0	0	0	0	0	0	0	0	0	0	0	0	0	8	0	0	0	0	0	0	0	0	92	0	0	1	0	0	1	0	0	0	1	0	2	0	3	0	0	0	0	2	0	0	0	1	0	0	1	0	0	0	0	1	0	1	0	22	0	0	0	0	0	0	4	0	0	0	0	0	0	1	0	1	0	0	0	1	0	0	1	0	11	4	0	0	0	0	0	0	1	0	4	0	1	0	0	0	0	0	0	0	0	0	0	0	0	8	0	1	0	0	0	0	0	1	39	0	0	0	0	6	0	0	0	0	0	0	0	0	0	0	1	1	5	0	0	0	0	0	0	0	0	0	0	0	21	0	0	0	0	0	0	0	0	0	0	0	0	3	0	0	0	0	0	0	0	1	0	0	0	0	0	0	0	1	0	0	1	0	0	1	0	2	0	0	48	0	0	0	1	0	0	0	8	1	1	1	1	1	40	0	51	17	2	0	0	7	0	10	0	0	4	57	0	8	0	0	61	3	37	1	0	1	0	0	1	1	1	6	2	0	0	4	5	0	1	7	0	2	0	0	5	0	9	0	14	0	5	0	11	0	4	2	15	1	7	3	0	1	2	1	2	10	5	2	3	3	7	0	0	2	14	0	4	20	1	1	1	3	21	4	2	0	0	0	27	14	14	3	0	0	10	0	8	4	1	3	0	3	29	0	0	127	0	1	5	0	5	0	107	4	17	15	6	0	2	0	3	2	8	10	16	1	1	1	1	6	4	11	0	17	28	20	8	39	58	24	5	0	1	5	16	0	8	0	0	0	1	0	0	0	0	4	0	1	0	0	0	1	0	0	0	16	2	12	0	0	0	0	5	2	0	17	0	16	4	0	0	0	2	7	0	1	0	0	0	0	3	0	0	0	4	0	3	0	0	5	0	0	0	4	0	0	0	0	0	0	0	0	0	0	0	0	2	0	0	0	0	0	1	10	0	0	0	1	0	0	1	8	0	0	0	19	1	1	0	0	0	22	0	0	0	0	0	0	0	0	0	2	0	2	0	0	0	0	0	0	0	3	0	0	4	0	0	0	0	0	6	0	24	0	4	0	1	0	0	0	0	0	0	24	0	2	4	0	0	1	0	0	0	0	0	0	0	0	0	0	1	0	0	0	0	1	16	13	0	10	13	0	0	0	0	0	0	1	1	238	0	6	6	65	0	0	4	0	3	3	6	0	0	2	15	0	0	0	1	0	2	4	10	179	0	2	36	2	0	0	0	0	0	0	0	0	0	0	0	0	1	0	0	0	11	2	0	0	11	10	0	2	1	0	2	0	0	0	0	14	8	9	6	20	23	0	9	8	688	0	12	10	0	12	0	1	4	8	0	0	0	0	0	0	8	2	0	0	0	0	11	6	2	0	0	2	0	0	0	0	0	1	0	0	19	14	6	1	0	23	0	0	0	1	0	0	1	1	3	2	0	3	9	2	1	8	0	6	0	67	0	0	0	1	3	0	5	0	12	0	2	3	1	2	9	0	0	14	4	9	2	155	18	0	0	0	0	0	0	0	0	0	0	0	0	0	0	0	0	6	8	9	0	0	0	3	2	1	11	0	5	0	0	2	12	1	4	1	0	0	0	4	8	14	37	14	1	0	0	0	1	13	0	0	0	0	0	1	40	33	27	0	10	0	0	3	3	2	0	0	0	0	1	9	34	2	40	10	4	2	15	64	0	8	2	2	2	0	3	3	9	21	4	1	1	21	19	0	0	0	2	0	0	0	22	0	0	12	0	0	0	0	0	0	0	29	3	6	0	0	0	0	0	0	0	0	1	0	2	1	0	0	0	3	7	1	24	2	8	0	0	0	1	0	4	16	0	0	7	0	1	0	1	0	0	360	10	0	32	0	2	0	5	12	0	0	1	1	0	7	0	1	0	0	0	0	0	0	3	8	0	7	4	4	4	0	0	0	0	10	1	0	98	1	0	0	17	0	0	13	0	5	4	0	4	38	0	0	0	0	0	13	6	0	0	2	2	1	2	0	0	1	1	0	0	0	8	22	3	3	0	0	0	0	5	0	0	0	0	1	0	12	6	0	39	2	3	64	17	24	62	9	9	22	9	16	3	39	6	37	48	12	24	11	0	3	0	1	0	8	0	1	0	0	1	1	4	0	0	0	0	0	0	1	3	0	0	0	0	2	1	0	0	8	0	0	0	0	0	0	0	0	0	0	0	0	0	0	0	0	0	0	0	0	0	0	0	0	0	0	0	5	1	0	0	0	0	0	2	0	0	0	0	0	0	0	0	0	0	0	0	0	0	0	0	0	0	3	2	0	11	4	0	1	8	0	0	0	13	21	16	16	1	18	34	5	0	5	0	1	1	0	0	0	0	0	0	0	8	17	0	17	1	5	0	0	0	7	1	5	0	0	0	0	3	1	0	0	0	0	0	5	1	0	1	0	0	8	6	12	3	1	0	3	7	2	0	7	27	1	0	1	0	2	0	0	2	12	0	0	0	0	0	0	0	1	1	3	0	0	42	3	0	1	0	35	0	0	0	0	7	0	1	1	73	3	5	4	0	1	66	0	0	0	1	1	0	6	0	0	21	0	0	3	1	0	15	3	4	0	6	13	2	0	1	2	0	0	0	4	0	2	2	1	7	14	0	2	0	2	0	11	1	0	1	3	12	3	8	2	0	1	2	20	0	2	0	0	11	0	1	0	0	4	0	0	5	2	1	0	1	2	0	0	0	0	0	3	1	1	0	0	1	1	0	0	0	0	0	0	0	0	0	4	0	0	0	0	0	0	2	1	1	0	14	1	1	1	0	0	0	4	3	3	3	0	15	0	0	134	6	14	5	4	0	5	135	84	0	11	14	0	0	0	5	9	0	0	0	4	0	8	12	6	0	0	3	0	2	3	5	10	0	0	3	7	23	4	0	1	0	0	0	0	49	0	1	0	1	5	0	0	0	0	0	0	1	81	16	33	5	4	0	12	3	3	0	0	0	0	0	0	0	0	0	2	0	11	0	3	7	3	0	17	0	119	15	0	0	0	15	11	8	90	7	11	15	10	57	2	20	41	2	0	0	0	0	0	0	2	420	64	19	0	4	0	2	0	0	15	1	0	2	5	0	0	0	17	85	0	0	0	34	35	27	18	2	24	0	4	24	0	1	53	0	0	17	3	2	1	0	0	0	0	0	0	12	1	0	1	0	0	0	0	0	0	0	0	0	0	0	0	46	0	0	0	0	8	14	9	0	0	3	1	4	6	0	0	0	23	9	3	0	19	1	6	5	0	1	5	11	1	13	9	0	0	22	5	17	4	13	24	16	0	2	3	84	3	24	39	0	0	0	0	0	0	0	0	1	0	0	0	3	0	0	0	0	0	0	0	3	0	1	0	1	1	2	0	0	5	0	0	0	0	0	0	7	0	0	0	4	1	1	11	6	1	2	0	1	0	0	1	0	0	1	0	0	0	0	0	1	0	0	0	0	0	0	0	0	0	0	3	0	0	3	0	2	0	1	0	0	5	0	15	0	0	2	0	0	3	1	0	8	0	0	1	1	0	0	0	0	1	3	13	9	0	0	6	9	23	0	8	0	159	0	81	127	1	2	0	0	1	0	1	0	1	30	736	14	5	1	1	26	5	9	7	6	2	3	0	1	3	0	0	3	17	0	0	0	154	0	0	7	1	0	1	0	0	0	0	7	0	0	0	0	0	0	0	0	0	0	0	0	0	0	0	0	0	0	0	0	0	0	0	0	0	0	2	2	0	8	3	0	22	0	9	12	23	14	0	0	0	0	0	0	0	0	2	17	0	0	9	7	0	0	0	0	0	13	0	7	2	7	0	0	0	0	1	0	0	0	0	0	0	0	0	2	1	1	1	0	2	8	1	1	1	2	0	0	2	0	0	12	15	1	0	2	2	5	0	9	2	0	3	4	0	2	0	12	3	3	1	0	1	0	0	0	1	1	0	1	0	60	0	2	0	1	2	4	0	0	0	0	0	0	0	0	0	0	2	1	0	7	12	0	0	0	0	0	3	0	0	3	0	5	5	1	1
LakWasMet39_LOW7_2_rpkm	0	0	0	0	0	14	7	0	2	0	0	8	1	0	1	0	0	1	4	0	0	0	0	43	1	1	0	0	0	11	0	8	0	6	0	12	1	0	0	1	0	0	0	4	33	71	54	28	0	19	0	17	0	0	0	0	2	5	39	15	60	0	0	1	0	0	0	0	2	49	0	0	0	0	0	0	0	0	0	0	0	12	0	0	0	0	0	2	0	0	0	0	26	2	16	0	0	0	0	0	0	0	0	0	0	0	0	0	0	0	0	1	73	2	47	0	0	0	0	0	0	1	0	1	0	0	2	0	0	0	1	34	2	0	1	4	0	0	5	0	0	0	0	3	0	0	0	0	19	0	4	53	3	1	166	0	1	1	25	1	6	1	0	1	3	0	0	2	0	4	0	0	0	0	0	0	0	0	0	0	0	0	0	0	0	1	0	0	0	3	4	2	6	18	1	0	0	39	36	62	1	0	4	0	0	0	8	0	5	1	11	8	57	36	23	0	1	0	0	0	0	5	4	0	0	3	0	1	25	0	0	0	0	0	1	0	46	8	44	1	0	0	27	1	24	6	0	0	4	23	3	16	17	0	1390	80	0	1	0	0	0	0	0	30	5	0	2	1	3	55	10	0	1	0	0	0	0	0	11	6	0	48	5	41	40	0	0	0	17	1	0	0	0	1	2	0	0	2	3	0	0	67	46	0	4	0	7	11	7	0	5	0	52	6	0	0	3	0	0	0	0	0	0	0	51	83	0	0	1	0	0	0	0	0	0	0	0	0	0	0	0	0	80	5	12	0	18	0	0	0	2	1	0	0	1	0	0	0	0	21	4	0	6	0	1	23	3	55	5	3	1	66	0	0	3	2	0	2	0	0	0	0	4	0	0	0	70	0	0	0	0	0	285	0	0	7	17	0	0	62	0	35	0	1	50	0	0	0	0	0	0	10	19	2	0	27	15	3	0	0	0	0	0	0	0	0	0	0	0	0	0	0	0	1	0	1	0	0	9	0	55	8	0	0	2	40	2	0	0	0	1	78	4	63	0	9	13	1	0	2	0	1	1	15	4	15	9	0	0	3	56	8	22	1	0	0	9	1	138	0	16	0	0	0	0	0	0	35	7	1	0	0	60	20	2	0	0	0	0	0	0	1	6	0	0	0	0	0	0	0	0	0	0	0	1	0	1	0	0	1	1	0	0	0	0	0	0	0	0	0	1	0	0	0	11	0	11	0	0	31	0	2	0	45	7	0	0	0	0	0	0	0	1	0	0	6	0	0	0	1	0	0	0	0	22	0	6	0	31	1	0	0	0	0	5	7	13	99	0	10	23	131	16	9	35	0	5	0	5	0	0	0	3	0	1	0	0	0	1	0	28	2	0	1	6	29	0	44	0	2	0	196	25	106	0	0	53	1	87	4	43	17	67	7	0	6	0	3	0	2	5	3	0	0	0	0	0	0	1	0	0	120	0	0	0	1	0	8	5	1	15	0	5	14	3	0	0	0	0	1	1	31	0	58	0	0	0	0	4	6	3	18	0	1	2	0	3	0	0	0	1	0	2	1	1	0	0	0	0	23	0	0	8	0	0	0	0	3	0	0	0	0	0	14	1	2	0	0	61	0	0	0	1	0	2	5	0	0	1	0	0	0	2	5	0	0	2	1	15	0	0	0	0	0	0	0	0	0	0	24	0	54	2	0	6	35	2	0	0	11	0	0	0	0	1	3	0	0	16	1	0	1	0	32	0	0	1	0	0	0	0	0	0	0	0	90	0	0	0	0	0	0	15	0	0	0	26	0	0	2	1	2	0	0	0	1	11	0	1	11	0	0	0	0	51	0	1	0	0	0	0	0	0	0	0	0	1	0	0	0	0	0	0	5	18	0	3	2	2	0	2	0	0	1	0	0	1	29	34	0	0	0	0	0	0	0	0	4	78	4	1	0	11	2	0	0	1	0	0	5	30	1	0	0	0	0	1	0	0	1	0	0	0	0	0	0	0	6	3	15	0	0	0	1	0	4	6	0	0	0	0	0	0	0	1	1	0	0	0	0	0	0	0	1	0	0	1	0	0	1	0	0	0	1	33	25	48	11	19	0	0	0	0	0	0	0	0	0	0	0	8	0	0	0	0	0	1	0	0	30	0	0	0	11	6	0	5	9	0	0	0	0	0	0	0	0	0	0	1	0	0	0	1	0	0	3	0	2	0	0	1	1	12	34	19	33	1	0	0	0	40	12	3	0	8	0	0	1	1	0	0	0	1	0	0	0	0	2	4	0	0	0	0	0	0	0	0	0	0	0	0	0	0	0	0	0	0	79	0	0	0	75	1	0	18	3	0	0	2	3	2	0	0	0	0	0	0	0	27	1	0	0	0	1	0	0	0	1	0	0	0	0	0	2	2	0	1	0	0	0	1	1	0	3	1	0	0	0	20	2	21	0	2	0	1	0	4	1	0	31	0	0	0	0	0	0	0	0	1	15	0	0	0	0	0	0	0	0	0	0	0	0	0	0	0	8	59	0	1	67	0	0	0	0	10	0	0	2	9	1	2	5	0	0	1	0	8	18	20	0	3	0	5	0	0	16	1	1	0	0	0	0	0	3	0	0	0	0	0	0	0	0	0	0	4	0	0	0	0	1	0	0	0	0	0	0	0	0	0	0	45	5	0	0	1	0	0	0	0	0	0	0	17	0	0	0	0	1	0	0	0	1	7	72	239	34	1	0	0	17	1	0	0	2	0	1	1	0	0	0	0	0	4	0	1	0	0	7	0	0	0	0	14	0	0	0	0	0	9	0	0	1	0	0	1	0	0	11	58	0	0	0	1093	2	0	0	0	0	0	0	0	0	0	87	181	0	0	6	0	1	10	0	0	38	0	1	0	0	0	0	0	2	2	11	1	6	12	106	0	139	2	1	1	1	0	5	0	0	12	0	0	0	0	0	0	5	0	0	0	12	0	0	2	0	0	3	0	0	0	28	1	1	0	0	1	0	0	0	0	0	0	0	10	0	0	0	0	0	2	0	0	0	0	33	9	0	76	6	55	3	0	0	11	0	0	0	1	2	4	6	0	0	0	0	0	0	16	13	0	0	0	0	4	0	40	0	11	1	0	3	0	0	7	25	4	3	10	0	3	0	0	0	2	0	31	1	23	33	10	51	16	6	16	0	0	6	2	16	0	0	0	1	1	15	16	0	24	1	0	0	0	1	18	14	0	0	17	0	0	0	0	0	0	10	5	0	0	0	6	1	15	65	2	0	4	0	3	7	0	1	0	1	0	7	5	2	0	0	0	0	0	1	0	1325	39	2	18	0	0	0	0	0	0	0	2	45	2	0	0	31	0	0	0	0	108	23	9	11	0	0	0	219	0	1	0	0	0	0	0	0	102	5	30	13	64	5	1	86	22	6	0	0	0	0	0	0	29	0	0	0	0	17	0	15	0	0	0	0	0	12	0	2	0	0	0	1	10	0	0	1	0	0	0	0	3	2	0	0	0	0	0	4	0	0	0	0	0	0	1	3	0	0	23	0	0	0	0	0	1	1	0	0	1	3	0	0	0	0	0	0	0	0	0	0	0	0	0	0	0	0	0	0	1	0	0	0	0	74	0	1	18	0	0	0	0	261	0	49	35	0	0	174	0	9	1	1	0	1	0	1	7	0	3	0	0	6	0	0	1	0	0	2	18	0	0	0	13	1	1	0	0	0	0	0	0	0	0	2	0	57	4	25	0	0	2	5	0	0	0	2	1	0	0	3	0	1	0	0	1	0	0	0	2	12	16	0	9	8	0	0	0	2	0	8	4	10	0	0	4	0	0	0	0	0	0	0	3	0	30	5	55	115	117	71	76	5	0	0	0	0	9	9	0	0	0	3	83	0	0	0	5	3	3	0	0	21	62	0	83	3	0	0	0	1	2	2	0	0	187	44	45	0	0	0	0	4	0	109	0	92	10	0	0	0	39	1	0	82	2	17	1	0	0	20	0	19	37	66	6	21	0	1	0	17	1	2	0	0	3	1	7	0	65	0	0	0	0	0	0	1	2	5	2	6	0	0	0	2	0	3	0	220	0	0	0	0	0	0	0	0	0	0	8	0	165	79	0	3	39	6	0	6477	3	0	3	0	0	0	0	0	0	0	0	0	1	1	0	0	0	150	1	0	0	0	0	0	1	0	0	70	0	1	0	0	0	6	0	0	0	0	1	0	10	1	1	0	30	0	0	0	0	0	0	0	26	0	0	22	2	0	1	0	158	38	0	6	0	49	136	0	28	1	75	3	10	2	4	1	11	3	0	10	0	0	0	0	0	0	0	0	0	0	0	0	0	0	34	0	0	5	0	3	67	0	0	1	0	0	0	0	1	0	0	0	2	0	0	1	0	0	31	12	5	1	0	0	0	0	0	0	0	0	0	1	1	0	0	0	0	0	0	0	0	2	0	0	0	0	8	0	0	0	0	2	0	1	11	0	0	0	0	0	75	0	5	0	1	0	1	0	0	1	3	10	408	5	1	0	1	0	1	0	0	0	0	4	0	0	8	2	1	1	0	3	0	0	0	0	0	1	0	0	1	3	4	1	15	4	1	38	1	1	0	0	54	61	96	0	0	0	0	0	0	0	0	0	0	0	1	0	11	0	0	1	0	0	0	0	0	0	0	0	0	0	0	0	1	0	0	0	1	0	2	37	16	0	0	0	0	0	0	0	59	0	0	8	4	0	0	0	0	5	0	0	5	0	0	3	3	0	0	3	0	0	0	26	0	3	0	0	0	0	0	0	0	0	0	13	0	0	0	0	0	28	0	0	2	23	0	27	29	30	1	0	2	0	0	0	13	0	43	2	0	0	0	0	1	1	0	2	0	0	0	0	0	0	0	0	1	1	0	2	0	0	0	0	0	1	0	0	0	0	3	43	0	0	0	0	0	0	0	0	0	0	0	0	0	0	0	0	2	0	0	1	0	2	6	0	0	16	0	0	1	917	0	11	42	78	9	11	1	0	16	3	0	0	0	0	0	1	103	0	0	0	0	0	0	0	1	0	11	0	5	0	0	0	0	10	0	0	13	2	4	0	0	1	0	0	0	3	0	0	0	1	0	0	2	0	0	0	0	1	0	0	19	4	0	11	0	0	0	0	5	4	0	0	0	0	0	0	0	0	11	0	0	0	0	3	16	0	0	0	0	0	1	0	0	2	2	2	1	0	0	0	0	1	0	0	0	0	0	1	0	0	0	0	0	0	0	0	1	0	0	0	0	0	0	3	0	0	4	0	1	0	3	0	32	0	3	0	0	0	0	0	0	16	9	0	0	0	0	0	21	105	38	94	108	23	73	58	5	26	17	33	28	25	4	18	8	177	42	0	5	0	244	180	137	109	137	75	37	8	39	2	10	15	0	1	0	0	0	0	0	0	1	0	16	137	0	0	0	0	0	0	0	0	0	0	0	0	0	0	0	0	0	0	0	0	6	0	14	0	2	2	0	0	0	0	195	0	17	3	3	0	0	0	0	0	0	0	0	0	0	24	0	0	0	0	5	12	0	16	1	0	0	6	0	0	0	1	0	0	1	0	0	0	0	0	26	0	0	8	0	0	0	0	0	0	0	0	0	0	0	5	0	0	0	0	0	0	2	0	0	0	0	0	0	0	0	0	0	2	1	19	0	0	8	2	0	0	0	0	0	1	0	0	1	0	0	0	0	7	11	0	0	0	0	0	0	0	20	16	29	2	8	4	2	4	5	4	3	316	7	3	1	1	0	0	0	0	0	0	6	0	4	10	0	0	0	0	0	1	0	4	0	0	0	0	1	0	0	1	0	0	0	1	0	0	1	0	0	0	0	0	1	0	1	0	0	12	0	4	0	319	1	1	0	3	0	0	0	5	0	0	0	0	0	0	0	0	10	0	121	4	0	1	0	0	13	0	2	123	11	0	1	1	0	39	1	4	1	0	0	0	1	0	1	0	0	5	0	0	0	0	0	0	0	0	2	0	1	0	5	0	0	0	0	0	0	0	0	0	0	0	2	0	0	0	0	0	13	0	0	0	0	2	0	2	222	150	1	0	3	0	0	0	0	0	0	1	0	0	0	0	0	0	0	0	25	1	0	7	0	1	0	2	0	0	1	0	38	17	2	0	0	0	107	0	0	0	0	0	0	0	0	0	0	0	0	0	82	7	0	0	0	0	0	0	0	0	0	1	42	3	4	1	0	1	0	0	15	2	0	2	0	0	0	0	0	0	0	0	1	1	0	1	368	1	0	0	0	0	1	1	1	0	0	0	0	0	0	0	1	0	0	0	0	0	0	0	0	0	1	0	0	13	0	0	0	0	0	0	0	1	3	0	39	0	1	25	0	3	0	0	2	2	12	1	1	32	0	37	3	0	0	0	0	0	0	0	1	12	0	0	0	0	0	0	63	0	1	2	32	1	0	8	6	1	0	0	0	3	0	5	1	2	0	14	25	6	13	1	1	2	0	0	0	4	1	0	0	17	0	25	0	77	72	85	91	64	23	26	0	0	13	10	16	0	72	0	0	0	2	12	1	68	3	1	0	2	40	16	0	0	0	0	0	0	5	0	0	0	0	4	6	0	0	0	0	35	0	0	0	0	0	0	0	0	12	0	0	14	0	2	3	0	0	0	1	0	0	0	0	1	1	1	0	4318	0	1	29	30	7	0	16	0	2	0	0	0	429	0	0	0	0	0	231	0	13	0	0	0	0	0	0	0	0	1	1	0	8	18	0	82	0	2	0	0	0	17	37	0	0	0	4	1	1	2	0	0	7	0	3	0	0	0	32	0	0	0	47	6	0	1	0	0	0	0	880	142	167	1	0	0	0	1	0	4	1	71	0	0	0	1	0	6	4	517	97	1	0	0	0	0	0	0	175	2	1	0	0	0	0	0	1	1	0	0	0	0	0	0	0	0	0	0	0	0	133	399	0	0	1	0	0	0	2	7	6	0	0	0	0	0	43	3	0	1	0	0	0	0	0	24	0	1	0	0	1	0	1	1	14	4	0	2	0	6	0	0	0	1	0	1	1	2510	0	0	0	4	2	0	0	0	0	0	0	0	0	0	1	6	0	20	0	0	0	0	0	0	0	0	0	0	0	0	1	0	0	0	0	0	0	0	0	0	0	3	0	0	30	0	0	0	0	0	0	0	0	0	0	0	0	0	0	21	0	0	0	0	0	0	58	0	0	0	0	0	0	85	0	0	0	0	0	7	1	24	0	1	3	0	0	15	0	2	125	0	0	6	1	0	0	0	0	0	0	2	107	0	1	1	0	0	0	0	0	0	0	0	0	25	0	0	0	0	0	0	0	0	0	1	14	0	0	0	0	0	4	0	0	1	0	0	0	0	0	13	0	1	0	3	47	19	3	10	0	1	0	0	0	1	0	0	3	2	0	2	0	13	0	14	0	0	0	0	0	0	0	1	0	5	0	4	28	3	0	4	0	5	0	0	0	0	6	0	0	0	0	0	1	35	0	6	7	0	616	0	16	434	0	0	0	0	0	0	0	3	1	51	0	0	0	0	0	0	880	235	0	11	0	0	0	2	0	0	0	0	0	0	0	1	0	0	0	3	13	4	0	0	0	0	0	0	0	15	52	0	19	0	0	0	0	0	0	1	12	5	0	0	0	0	24	0	0	0	1	0	12	1	1368	8	0	55	11	4	0	1	32	0	0	0	22	0	1	20	0	0	0	0	52	0	0	0	1	19	0	0	0	0	0	0	0	0	0	0	0	0	1	72	1	0	0	0	0	0	0	32	0	0	1	0	0	1	0	0	0	0	0	0	0	0	1	1	0	1	16	2	0	6	0	0	2	0	19	3	1	0	0	0	0	1	0	2	3	0	4	0	0	0	1	19	0	9	0	0	0	0	0	0	0	0	0	1	0	0	0	0	1	0	0	0	0	1	0	0	0	0	0	0	0	0	0	0	0	0	0	1	0	0	0	0	11	0	0	0	17	1	0	3	7	0	2	6	0	0	0	0	0	0	0	0	0	0	0	0	0	0	1	0	1	1	0	0	0	61	2	0	2	0	50	0	0	0	35	0	0	0	0	0	0	0	0	74	0	0	0	0	49	0	0	0	0	49	2	0	0	41	1	0	0	0	0	0	0	0	0	0	0	0	1	0	0	33	0	0	0	0	2	0	0	0	52	0	0	0	0	1	0	1	0	0	0	0	0	0	9	0	0	0	0	0	0	0	0	0	2	113	0	0	0	0	0	4	0	1	0	0	0	0	0	0	0	7	0	0	0	0	0	0	0	0	0	0	0	0	0	0	0	0	0	0	0	0	0	0	15	0	0	0	0	0	0	0	0	0	0	0	0	0	0	0	0	0	0	0	0	5	0	0	0	0	0	0	6	0	0	0	0	0	0	0	0	0	3	0	0	0	0	0	0	0	0	0	0	1	1	0	0	2	0	0	0	0	0	0	0	0	0	0	1	0	0	0	0	0	150	0	0	13	0	2	0	0	0	21	0	0	16	0	1	2	1	0	3	1	1	0	0	0	0	2	1	145	336	8	0	0	4	24	0	0	0	0	0	0	0	2	0	0	0	0	1	0	0	1	0	0	0	0	0	2	0	0	0	30	0	0	1	0	0	0	0	0	0	0	0	0	0	0	0	0	1	0	0	0	1	0	0	71	0	57	7	0	0	0	0	0	0	0	0	0	357	1	0	0	0	2	0	0	1	0	1	0	1	1	0	9	2	0	0	0	0	0	0	0	1	4	0	0	0	0	13	4	0	0	0	0	0	0	0	12	1	0	4	1	0	0	0	0	0	0	0	0	0	0	64	2	0	1	0	0	90	0	0	59	0	2	1	0	0	0	0	0	0	0	0	0	6	0	0	0	0	1	0	0	0	0	2	0	0	0	0	0	0	57	0	0	0	0	0	0	0	1	0	0	0	0	0	0	0	0	2	1	1	2	0	1	0	0	0	0	10	0	0	1	0	0	0	0	1	0	0	0	0	0	0	0	0	0	0	4	0	0	0	0	2	0	1	0	0	0	2	0	0	0	6	0	0	0	0	0	0	0	1	10	8	0	5	0	0	0	0	15	0	0	0	0	9	2	0	0	0	0	0	0	23	0	0	1	5	1	1	1	3	0	0	2	0	36	0	1	0	0	0	0	0	0	0	0	0	0	6	0	10	15	0	0	1	66	1	0	33	0	0	0	0	1	0	0	0	1	0	0	0	0	0	0	0	0	0	0	0	0	0	0	39	0	1	0	0	0	6	0	0	0	0	0	11	0	0	0	0	12	0	0	0	0	7	2	2	0	0	0	0	0	0	0	0	0	0	12	0	2	0	49	36	2	123	272	0	0	0	0	54	0	35	14	3	0	0	0	13	67	0	88	0	2	74	0	251	0	4	0	1	2	0	0	4	6	1	4	0	0	4	1	7	23	25	0	0	7	1	5	0	1	1	0	2	2	1	1	0	0	0	0	0	2	5	0	0	0	1	40	0	0	6	0	0	0	0	0	1	0	0	0	0	5	0	0	0	16	0	80	1	122	1	0	0	5	2	32	1	0	0	0	0	0	0	0	0	0	12	250	1	0	0	0	0	0	0	1	2	0	0	0	0	0	0	4	22	0	0	0	1	0	2	8	3	0	0	0	0	0	3	0	0	0	3	0	5	0	1	2	0	3	0	0	0	0	1	4	0	1	0	0	0	0	27	0	0	8	0	12	3	0	0	0	0	0	1	0	1	0	7	0	0	0	0	4	2	1	0	46	69	195	0	4	11	5	57	0	33	32	12	2	34	112	25	0	140	17	31	7	15	1	130	16	83	0	17	0	1	0	19	0	6	0	1	0	0	0	0	0	1	2	0	0	0	0	0	0	36	0	0	40	4	0	0	0	1	0	0	3	0	24	12	1	0	0	0	1	0	41	0	0	0	1	0	4	0	61	10	0	1	0	6	0	0	7	2	11	9	12	0	0	0	0	5	0	19	135	1	40	0	140	0	0	0	1	0	0	0	0	0	0	0	0	0	0	2	5	0	0	0	5	1	0	0	0	1	28	1	0	3	0	8	2	0	0	0	0	1	4	1	545	0	1	0	0	0	0	3	2	1	8	2	0	2	0	0	0	0	0	0	0	0	1	0	12	0	1	61	3	0	0	0	0	0	0	15	0	0	0	0	15	0	0	0	0	12	0	0	45	12	7	8	1	0	0	1	0	0	0	0	0	0	0	19	0	0	0	1	1	0	0	0	0	0	24	0	0	0	3	0	0	0	0	0	0	0	0	51	1	0	0	0	4	0	0	0	9	10	0	0	49	71	29	0	0	0	0	33	0	0	0	0	4	0	0	0	0	0	1	0	0	0	40	1	3	0	56	0	0	0	0	0	0	0	2	4	0	0	1	2	0	0	0	0	0	1	41	0	3	1	0	0	1	16	0	0	0	1	0	0	1	2	0	4	7	0	35	0	0	0	1	9	0	1	26	1	0	0	0	21	0	4	0	0	0	0	0	0	4	0	5	0	0	0	0	0	0	0	0	0	0	0	0	13	0	4	0	0	5	2	0	0	0	5	0	0	1	0	1	0	15	1	0	0	0	0	0	11	0	0	0	0	0	1	0	0	2	9	0	11	0	1	0	1	0	0	0	54	0	3	0	0	0	0	0	17	0	0	0	0	0	0	0	0	1	0	0	1	0	0	0	0	1	19	5	0	0	0	0	0	0	0	0	0	0	1	0	0	0	0	1	9	1	1	0	0	79	15	24	4	0	0	0	0	0	0	0	0	0	0	0	41	6	0	3	0	0	0	6	0	2	11	4	22	1	20	31	2	1	0	0	0	1	4	1	0	1	1	1	0	0	0	0	0	0	0	29	12	0	39	10	16	3	0	0	0	0	153	0	1	0	0	0	0	10	1	0	0	0	0	0	1	0	0	0	0	1	1	0	0	0	10	0	0	49	10	0	0	0	0	51	4	13	8	2	1	2	0	0	13	0	0	0	0	0	0	6197	1	19	0	0	0	2	0	0	16	0	0	0	0	0	0	0	0	1	1	0	55	4	0	0	2	0	0	1	1	1	0	0	0	0	0	3	1	0	0	2	0	0	0	3	2	0	0	4	0	0	0	45	0	0	0	0	1	0	1	0	0	1	32	0	2	1	0	1	0	0	0	2	0	28	7	0	43	0	54	0	4	3	0	0	0	9	0	0	0	0	0	2	0	0	39	19	0	3	0	1	0	0	165	0	4	0	24	0	1	0	2	13	0	1	1	2	0	43	7	0	0	0	0	1	31	0	0	0	0	0	0	80	0	0	0	2	0	0	0	134	16	2	0	0	0	17	0	1	0	0	0	1	2	0	0	0	0	11	0	0	0	0	0	0	0	0	0	0	0	0	0	0	5	0	0	0	0	0	0	0	0	0	0	0	0	0	0	0	0	0	0	0	98	0	0	0	0	0	0	0	0	2	0	0	13	0	0	0	0	0	2	0	0	0	4	0	0	0	0	0	0	3	0	0	0	1	0	0	2	0	0	1	0	46	0	0	0	0	0	1	0	2	0	0	1	0	0	0	2	12	0	0	1	0	0	0	0	3	0	0	11	0	1	6	0	0	0	0	0	6	0	0	3	0	8	0	0	0	0	0	0	0	11	0	0	13	0	0	0	0	0	0	0	1	1	0	0	0	0	0	0	29	0	12	32	0	0	0	0	0	1	1	0	0	0	0	0	0	0	0	0	4	0	0	0	0	531	0	0	0	2	0	0	0	0	0	2	0	0	20	0	0	0	0	0	1	0	0	0	0	0	55	0	0	0	0	0	0	0	0	0	1	2	0	0	0	0	1	1	1	0	0	0	0	0	0	11	7	0	0	0	0	0	1	0	2	0	0	0	0	0	0	0	11	0	6	0	4	0	0	0	0	0	0	0	47	3	0	0	0	0	0	0	2	50	4	29	1	1	2	0	0	1	0	7	1	0	0	3	114	43	48	13	0	6	37	0	46	0	0	0	8	18	0	7	2	0	0	2	1	0	0	0	81	3	1	2	96	508	0	0	0	7	20	15	0	0	0	8	0	0	8	0	4	0	0	1	0	0	0	0	76	0	1	11	0	0	0	0	0	22	0	15	1	7	0	30	0	24	3	0	18	0	2	0	2	26	11	0	0	0	1	0	0	3	0	0	0	0	10	2	25	0	3	0	1	0	32	34	0	2	1	1	170	1	0	0	4	1	0	1	1	0	0	0	1	1	0	1	0	0	0	0	0	0	15	0	22	0	0	0	0	0	3	0	0	0	1	0	0	0	0	0	1	1	0	0	0	0	0	0	1	0	0	0	0	0	0	0	0	0	6	6	0	0	1	0	0	0	0	0	0	0	1	0	9	0	3	1	0	0	2	0	0	1	64	9	0	0	1	1	0	0	0	0	0	0	3	77	0	1	0	0	0	5	1	5	0	3	4	2	1	0	4	0	0	0	4	4	0	0	0	0	0	0	2	0	0	0	0	0	0	0	0	4	0	0	0	11	0	0	28	6	0	1	0	0	0	0	5	3	2	0	14	14	1	0	0	0	0	7	0	0	0	33	1	28	55	0	7	0	0	0	6	0	25	0	0	0	291	0	8	0	2	0	1	0	49	0	0	55	3	45	6	0	43	0	0	0	0	34	0	0	15	0	0	43	8	16	1	12	2	0	0	0	16	0	0	1	0	0	7	0	9	2	0	0	0	0	5	0	0	1	0	0	0	1	1	0	0	0	28	0	18	1	0	63	6	0	0	0	14	0	38	3	4	13	32	1	0	36	4	44	4	80	3	0	0	0	0	21	0	0	4	0	0	1	0	0	0	0	0	0	1	21	3	1	1	46	7	22	0	533	1	2	0	0	1	0	0	0	0	0	0	0	0	0	0	0	3	0	0	26	36	2	0	1	0	0	0	0	0	0	1	1	69	0	0	0	0	0	1	2	0	0	1	0	36	0	0	1	1	2	0	47	37	17	14	1	0	21	0	0	0	82	15	0	0	0	0	2	0	0	11	0	1	0	52	8	12	4	0	0	13	0	0	51	31	0	36	0	3	1	2	0	1	0	0	65	54	40	2	0	6	1	1	0	0	0	0	0	0	0	14	5	0	0	1	2	0	42	167	25	0	1	4	115	0	0	0	0	2	0	3	0	1	0	1	0	5	41	10	1	2	0	8	4	0	1	0	0	0	0	12	26	1	6	5	0	2	0	103	0	22	25	27	6	12	9	0	3	151	75	0	13	0	0	0	37	12	1	0	1	0	0	0	0	0	0	1	1	0	0	0	0	0	1	14	4	215	304	42	4	4	15	0	57	46	38	0	0	25	0	0	0	0	0	0	0	0	0	3	2	2	0	0	0	0	1	0	8	0	0	2	0	0	0	8	0	51	0	0	69	2	19	1	29	6	13	46	1	2	0	4	0	0	599	84	5	0	0	0	7	0	22	0	2	1	0	0	4	14	2	0	3	0	0	0	0	26	13	0	1	0	0	0	1	0	0	4	0	0	0	0	0	15	1	4	3	93	3	0	0	0	0	0	11	0	6169	0	7	0	6	8	14	0	0	0	0	0	0	0	0	0	14	0	9	0	0	0	0	0	0	6	3	3	0	0	63	0	0	2	0	0	0	1	0	0	0	21	0	0	0	0	0	0	0	0	0	3	0	0	0	0	0	0	0	0	0	0	0	0	0	0	0	9	2	0	36	1	0	15	0	0	0	0	4	42	0	0	7	0	0	0	0	1	35	0	0	6	0	0	0	0	1	0	0	0	255	5	0	38	29	0	1	0	0	4	0	53	20	20	3	0	0	0	0	6	0	0	64	0	0	0	0	74	0	0	0	2	0	0	0	0	0	0	0	0	0	2010	6	15	0	1	481	1	7	93	9	26	3	631	440	559	200	34	23	23	0	4	76	53	58	13	11	1	0	0	945	4	1	1	1	0	76	3	0	0	254	0	0	0	0	0	3	0	36	0	3	0	20	28	82	29	31	30	24	4	35	0	2	0	52	5	18	37	0	0	0	0	0	0	0	0	0	0	12	0	0	3	2	44	0	0	19	0	0	0	0	0	9	1	0	0	10	0	0	19	8	0	0	0	0	0	12	0	2	0	2	7	16	5	0	29	1	0	0	8	61	311	0	0	4	16	15	1	7	8	0	3	0	27	1	0	14	0	0	7	1	20	86	3	0	29	6	78	6	0	0	10	4	0	0	53	2	6	1	0	0	32	0	1	2	1	3	0	11	25	0	0	14	0	0	2	1	0	0	1	0	0	12	1	0	23	0	0	4	0	0	489	29	21	0	0	0	4	0	7	9	0	6	0	0	0	27	1	0	16	16	0	14	5	13	7	26	7	4	0	1	1	4	8	8	20	74	38	26	1	0	0	0	3	0	0	1	0	2	0	3	1	0	0	0	0	0	9	64	8	0	6	0	0	0	0	0	0	8	20	0	0	0	1	0	0	0	1	0	0	0	0	0	0	0	0	0	0	10	0	0	1	0	0	0	45	13	0	0	0	10	1	0	0	0	0	0	0	0	16	0	0	0	0	0	0	0	4	0	1	3	12	8	0	7	0	0	0	0	0	0	0	0	0	147	0	0	0	0	0	0	37	4	12	0	1	0	0	0	6	0	17	1	6	4	0	0	1	0	0	0	0	0	0	0	8	102	103	68	96	4	83	48	3	113	0	98	16	16	9	269	852	334	217	397	56	37	91	96	1	34	0	0	17	20	12	9	14	410	12	114	268	4	135	9	338	51	10	229	7	77	60	2	104	0	0	3	0	237	39	0	58	57	159	149	0	3	217	532	710	1502	0	56	74	0	0	0	1	0	12	1	82	0	4	0	585	150	166	2	0	17	0	0	0	0	2	179	4	110	8	38	5	135	4	2	88	0	64	1	47	8	0	0	0	4	0	29	34	5	25	6	21	1	0	1	36	31	3	0	0	0	2	0	0	0	26	0	0	1	1	0	0	0	24	3	0	0	0	0	16	1	0	0	0	0	1	0	0	0	20	0	0	0	0	0	0	0	0	3	2	0	0	0	0	0	1	1	0	3	0	0	3	0	27	29	0	3	24	0	0	3	0	0	0	3	0	1	0	0	0	0	0	0	0	0	0	0	12	0	0	0	0	0	45	1	1	0	0	0	0	0	0	0	0	0	1	0	0	0	0	35	0	0	0	0	2	0	80	5	25	48	0	63	1	62	1	0	0	0	0	1	0	0	0	0	0	0	0	33	5	24	3	2	0	0	0	0	0	0	0	1	15	1	0	7	0	4	0	1	32	38	0	0	0	27	0	0	33	7	49	10	16	0	0	2	0	1	58	1	74	0	0	0	3	13	2	0	3	19	2	46	5	0	1	37	4	1	3	78	104	20	1	1	4	0	22	1	38	2	0	2	0	0	0	0	1	0	0	0	0	0	0	0	22	0	0	31	1	0	0	0	0	0	9	1	2	0	72	0	0	0	0	0	0	0	0	0	70	26	2	0	0	7	0	1	1	0	17	2	4	0	0	4	0	1	0	2	0	0	0	0	0	0	0	8	0	9	1	1	0	0	0	0	1	1	0	14	23	4	0	0	142	1	1	0	0	0	1	0	5	6	3	1	74	25	5	0	0	7	0	1	1	2	0	0	1	0	0	0	0	0	0	0	0	0	2	3	1	1	0	0	53	2	0	0	0	0	0	0	6	0	13	10	13	0	0	0	0	0	0	1	10	0	3	0	0	7	0	1	0	0	28	19	0	0	42	8	3	0	0	54	0	18	4	2	183	0	0	35	0	4	0	0	0	1	0	0	0	48	4	0	24	0	22	0	0	489	0	105	0	0	0	0	0	1	0	0	0	0	0	0	0	0	1	0	0	1	0	0	0	1	0	2	0	1	0	2	13	7	0	0	0	0	33	1	2	0	0	0	111	30	0	2	0	0	13	0	29334	0	0	0	0	1	1	0	7	0	0	0	0	0	0	1	1	21	0	0	0	0	5	1	112	17	0	2	18	2	0	0	0	0	0	0	1	0	21	39	0	8	5	1	0	0	0	1	0	0	2	0	0	2	0	5	9	25	40	43	6	7	18	0	15	3	0	16	0	0	43	1	3	21	0	0	0	1	2	7	0	17	102	18	1	3	0	0	0	0	99	0	0	3	0	58	4	0	42	0	0	5	44	36	0	0	78	6	0	0	0	3	0	0	0	0	0	0	0	54	96	20	106	122	0	3	45	0	59	37	91	83	190	134	25	22	29	60	24	0	20	37	10	1	0	0	0	0	45	31	70	91	44	0	17	0	0	71	26	2	15	3	0	1	0	0	0	0	0	0	0	0	0	2	6	0	5	0	5	1	0	2	12	0	0	0	0	26	17	11	19	1	2	2	4	0	3	0	26	0	4	1	1	0	4	10	24	19	0	8	0	0	0	38	19	0	0	0	1	0	0	0	0	1	0	0	0	0	0	40	1	0	0	22	3	2	0	1	0	0	0	0	0	3	1	21	0	17	0	0	0	45	18	0	1	2	0	289	2	0	14	7	0	2	0	0	0	0	0	0	0	0	1	0	0	0	0	2	0	0	0	0	8	0	9	0	0	0	0	1	0	0	0	1	1	10	0	0	0	0	0	2	0	3	0	0	0	0	1	0	0	0	6	43	0	0	10	0	0	0	0	0	7	0	2	0	154	33	6	0	18	0	0	1	38	29	39	5	1	0	1	2	2	22	0	0	9	0	13	2	10	4	0	0	0	0	0	0	0	0	0	0	22	0	5	21	30	0	0	0	0	1243	4180	0	0	0	0	0	0	1	37	6	63	18	0	9	0	28	36	2	4	4	2	0	31	54	3	32	2	39	0	0	16	11	70	21	9	0	0	1	0	0	0	27	0	0	84	24	0	0	0	0	85	7	1	0	1	2	0	3	1	0	0	0	0	0	6	9	2	0	11	0	0	2	1	0	0	2	0	4	7	0	0	0	0	0	0	0	65	201	47	23	25	13	34	2	43	0	17	7	4	14	0	1	8	1	4	0	1	2	2	0	0	0	13	1	0	1	0	0	0	2	0	6	1	10	0	1	0	4	11	5	0	0	13	0	0	0	0	3	0	0	0	137	0	17	0	0	0	0	3	0	5	1	9	0	0	0	0	2	0	0	0	0	0	1	12	0	1	0	0	0	3	8	0	0	0	2	3	3	0	4	0	1	1	6	0	0	0	0	0	4	0	0	1	0	1	0	0	0	17	0	40	16	69	279	56	42	0	0	0	0	0	0	0	0	0	0	0	0	0	0	0	0	7	97	0	0	0	0	0	1	6	0	0	0	0	0	0	0	0	0	54	0	0	0	5	0	13	2	0	16	2	0	1	1	2	2	4	50	11	0	68	25	21	48	498	981	14	84	0	0	38	0	0	1	4	10	12	0	0	0	0	0	0	481	0	0	1	0	362	0	0	0	0	4	98	0	7	0	0	0	3	3	0	0	2	0	0	0	2	0	1	0	0	0	2	140	9	0	0	0	1	0	0	0	0	29	1	0	0	0	0	0	59	6	1	0	0	0	1	2	0	0	80	6	0	17	2	2	0	1	0	1	0	20	4	15	1	0	2	0	0	0	32	0	1	2	0	14	5	0	0	10	95	22	3	2053	0	0	1	0	0	0	0	99	7	11	0	0	0	0	6	0	6	0	2	0	0	0	0	6	0	6	0	19	9	2	20	1	0	16	317	0	0	1	0	0	3	7	1	0	1	0	1	0	0	15	0	0	0	1	0	0	7	0	0	16	0	3	0	0	0	1	0	0	1	2	20	0	4	0	1	12	1	0	0	0	0	0	5	1	14	22	10	90	17	0	1	23	0	12	60	53	0	0	0	1	0	0	3	0	0	312	0	0	21	36	35	26	0	4	4	0	0	2	4	1	0	57	9	0	1	0	0	0	0	0	21	355	57	0	0	0	0	1	0	0	0	1	0	0	1	3	1	0	0	0	0	0	0	0	0	9	0	0	0	0	2	0	0	0	0	0	2	0	0	0	0	0	0	0	40	0	0	0	0	0	0	0	0	1	0	0	0	0	0	0	0	12	3	15	1	0	7	2	1	0	0	0	0	3	0	0	0	0	15	33	14	48	8	0	3	0	1	3	0	7	8	0	0	0	0	14	1	5	0	0	9	0	1	15	0	1	10	0	1	3	0	0	58	4	0	3	0	0	1	1	0	0	39	4	27	1	31	1	34	4	6	68	1	13	2	0	0	3	0	12	31	47	53	0	54	12	21	1	1	0	4	0	0	0	0	0	2	0	0	0	0	0	0	46	0	0	0	0	0	2	10	0	23	26	3	23	2	0	8	1	71	8	13	17	4	6	66	8	51	0	0	0	0	0	0	0	1	0	49	4	76	13	1	0	23	1	0	0	0	0	0	0	0	0	0	0	0	0	1	5	45	2	4	25	76	1469	9	0	25	0	0	0	1	0	3	0	1	0	0	2	18	0	1	1	4	2	0	0	0	0	0	0	1	29	157	0	29	23	0	2	1	0	0	0	1	0	50	0	2	157	0	0	0	33	0	48	0	0	0	1	3	0	0	0	0	0	0	5	0	0	0	0	0	18	0	0	0	0	0	0	0	0	0	2	1	2	1	0	0	0	0	0	0	0	28	1	44	194	1	21	84	17	31	29	88	58	0	1	0	3	0	0	0	0	0	0	0	0	0	0	0	17	0	1	0	0	20	1	0	0	1	2	0	16	0	0	0	0	13	0	0	0	0	0	0	2	0	0	17	3	0	0	0	0	0	0	0	0	0	5	0	1	0	4	0	6	8	8	18	36	0	0	0	0	0	0	0	0	31	0	76	0	1	6	20	1	131	20	0	0	0	0	1	0	2	0	0	0	0	0	0	0	0	0	0	0	0	0	0	0	0	0	0	0	0	8	1	0	1	0	0	0	0	0	609	0	0	0	0	0	0	0	0	0	24	0	1	0	0	0	0	0	0	0	0	0	0	1	0	0	0	0	0	0	0	0	1	0	0	133	0	0	0	0	1	0	15	0	0	2	0	0	1	0	0	0	0	1	0	3	0	0	2	0	0	3	0	0	0	0	0	0	0	0	10	0	1	3	0	0	0	0	0	0	0	0	0	0	1	0	0	0	0	0	0	0	0	0	2	0	0	0	0	27	1	0	0	0	0	0	0	0	0	0	0	1	3	0	0	2	0	0	0	1	0	2	0	0	4	0	0	0	0	0	0	0	0	0	0	0	0	51	0	0	0	0	0	0	0	0	0	0	0	0	0	0	1	0	0	0	0	1	0	1	8	1	0	0	28	0	0	0	0	0	0	2	4	0	0	0	0	1	29	0	31	2	0	0	0	2	0	2	0	0	1	61	0	0	0	0	50	0	15	0	1	0	0	0	0	0	0	1	2	0	0	2	2	0	1	3	0	1	0	0	2	1	5	0	10	0	1	0	6	1	1	2	19	0	2	1	0	0	1	4	1	13	6	1	0	1	5	0	0	0	3	1	1	14	1	0	0	0	10	12	1	0	0	0	14	9	5	0	2	0	21	0	5	0	0	3	0	1	7	0	0	76	0	1	5	0	1	0	46	1	6	5	0	0	1	1	1	7	3	4	6	1	1	0	0	28	12	8	17	6	13	10	2	16	62	14	2	0	0	2	94	0	3	0	0	0	0	0	0	0	0	9	0	2	0	0	0	0	0	0	1	177	14	5	0	0	0	0	3	94	2	127	0	40	16	0	0	0	25	2	0	0	0	0	0	0	1	0	0	1	8	0	12	0	1	2	0	0	0	1	0	0	0	0	4	0	0	0	1	0	0	0	0	0	0	0	0	0	5	15	0	0	1	2	0	0	1	2	1	0	1	33	0	1	0	1	0	11	1	0	0	25	0	0	1	0	0	27	2	10	0	0	0	0	1	0	0	0	0	0	1	0	0	0	0	0	2	2	65	0	2	0	0	1	0	0	0	0	0	148	0	3	1	1	1	0	0	0	0	0	0	0	0	1	0	0	0	0	0	0	0	2	31	66	1	54	25	0	0	0	0	0	0	0	0	867	0	0	5	41	0	0	1	0	4	2	6	0	0	0	3	0	0	0	3	0	19	5	7	105	0	90	6	66	1	0	0	0	0	0	0	2	0	0	0	0	0	0	0	0	9	0	0	0	6	63	1	2	13	0	1	0	0	0	0	32	3	9	23	54	74	1	51	61	4	0	41	15	2	43	0	1	38	4	0	1	0	0	0	0	26	11	0	0	0	0	50	5	5	0	0	22	1	0	0	0	0	2	0	0	28	36	1	1	0	66	0	0	0	0	0	0	2	3	9	0	5	6	13	2	0	2	0	3	0	80	0	0	0	0	4	0	44	0	30	0	7	4	2	2	8	0	1	5	1	5	4	118	19	0	0	0	0	1	0	0	0	0	2	0	0	0	0	0	0	17	40	6	0	0	0	0	9	20	41	0	2	0	0	10	4	11	29	6	1	0	0	23	20	19	69	8	0	1	0	0	1	9	0	0	0	0	2	0	141	19	19	0	6	0	0	3	1	12	7	0	0	0	1	2	13	4	7	5	27	10	2	19	0	1	0	0	12	0	14	17	9	32	1	0	5	68	46	0	0	0	0	0	0	1	9	0	0	94	0	0	0	1	3	0	3	85	9	4	0	0	0	1	0	0	0	0	0	0	0	0	0	0	0	12	20	2	130	2	7	0	0	0	2	0	39	9	0	0	16	0	0	0	20	0	0	16	2	1	14	0	1	0	18	35	0	0	0	1	0	7	0	0	8	0	0	0	0	0	41	6	0	22	1	19	2	0	0	0	0	7	0	0	19	0	0	0	26	0	0	96	1	9	1	1	20	8	0	0	0	0	0	31	4	0	0	3	1	0	2	1	0	1	1	3	0	0	35	6	17	4	1	0	0	0	1	0	0	0	0	0	1	4	3	1	69	7	2	89	40	121	118	97	8	46	82	148	112	74	85	41	86	13	29	6	0	1	0	0	0	1	0	0	0	0	3	1	11	0	0	0	1	0	0	1	2	0	0	0	0	7	2	1	2	5	0	0	0	0	0	0	0	0	0	0	0	0	0	0	0	1	0	0	0	0	0	0	0	0	0	0	2	17	9	0	0	1	0	0	0	0	0	0	0	0	0	0	0	0	0	0	0	0	0	0	0	0	0	30	25	0	84	6	0	1	20	0	0	0	39	91	106	6	0	5	112	0	0	3	0	0	1	0	0	0	0	0	0	0	19	7	3	6	29	46	0	0	0	20	2	9	0	0	4	0	0	0	0	0	0	2	2	3	0	1	2	0	0	22	4	27	0	11	0	9	17	7	0	16	13	0	0	0	0	0	0	0	9	28	1	0	0	1	0	0	0	2	0	0	0	0	53	12	0	43	0	14	0	0	0	0	3	3	2	0	175	67	5	2	0	0	356	0	0	0	2	6	0	4	0	0	12	0	0	0	13	0	4	71	13	0	16	76	0	0	9	28	0	0	0	5	4	1	17	17	3	11	0	1	0	0	1	14	8	0	0	22	83	22	21	2	5	0	8	15	0	13	1	0	4	0	0	0	0	20	0	0	1	2	13	0	8	1	0	0	0	0	0	19	0	0	0	0	1	0	0	0	0	0	0	0	0	0	0	6	0	0	0	0	0	1	2	1	3	0	0	1	0	0	0	0	7	5	3	26	2	0	28	0	0	64	102	73	26	10	0	5	373	278	3	4	63	1	1	0	5	6	1	0	0	24	0	36	19	2	0	1	3	0	1	1	30	4	0	0	1	6	46	3	0	1	0	0	1	0	24	0	14	16	33	2	0	0	2	0	0	0	1	180	2	75	11	4	0	26	0	6	0	0	0	0	0	0	0	0	0	2	0	192	0	1	3	3	0	17	3	292	7	0	0	0	10	2	8	43	22	2	7	8	40	0	13	13	1	0	0	0	0	1	4	4	205	74	0	0	4	0	1	0	0	40	0	0	1	2	1	0	0	200	26	0	0	0	48	15	5	5	1	21	17	31	55	0	3	25	0	0	6	0	1	0	0	0	0	0	0	0	9	72	0	0	1	1	0	0	0	0	0	0	0	0	0	0	71	0	0	0	0	73	8	12	0	0	0	6	0	2	1	0	0	84	39	3	0	6	3	26	3	0	1	7	119	1	7	4	0	0	11	31	49	46	76	89	83	0	0	3	177	9	11	16	0	0	0	0	0	0	0	0	7	1	0	0	1	0	0	0	0	0	1	0	29	0	3	0	7	2	14	0	0	38	0	10	0	0	2	0	12	0	0	11	42	11	5	37	42	9	14	0	7	0	0	0	0	0	1	0	0	0	0	2	2	0	0	0	0	0	0	0	0	0	0	1	0	1	2	0	4	0	3	4	0	44	0	131	0	0	2	1	0	5	2	0	3	0	0	5	0	0	0	1	0	1	2	16	11	3	0	286	2	11	0	6	0	150	0	66	67	0	2	2	0	10	2	0	0	11	21	828	95	53	22	13	48	24	20	42	34	3	8	0	10	29	0	0	0	7	0	0	0	1	0	1	29	2	0	0	0	0	0	0	5	0	0	0	0	0	0	0	0	0	0	0	0	0	0	1	0	0	0	0	0	0	0	0	0	0	0	4	1	0	39	2	0	54	0	30	80	9	46	0	0	0	4	0	0	0	0	0	1	0	0	63	87	0	0	0	8	0	30	0	7	27	24	0	0	0	0	1	0	2	1	0	0	0	0	0	2	0	1	1	0	3	11	1	1	4	0	0	0	1	0	0	55	7	1	1	8	0	24	0	13	0	0	3	11	0	2	0	22	0	2	0	0	0	0	0	0	0	6	0	0	0	59	9	0	0	3	2	16	0	0	0	0	0	0	0	1	0	1	1	10	0	30	40	0	0	1	0	1	1	0	0	6	0	1	1	2	0
LakWasMet40_LOW7_2_rpkm	0	0	0	0	0	12	28	2	0	1	0	5	4	0	0	0	0	0	7	0	0	0	0	8	0	0	0	0	0	2	0	0	1	1	5	0	1	0	0	0	0	0	0	0	13	13	20	5	0	0	0	2	0	0	0	2	0	7	88	4	275	0	0	1	0	0	0	0	7	32	0	0	0	0	0	0	0	0	0	0	0	27	0	0	0	0	0	2	0	0	0	0	3	3	5	0	0	0	0	0	0	0	1	0	0	0	0	0	0	0	0	0	48	1	24	0	0	1	0	0	0	1	1	1	0	0	1	0	0	0	0	28	24	0	0	0	0	1	12	0	1	0	0	1	0	0	0	0	4	0	1	4	3	0	4	0	2	8	4	1	2	2	0	1	13	0	0	1	0	1	0	0	0	0	0	0	0	0	0	0	0	0	0	0	0	0	0	0	0	9	0	1	1	3	1	0	0	10	1	18	50	0	9	0	0	0	17	1	14	5	4	0	27	3	5	0	15	0	0	2	3	0	12	0	1	14	0	0	2	0	0	0	0	0	1	0	0	10	4	5	0	0	9	5	8	15	0	0	20	3	14	0	2	0	492	277	0	0	0	0	0	0	0	3	9	0	1	0	2	5	19	0	0	0	0	0	0	0	46	38	1	5	29	4	4	0	0	0	1	2	0	0	0	1	1	0	0	1	0	0	0	10	36	2	8	0	12	2	21	0	20	0	14	0	0	0	0	0	40	0	0	0	0	0	2	33	2	0	2	0	0	0	0	0	0	0	0	0	0	0	0	0	3	11	3	0	1	0	0	0	0	0	0	0	0	0	0	0	0	108	1	0	3	0	0	3	7	4	18	0	0	3	0	0	2	3	0	0	0	0	0	0	1	2	0	0	30	0	0	0	0	0	12	2	0	11	64	0	0	5	0	11	0	0	4	0	0	0	0	0	0	2	15	2	1	41	38	1	0	0	0	0	0	0	0	0	0	0	0	0	1	1	0	0	0	0	0	0	2	0	7	28	1	0	11	12	0	0	0	0	0	32	18	189	0	46	14	0	0	15	0	0	0	0	0	9	1	0	0	13	2	10	3	0	0	0	0	3	243	1	11	0	0	2	0	0	0	118	4	7	0	0	21	20	6	0	0	0	0	0	0	0	0	0	0	0	0	0	0	1	0	0	0	0	0	0	0	0	0	0	1	0	0	0	0	0	0	0	0	0	0	0	1	0	8	0	0	0	0	1	0	12	0	3	6	0	0	0	1	0	0	0	0	0	0	10	0	0	0	0	0	1	0	0	6	0	26	0	12	0	0	1	0	0	28	54	43	87	0	29	120	64	44	71	3	0	15	0	1	0	0	0	716	0	1	0	0	0	0	0	9	0	0	0	2	3	0	27	0	8	0	43	67	15	0	0	15	0	50	1	121	33	2	1	0	2	3	8	0	1	2	10	0	0	0	0	0	0	0	0	0	5	0	0	0	0	0	4	1	0	30	0	0	10	0	0	0	0	0	0	3	55	0	382	0	0	0	0	7	16	18	8	0	0	1	0	7	0	0	0	0	0	1	0	0	0	1	0	0	11	0	0	7	0	0	0	0	1	0	4	0	1	0	3	0	0	1	0	4	0	0	0	0	0	3	1	0	0	0	0	0	0	0	7	0	0	1	0	4	1	0	0	0	0	0	0	0	0	0	4	0	2	3	0	13	16	7	0	0	20	0	0	0	0	1	10	0	0	51	0	0	11	1	22	0	1	0	0	0	0	0	0	0	0	0	4	0	0	0	0	0	0	5	0	0	0	1	0	0	2	1	1	0	0	0	0	2	0	0	10	0	0	0	0	154	0	2	0	0	0	0	0	0	0	0	0	14	0	1	0	0	0	0	34	4	1	0	1	1	0	0	0	0	0	0	0	0	10	12	0	0	0	0	0	0	0	0	5	14	11	0	0	0	0	0	0	2	0	0	14	10	1	0	0	0	0	1	0	1	8	0	0	0	0	0	0	0	7	1	38	0	0	0	1	0	0	0	0	0	0	0	0	0	0	1	0	0	0	0	0	0	1	0	0	0	0	0	0	0	0	0	0	0	1	9	16	32	6	10	0	0	0	0	0	0	0	0	0	0	0	35	0	0	0	0	0	0	0	0	53	0	0	0	3	7	0	14	0	0	0	1	0	0	0	0	0	0	0	0	0	0	0	0	0	0	2	0	0	0	0	0	7	6	65	0	8	0	0	0	0	3	1	8	0	22	0	0	0	2	0	0	0	2	0	0	0	0	9	13	0	0	0	0	0	0	0	0	0	0	0	0	0	0	0	0	0	0	26	0	0	0	22	4	0	0	1	0	0	3	1	1	0	0	0	0	0	0	0	129	0	0	0	0	0	0	0	0	9	0	0	1	0	0	1	5	0	0	0	0	0	8	3	0	1489	0	0	0	0	48	2	7	0	0	0	0	0	12	0	6	1	0	1	0	0	0	0	0	0	0	3	0	0	0	0	0	0	0	0	0	0	0	0	0	0	0	4	22	0	7	27	0	0	0	0	3	0	0	3	2	0	0	0	0	0	0	0	65	23	0	0	5	0	0	0	0	9	0	1	0	0	0	0	0	1	0	0	0	0	0	0	0	0	1	0	12	0	0	0	0	0	0	0	0	0	0	0	0	0	0	0	7	7	0	0	0	0	0	0	0	0	0	0	1	0	0	0	0	0	0	0	0	0	26	1	10	17	0	0	0	2	0	0	0	2	0	1	0	0	0	0	0	0	7	0	0	0	0	0	0	0	0	0	0	0	0	0	0	0	74	2	0	0	0	0	0	0	1	4	0	0	3	0	149	5	0	0	0	27	0	0	1	0	0	23	10	0	0	0	0	0	12	0	0	4	0	2	0	0	0	0	0	0	7	3	2	2	0	76	0	4	2	0	2	2	0	1	1	0	0	0	0	2	0	0	0	0	0	0	1	0	0	0	1	0	0	0	0	0	1	3	1	0	0	0	0	0	0	0	0	0	0	0	170	0	0	0	0	0	9	0	0	0	6	8	4	0	6	22	7	9	0	0	3	0	0	0	0	2	0	2	0	1	1	0	0	0	13	5	0	0	1	0	13	0	7	0	0	1	1	8	0	0	7	7	9	3	1	5	1	0	0	0	6	0	11	0	2	1	0	19	1	2	29	0	0	2	7	17	0	0	0	0	4	6	2	0	1	0	0	3	1	7	13	7	0	0	1	0	0	0	0	0	0	2	8	0	0	0	5	1	20	17	1	3	13	0	1	3	2	2	0	0	0	2	7	6	0	0	0	0	0	0	1	72	29	2	3	0	1	0	0	0	0	0	0	70	1	2	0	18	0	0	0	1	26	15	14	16	0	0	0	29	0	0	0	0	0	0	0	0	75	38	8	32	35	19	0	2	28	2	0	0	0	0	0	0	74	0	0	0	0	7	0	4	0	0	0	0	0	1	0	2	0	0	0	0	2	0	0	0	0	0	0	1	12	9	0	0	0	0	0	8	0	0	0	0	0	0	2	0	0	0	1	0	0	0	0	0	0	1	0	0	0	1	0	0	0	0	0	0	0	0	0	0	0	0	0	0	0	0	0	0	0	0	1	0	0	181	0	0	50	0	1	0	0	46	0	6	1	0	0	56	0	5	6	1	1	0	0	0	7	0	6	0	0	0	0	0	2	0	0	8	15	0	0	0	2	0	0	1	0	0	1	0	0	0	0	5	0	30	4	29	0	0	1	15	0	0	0	2	1	0	0	2	1	0	0	0	6	2	1	1	9	6	7	0	9	3	0	0	0	7	0	0	4	5	3	0	12	0	0	0	0	0	0	0	4	0	38	3	14	42	29	26	4	0	0	0	0	1	5	19	0	0	0	37	19	0	0	0	8	2	2	0	0	10	11	0	17	9	0	3	0	5	6	0	2	0	15	0	0	0	0	0	0	0	0	26	0	4	24	1	0	0	0	2	2	1	0	0	13	1	0	1	0	4	15	271	6	24	0	15	0	4	8	2	0	0	4	0	0	0	129	0	1	0	0	0	0	0	5	0	2	0	0	0	0	0	0	0	0	9	0	0	0	0	0	11	5	0	0	0	40	0	218	54	0	4	21	5	0	9073	9	0	4	0	0	0	0	0	0	0	1	0	1	0	0	0	0	4	0	0	0	0	0	1	0	1	0	8	0	0	0	5	0	10	0	0	0	1	5	0	3	0	0	0	4	0	0	0	0	1	0	0	23	0	1	5	17	0	0	0	6	100	0	8	0	8	43	0	18	6	14	1	14	14	39	4	40	18	0	0	0	0	0	1	0	0	0	0	0	0	0	1	0	0	1	0	0	7	0	7	19	0	0	0	0	0	0	0	1	0	0	0	2	0	0	0	0	0	1	0	34	0	0	0	1	0	0	0	1	0	0	0	0	0	0	0	1	0	0	0	0	0	0	0	0	0	0	1	0	0	0	0	0	0	0	0	0	0	0	0	34	0	2	0	1	0	1	0	17	0	13	15	11	0	0	0	0	0	0	0	0	0	0	8	0	0	19	1	2	1	0	5	0	0	0	0	0	0	0	0	1	0	13	7	22	18	0	11	4	0	0	0	4	1	16	4	0	0	0	0	0	0	0	0	0	0	1	0	0	0	0	0	1	0	0	0	0	0	0	0	0	0	1	0	0	0	0	0	0	0	1	209	222	0	0	0	0	0	1	0	3	0	0	3	4	0	0	0	0	1	0	0	2	0	0	0	4	0	0	1	1	1	0	26	0	1	0	0	1	0	0	0	0	0	0	20	0	0	0	0	0	4	0	0	3	8	0	13	16	22	2	0	2	0	0	0	15	0	13	1	0	0	0	0	0	6	0	7	0	0	0	0	0	0	0	0	0	0	0	20	0	0	0	0	0	0	1	0	0	0	12	5	0	0	0	1	0	0	0	0	0	0	0	0	0	0	0	0	1	0	0	0	0	6	0	1	0	4	0	0	0	318	0	0	29	77	20	3	1	0	7	7	0	0	1	0	0	4	16	0	0	1	0	2	0	0	0	0	4	1	3	0	0	0	0	21	0	0	5	0	16	0	0	1	0	0	1	4	0	0	0	0	0	3	0	0	2	0	0	1	1	0	21	8	0	1	2	0	0	0	11	5	0	0	0	0	2	0	0	0	0	0	0	0	0	0	48	1	0	0	0	0	0	0	0	1	0	1	0	0	0	0	0	0	0	0	0	0	0	1	0	0	0	0	0	0	0	0	3	0	0	0	0	0	0	6	0	0	0	1	1	0	7	0	0	0	7	0	0	0	0	0	0	0	0	0	0	0	0	2	669	96	164	116	203	120	77	346	5	274	133	318	140	60	17	114	36	266	117	18	14	2	289	111	114	62	157	22	165	168	127	2	135	13	0	0	0	0	0	0	1	0	0	0	42	17	0	0	0	0	2	0	0	0	1	0	1	0	0	0	0	0	0	0	0	0	3	3	3	0	4	1	0	0	0	0	31	0	1	1	0	0	0	0	0	0	0	0	0	0	0	1	0	0	0	0	1	1	0	2	2	0	0	0	1	0	0	6	0	0	0	0	0	0	0	1	68	0	0	9	0	0	0	0	0	0	0	0	0	0	0	2	0	1	0	0	0	0	2	0	0	0	0	0	0	0	0	1	0	0	1	10	0	0	1	1	0	0	0	0	0	0	0	0	0	0	1	0	0	5	1	1	0	0	0	0	0	0	1	1	0	0	0	0	1	0	0	0	0	6	0	1	1	0	0	0	0	0	0	0	3	0	1	26	0	0	0	0	0	13	0	2	0	0	0	2	0	0	0	0	0	0	0	1	0	0	2	0	0	0	0	0	0	0	0	0	0	7	0	8	0	45	0	1	0	0	0	0	0	1	0	0	0	0	0	0	0	0	1	0	5	7	1	0	0	0	2	1	0	71	3	0	1	2	0	12	0	3	4	2	0	0	0	0	0	0	0	2	0	0	0	0	0	0	0	0	4	0	0	0	0	0	0	0	0	0	0	0	0	0	0	0	0	0	1	1	0	0	8	0	0	0	0	16	0	6	17	89	8	0	0	0	0	0	0	1	0	0	0	0	0	0	0	0	0	0	20	0	1	0	0	0	0	1	0	0	0	0	9	2	1	0	4	0	403	0	0	0	0	0	0	0	0	0	0	0	0	0	17	31	0	0	0	0	0	0	1	0	0	0	3	11	1	2	0	0	0	0	13	2	0	1	0	0	0	0	0	0	0	0	0	1	0	0	26	0	0	0	0	0	2	0	0	0	0	0	0	0	0	0	0	0	0	1	0	0	0	0	0	0	1	0	0	1	2	0	0	0	0	0	0	1	3	0	62	1	1	19	0	4	0	0	0	0	2	0	1	2	0	5	7	0	0	0	0	0	0	0	1	25	0	0	0	0	2	0	33	0	12	7	17	2	0	33	17	3	0	8	0	14	0	16	1	8	0	6	1	8	3	1	0	7	0	3	0	9	0	0	0	5	0	1	0	5	4	4	5	7	3	8	0	1	1	1	0	0	135	0	0	0	1	18	0	5	0	0	0	0	21	1	0	0	0	2	0	0	20	0	0	0	0	2	0	0	0	0	0	126	0	0	0	0	0	0	0	0	10	1	0	0	0	6	1	2	0	0	0	0	0	0	0	2	0	0	0	1458	0	0	12	17	4	0	5	0	4	0	0	0	34	0	0	0	0	0	69	0	54	0	0	3	0	0	0	0	0	1	0	0	1	2	0	34	0	4	0	0	0	18	23	0	0	0	1	0	0	0	0	0	2	0	0	0	0	0	39	0	0	0	16	13	0	0	0	0	0	0	51	491	360	0	0	0	0	3	0	0	2	9	0	0	0	3	0	1	3	177	6	1	0	0	0	0	0	0	9	0	0	0	0	0	0	0	0	5	0	0	0	0	0	0	0	0	0	0	0	0	39	52	0	0	2	0	0	0	0	20	6	0	0	0	0	0	10	0	0	0	1	0	0	0	0	37	1	0	0	0	1	3	0	0	9	0	0	1	1	2	0	0	0	0	0	1	0	1266	1	0	1	0	0	0	0	0	0	0	0	0	0	0	0	8	0	2	0	0	0	0	0	0	0	0	0	0	0	0	0	0	0	0	0	0	0	0	0	0	0	3	1	0	25	0	0	2	0	0	0	0	0	0	0	0	0	0	0	49	1	0	0	0	0	0	15	0	0	0	0	0	0	14	1	0	0	0	0	12	1	31	2	0	8	0	0	9	0	0	7	0	0	17	0	0	0	0	0	0	0	1	14	0	0	0	0	0	0	0	0	0	0	0	0	26	0	0	0	0	0	1	0	0	0	0	6	0	0	0	0	0	6	0	0	0	0	0	1	0	0	5	0	0	0	9	3	0	1	0	0	4	0	0	0	1	0	0	0	0	0	2	0	0	1	2	0	0	0	0	0	0	0	2	0	2	0	19	0	13	0	7	0	7	0	1	0	0	13	0	0	0	0	0	0	4	0	10	19	0	4	0	9	1058	0	0	1	0	0	0	0	1	1	10	0	0	0	0	0	0	107	14	0	1	0	0	0	6	0	0	0	0	0	0	0	1	0	0	0	5	43	5	0	0	0	0	0	0	0	0	10	0	5	0	0	0	0	0	0	0	34	2	0	0	0	0	1	0	0	0	1	0	0	0	3	1	0	3	2	0	0	0	8	0	0	0	9	0	0	0	0	0	0	0	31	0	0	0	0	28	0	0	0	0	0	0	0	0	0	0	0	0	0	23	0	0	0	0	0	0	0	13	0	0	0	0	0	0	0	0	0	0	0	0	0	0	4	2	0	0	0	1	0	2	0	0	2	0	1	3	0	0	0	0	0	0	0	0	2	0	1	0	1	0	0	5	0	1	0	0	0	0	0	0	0	0	0	0	0	0	0	0	0	0	0	0	2	0	0	0	0	0	0	0	0	0	0	0	0	0	0	0	0	0	0	0	0	0	0	0	6	0	0	2	1	0	0	0	0	0	0	0	0	0	0	0	0	0	0	1	0	0	1	0	0	0	0	0	0	2	1	1	1	0	27	0	0	0	2	0	0	0	0	0	0	0	0	4	0	0	0	0	1	0	0	0	0	5	0	0	0	66	5	0	1	0	0	0	0	0	0	0	0	0	7	0	0	68	0	0	0	0	1	0	0	0	692	0	0	0	0	0	0	0	0	0	0	0	0	0	5	0	1	0	0	0	0	0	0	2	0	3	0	0	0	1	0	0	0	1	0	0	0	0	0	0	0	6	0	0	0	0	0	0	0	0	0	0	0	0	0	0	0	0	0	0	1	0	0	0	0	0	0	0	1	0	0	0	0	0	0	0	0	0	0	0	0	3	0	0	0	0	0	0	0	0	0	0	0	0	0	0	0	0	0	0	0	0	0	0	0	0	0	0	0	1	0	0	0	0	0	0	0	6	0	0	0	0	0	1	0	0	0	0	0	0	0	0	0	0	0	0	0	0	0	1	0	0	0	1	0	0	3	0	0	4	0	0	0	0	0	0	0	0	0	0	0	35	10	1	0	1	1	68	0	0	0	0	4	1	1	1	0	0	0	0	3	0	0	0	0	0	0	0	0	0	0	0	0	4	0	1	0	0	0	0	0	0	0	0	0	0	0	0	0	0	0	0	0	0	0	0	0	91	0	9	8	0	0	0	0	0	0	0	0	0	9	0	0	0	0	0	0	0	0	0	0	0	1	2	0	0	0	0	0	0	0	2	0	0	0	2	0	0	0	0	11	0	0	0	0	0	0	0	0	0	1	0	0	0	0	0	0	0	0	0	0	0	0	0	2	1	0	0	0	0	4	0	0	27	0	1	0	0	0	0	0	0	2	0	0	0	1	0	0	0	1	0	0	0	0	0	3	0	0	0	0	0	0	6	1	0	0	0	0	0	0	0	0	0	0	0	0	0	0	0	0	2	0	0	0	0	0	0	0	0	1	0	0	0	0	0	0	1	0	0	0	0	0	0	0	0	0	5	0	2	0	0	0	2	0	0	0	0	0	0	2	0	0	0	0	0	0	0	0	0	0	0	0	23	1	0	11	0	0	0	0	0	0	0	0	0	6	0	0	0	0	0	1	0	11	0	0	1	5	0	0	0	1	0	0	0	0	12	0	0	0	0	0	0	0	0	0	0	0	1	2	0	1	0	0	0	0	4	0	0	5	0	0	0	0	1	0	0	0	0	0	0	0	0	0	0	0	0	0	0	0	0	0	0	4	0	1	1	0	0	2	0	0	0	0	0	10	0	0	0	0	2	0	0	0	0	2	2	12	0	0	0	0	0	0	0	0	0	0	1	3	3	0	8	1	1	11	63	0	0	5	0	206	0	8	64	0	0	0	0	80	224	0	20	0	4	3	0	188	0	4	0	3	1	0	0	11	15	0	15	0	0	5	0	50	73	2	0	0	0	3	7	0	13	0	0	11	3	0	0	0	0	0	0	0	5	9	0	0	0	0	1	0	0	28	0	3	0	0	0	0	0	0	0	1	14	0	0	1	4	0	1	0	9	0	0	0	21	1	2	0	0	0	0	0	0	0	0	0	0	85	34	0	0	3	0	1	1	0	4	3	0	0	0	0	0	0	9	6	0	1	0	0	0	0	19	1	0	0	0	0	0	0	0	0	0	0	0	2	0	0	0	0	9	0	0	0	0	2	0	0	0	0	0	0	0	3	0	0	5	0	6	15	0	0	0	0	0	1	2	5	0	10	0	0	0	0	7	0	0	0	47	11	189	0	14	10	16	129	0	92	49	10	3	298	208	190	0	254	64	270	38	114	5	143	4	194	0	1	0	2	0	7	0	0	0	0	0	0	0	0	0	0	7	1	0	1	0	0	0	18	0	0	4	2	0	0	0	0	0	0	2	0	1	2	1	0	0	0	0	0	37	0	0	0	1	0	0	0	24	2	0	0	0	27	0	0	12	1	3	1	11	0	0	0	0	0	0	2	13	4	5	1	12	0	0	0	0	0	0	0	0	0	0	0	0	0	1	0	13	0	0	0	0	0	0	0	0	0	16	0	0	12	0	1	0	0	0	0	0	2	16	6	0	0	1	0	0	0	0	0	14	0	4	0	0	0	0	0	0	0	1	0	0	0	0	0	38	0	0	50	1	0	1	0	0	0	0	25	0	0	0	0	8	0	0	0	0	1	0	0	2	1	1	1	0	0	0	4	0	0	0	0	0	0	0	0	0	0	0	0	0	0	0	0	0	0	12	0	0	0	0	0	0	0	0	0	0	0	1	19	0	0	0	0	2	2	0	1	2	7	0	0	21	50	13	0	0	0	1	20	1	0	0	0	1	0	0	0	0	0	0	0	0	0	48	6	11	0	8	0	0	0	0	1	0	0	4	1	0	0	0	0	0	0	0	1	0	0	0	0	11	1	0	0	0	14	0	0	0	0	0	0	0	4	0	2	3	0	1	0	0	0	1	28	0	0	4	0	0	0	0	65	0	64	0	0	0	0	0	0	25	0	8	0	0	0	0	0	0	0	0	0	0	0	0	2	1	19	0	0	1	2	0	0	0	3	0	1	0	0	0	0	1	0	0	0	0	0	0	0	0	0	0	0	0	2	0	0	3	2	0	1	0	3	0	0	0	0	0	9	0	0	0	0	0	0	0	0	0	0	0	0	0	0	0	0	0	0	0	0	0	0	0	0	0	2	0	0	0	0	0	0	0	0	0	0	0	1	0	0	0	0	1	1	1	0	1	0	26	57	5	12	0	0	0	0	0	0	0	0	1	0	0	54	2	0	3	0	0	0	11	0	3	2	9	9	7	5	14	1	0	0	0	0	0	5	0	0	1	0	0	1	0	0	0	0	0	0	4	1	0	4	0	2	1	0	0	0	0	89	0	0	0	0	0	0	5	0	0	0	0	0	0	0	0	0	0	0	2	1	0	0	0	0	0	0	16	10	0	0	2	0	1	3	6	1	1	0	1	0	0	1	1	0	0	0	0	0	681	0	4	0	0	0	5	0	0	1	0	0	1	0	0	1	0	0	0	0	0	1	1	0	0	0	0	0	1	0	0	0	0	1	5	0	1	0	0	0	2	0	0	0	0	1	2	1	3	0	0	1	3	0	0	0	0	0	0	0	1	0	0	18	0	2	1	0	0	0	0	0	1	0	3	2	0	0	0	1	0	1	1	0	0	0	0	0	0	0	0	0	0	0	0	2	4	0	0	0	1	0	0	41	0	1	0	23	0	1	0	0	0	0	0	0	3	0	8	2	0	0	0	0	0	22	0	1	1	0	0	0	12	0	0	0	0	0	0	0	65	1	0	0	0	1	0	0	0	0	0	1	0	0	0	0	0	0	13	0	0	0	0	0	0	0	0	0	0	0	0	0	0	0	0	0	0	0	0	0	0	0	0	0	0	0	0	0	0	0	0	0	0	12	0	3	0	0	0	0	0	0	1	0	0	6	0	0	0	0	0	0	0	0	0	2	0	0	0	0	1	0	0	0	0	0	0	0	0	0	0	0	0	1	87	0	0	0	0	0	9	0	1	0	0	0	1	0	0	2	28	0	0	0	0	0	0	0	6	0	0	20	0	1	21	0	0	0	0	0	0	0	0	0	0	22	0	0	0	1	0	0	0	6	0	0	31	0	0	0	0	2	0	0	0	0	0	0	0	0	0	1	4	0	1	6	0	0	0	0	0	1	0	0	0	0	0	0	0	0	0	0	2	0	1	0	0	824	0	0	0	6	0	1	0	0	0	1	0	0	4	1	0	0	0	0	0	0	0	0	0	2	36	0	1	0	0	0	0	0	0	0	1	1	0	0	0	0	0	1	4	1	0	0	0	0	0	6	5	0	0	0	0	0	13	0	3	7	0	0	0	0	1	0	14	0	3	0	66	0	0	0	0	0	0	0	3	2	0	0	0	0	0	0	0	23	17	6	5	0	1	0	1	1	0	1	0	1	0	0	33	2	2	36	0	29	10	0	5	1	0	0	10	2	0	22	0	0	0	2	0	0	0	0	30	5	0	8	125	314	1	0	0	1	3	5	0	0	0	1	0	0	3	0	10	0	0	0	0	1	0	0	6	0	0	4	0	0	0	0	0	36	0	5	1	0	0	11	5	20	6	0	4	0	0	0	4	2	2	0	0	0	0	0	0	1	0	0	0	0	0	0	7	0	6	0	0	0	15	8	2	0	0	0	31	0	0	0	7	0	0	1	0	0	0	0	0	0	0	1	1	0	0	0	0	0	16	1	59	0	0	1	0	0	15	0	0	0	0	0	0	0	0	0	1	0	0	0	0	0	0	0	0	0	0	0	0	0	0	0	0	0	4	0	0	0	4	0	0	0	0	0	0	0	0	0	3	0	0	0	0	0	0	0	8	1	16	26	0	1	0	0	0	0	0	0	0	0	0	97	0	0	0	0	0	3	0	0	0	1	0	1	0	0	1	0	0	0	8	20	1	0	0	0	0	0	11	0	0	0	0	0	0	0	0	10	1	0	0	28	0	0	12	13	0	0	0	0	0	0	15	0	0	0	33	8	0	0	1	0	0	2	0	0	0	0	5	1	2	0	14	0	0	0	10	0	114	0	1	0	305	0	10	0	0	0	0	0	0	0	0	19	1	9	6	0	7	0	0	0	0	11	0	0	2	0	0	2	20	15	5	4	3	0	0	0	3	0	2	0	0	0	3	0	0	0	0	0	0	0	6	0	0	2	0	0	0	1	4	0	0	0	7	0	4	2	0	7	10	1	0	0	22	0	3	3	3	0	20	1	0	10	6	13	11	17	16	0	0	0	0	13	0	0	6	0	1	1	0	0	0	0	0	0	1	3	5	6	2	53	25	115	0	14	0	11	0	0	0	0	0	0	0	0	0	0	0	0	0	0	3	0	0	4	7	0	0	1	0	0	0	0	0	0	4	0	248	0	1	0	0	0	1	9	0	0	0	0	5	1	0	0	0	20	0	19	1	3	0	4	0	22	0	0	0	7	24	0	0	0	0	2	0	1	42	0	0	0	4	2	7	2	0	0	18	0	0	2	1	0	5	0	0	0	2	0	0	0	0	22	31	23	2	0	5	0	0	0	1	0	0	3	0	0	12	11	0	0	14	0	0	25	20	84	0	0	7	13	0	0	0	0	0	0	0	0	0	0	0	0	3	6	20	0	0	0	2	2	1	0	0	0	0	0	8	2	0	3	7	0	9	0	12	0	9	10	11	7	11	1	0	2	134	47	0	6	0	1	0	0	1	9	0	2	0	0	0	0	0	0	0	0	0	0	0	0	0	4	20	21	83	205	3	23	2	0	0	6	6	8	0	0	6	0	0	0	0	1	0	0	0	0	0	0	1	0	0	0	0	0	0	4	0	0	0	0	0	0	2	0	7	0	3	23	1	15	3	0	11	0	12	8	7	0	0	0	0	17	15	24	1	0	0	10	13	1	0	5	2	1	0	3	8	3	0	0	0	0	0	0	29	4	0	1	0	0	0	2	1	0	0	0	0	0	0	0	46	3	2	3	28	6	0	0	0	0	0	13	0	2104	0	0	0	0	49	28	0	0	0	0	0	0	0	0	0	7	2	1	0	0	0	0	0	0	5	0	1	0	0	8	0	0	1	0	0	0	5	0	0	2	8	0	0	0	0	0	0	0	0	0	3	7	0	1	0	0	0	0	1	0	0	0	0	0	0	0	3	0	0	21	10	0	46	0	0	0	0	2	16	0	0	1	0	0	0	0	0	9	0	0	0	0	0	0	0	0	0	1	0	58	7	0	1	94	0	2	0	0	8	0	57	3	13	3	0	0	0	1	2	0	8	145	0	0	0	0	14	0	0	0	0	0	0	0	0	0	0	0	0	0	750	18	4	0	3	1426	0	21	10	17	3	0	70	35	31	6	15	5	1	0	15	191	122	132	17	32	0	0	0	120	1	0	11	0	0	47	19	0	0	1144	2	0	0	0	0	1	1	13	0	0	0	3	1	27	19	4	8	3	8	2	0	2	1	3	11	2	3	0	0	0	0	0	0	0	0	0	0	1	0	0	9	2	3	0	3	13	0	2	0	2	0	0	1	2	0	2	0	0	0	22	0	0	0	0	0	12	0	0	0	6	1	3	6	0	7	5	0	0	21	76	67	0	0	15	21	28	2	14	37	0	9	0	11	2	0	56	0	0	5	6	1	22	10	0	17	14	23	12	0	0	4	7	0	0	34	6	2	0	0	0	21	0	0	6	0	2	0	0	1	0	0	17	0	0	4	0	0	0	0	0	0	2	0	0	5	0	0	1	0	0	142	4	0	0	0	0	5	0	12	1	0	3	0	0	2	214	0	0	34	65	0	4	4	1	0	2	0	7	7	1	0	13	10	19	5	64	18	2	1	0	0	0	3	0	0	0	0	0	0	1	5	0	0	0	0	0	7	3	21	0	4	1	0	0	0	0	0	3	0	0	0	0	0	0	0	0	2	0	0	0	0	0	0	0	0	0	0	1	0	0	4	0	0	0	1	2	0	0	0	2	5	0	0	0	0	0	0	0	2	0	0	0	0	0	0	0	2	0	3	0	2	2	0	8	0	0	0	0	0	0	0	0	0	22	0	0	24	0	0	0	3	19	4	0	0	0	0	0	22	0	1	9	11	5	0	0	0	0	1	0	0	0	0	0	34	31	25	8	1	12	5	19	14	1	0	18	22	39	14	21	116	89	47	66	7	8	4	8	3	3	0	0	2	4	2	16	32	37	47	4	39	21	18	41	14	83	20	6	17	18	11	5	14	0	0	6	0	14	123	0	3	1	44	17	1	14	664	169	13	424	0	216	3	0	1	0	0	0	9	4	44	0	10	0	188	462	53	1	0	21	0	0	0	0	0	64	8	54	6	28	9	126	2	1	88	0	3	0	10	12	0	0	0	0	0	25	4	6	1	19	9	2	0	1	5	3	14	0	0	0	0	0	0	2	6	0	0	1	0	0	0	0	8	1	0	0	0	0	8	1	0	2	0	0	1	0	0	0	0	0	0	0	0	0	0	0	0	1	0	0	0	0	0	0	0	0	0	2	0	0	0	0	0	2	0	2	41	0	0	1	0	0	0	2	0	0	0	0	1	0	0	0	0	0	0	0	17	0	2	0	0	1	1	0	0	0	0	1	0	0	0	0	0	0	0	0	0	0	0	2	0	0	0	0	8	0	19	2	5	20	0	21	1	11	0	0	0	0	0	0	0	0	0	0	0	0	0	7	28	11	2	1	0	0	0	0	0	0	0	0	0	7	0	40	0	2	0	0	7	26	0	0	0	4	0	0	3	13	5	24	2	3	0	10	0	0	3	1	33	0	0	0	8	3	4	0	0	0	9	3	9	0	15	12	5	0	0	12	114	0	4	1	0	0	15	1	5	2	0	17	0	0	0	0	5	0	0	0	0	0	0	0	1	0	0	3	0	0	0	0	0	0	12	1	1	0	23	0	0	0	0	0	0	0	0	0	1	2	5	0	0	16	0	4	0	0	0	6	11	0	0	14	1	3	0	4	7	1	0	0	0	0	0	6	0	6	0	0	0	0	0	0	0	0	0	0	2	12	0	0	42	0	0	0	0	1	0	0	5	9	7	1	44	5	16	0	0	61	0	0	3	5	0	0	3	0	0	0	0	0	0	0	0	0	1	0	0	0	0	76	2	1	0	1	0	0	2	0	4	0	5	1	0	0	0	0	0	1	0	0	19	0	4	0	1	30	0	1	0	0	13	30	0	0	6	26	22	0	0	8	0	4	7	7	301	0	0	16	0	3	0	0	0	0	0	0	0	4	20	0	8	3	6	6	0	151	0	6	0	0	0	0	0	3	0	0	0	0	0	0	0	0	0	0	0	0	1	0	0	0	0	3	0	3	0	1	1	4	0	0	0	0	3	5	5	0	0	0	29	7	0	1	0	0	1	0	19683	0	0	0	0	0	2	0	0	0	0	0	0	1	0	0	0	0	0	0	0	0	22	9	9	55	0	8	0	7	0	0	0	0	0	0	0	0	2	26	0	55	23	0	0	0	0	3	6	0	0	0	0	1	0	16	1	4	3	14	34	71	10	0	5	2	0	19	0	0	18	0	1	13	0	0	0	0	0	4	0	21	24	55	7	4	0	0	0	0	105	0	1	1	0	12	15	0	10	0	0	0	10	9	0	0	21	14	0	3	0	0	0	0	0	0	0	0	0	31	31	37	54	71	0	4	1	0	4	51	8	123	10	2	3	23	1	55	8	0	1	16	10	0	2	0	0	0	11	4	155	23	6	0	0	0	0	5	4	5	1	7	0	0	0	0	0	0	0	0	0	0	3	4	2	1	0	0	3	2	0	2	5	1	1	0	0	8	20	5	1	3	2	11	10	0	2	0	24	0	1	1	3	2	13	1	3	3	0	2	0	0	0	21	7	1	0	0	0	1	0	0	0	0	0	0	0	0	4	41	0	0	0	4	12	1	0	1	0	0	0	0	0	8	0	2	0	8	0	0	0	28	55	0	1	1	0	7	1	0	5	0	0	2	0	0	0	2	0	0	3	0	0	1	0	0	0	0	0	0	0	0	8	0	0	0	0	0	0	0	0	0	0	0	0	8	0	1	0	0	0	0	0	0	0	0	0	0	1	0	0	0	2	16	0	0	0	0	0	0	0	2	26	1	0	0	1	1	3	0	11	0	0	1	79	1	4	4	1	0	0	3	10	10	0	0	2	3	4	1	1	1	0	0	0	0	0	0	0	0	0	1	8	0	0	12	6	0	0	0	0	43	137	0	0	0	0	0	0	5	1	21	22	15	0	17	0	11	14	2	755	7	0	0	3	6	11	13	1	9	0	0	43	0	36	1	0	0	0	1	1	0	0	0	0	0	48	6	1	0	0	1	1	6	1	0	0	0	0	0	0	0	0	0	0	0	12	0	8	0	18	1	3	8	1	0	0	0	0	12	10	0	0	0	0	0	1	0	11	29	6	3	1	4	10	0	42	1	1	1	0	2	0	1	3	0	1	0	3	18	1	0	0	0	5	1	4	1	0	0	0	3	0	1	2	1	0	6	0	9	3	0	0	0	10	0	0	0	0	2	0	0	0	99	0	0	0	0	0	1	5	0	0	0	0	0	0	1	0	1	0	0	0	0	0	3	10	0	1	566	0	0	3	0	0	0	0	0	1	0	0	0	0	0	0	2	0	0	0	0	0	0	0	0	0	0	0	1	0	0	65	0	0	1	6	6	0	1	0	0	0	0	0	0	0	0	0	0	0	0	0	0	0	0	0	13	0	0	0	0	0	0	0	0	0	0	0	0	0	0	0	0	117	0	0	0	0	4	1	4	0	2	9	1	2	3	0	1	2	30	4	1	16	11	9	26	73	9	65	214	0	0	7	0	0	0	9	7	0	0	0	0	0	0	0	81	0	0	3	0	134	0	0	0	0	2	171	0	2	0	1	0	6	5	0	0	0	0	0	0	1	0	2	0	0	0	0	55	28	0	0	0	0	0	0	0	0	5	0	0	0	0	0	0	8	17	0	0	0	0	1	0	0	0	10	0	0	6	15	1	0	0	0	16	1	1	7	24	1	0	0	0	0	0	2	0	0	1	0	58	5	0	0	38	186	3	22	84	0	0	0	0	0	0	0	38	1	5	0	0	1	3	98	0	52	0	28	0	0	0	0	38	0	1	0	64	35	1	72	1	0	36	46	0	0	0	0	0	3	0	0	0	0	0	19	0	0	1	0	0	0	0	0	0	6	0	0	1	0	0	0	0	7	3	0	0	0	1	103	5	17	0	1	50	4	0	0	0	0	0	8	9	1	12	10	42	42	1	0	15	0	3	9	12	0	0	0	0	1	0	7	0	0	117	0	0	1	4	4	5	0	14	0	0	2	0	3	1	0	22	7	0	0	0	0	19	0	0	26	182	12	0	0	0	0	0	0	0	0	0	0	0	0	1	3	0	0	0	0	0	0	0	0	7	0	0	0	0	0	0	0	0	0	0	0	0	0	0	0	0	0	1	20	0	0	0	0	0	0	0	0	0	0	0	0	0	1	0	0	8	6	21	3	0	6	5	0	2	0	4	3	5	0	0	0	0	1	202	2	4	1	3	45	1	1	5	0	17	2	0	0	0	0	1	27	0	0	0	6	0	0	1	0	11	6	0	0	1	0	0	12	19	0	10	0	4	0	0	0	0	3	7	6	7	14	3	5	9	1	16	8	0	3	0	0	0	0	0	5	21	3	0	43	7	7	2	0	0	1	0	0	0	0	0	0	0	0	0	0	0	0	14	0	0	0	0	0	1	1	0	0	3	18	5	12	0	1	2	6	25	1	12	8	0	14	36	25	0	0	0	0	0	0	0	3	1	7	3	31	14	0	0	1	0	0	0	0	0	0	0	0	0	0	0	0	0	3	1	27	0	2	9	5	1633	16	1	2	0	0	0	0	0	1	0	1	0	0	0	5	0	0	0	0	3	0	0	0	0	0	0	0	8	23	0	8	24	0	4	1	0	0	0	1	0	13	0	0	87	0	0	0	3	0	29	0	0	0	2	2	0	0	0	0	0	1	11	0	0	0	0	0	0	0	0	0	0	0	0	0	0	0	2	1	1	0	0	0	1	0	0	0	0	0	0	134	597	0	3	0	1	3	2	3	0	0	4	0	15	0	0	0	0	0	0	0	0	0	0	0	5	0	0	0	0	27	0	0	0	0	1	0	6	0	0	0	0	2	0	0	0	0	0	0	5	0	0	1	8	0	0	0	0	0	0	0	0	0	4	0	0	0	1	0	22	20	32	4	4	0	0	0	0	0	0	0	0	7	0	15	0	0	3	4	0	1	19	0	0	0	0	1	0	0	0	0	1	0	0	0	0	0	0	0	0	0	0	0	0	0	0	0	0	1	0	0	0	0	0	0	0	0	0	25	0	0	1	0	0	0	0	0	0	3	0	2	0	0	0	0	0	0	0	0	0	0	2	0	0	1	0	0	0	0	0	1	0	0	25	0	0	1	0	0	0	4	0	0	0	0	0	0	0	0	0	0	0	0	35	0	0	1	0	0	1	0	0	0	0	0	0	0	0	3	0	1	0	0	0	0	0	0	0	0	0	0	0	0	9	0	0	0	0	0	0	0	0	41	0	0	0	0	1	0	0	0	0	0	0	0	0	0	0	0	0	3	0	0	0	0	0	0	0	0	0	0	0	7	0	0	0	0	1	0	0	9	0	0	0	0	1	0	0	1	0	0	0	0	0	0	0	0	1	0	0	0	0	0	0	0	0	0	0	0	1	0	0	101	0	0	0	0	0	0	3	8	0	0	3	1	1	83	0	47	10	0	0	0	10	0	7	0	0	25	123	0	19	0	0	28	1	3	0	0	4	0	0	1	1	0	4	3	1	0	5	8	0	5	25	0	5	0	0	2	2	15	0	19	0	3	0	0	4	6	1	39	1	19	22	0	1	3	93	7	41	11	2	0	3	6	0	0	3	11	4	8	24	2	2	2	7	39	8	3	0	0	0	50	14	38	3	2	0	19	0	6	1	3	58	0	3	52	0	0	300	0	1	5	0	3	0	94	5	24	10	5	0	3	9	5	6	9	2	13	1	1	1	0	7	0	19	1	12	32	61	17	54	149	35	10	0	0	7	14	0	12	0	0	0	0	0	0	0	0	4	0	0	0	0	0	0	0	2	0	3	5	13	0	0	0	0	4	3	0	8	0	12	3	0	0	0	6	9	0	0	0	0	0	0	10	0	0	0	1	0	2	0	2	9	0	0	0	2	0	0	0	0	1	0	0	0	0	0	0	0	0	0	0	0	0	1	2	155	0	0	0	1	0	0	1	0	2	0	0	14	0	2	0	0	0	31	0	0	0	2	0	0	0	0	0	4	1	3	0	0	0	0	0	0	0	3	0	0	2	0	1	0	0	0	11	2	32	0	5	0	0	0	0	0	0	0	0	19	0	9	3	0	0	0	0	0	0	0	0	1	0	0	0	0	0	0	0	0	0	3	15	15	0	11	14	0	0	0	0	0	0	0	2	49	0	13	12	50	0	0	3	0	4	1	6	0	0	0	21	0	0	1	1	0	2	2	22	380	0	1	8	2	0	0	0	0	0	0	0	0	0	0	0	0	0	0	0	0	11	0	0	0	9	20	0	1	1	0	0	0	0	0	0	9	12	4	5	18	21	0	10	11	444	0	13	11	1	18	2	0	1	7	0	2	0	0	0	0	7	2	0	0	0	0	20	3	0	0	0	1	0	0	1	0	0	1	1	0	15	12	3	1	0	32	0	0	0	0	0	0	0	0	0	0	2	4	5	3	0	25	0	18	0	58	0	0	0	0	3	0	2	0	12	0	0	4	1	3	11	0	0	19	6	11	3	145	45	0	0	0	0	0	0	0	0	0	0	0	0	0	0	0	0	6	0	15	0	0	0	0	7	2	6	0	5	0	0	0	17	2	12	2	0	0	0	1	4	5	26	9	0	0	0	0	0	10	0	1	0	1	2	0	35	68	39	0	16	0	0	3	4	1	1	0	0	0	1	4	58	0	83	2	7	2	8	202	0	1	1	0	2	0	2	3	2	16	9	0	1	28	43	0	0	0	0	0	0	0	27	0	0	7	0	0	0	0	0	0	0	29	3	1	0	0	0	0	0	0	0	0	0	0	0	0	0	0	0	5	2	0	33	4	0	0	0	0	0	0	1	6	0	0	4	0	0	0	0	0	0	8	13	0	52	0	0	0	4	9	0	0	0	0	0	9	0	0	0	0	1	0	0	0	3	20	0	5	1	1	5	0	0	0	0	4	0	0	83	0	1	0	16	0	0	6	0	3	9	0	3	35	0	0	0	0	0	28	8	0	0	2	4	0	6	0	0	0	0	0	0	0	8	31	3	4	1	0	0	0	6	0	0	0	0	0	1	21	3	0	70	2	1	109	45	12	78	1	4	12	8	4	2	34	9	42	32	5	63	6	0	1	0	0	0	12	0	0	0	0	5	2	0	0	0	0	0	0	0	0	2	0	0	0	0	1	0	0	0	2	3	0	0	1	0	0	0	0	0	0	0	0	0	0	0	0	0	0	0	0	0	0	0	1	0	0	1	5	4	0	0	0	0	0	1	0	0	0	0	0	0	0	0	0	0	0	0	0	0	0	0	0	0	1	1	0	3	6	0	0	2	0	0	0	8	6	10	7	0	8	23	1	0	2	0	0	0	0	1	0	0	0	0	0	7	29	0	19	5	7	0	0	0	8	1	5	1	0	0	0	0	0	0	0	0	0	0	7	2	4	2	4	0	6	3	13	2	0	0	1	2	1	0	7	26	2	0	1	0	1	0	0	7	27	0	0	0	2	0	0	0	1	0	1	0	0	25	3	0	0	0	35	0	0	0	0	0	0	0	0	94	3	3	3	0	0	57	0	0	0	4	1	0	5	0	0	88	0	0	0	0	0	20	4	3	0	4	17	0	0	0	16	0	0	0	1	0	1	2	2	3	13	0	6	0	10	0	3	1	0	1	0	1	3	6	0	4	2	11	14	0	4	1	0	22	0	0	0	0	6	0	0	7	4	1	0	3	3	0	0	0	0	0	1	1	0	1	0	0	0	0	0	0	0	0	0	0	0	0	0	0	0	0	0	0	1	3	0	2	0	17	2	0	0	0	0	21	8	19	4	1	0	16	0	0	117	2	22	2	4	0	0	71	89	1	7	17	0	0	0	6	8	0	0	0	3	0	15	8	4	0	0	1	0	0	1	4	6	0	0	0	2	19	13	0	0	0	0	0	0	210	0	0	1	0	1	0	0	0	0	0	0	0	104	8	34	3	7	0	34	2	1	0	0	0	0	0	0	0	1	0	4	0	25	0	0	5	0	0	80	1	216	20	0	0	0	7	13	17	68	16	7	6	11	99	0	32	163	1	0	0	0	0	0	2	1	178	38	6	0	2	0	0	0	0	9	0	0	0	4	0	0	0	9	128	0	0	0	23	34	36	31	3	17	7	4	13	0	0	57	0	0	16	0	0	0	0	0	0	0	1	0	62	1	0	1	0	4	1	0	0	0	0	0	0	0	0	0	63	0	0	0	0	12	12	9	0	0	3	2	2	3	0	0	0	12	12	11	0	21	0	11	2	0	0	0	14	1	17	11	0	0	25	2	6	9	9	13	19	0	8	3	61	4	33	34	0	0	0	0	0	0	0	0	1	0	0	0	2	0	0	0	0	0	0	0	3	0	0	0	3	0	2	0	0	4	0	2	0	0	1	0	4	0	0	2	0	1	0	6	2	1	3	1	2	0	1	0	0	0	0	0	0	0	0	0	0	0	0	0	0	0	0	0	0	0	0	0	0	0	1	0	0	0	1	2	0	3	0	20	0	0	3	1	0	2	1	0	0	0	0	2	0	0	0	0	0	0	2	11	7	0	0	8	9	75	0	10	0	153	0	57	89	0	1	1	0	1	1	0	0	18	59	152	9	4	159	5	31	8	2	5	2	34	41	0	7	2	0	0	6	25	0	0	0	0	0	0	3	1	0	0	0	0	0	0	7	0	0	0	0	0	0	0	0	0	0	1	0	0	0	0	0	0	0	0	0	0	0	0	0	1	0	1	1	0	6	7	0	23	1	7	4	38	14	1	0	0	1	0	0	3	0	0	29	0	0	14	0	1	0	0	2	0	25	0	5	4	13	0	0	0	0	0	0	0	0	0	0	0	0	0	0	1	0	0	0	3	6	2	0	4	0	0	0	2	0	0	11	20	1	0	1	0	4	0	5	2	0	4	7	0	2	0	13	4	2	0	0	0	0	0	0	1	1	0	0	0	125	1	4	0	0	0	3	0	0	0	0	0	0	0	0	0	0	1	2	0	18	11	0	0	0	0	0	0	0	0	5	0	7	1	0	0
LakWasMet44_HOW7_2_rpkm	0	0	0	0	2	6	2	1	0	0	0	8	1	0	1	1	0	3	1	0	0	0	0	29	0	2	0	0	0	8	0	0	0	16	0	5	2	0	0	0	0	0	1	6	50	40	28	15	1	19	0	10	1	0	0	0	0	1	44	9	30	0	0	2	0	0	0	0	1	26	2	0	8	0	13	0	1	0	0	0	0	17	0	0	0	0	0	2	0	0	0	1	4	0	26	3	0	0	0	0	0	0	0	0	0	0	0	2	0	0	1	1	92	0	17	0	0	107	0	1	0	0	1	2	2	2	3	1	0	0	23	126	2	0	0	2	1	0	3	0	2	0	0	8	2	0	0	0	34	1	4	56	0	1	162	0	0	2	76	0	7	18	0	8	1	0	0	10	1	9	1	0	0	1	0	0	0	0	1	0	0	0	1	9	4	7	0	0	0	2	4	4	6	11	1	1	2	16	45	234	0	0	6	0	0	0	4	0	5	1	36	6	16	24	13	0	3	3	0	0	2	7	1	4	0	2	0	1	7	0	1	3	1	0	0	0	26	5	44	1	0	0	10	3	14	1	0	0	0	5	2	5	14	0	759	46	0	0	0	1	4	0	0	33	1	0	3	0	3	130	4	1	8	0	0	1	0	0	5	3	1	34	7	47	25	0	0	0	3	0	1	0	0	0	17	0	0	3	10	0	0	14	35	1	3	1	7	43	3	1	1	1	88	27	1	0	6	0	45	0	1	0	0	1	1	478	1	0	3	0	0	2	0	0	0	3	12	2	1	0	0	5	12	6	48	0	11	3	1	1	2	2	2	0	3	0	0	1	1	19	2	0	2	0	0	38	1	52	2	3	1	56	0	0	4	0	1	14	0	2	0	0	7	1	1	0	29	1	0	0	0	2	198	0	0	5	34	0	0	21	1	14	0	10	16	0	0	0	2	6	0	1	2	386	1	21	15	4	5	1	0	0	0	0	1	0	1	0	5	0	37	1	1	0	0	6	0	0	5	0	29	6	0	0	2	98	0	0	0	1	0	145	3	531	5	5	46	0	0	1	1	0	0	11	2	18	40	0	0	1	10	2	7	2	0	1	12	2	28	0	0	0	3	5	0	0	0	17	8	0	0	0	38	36	0	0	4	0	0	0	0	0	24	1	0	1	0	2	0	1	0	0	0	1	1	1	0	0	1	11	0	0	0	1	0	0	0	0	1	0	1	0	166	9	8	0	5	0	0	19	0	2	1	25	12	0	0	1	1	0	0	0	2	1	0	4	0	3	0	0	0	2	0	1	14	0	0	1	36	0	0	1	0	0	0	2	7	776	12	3	19	26	13	4	127	0	1	2	23	0	0	1	524	2	10	7	0	0	0	0	34	0	1	23	9	7	0	24	0	0	1	316	26	400	1	0	102	2	238	7	21	15	54	20	1	15	0	6	0	10	2	2	0	0	1	0	0	0	0	5	1	98	0	1	0	1	1	12	6	0	15	1	2	7	2	0	0	0	3	3	0	19	0	1	0	0	0	0	4	9	0	15	0	1	2	0	0	0	0	0	0	0	3	0	0	0	2	0	0	11	2	1	8	0	0	0	0	1	0	1	0	2	0	3	3	3	6	1	42	0	1	10	0	0	29	2	2	1	12	0	1	1	8	6	2	0	1	1	27	0	0	2	2	0	0	0	0	0	0	2	0	20	12	2	3	53	1	0	0	9	2	0	1	2	1	3	2	0	20	0	0	4	1	16	1	0	3	2	0	0	0	0	0	1	0	151	0	0	0	0	0	0	31	0	0	1	0	0	0	3	3	2	0	0	0	1	6	0	0	3	0	0	0	0	18	2	77	0	2	0	0	0	0	0	17	0	2	0	0	0	2	12	0	1	25	0	0	0	1	17	10	2	0	0	0	0	1	78	52	0	0	0	0	1	0	0	0	0	20	62	0	0	2	0	1	1	1	0	0	2	26	1	0	2	0	1	1	0	8	0	0	0	0	3	0	0	7	0	3	5	0	0	0	1	2	8	54	1	0	1	0	0	0	0	0	1	0	3	0	0	0	0	4	1	1	0	0	0	0	0	0	1	0	8	4	10	7	5	5	0	0	0	0	3	0	0	0	0	0	0	11	0	2	1	0	0	0	0	0	4	0	0	0	16	11	0	2	4	0	1	0	1	0	1	1	0	0	0	0	0	0	0	0	1	0	1	0	0	0	1	0	3	11	75	1	14	0	16	0	0	33	19	6	0	2	1	0	6	0	0	0	0	0	0	0	0	0	1	2	0	1	0	3	0	0	0	0	0	4	0	0	4	0	0	0	0	0	174	0	0	0	28	1	0	0	4	0	0	2	1	13	0	0	0	0	0	0	4	28	4	0	0	0	0	1	0	0	2	0	0	1	0	0	2	0	0	0	0	0	1	0	1	0	1225	0	0	0	0	10	1	7	0	0	3	0	0	1	1	6	41	0	0	0	0	0	0	0	0	1	17	3	1	0	0	0	0	2	0	0	0	0	0	0	0	8	6	8	0	1	5	0	5	0	0	3	0	0	21	1	0	0	0	0	0	0	0	2	10	25	0	0	1	3	1	0	13	2	0	1	0	0	0	1	11	0	0	0	0	0	0	0	0	0	0	2	0	2	3	1	0	0	0	0	0	0	0	0	0	1	0	48	1	0	0	2	0	9	0	1	0	0	0	14	0	4	0	0	6	2	0	1	2	15	5	14	26	1	1	0	116	11	1	0	0	1	6	14	0	0	0	1	0	0	0	1	0	1	7	0	0	0	2	5	0	0	0	2	0	3	4	0	0	0	1	2	0	0	1	4	0	6	0	78	6	1	1	0	0	0	1	14	0	3	53	144	0	0	1	2	1	6	0	0	21	0	1	1	0	0	0	0	2	2	47	0	8	26	8	1	40	0	0	0	0	0	35	3	0	11	0	0	2	0	0	0	11	0	0	12	0	1	1	0	0	1	2	3	4	0	5	0	0	0	0	0	1	1	0	2	2	0	0	8	0	0	3	2	1	2	0	0	0	1	34	4	1	28	6	28	3	1	1	12	0	1	1	2	1	0	9	0	0	2	1	1	2	34	9	0	0	0	0	1	0	4	0	4	0	0	2	0	0	7	44	0	1	9	1	0	0	0	0	2	0	28	0	17	38	5	35	19	2	23	0	0	18	1	12	0	3	0	5	0	15	11	0	9	0	2	1	4	5	11	17	3	1	21	0	0	0	1	0	0	5	2	0	0	0	3	0	0	38	1	2	8	0	4	2	0	0	0	5	1	8	2	18	0	4	0	0	0	0	2	614	20	129	37	1	10	1	0	0	0	0	0	47	1	1	2	11	0	0	0	3	149	246	24	46	3	1	114	95	0	0	0	0	0	0	1	0	97	2	48	11	102	10	0	32	2	10	0	0	1	1	0	0	15	63	0	0	0	13	0	25	1	1	0	1	0	8	0	1	0	0	0	0	19	0	2	1	0	1	0	193	3	5	0	0	0	0	0	1	0	0	0	0	0	0	0	2	0	0	12	0	0	0	0	0	0	7	0	1	2	23	0	0	1	0	0	0	0	0	0	0	0	0	0	0	0	0	0	0	1	0	1	1	0	25	3	0	17	0	22	1	0	60	0	55	190	0	0	23	1	42	1	0	0	0	1	0	28	1	13	0	0	2	0	0	2	1	1	2	10	0	0	0	12	0	1	2	1	0	0	0	0	1	0	9	0	35	1	8	2	0	12	3	0	0	0	0	3	1	0	0	2	5	0	2	0	0	4	0	0	18	7	0	0	14	0	0	2	1408	0	7	0	11	0	0	3	0	0	0	0	0	0	0	0	0	25	15	62	65	117	23	18	48	0	0	2	1	0	9	0	0	2	5	43	1	0	1	2	0	0	0	4	23	34	0	39	0	0	43	0	9	1	14	3	0	25	2	2	1	1	0	3	5	0	45	0	2	1	1	0	0	6	0	2	171	5	0	0	0	0	1	1	3	30	64	9	100	0	0	1	26	1	9	0	0	1	0	0	0	16	0	3	1	1	5	2	5	1	15	11	7	0	0	0	1	0	1	0	12	0	0	3	0	6	0	9	0	0	0	5	0	85	0	0	16	50	7	0	2579	2	0	1	0	0	0	0	0	1	20	0	0	1	1	1	0	0	12	1	1	0	1	1	0	0	3	0	62	3	7	0	0	0	1	3	0	0	1	0	0	2	5	0	0	9	1	1	1	3	0	0	0	11	1	0	34	1	0	1	1	116	18	21	4	0	16	91	0	13	1	72	0	13	3	3	2	8	1	0	25	4	0	0	0	3	0	0	0	0	0	0	1	0	1	11	7	1	3	0	3	33	0	0	0	0	0	3	0	0	0	0	0	0	0	21	20	0	5	1	3	3	11	0	0	3	0	0	1	27	0	0	44	6	0	1	0	0	0	0	0	0	0	0	0	0	0	4	8	0	0	6	1	0	0	0	0	1	0	0	0	94	0	11	16	3	3	7	0	15	2	1	42	318	9	0	0	0	0	0	0	0	0	0	2	0	0	4	8	0	0	2	1	0	0	1	0	0	4	0	0	0	0	50	2	25	3	0	13	11	0	10	0	61	30	44	0	5	0	0	1	0	0	1	0	0	0	4	0	8	0	0	3	4	0	0	0	2	0	2	3	0	2	2	0	0	0	4	1	0	1	2	15	6	2	0	0	0	1	0	0	8	0	1	62	0	0	11	0	0	4	1	1	1	0	6	2	102	0	0	108	4	0	1	197	2	0	0	1	0	0	0	0	0	0	0	3962	0	0	0	0	2	26	0	0	1	8	3	24	18	24	1	0	2	0	0	0	10	0	26	2	0	3	1	0	2	0	0	4	0	0	0	4	0	1	0	1	6	1	0	2	0	0	0	2	0	7	0	0	0	0	2	132	0	0	0	134	1	0	4	0	0	0	0	2	0	0	0	0	3	0	0	0	0	1	4	14	0	18	1	0	0	78	0	6	7	17	6	6	1	3	12	1	0	0	0	0	0	1	97	2	2	2	8	0	0	0	0	0	7	27	20	0	0	1	5	10	0	0	3	0	1	0	1	5	0	0	1	17	0	0	0	0	0	0	1	0	10	0	0	4	1	1	18	1	2	5	0	0	0	0	2	8	1	1	0	1	1	1	0	0	11	2	0	2	0	7	14	0	0	1	0	0	0	13	0	2	0	1	2	0	0	0	0	1	0	0	0	0	0	0	0	2	0	0	0	0	0	0	1	0	0	0	0	0	0	38	0	0	2	4	5	1	1	0	7	0	0	1	4	0	0	0	0	6	5	0	0	0	0	2	9	78	37	113	111	13	71	15	7	122	9	88	14	9	0	7	7	20	14	0	12	4	22	30	38	87	72	111	10	4	12	7	9	33	0	4	1	0	0	0	3	0	0	0	10	64	0	0	0	0	0	0	1	0	1	0	0	0	1	0	0	3	1	0	0	3	12	0	22	0	64	5	1	0	4	1	2	3	1	0	1	11	0	0	1	0	0	0	0	1	0	19	0	0	0	0	2	20	1	12	0	0	2	14	0	0	0	2	0	1	5	0	0	0	0	2	18	0	0	2	1	0	0	0	1	1	0	0	0	1	20	10	0	14	0	0	0	2	2	0	0	0	0	1	4	1	0	1	0	1	0	99	0	0	8	64	0	1	0	0	0	1	0	0	3	0	0	1	0	2	21	0	0	0	1	0	1	0	45	13	31	0	0	28	20	18	21	22	0	6	18	31	0	1	0	0	1	0	0	0	34	0	3	2	2	0	0	0	0	2	0	0	1	1	0	0	2	0	0	6	0	0	2	16	0	0	6	1	1	0	0	0	5	2	17	0	0	40	1	32	3	332	8	0	2	25	0	0	0	0	2	15	1	0	2	1	0	1	2	0	1	1	1	1	0	0	38	1	0	25	4	0	5	1	0	47	1	2	1	0	0	0	0	0	1	0	0	6	1	1	0	0	2	0	3	0	0	0	0	4	1	0	0	0	1	0	0	0	0	0	0	0	0	0	2	0	0	0	15	0	0	0	0	1	3	0	70	40	1	3	6	0	0	1	0	1	1	2	1	0	0	2	0	1	0	0	28	2	18	19	0	2	2	11	0	0	7	0	15	46	4	0	0	1	15	0	0	0	0	0	0	0	0	0	0	0	0	0	42	2	0	1	0	0	0	0	0	3	0	21	5	3	5	0	2	3	0	1	45	0	0	2	0	0	0	1	0	0	0	0	14	1	1	0	23	1	0	0	0	0	1	0	0	0	0	0	1	0	0	1	1	1	1	1	1	0	0	1	0	1	0	0	1	3	1	0	0	0	0	0	0	16	3	0	65	0	2	20	0	647	1	0	1	1	2	0	0	12	0	11	1	0	0	0	0	0	0	0	0	8	0	0	0	1	0	0	167	0	5	4	42	3	0	6	3	5	3	2	1	3	0	1	3	1	12	4	2	2	3	2	0	7	2	1	0	2	0	0	0	17	1	13	1	20	23	6	18	25	20	23	17	0	25	15	19	0	6	2	2	0	31	3	0	13	0	7	1	5	36	5	0	0	0	4	0	0	1	0	0	1	0	1	12	0	0	0	2	20	0	0	0	0	0	0	0	0	0	1	0	6	0	3	5	1	7	0	0	16	0	0	1	1	5	0	0	25	0	3	30	18	13	0	19	1	1	1	0	8	50	0	0	1	0	1	1	0	5	0	4	0	0	0	0	0	1	100	3	0	42	1	0	41	4	7	0	0	0	30	26	1	0	0	1	6	0	1	0	0	4	1	2	3	1	8	4	0	1	2	25	7	0	0	0	0	0	0	1539	77	55	4	0	0	1	0	0	3	0	87	0	14	1	1	0	0	355	262	49	2	0	0	9	0	2	0	52	4	2	0	0	0	3	0	0	0	1	0	1	0	6	0	0	1	1	0	1	0	46	9517	0	3	0	0	0	0	0	5	2	0	0	0	0	0	4	5	0	0	0	0	6	1	0	11753	26	92	1	1	3	2	0	0	3	0	0	17	0	0	0	1	0	0	0	1	0	1065	1	0	2	0	2	0	1	0	0	0	1	0	0	0	0	3	0	14	0	0	0	0	0	1	0	0	2	0	0	0	3	2	1	0	1	0	3	0	0	0	0	0	0	0	0	0	10	0	0	0	0	0	0	0	1	5	0	0	2	3	0	0	0	2	0	0	58	0	0	0	0	0	0	110	3	0	1	0	2	3	1	83	6	0	4	0	0	16	0	0	66	0	0	8	1	0	0	1	0	0	0	0	7	0	3	0	0	0	2	0	0	1	1	0	0	0	3	0	0	3	1	0	0	0	5	0	0	0	0	0	1	0	0	0	0	1	0	1	0	2	0	20	1	3	7	1	29	4	0	6	0	0	0	2	0	1	0	4	5	7	0	4	0	12	0	17	0	0	1	0	0	0	0	2	0	1	0	4	18	1	1	1	0	2	0	0	1	0	1	0	0	0	0	0	0	14	0	3	6	0	2	0	34	3	0	0	1	0	0	0	0	13	12	37	1	0	1	0	0	0	41	65	2	20	0	0	0	1	0	0	0	0	0	0	0	4	0	0	2	0	5	1	0	0	0	0	3	0	0	0	62	0	12	1	2	0	0	0	0	1	1	0	0	0	0	0	22	1	0	0	4	0	10	1	4	0	0	38	0	3	0	1	42	0	0	1	21	0	0	0	2	0	0	1	159	0	8	1	1	0	0	0	0	0	2	0	3	0	1	0	0	2	0	89	0	0	0	1	0	0	0	64	0	0	0	13	1	3	0	0	0	0	1	2	10	0	0	0	0	0	0	3	1	3	0	0	2	0	0	0	0	0	0	2	0	0	0	0	6	4	3	0	0	2	1	67	0	1	0	0	0	0	0	0	0	0	0	0	0	0	1	0	2	1	0	0	0	0	1	0	0	1	0	0	1	1	1	0	0	0	1	0	0	0	0	3	29	1	0	0	19	1	0	30	17	0	0	2	0	0	0	0	0	0	0	0	0	0	5	2	0	0	0	0	4	0	0	1	0	9	0	1	2	0	49	0	6	2	14	1	0	0	0	0	1	4	0	42	0	0	0	0	2	1	0	0	2	17	3	0	0	0	0	0	0	0	0	0	0	1	0	2	0	0	1	1	0	14	0	0	0	0	0	0	1	0	9	0	0	0	0	0	0	0	0	0	1	4	0	0	1	0	1	0	0	0	0	0	0	0	3	20	0	0	0	1	0	22	0	1	0	0	0	1	0	0	0	111	0	0	0	0	0	0	0	0	2	1	0	0	0	0	0	0	0	0	0	0	1	3	0	0	0	0	0	1	0	0	2	0	1	18	0	0	5	0	0	6	1	0	0	4	0	0	2	0	0	1	4	1	5	1	0	0	0	0	0	0	0	0	0	0	0	0	0	1	0	0	0	6	0	0	0	0	0	0	0	0	0	10	0	1	0	0	0	0	0	0	1	0	65	0	0	5	6	2	1	0	0	28	0	0	5	0	0	177	1	3	1	3	8	1	2	0	0	4	0	25	59	7	0	0	2	459	1	13	0	1	0	85	2	1	0	0	0	1	1	0	0	0	0	0	0	0	1	2	1	0	0	12	0	0	2	0	0	1	1	0	0	0	0	0	0	0	0	0	0	0	0	0	1	1	0	60	0	20	2	0	0	0	0	0	0	0	0	0	932	1	0	0	0	0	3	0	0	0	1	0	0	0	0	1	1	0	1	0	0	0	1	0	0	35	0	0	1	1	3	44	0	0	0	0	0	1	0	1	89	2	5	1	1	2	0	0	0	0	1	0	2	1	79	1	0	2	9	2	5	0	0	222	0	0	0	0	0	1	0	0	0	0	0	1	0	0	1	0	1	0	0	0	0	1	0	0	0	2	0	0	0	57	0	0	0	0	1	3	0	0	0	0	0	0	0	1	0	0	0	0	1	0	0	1	0	1	0	0	40	1	0	0	0	0	0	37	2	4	0	0	0	0	0	0	0	0	1	0	1	0	7	0	13	0	3	0	1	0	9	1	0	0	0	3	0	0	0	0	0	0	1	5	1	0	18	1	2	1	0	2	1	1	2	0	2	1	0	0	0	0	0	0	40	1	92	1	3	0	0	3	1	0	0	6	1	37	2	5	0	0	0	2	0	0	0	5	3	23	8	0	9	0	0	0	0	4	0	0	16	0	0	2	2	4	0	0	2	3	0	1	8	0	0	0	0	0	0	0	0	0	0	1	17	0	3	1	0	0	23	0	0	0	0	0	1	0	0	0	0	0	0	2	0	0	6	1	0	4	0	8	0	0	0	3	1	0	0	3	0	0	0	61	23	28	575	717	0	0	0	0	42	0	17	12	2	0	0	0	10	31	0	40	1	3	45	0	127	0	1	0	3	1	0	0	2	3	0	3	0	2	1	0	0	2	47	0	0	11	1	2	0	6	0	0	0	0	1	0	0	1	0	0	0	54	6	0	0	0	1	21	0	1	2	0	0	0	0	0	2	0	0	0	0	1	0	0	2	9	0	2	7	56	1	0	0	4	8	10	2	1	0	0	0	0	1	0	0	0	6	50	0	0	2	1	0	0	0	0	1	0	0	1	1	0	0	10	12	0	3	0	0	0	0	2	8	1	0	1	1	0	1	0	0	0	7	10	4	0	3	0	0	1	2	0	0	0	0	6	0	6	2	0	0	0	26	0	0	19	0	23	1	2	2	2	5	0	2	43	0	0	2	0	0	0	1	2	0	0	0	111	132	112	4	1	22	11	23	11	11	10	20	6	9	304	17	0	101	18	14	10	6	3	78	12	171	0	27	0	273	0	0	0	0	0	0	8	2	0	2	1	0	3	0	0	1	0	0	1	4	1	3	3	6	2	0	1	1	0	0	0	0	2	22	1	1	0	1	1	0	208	0	0	0	0	0	0	0	54	4	0	0	0	2	0	0	7	0	7	1	29	0	0	0	0	3	0	10	107	2	71	86	41	0	1	0	1	8	0	4	2	0	0	0	1	0	0	1	9	0	0	0	0	3	1	0	0	0	40	1	0	3	0	1	0	2	0	3	5	30	0	1	0	1	2	3	0	0	0	7	3265	2	4	8	0	4	0	0	1	1	0	0	0	0	2	0	9	0	0	162	1	0	0	0	0	0	0	9	2	13	0	0	3	248	78	1	0	6	1	0	25	1	7	9	2	7	0	7	0	1	0	0	0	0	1	1	0	0	0	0	1	0	0	2	0	0	7	24	0	0	0	3	0	0	2	0	0	0	2	48	0	0	6	1	11	3	1	2	6	1	0	0	38	13	24	0	0	5	0	13	0	1	0	1	5	0	0	0	4	1	0	0	0	0	19	1	1	0	47	0	2	1	0	4	0	2	1	7	1	0	0	0	0	0	0	0	2	0	50	0	1	0	0	6	1	1	0	2	3	5	0	0	4	1	1	7	10	1	19	0	0	2	1	3	0	1	56	1	4	1	1	10	0	6	0	0	0	0	0	0	3	0	11	0	1	0	0	0	0	0	0	4	0	0	2	17	5	14	6	1	29	2	0	12	0	1	0	0	3	1	0	3	12	1	0	1	0	0	1	0	2	0	0	0	0	0	0	0	5	18	1	0	0	0	1	0	0	0	0	44	1	9	0	1	0	0	0	117	0	1	0	4	0	0	0	20	2	0	0	0	13	0	2	0	0	7	0	7	0	1	0	1	0	0	0	0	0	0	0	0	0	0	1	12	10	0	0	0	100	8	11	1	0	0	0	0	0	1	0	0	2	0	0	72	2	1	0	0	0	0	0	0	3	55	1	99	5	10	66	3	0	1	2	0	0	25	2	4	5	4	7	0	0	1	0	0	22	0	22	6	3	9	12	20	61	0	0	0	0	25	0	6	0	12	0	2	1	0	0	0	0	0	0	0	0	0	1	1	4	1	0	1	0	0	0	0	65	2	0	0	0	0	12	9	15	0	4	0	0	0	0	29	0	3	0	0	0	3	8	1	70	0	0	23	8	0	0	15	1	3	9	0	0	2	1	2	2	1	0	4	41	0	0	2	0	0	21	0	2	2	0	1	0	1	10	7	0	0	1	0	0	7	1	3	0	1	2	1	0	1	4	0	0	0	0	0	0	1	2	1	0	25	2	6	2	1	0	1	4	0	61	0	3	13	0	26	0	10	0	3	1	0	0	0	0	2	0	1	3	0	0	1	0	1	1	25	33	0	4	0	0	229	0	2	0	0	0	12	10	2	6	0	1	0	92	1	6	6	0	0	1	1	1	3	0	0	2	0	0	0	13	0	6	2	2	0	0	1	14	3	0	0	11	1	4	0	1	2	0	2	1	1	0	1	0	0	3	0	1	0	0	1	0	1	0	0	0	0	1	0	0	0	1	0	0	0	0	0	0	0	0	0	0	0	1	0	0	0	0	0	0	92	0	0	0	0	0	14	4	0	4	0	0	8	0	0	1	1	1	1	0	0	0	17	1	0	0	0	2	0	5	0	0	1	2	0	0	0	0	0	1	0	19	0	2	0	0	1	5	1	1	0	0	0	0	0	0	0	73	0	0	0	1	0	0	1	4	0	0	23	0	0	11	0	0	0	0	0	1	0	0	52	0	4	0	0	0	2	9	1	0	0	0	0	4934	0	0	0	0	0	1	0	1	3	1	0	0	15	0	0	2	0	13	123	0	0	0	0	1	0	4	0	2	0	0	1	0	0	0	0	2	0	0	0	1	11	2	0	0	0	8	0	0	0	0	19	0	0	8	1	0	0	0	0	0	0	0	0	0	0	7	0	1	0	0	0	0	0	0	0	0	7	2	5	0	0	0	0	0	48	1	0	0	0	3	28	13	0	0	0	0	0	2	1	0	1	2	0	0	0	2	0	15	0	0	0	24455	0	0	0	0	0	0	0	5	3	0	0	3	0	0	0	0	50	5	20	4	4	0	1	0	0	0	8	1	0	0	1	10	20	24	5	0	5	21	0	38	0	1	1	12	124	0	5	4	1	0	2	4	0	0	0	104	4	6	2	1	260	0	0	1	36	6	99	0	2	0	5	4	0	11	3	3	0	0	0	0	1	0	0	9	0	1	20	3	0	1	0	0	31	1	9	2	2	1	20	0	59	7	0	11	1	9	0	0	16	2	0	0	1	3	0	1	2	1	0	0	0	4	1	19	10	2	0	0	1	32	18	1	3	2	2	256	7	0	0	0	1	0	1	5	0	0	0	0	1	0	12	0	0	0	0	9	0	8	0	38	9	0	7	0	0	4	0	0	0	0	4	1	2	0	0	0	0	0	0	0	0	0	0	0	0	0	0	1	2	1	1	0	0	0	5	1	0	0	0	2	4	0	1	2	0	16	0	7	11	0	0	2	1	1	0	5	0	47	6	0	3	3	2	4	5	2	2	0	0	3	28	1	0	5	1	0	31	7	6	2	6	4	3	3	0	13	1	0	1	21	2	1	0	0	0	1	0	14	1	0	0	0	0	0	0	0	10	0	0	1	5	0	0	12	5	0	2	0	0	1	1	4	1	1	3	7	100	3	0	0	1	1	8	0	0	0	5	2	13	11	0	1	0	0	0	1	0	15	2	1	0	366	0	0	58	11	17	44	0	13	11	0	30	3	50	0	0	15	0	0	0	0	10	0	0	16	0	0	16	2	82	3	18	2	1	0	0	23	0	0	0	1	0	3	1	1	0	5	0	0	1	11	0	0	1	1	0	2	0	3	0	0	0	41	1	10	0	0	43	5	0	0	0	5	1	31	2	4	17	30	4	5	17	1	14	2	31	2	2	0	0	2	14	0	0	0	0	1	1	0	2	0	0	0	0	14	3	6	0	0	18	2	48	1	405	149	0	0	21	2	1	0	0	0	0	0	0	0	0	1	0	0	0	0	14	11	2	0	0	1	3	0	14	0	0	0	0	5	0	0	0	1	0	0	2	1	1	0	0	33	2	4	1	0	5	0	111	72	14	6	1	1	6	1	0	0	13	5	0	2	2	0	0	0	1	26	0	0	0	40	12	13	21	0	0	1	0	3	0	0	1	4	0	3	2	0	1	1	5	2	37	37	18	1	3	7	2	5	5	9	5	0	0	0	0	15	4	0	2	4961	6	0	35	89	12	1	0	0	33	0	0	0	1	0	1	5	0	1	0	0	0	95	50	0	1	3	0	51	13	1	2	14	0	0	0	16	8	1	0	1	0	2	0	382	0	24	32	64	22	28	37	0	1	404	16	0	42	4	0	0	16	16	8	0	0	0	0	3	3	0	0	4	67	1	1	6	0	0	2	15	5	200	210	1	1	0	28	0	145	82	43	0	0	61	1	0	0	2	0	0	0	0	0	0	0	0	0	0	0	0	1	4	2	2	0	17	0	1	0	6	1	16	0	2	49	1	6	2	17	2	58	19	2	3	0	1	1	1	230	50	3	19	1	0	1	1	43	0	1	6	1	0	13	7	0	1	0	0	2	0	1	18	50	0	0	1	0	2	1	0	5	5	0	0	0	1	0	9	1	11	6	27	4	0	0	0	0	0	2813	2	2264	0	10	0	7	36	8	6	0	0	0	0	0	0	0	3	38	1	13	0	0	1	0	1	0	0	1	3	0	0	149	0	0	4	0	0	1	1	8	1	4	365	0	0	0	0	0	0	1	1	0	7	1	0	0	0	0	2	0	2	0	0	0	0	0	0	1	1	3	0	13	0	0	3	0	0	1	2	0	45	0	0	0	1	1	2	0	0	53	0	9	8	1	1	0	0	1	0	0	0	124	1	2	47	11	0	1	0	1	0	0	161	18	9	1	2	0	1	3	2	0	0	4	0	0	0	1	89	0	1	3	1	0	5	0	1	0	0	1	0	0	2076	0	19	1	3	281	0	3	366	3	119	47	1454	1463	502	53	113	47	96	1	1	104	15	17	24	5	16	44	0	2724	3	0	4	4	1	57	1	1	0	69	26	10	0	1	1	0	0	20	0	2	0	11	54	33	5	7	5	26	2	9	0	3	0	42	3	7	11	1	5	0	0	2	1	0	0	0	0	27	0	0	1	1	15	0	0	117	0	3	0	4	1	16	1	1	0	6	0	2	23	3	0	1	0	2	0	0	0	14	0	1	1	20	1	0	105	0	0	0	4	121	654	1	19	1	5	5	1	1	9	0	15	0	46	3	0	4	0	0	16	4	21	152	4	0	3	4	46	6	0	0	14	1	1	0	12	0	16	0	0	1	117	1	3	1	0	6	0	13	10	0	0	4	0	0	1	0	0	0	0	1	0	1	0	0	43	0	0	0	2	0	57	26	13	0	0	4	4	0	9	1	2	21	0	0	0	10	33	1	36	64	0	0	16	1	0	3	2	3	3	0	0	4	0	8	11	93	37	45	2	0	0	0	0	0	1	1	0	3	1	2	5	0	0	0	0	1	1	35	5	0	20	0	0	0	0	0	0	8	0	0	0	0	0	1	0	0	0	3	0	0	0	0	0	0	0	0	0	14	0	0	3	0	0	0	12	5	2	2	0	7	17	0	0	0	1	0	0	0	11	0	0	10	0	0	0	0	9	0	0	2	2	1	1	3	0	0	0	0	0	1	0	0	5	102	0	0	1	0	0	0	13	3	56	0	0	0	0	0	5	1	20	3	11	11	0	0	0	0	0	171	1	0	1	0	1	112	149	19	66	0	49	120	4	91	0	67	2	1	1	121	224	128	63	128	34	29	27	34	0	61	2	2	20	18	20	5	0	111	4	48	245	1	67	3	169	2	1	40	1	60	48	3	64	0	0	2	1	187	17	0	41	49	105	67	1	4	16	104	154	3567	0	19	25	0	0	0	0	1	5	1	1	1	4	0	226	228	123	10	0	6	0	0	0	0	4	27	11	18	6	13	14	18	9	43	121	0	14	37	21	4	0	1	1	15	13	29	6	1	104	2	5	1	44	1	0	15	5	0	0	0	25	0	0	0	60	0	0	1	0	0	1	0	48	2	11	0	0	3	26	2	1	5	3	0	4	0	2	0	50	0	1	1	0	0	0	0	0	1	3	1	0	3	0	0	0	6	0	1	0	1	6	0	21	51	33	106	18	2	1	0	0	0	0	1	0	0	0	0	0	0	0	1	0	0	0	0	4	0	0	3	0	0	25	1	0	2	0	0	0	0	0	0	0	0	1	1	1	0	2	32	0	3	0	1	3	0	278	6	23	73	1	71	0	50	0	0	0	0	1	0	0	0	0	0	0	1	2	26	9	13	1	1	0	1	3	0	0	1	1	2	18	0	1	4	1	6	0	0	41	39	0	0	1	14	0	0	18	2	47	3	15	1	0	1	0	1	27	0	47	0	0	1	4	21	2	2	9	8	0	10	8	0	0	15	2	0	2	53	39	4	2	0	0	0	3	57	14	10	0	1	1	0	0	0	0	1	2	1	0	0	0	0	9	14	0	19	1	0	1	0	0	0	2	3	1	0	58	2	0	0	1	1	0	0	0	0	74	8	2	0	2	4	0	1	3	1	2	0	4	1	0	2	0	1	0	7	3	1	0	0	0	1	0	21	0	19	0	1	3	2	0	0	1	6	0	1	12	3	0	0	33	2	1	0	1	0	1	0	1	10	0	2	36	51	14	1	0	5	0	0	1	0	0	1	0	2	1	17	1	0	1	0	0	0	2	1	0	0	0	0	62	5	1	0	1	0	3	20	2	23	1	4	189	0	1	1	0	1	0	0	0	5	1	1	0	2	1	0	2	0	10	3	0	0	46	2	2	0	0	43	1	15	1	2	127	0	0	17	0	6	0	0	0	0	1	1	3	28	2	0	20	0	9	0	1	8	0	93	0	1	1	0	0	160	0	0	0	0	1	2	1	2	3	0	0	1	0	1	0	2	0	5	0	1	1	1	16	7	0	0	0	0	31	0	1	0	0	5	14	26	0	3	0	0	445	1	53943	0	0	0	0	0	9	0	1	0	0	0	0	0	0	0	0	31	0	0	0	0	2	2	39	5	0	3	10	0	0	0	0	0	0	0	0	1	22	42	1	12	2	0	0	0	0	1	1	0	11	0	0	4	0	5	25	5	30	41	2	6	9	0	11	2	0	8	0	9	169	9	32	33	1	0	0	0	1	11	0	10	52	6	2	139	1	0	0	0	3	0	6	5	1	41	4	0	114	19	0	3	21	21	3	0	43	2	0	1	0	0	0	0	0	0	0	1	2	14	82	2	73	100	2	5	88	0	195	40	11	180	49	142	50	31	50	115	286	0	18	132	3	49	100	0	0	0	80	86	97	116	105	2	59	0	0	92	36	2	4	0	0	1	0	0	0	2	0	0	0	1	1	30	15	1	7	0	7	1	0	1	31	0	0	0	0	3	20	12	9	0	0	0	0	0	1	0	11	0	12	0	1	1	9	0	25	20	0	13	1	0	0	8	29	0	0	0	5	0	0	0	0	2	1	0	0	0	3	0	1	9	1	3	5	24	30	0	1	10	7	0	3	1	0	48	0	11	0	0	0	39	10	0	7	8	3	49	6	0	2	3	0	3	2	2	0	0	0	0	0	0	0	3	0	0	0	0	0	1	0	0	2	2	4	0	1	0	0	5	2	0	0	0	2	8	0	3	0	0	0	0	0	3	5	3	0	0	1	0	2	1	0	13	0	0	3	0	0	1	0	6	8	0	4	6	5	21	25	3	78	16	0	3	32	42	34	38	28	2	1	1	2	44	0	0	1	0	15	0	5	1	0	0	0	0	0	0	1	0	44	0	0	0	6	3	1	0	0	3	0	3257	20055	3	11	1	10	0	0	0	20	2	55	3	0	6	0	24	11	1	583	0	3	0	28	10	4	25	1	395	0	0	17	1	993	1	0	3	1	2	3	5	0	96	0	4	67	34	65	10	1	2	29	3	10	4	2	1	0	3	1	0	0	1	1	0	1	15	0	1	5	0	12	2	2	2	6	1	1	0	2	0	0	1	0	0	0	4	23	130	23	16	16	39	21	246	0	0	4	4	30	22	0	2	3	1	17	0	3	1	2	0	0	2	27	1	3	2	2	3	0	4	0	2	0	17	17	1	0	7	8	10	0	1	12	0	0	2	1	1	0	0	3	111	1	34	0	0	0	0	0	1	0	0	1	0	1	3	0	0	0	0	0	0	2	3	72	0	0	540	1	0	1	12	0	0	2	3	8	11	0	0	0	1	1	1	0	0	1	0	0	0	0	0	2	0	23	0	0	0	10	0	9	13	70	147	21	41	0	0	0	0	0	0	0	0	1	0	0	0	0	0	0	0	0	57	1	3	0	0	1	1	0	1	0	0	0	0	1	8	0	0	52	0	0	0	17	2	14	0	0	21	0	1	0	12	6	0	14	21	20	18	32	2	5	3	45	21	4	18	0	0	15	1	1	2	2	28	17	0	0	1	0	0	0	100	0	0	0	1	407	0	0	1	0	4	12	0	5	1	0	0	1	2	0	0	1	0	0	0	0	14	4	0	0	0	2	166	11	0	0	0	2	1	0	0	1	16	2	0	0	1	0	1	21	2	0	0	0	0	1	2	6	0	37	0	0	41	3	3	0	2	0	0	9	16	1	25	0	0	0	2	0	0	218	0	1	3	0	1	13	0	0	10	51	8	2	4696	0	21	116	8	1	21	0	176	43	92	9	5	1	1	7	4	5	0	7	1	11	0	4	1	0	3	0	3	7	0	38	1	0	6	333	0	1	2	1	0	16	13	2	0	2	0	7	0	0	13	1	0	0	3	8	0	0	0	0	41	2	6	0	0	1	0	4	0	0	5	10	0	1	0	0	10	2	0	1	0	0	1	2	5	4	16	7	21	6	1	24	25	12	40	56	52	0	0	0	0	0	0	2	1	0	162	2	0	7	86	26	24	9	2	148	0	2	15	17	1	0	9	5	2	0	0	0	0	0	0	6	78	61	2	0	0	0	0	0	1	0	0	0	26	4	0	2	0	0	11	0	1	0	0	0	1	0	0	0	0	2	0	0	0	0	0	17	0	0	0	0	4	0	4	11	1	0	0	0	0	0	0	0	1	0	0	0	4	0	0	0	11	1	5	1	0	0	3	5	0	0	1	1	0	0	0	0	0	5	132	10	32	5	2	3	2	0	0	2	11	15	1	0	0	0	7	1	6	0	1	12	0	5	10	0	1	12	1	2	7	19	2	48	4	0	3	0	0	1	0	0	0	44	2	11	1	20	1	49	5	0	109	1	2	21	0	2	0	0	12	76	72	63	0	62	15	18	1	11	0	16	0	2	0	0	0	1	0	1	1	0	0	0	11	1	16	4	0	0	1	14	1	5	21	5	12	3	3	10	1	15	3	10	36	24	5	67	4	34	0	0	0	0	0	5	0	3	0	61	3	25	3	0	0	9	0	0	0	0	0	0	0	0	0	0	1	1	0	0	95	60	2	37	37	44	2539	6	0	2	3	0	0	0	0	6	4	14	1	0	3	34	1	0	1	6	2	9	0	0	2	0	0	0	109	28	0	4	40	0	0	0	1	1	1	65	0	30	0	4	459	0	0	0	17	2	6	0	0	1	0	0	0	1	0	1	0	5	2	0	0	0	0	0	2	0	0	2	1	0	0	0	0	0	0	0	2	3	0	0	0	0	2	1	0	32	0	364	34	0	23	21	7	52	9	16	15	0	1	1	2	1	0	0	0	0	0	0	0	0	0	0	24	0	1	0	0	0	0	1	0	2	5	0	13	0	0	0	1	9	2	0	1	0	0	0	8	0	1	18	1	0	1	0	0	0	0	0	0	2	0	2	5	1	5	0	5	2	7	2	51	0	0	3	1	0	0	0	1	10	0	61	0	2	1	17	1	17	90	0	0	1	0	1	1	1	0	0	1	1	0	0	0	0	0	0	5	0	2	0	0	0	0	0	0	0	11	1	0	0	0	0	1	0	0	581	0	0	0	0	0	1	1	0	0	2	0	0	0	20	3	0	1	0	1	0	1	0	0	0	2	0	0	0	0	0	19	0	0	0	72	0	0	0	0	0	0	12	0	0	26	0	0	0	1	0	2	0	0	0	7835	0	0	0	0	0	2	0	0	0	1	2	1	3	2	1	0	0	0	0	0	1	0	0	0	0	1	0	0	1	0	0	0	0	0	0	0	0	1	0	0	0	0	0	11	0	0	0	0	0	0	0	0	0	0	1	4	0	0	0	20	0	0	1	0	0	0	2	0	0	0	0	0	0	0	0	0	0	0	0	0	0	15	0	0	0	0	0	0	1	0	0	0	0	0	0	0	0	0	0	0	1	0	9	0	4	0	2	0	146	0	0	1	0	1	0	1	2	5	0	0	0	2	10	0	31	4	1	0	0	0	1	3	2	0	0	23	1	1	0	0	97	0	47	0	0	0	0	0	0	7	1	1	0	0	0	1	2	0	0	1	1	1	0	0	3	1	1	4	2	1	0	1	17	0	2	0	12	0	4	7	0	0	1	2	1	1	0	2	2	1	2	1	0	1	3	0	0	16	1	0	0	0	3	4	2	1	0	0	4	4	1	1	1	7	4	0	2	0	1	3	0	0	4	0	0	44	0	1	4	0	4	0	11	1	1	2	0	0	0	1	0	4	2	3	1	0	0	1	1	68	1	3	0	8	2	6	2	17	130	3	1	0	1	1	50	0	1	0	0	0	2	0	1	0	0	10	0	0	0	0	1	1	0	1	0	505	10	17	0	0	0	0	0	68	1	195	1	19	19	0	8	0	10	1	4	0	0	0	0	0	1	3	0	1	5	1	8	0	1	3	0	0	0	0	0	0	0	0	4	0	0	0	0	0	0	0	1	0	0	0	0	0	1	1	1	0	0	40	3	0	0	0	1	1	4	8	1	0	0	0	0	1	0	1	1	2	4	0	0	38	2	21	0	10	0	1	0	0	8	0	0	0	0	1	5	1	0	0	3	1	0	1	130	0	0	0	0	0	0	1	0	0	0	275	0	2	1	0	0	0	2	0	0	0	0	0	0	0	0	2	0	0	0	0	0	1	73	22	1	33	41	1	0	0	0	1	1	16	0	6788	0	3	0	42	0	0	0	0	9	15	4	0	2	2	1	0	0	0	1	0	19	20	6	105	0	10	8	48	1	0	0	0	0	0	0	2	2	1	0	0	0	0	0	0	2	2	1	1	3	70	0	1	3	1	0	0	0	0	0	6	5	11	19	62	49	0	63	62	466	0	25	3	5	34	0	0	8	5	0	5	1	1	0	0	29	13	0	0	0	0	81	2	0	0	0	28	1	0	2	0	0	3	0	0	10	3	3	38	0	49	0	0	0	1	0	0	1	0	2	2	7	1	10	2	2	5	0	13	0	2	0	0	1	9	13	1	14	0	3	2	23	26	3	8	12	4	0	2	3	2	1	50	15	1	2	0	2	0	0	0	0	0	3	0	1	0	3	1	0	5	84	4	0	12	1	5	37	15	14	0	2	1	2	14	0	10	30	1	4	0	0	21	7	11	30	4	56	4	0	0	1	4	0	1	1	0	4	2	113	14	33	0	1	0	0	1	0	11	9	0	0	0	1	2	6	13	2	4	9	6	0	6	0	0	0	1	49	0	12	13	51	30	0	0	8	47	11	3	0	0	1	0	0	3	4	1	0	87	0	8	0	1	1	3	5	62	21	28	0	0	5	0	2	0	0	2	0	4	0	3	2	4	0	19	6	6	136	0	17	0	2	0	1	0	5	0	3	0	14	0	1	0	7	3	3	19	0	10	10	0	0	0	17	81	0	0	2	0	0	3	0	0	9	0	0	0	0	5	26	2	1	14	0	29	1	1	0	0	0	0	0	0	6	0	0	0	41	0	0	234	0	18	21	0	12	18	0	0	0	1	0	28	1	0	1	0	1	1	1	0	0	2	3	3	0	0	65	10	16	0	0	0	0	0	1	0	0	0	0	5	21	11	15	0	73	12	0	106	32	31	74	83	12	32	181	81	13	98	323	112	95	7	30	21	0	1	0	2	0	1	0	4	9	1	0	0	7	0	0	1	0	0	0	1	1	1	0	1	0	25	3	4	9	2	2	0	0	0	0	0	0	0	0	0	0	0	2	0	1	0	1	0	1	0	0	0	0	0	0	0	0	7	19	0	0	0	0	0	0	0	1	0	0	0	2	0	0	0	0	0	1	1	0	0	0	3	0	29	15	0	35	5	1	0	13	0	0	1	39	18	37	10	6	5	81	3	0	0	0	4	4	0	0	0	0	1	0	1	26	8	7	13	31	70	0	0	1	13	1	9	0	6	3	0	0	1	0	0	1	0	1	1	1	0	2	0	0	12	1	18	0	9	0	4	17	17	0	22	3	43	0	0	2	1	0	0	7	29	2	1	0	0	0	0	0	2	3	4	0	1	43	18	4	30	0	5	0	0	0	0	5	1	2	3	236	0	0	2	0	1	165	0	0	0	1	16	1	5	0	0	9	0	0	2	9	0	3	12	64	1	9	7	0	6	1	24	0	0	1	1	0	1	0	9	3	15	0	1	1	0	1	10	12	0	1	24	13	5	21	3	10	0	16	1	0	9	1	0	3	0	3	0	0	21	1	1	0	12	10	0	15	2	1	1	10	0	0	0	0	5	0	1	1	0	1	1	3	1	0	0	0	0	0	3	0	0	0	0	0	0	1	27	0	0	0	1	0	0	0	0	18	7	0	13	28	0	1	0	4	10	100	45	64	30	0	13	205	73	0	4	36	1	29	0	1	2	5	0	0	18	0	18	17	3	3	1	1	0	0	9	15	5	0	0	39	27	152	3	0	0	0	0	0	0	6	0	1	0	3	11	0	0	2	0	0	1	1	213	3	38	26	21	0	18	3	7	0	0	0	0	0	5	0	0	0	1	0	41	1	5	8	4	1	49	3	267	1	8	0	0	3	4	0	45	25	325	17	3	26	0	15	10	1	0	0	0	0	11	3	8	381	27	5	0	34	5	1	0	0	22	0	2	1	0	2	0	0	68	14	0	0	0	107	10	4	5	0	5	92	30	73	0	1	11	0	3	3	0	19	1	2	2	8	0	0	0	1	4	3	0	2	1	0	2	6	0	0	0	0	0	0	0	122	0	1	0	0	159	2	4	0	0	1	4	1	2	0	0	0	22	15	1	1	9	0	19	0	0	5	8	7	1	2	2	0	0	4	1	1	30	12	5	8	14	0	0	42	8	11	12	1	0	0	0	0	0	0	0	8	0	1	0	18	0	0	0	0	0	0	0	13	0	0	1	15	3	15	1	2	10	0	19	0	0	3	2	6	0	0	0	0	3	10	46	68	10	32	0	90	0	0	0	0	4	1	1	0	0	2	0	5	0	0	0	0	0	0	12	0	0	0	22	0	0	3	3	6	1	4	1	0	73	0	267	0	0	152	0	0	5	0	0	0	0	0	6	65	0	0	0	0	1	1	6	5	6	1	14	0	8	0	2	0	53	0	30	52	1	15	3	0	3	1	0	0	21	28	844	50	68	40	10	36	15	40	27	51	22	22	0	20	18	0	0	0	3	0	1	0	0	2	1	2	1	0	0	0	1	1	2	3	0	0	0	0	1	1	1	1	1	0	0	0	0	1	1	0	0	0	0	0	0	0	0	0	1	1	0	0	0	17	3	0	72	0	331	165	1	53	0	1	0	6	0	1	6	1	1	15	0	0	40	8	1	0	0	2	0	9	0	11	16	31	0	0	0	0	4	0	3	3	1	0	1	0	0	1	7	7	15	0	53	0	10	4	3	1	0	0	0	7	2	9	3	2	0	1	17	36	0	34	1	0	0	11	0	0	0	22	3	0	1	1	0	5	0	0	0	24	1	0	0	19	8	1	1	0	4	7	0	1	0	1	0	0	1	1	0	0	4	2	2	14	16	0	2	1	1	0	2	1	0	4	0	0	1	0	4
LakWasMet45_HOW7_2_rpkm	0	0	0	0	0	9	3	0	0	0	7	0	0	0	0	0	0	0	3	0	0	0	0	40	0	0	0	0	0	6	0	0	0	17	0	8	2	0	0	0	0	0	0	0	15	64	15	18	0	28	0	13	0	0	0	0	0	2	24	14	79	0	0	0	0	0	0	0	8	24	0	0	0	0	2	0	0	0	0	0	0	3	0	0	0	0	0	0	0	0	0	0	9	0	41	0	0	0	0	0	0	0	0	0	0	0	0	0	0	3	1	4	67	2	11	0	0	3	0	0	0	0	0	10	0	0	0	0	0	0	18	187	4	0	0	0	0	0	0	0	0	2	0	2	0	0	0	0	16	0	33	19	0	1	127	0	1	2	64	0	39	1	0	7	36	0	0	0	0	5	0	0	0	0	0	0	0	0	0	0	0	0	0	0	0	4	0	0	0	4	3	5	3	1	2	0	0	17	28	58	0	0	0	0	0	0	2	0	0	1	21	0	8	16	12	0	0	2	0	0	0	0	0	0	0	0	0	4	23	0	0	1	0	0	0	0	3	0	14	0	0	0	14	2	20	0	0	0	0	2	2	6	7	0	757	16	0	0	0	0	0	0	2	39	9	0	7	0	0	128	3	0	4	0	0	0	0	0	4	4	2	58	0	113	56	0	1	0	8	2	0	0	0	0	1	0	0	2	0	0	0	29	2	0	2	0	13	54	1	0	4	0	138	14	0	0	0	0	155	0	0	0	0	1	4	68	0	0	0	0	1	0	0	0	0	0	2	0	0	0	0	0	10	8	9	16	17	1	1	0	0	1	6	0	0	0	0	0	0	7	2	0	0	0	0	45	4	38	6	0	0	61	0	0	7	0	0	13	0	0	0	0	4	1	11	0	115	0	0	0	0	0	172	0	0	0	8	0	0	19	0	13	0	6	16	0	0	0	0	5	0	0	0	525	0	17	23	9	0	0	0	0	0	0	0	0	0	0	0	3	0	0	0	0	0	0	0	1	2	0	15	3	0	1	0	80	0	1	0	0	0	67	9	800	0	13	115	6	0	0	0	0	5	11	0	9	8	0	1	0	13	0	5	0	0	0	15	1	22	0	0	0	7	0	0	1	0	6	5	0	0	0	20	36	3	0	0	0	0	0	0	0	7	8	0	0	1	0	0	0	0	0	0	0	4	0	0	0	0	11	0	0	0	0	0	0	0	0	0	0	0	0	104	36	9	0	18	0	0	35	0	1	3	34	12	0	0	0	3	0	0	0	1	0	0	5	1	0	0	0	0	8	0	0	15	0	2	0	74	0	0	0	0	6	3	0	0	32	0	0	0	36	6	8	34	0	3	4	54	0	0	0	2244	0	6	4	0	0	9	0	55	0	0	2	6	2	0	22	0	0	0	360	19	243	0	0	241	0	334	0	10	10	54	18	0	5	0	7	0	4	0	2	0	0	0	1	0	0	0	1	3	168	0	1	0	0	0	18	6	0	14	0	2	5	0	0	0	1	0	0	3	13	1	12	0	0	0	0	0	6	5	8	0	0	0	0	0	0	0	1	1	0	1	1	2	0	0	0	0	14	0	0	0	2	0	0	0	4	5	0	0	0	0	4	1	0	2	0	90	0	0	0	0	0	24	9	0	0	6	0	0	0	1	2	14	0	27	0	27	0	0	0	3	0	0	0	0	1	0	0	0	6	2	0	3	88	3	0	0	3	0	0	0	1	0	0	0	0	18	0	0	0	0	14	0	0	4	0	0	0	0	0	0	0	0	109	0	1	0	0	0	0	0	0	0	0	0	0	0	15	25	0	0	0	0	1	13	0	0	9	0	0	0	0	28	3	97	0	0	17	0	0	0	0	0	0	0	0	0	0	0	0	0	4	18	0	0	0	0	12	6	0	0	0	0	0	1	53	22	0	0	0	0	0	0	1	0	0	54	154	0	0	0	0	0	0	0	0	0	2	24	0	0	1	0	2	0	0	3	0	0	0	0	0	0	0	0	0	25	0	0	0	0	1	1	6	88	0	0	0	0	0	0	0	5	0	0	0	0	0	0	0	0	0	0	0	0	0	0	0	0	0	0	0	5	0	3	3	0	0	0	0	0	0	0	0	0	0	0	0	0	0	0	0	0	0	0	0	0	3	0	0	0	30	6	0	5	0	0	0	0	0	0	0	0	0	0	0	2	0	0	0	0	0	0	3	0	0	0	0	0	2	8	80	0	15	0	32	0	0	111	21	2	0	3	0	0	0	0	0	0	2	0	0	0	0	0	0	0	0	2	0	0	0	11	0	0	0	0	0	0	0	0	0	0	0	0	204	0	0	0	17	2	0	0	3	0	0	5	2	6	0	0	0	0	0	0	0	5	5	0	2	0	0	0	0	0	1	0	0	0	0	2	8	0	2	0	0	0	1	0	3	0	4844	0	0	0	0	0	15	4	0	0	0	2	0	2	3	0	19	0	0	0	0	0	0	0	0	0	26	0	0	0	1	0	0	0	0	0	2	0	0	0	0	0	0	5	0	0	15	0	0	0	0	6	0	0	7	0	0	0	17	0	0	0	0	0	11	27	0	0	0	0	3	0	0	4	0	0	0	0	0	0	0	0	0	0	0	0	0	0	0	0	0	0	0	0	0	0	0	0	21	0	0	0	0	0	0	0	0	22	0	0	0	0	0	16	0	0	0	3	0	7	0	0	0	0	2	0	1	6	0	31	6	68	66	0	0	0	115	5	0	0	0	0	0	0	0	0	0	0	0	0	0	0	0	1	1	0	0	0	0	0	0	2	0	0	0	5	0	0	0	0	0	0	0	0	0	0	0	9	0	102	1	3	0	0	0	0	0	15	0	0	11	104	0	0	3	13	0	5	0	0	14	0	2	0	0	0	0	0	0	0	71	1	11	8	9	0	73	0	2	0	2	0	7	0	0	8	1	0	1	0	2	0	3	0	0	2	1	4	0	14	0	0	0	2	4	0	0	0	2	0	0	0	0	0	0	6	0	0	0	18	1	0	0	1	0	2	0	0	0	0	0	11	0	33	4	35	3	0	0	19	0	0	0	0	2	1	8	0	2	11	0	0	0	33	11	0	2	0	2	0	1	31	0	7	0	0	1	0	2	5	16	0	0	4	0	0	0	0	0	1	0	82	0	21	26	8	19	17	1	20	0	0	8	1	10	0	0	1	2	0	10	0	0	11	0	0	4	0	1	4	4	9	0	21	0	0	0	0	0	0	2	2	0	0	0	2	0	2	51	1	0	3	0	10	2	0	0	3	0	2	0	0	0	0	0	0	0	0	0	0	73	10	195	30	0	0	2	0	0	0	0	0	107	2	6	0	8	2	0	0	0	196	375	2	74	0	1	0	83	1	2	0	0	4	0	0	0	48	1	15	3	50	4	0	6	7	10	0	0	0	0	0	0	30	24	0	0	0	8	0	14	0	0	0	3	0	2	0	4	0	0	0	0	19	0	0	0	0	0	0	0	1	0	0	0	0	0	0	0	0	0	0	0	0	0	3	0	0	0	18	0	0	0	0	0	0	1	0	0	0	6	0	0	0	0	0	0	0	0	0	0	0	0	0	0	0	0	0	0	0	0	0	0	0	49	0	0	18	0	0	18	0	85	1	35	190	0	0	4	0	17	2	0	4	0	0	0	96	0	28	0	0	2	0	0	4	0	0	1	3	0	0	0	24	0	0	0	0	0	0	0	0	0	0	12	0	16	4	0	0	0	0	0	0	0	0	269	0	0	0	0	2	0	0	0	0	0	0	0	0	34	14	0	0	13	2	0	2	78	2	2	7	17	0	0	7	0	0	1	0	1	0	0	0	0	3	4	27	14	57	10	29	83	0	0	0	0	0	6	0	10	1	0	58	0	0	0	4	0	0	0	1	18	13	0	35	0	0	5	0	9	0	2	29	0	11	0	3	0	0	0	0	0	0	216	0	2	0	0	0	0	6	0	0	372	0	0	0	0	0	0	0	27	7	196	7	200	0	0	0	12	0	0	0	0	0	0	0	0	18	0	0	0	0	34	0	2	4	23	0	6	0	0	0	2	0	0	0	0	0	0	0	0	0	0	20	0	0	0	6	0	29	0	0	1	24	0	0	813	0	0	0	0	0	0	0	0	6	25	0	0	0	8	1	0	0	16	3	0	0	0	1	0	0	0	0	30	3	0	0	0	0	3	3	0	0	0	1	0	8	13	0	0	3	0	0	1	0	0	0	0	8	0	0	59	0	0	1	0	102	17	53	1	0	31	38	0	16	0	57	0	7	7	0	0	14	1	0	21	0	0	0	0	0	0	0	0	0	0	0	1	0	0	57	16	0	5	0	1	25	0	0	0	0	0	1	0	0	0	0	0	0	0	4	0	0	0	5	5	4	14	0	0	4	0	0	0	9	0	0	24	10	0	0	0	0	0	0	0	1	0	14	0	0	0	0	4	0	0	2	5	0	0	0	0	2	0	0	0	88	0	9	2	0	3	0	0	9	0	0	93	345	16	0	0	0	0	0	1	0	0	0	3	0	0	10	0	0	0	0	0	0	0	0	0	0	20	1	0	0	0	0	0	6	4	0	26	6	0	15	0	108	107	39	0	0	0	0	0	0	1	0	0	0	0	2	0	6	0	0	0	0	0	0	0	4	0	0	0	0	0	0	18	0	0	0	0	0	0	1	17	4	0	0	0	1	0	0	0	0	0	0	82	0	0	4	0	0	1	0	0	0	0	0	0	19	0	0	62	1	1	0	68	0	1	1	0	0	0	0	0	1	0	0	191	0	0	0	0	0	28	0	0	5	2	0	381	19	19	0	0	0	0	0	1	7	0	69	0	0	0	0	0	0	0	0	2	0	0	0	0	0	0	0	0	4	0	0	4	0	0	0	0	0	0	0	0	0	1	3	51	0	0	1	190	0	0	0	0	0	0	0	0	45	0	0	0	0	0	0	0	0	0	0	0	0	5	0	0	0	24	0	6	2	6	1	0	0	5	7	2	0	0	0	0	0	0	122	2	2	3	0	0	0	0	1	3	7	96	39	0	8	0	2	4	0	0	0	0	4	0	0	24	0	0	0	3	0	0	0	0	0	0	0	0	0	1	0	4	0	1	4	0	0	8	1	0	0	2	0	8	0	0	9	0	3	0	0	0	6	0	0	8	0	1	11	0	0	0	0	0	0	4	0	11	0	0	0	0	0	0	0	0	0	0	1	0	0	0	1	0	1	0	0	0	0	0	0	0	0	0	2	0	0	1	0	0	5	0	4	0	0	0	20	0	110	4	3	0	0	0	0	19	8	0	0	0	0	0	8	3	19	6	12	6	39	0	0	40	6	31	4	0	0	4	2	16	12	0	8	0	12	23	35	62	155	36	4	0	5	0	6	12	0	0	0	0	0	0	7	0	4	0	2	88	0	0	1	0	0	0	0	0	0	0	0	0	0	0	0	0	0	0	0	1	2	0	21	0	18	6	0	0	0	0	0	0	0	0	0	0	0	0	0	0	0	0	1	9	0	21	0	0	0	0	0	17	0	46	20	0	0	0	0	0	0	0	0	2	5	0	0	0	0	0	7	0	0	4	0	68	0	0	1	1	0	0	0	0	19	7	0	9	0	0	0	0	0	0	0	2	0	0	1	0	0	2	0	2	0	24	1	0	1	35	0	0	0	0	0	2	0	0	0	0	0	0	0	0	13	1	0	0	0	0	0	0	85	28	71	0	0	36	11	9	2	15	0	6	0	16	0	0	0	0	8	0	0	0	9	0	7	2	0	0	0	0	0	0	0	0	0	0	0	0	0	0	0	0	2	0	1	16	0	0	18	0	1	0	0	0	1	0	0	0	0	18	0	5	0	406	4	0	0	4	13	0	0	0	0	6	0	0	0	0	0	0	2	0	0	0	1	0	0	0	13	0	0	17	36	0	2	0	0	81	5	3	0	0	0	0	0	0	0	3	0	2	1	0	3	0	0	0	0	0	0	0	0	0	0	0	0	0	0	0	0	0	0	0	0	0	10	0	8	0	0	0	44	0	2	0	0	9	0	2	73	28	0	0	0	0	0	0	0	0	0	0	0	0	0	0	0	0	0	0	65	5	13	21	0	5	0	18	0	0	0	0	27	50	0	0	0	0	16	0	0	0	0	2	0	0	0	0	1	0	0	0	50	4	0	0	0	0	0	0	0	1	0	10	4	0	2	0	0	2	0	0	11	0	0	29	1	0	0	0	1	0	0	0	8	1	0	0	16	0	0	0	0	31	0	1	0	0	2	0	0	0	2	0	0	0	0	0	2	0	0	3	0	0	0	0	0	6	1	0	0	0	3	0	0	0	17	0	147	0	0	23	2	110	1	2	0	0	0	0	0	15	0	18	1	0	0	0	0	0	0	0	0	0	0	0	0	0	0	0	95	0	0	0	18	0	0	0	1	1	0	6	0	2	0	6	0	0	3	0	2	15	14	0	1	0	1	2	1	3	0	0	0	45	0	16	0	2	15	0	29	43	20	11	9	0	42	37	22	3	13	0	0	0	4	4	0	24	0	12	0	8	66	4	0	0	0	0	0	0	3	0	0	0	0	0	12	0	0	0	0	9	0	2	0	0	0	0	0	0	0	0	0	0	0	1	3	0	15	0	0	9	1	0	0	0	0	2	0	618	2	0	14	18	19	0	31	2	2	0	0	0	42	0	0	0	0	0	2	0	10	0	0	0	0	0	0	0	0	20	0	0	100	2	0	40	0	2	0	0	0	15	26	10	0	0	0	4	1	2	0	0	0	0	6	0	0	0	3	0	0	0	69	8	1	0	0	0	0	0	2175	59	30	0	0	0	0	0	0	2	0	43	0	8	0	0	0	0	979	145	63	3	0	0	92	0	4	0	46	0	1	0	0	0	1	0	0	0	0	0	0	0	0	0	0	0	0	0	2	0	63	962	0	1	1	0	0	0	1	5	1	0	0	0	0	0	0	14	0	1	0	0	5	4	0	6986	24	150	0	0	0	2	0	0	0	0	0	16	7	0	0	0	0	0	0	0	0	959	2	2	0	0	0	0	0	0	0	1	0	0	0	0	0	3	0	0	0	0	0	0	0	0	0	0	0	0	0	0	0	0	0	0	0	0	0	4	0	0	0	0	0	1	0	0	4	0	0	0	0	0	0	0	0	2	0	0	1	164	0	0	0	0	0	0	46	0	0	0	0	0	0	265	0	0	0	0	0	1	3	55	2	0	0	0	0	18	1	0	41	0	2	4	3	0	0	0	0	0	0	0	18	0	0	0	0	0	0	0	0	0	0	0	0	420	0	0	0	0	0	0	0	0	0	0	0	0	0	0	0	0	0	0	0	4	0	0	0	0	0	6	0	0	3	5	20	10	16	3	0	0	0	0	0	0	0	11	28	0	0	7	0	8	0	39	0	0	1	0	1	2	0	28	0	0	0	5	0	0	0	0	0	6	0	0	0	3	0	0	0	0	1	0	0	0	0	17	3	0	16	0	57	8	0	0	0	0	0	0	0	0	2	33	0	0	0	0	0	0	26	116	0	82	0	0	0	2	0	0	0	0	0	0	0	1	0	0	1	0	6	1	0	0	0	0	0	0	0	0	71	0	17	0	0	0	0	0	0	0	0	1	0	0	0	0	26	0	0	0	0	0	0	2	335	0	0	56	0	0	0	0	19	0	0	0	3	0	2	0	0	0	0	4	99	0	0	0	0	0	0	1	0	0	0	0	3	0	0	0	0	0	0	140	0	0	0	0	0	0	0	105	0	0	0	29	0	0	0	0	0	0	0	0	12	0	0	0	0	0	0	0	0	4	0	0	1	0	0	0	1	0	0	1	0	0	0	0	1	0	2	0	0	0	0	144	0	0	0	0	0	0	0	0	0	0	0	0	0	0	0	0	0	0	0	0	0	0	0	0	0	0	0	0	0	2	0	1	6	2	0	0	0	0	0	4	7	0	0	0	28	0	0	13	8	0	0	0	0	0	0	0	0	0	0	0	0	0	0	2	0	0	0	0	0	0	0	0	0	0	0	4	0	0	6	0	0	0	12	0	0	0	0	0	0	0	0	6	0	0	0	0	0	0	0	0	0	40	0	0	1	1	3	0	0	0	0	0	0	0	0	0	0	0	0	0	0	13	0	0	0	0	0	0	0	0	2	0	1	0	0	0	0	0	0	0	0	0	0	0	3	0	0	0	0	0	0	0	0	0	0	0	0	0	0	0	0	8	0	0	0	0	0	4	1	0	0	28	0	0	0	0	0	0	0	0	0	0	0	0	0	0	0	0	0	0	0	0	0	0	0	0	0	0	0	0	0	0	0	0	0	69	0	0	0	0	0	0	0	0	0	4	0	0	3	0	0	0	8	0	6	0	0	0	0	0	0	0	0	0	0	0	0	0	0	0	0	0	0	4	0	0	0	0	0	0	0	0	0	3	0	0	0	0	0	0	0	0	0	0	64	0	0	6	6	0	0	0	0	6	0	0	5	0	7	94	0	0	0	0	8	0	1	0	6	5	0	7	90	9	9	0	0	57	0	0	0	0	0	38	4	3	0	0	0	4	0	0	2	0	0	0	0	0	0	0	0	0	0	21	0	0	0	0	0	1	0	0	0	0	0	0	0	0	0	0	0	0	0	0	0	4	0	38	0	18	0	0	0	0	0	0	0	0	0	0	949	0	0	0	0	0	3	0	0	0	0	0	0	3	0	0	0	0	0	0	0	0	0	0	0	14	0	0	0	0	0	0	0	0	0	0	0	0	0	0	56	0	0	0	0	0	0	0	0	0	0	0	0	0	188	0	0	0	0	0	0	0	4	194	0	0	0	0	0	0	0	3	0	0	0	0	0	0	0	0	0	0	2	0	0	0	0	0	0	0	0	0	0	39	0	0	0	0	0	3	0	0	0	2	0	0	0	0	0	0	0	0	0	0	0	0	0	0	0	0	15	0	0	0	0	0	0	17	0	0	0	4	0	0	0	2	0	0	0	0	0	0	2	0	17	0	0	0	0	0	20	0	0	0	1	0	0	0	0	0	0	0	0	4	3	0	23	0	0	0	0	0	0	1	0	0	0	0	0	0	0	2	0	0	5	0	104	0	0	0	0	0	55	0	0	6	0	41	0	0	0	0	0	3	0	0	0	0	0	21	5	0	2	0	0	0	0	36	2	0	26	0	0	0	0	0	0	2	4	1	0	0	9	2	0	0	0	0	0	0	0	0	0	0	12	0	0	0	0	0	70	0	0	0	0	0	2	0	0	0	0	0	0	0	11	0	14	3	0	0	0	2	0	0	0	0	0	0	0	6	4	0	0	39	13	3	130	481	0	0	2	0	48	0	29	5	5	0	0	0	0	37	0	42	0	0	77	0	58	0	0	0	0	3	0	0	1	3	0	0	0	0	2	0	5	5	20	0	0	16	0	4	0	4	12	0	0	0	1	0	0	0	0	6	0	0	0	2	0	0	0	33	23	0	4	0	0	0	0	0	0	0	0	0	0	0	0	0	0	0	0	6	23	54	0	0	0	1	2	0	0	0	0	0	0	0	3	0	0	0	14	13	0	0	0	0	0	0	0	0	0	0	0	0	0	0	0	9	13	0	0	2	0	0	0	5	0	0	0	2	0	0	0	0	0	1	0	0	0	0	0	0	0	1	0	0	0	1	0	14	0	0	0	0	0	0	24	0	0	7	0	52	0	0	1	0	6	0	2	48	0	0	5	0	0	0	0	5	0	0	0	45	60	62	0	3	0	0	5	0	10	12	5	1	17	60	9	0	47	2	4	5	11	5	36	84	25	0	32	0	33	0	0	0	0	0	0	0	0	0	0	0	0	2	4	0	0	0	0	0	2	0	0	0	12	0	0	0	6	0	0	0	2	2	34	0	0	0	2	0	0	102	0	0	0	0	0	0	0	133	6	0	0	0	0	0	0	4	1	7	0	19	0	0	0	0	0	0	18	169	0	52	58	13	0	0	0	0	1	0	0	0	0	0	0	0	0	0	0	2	0	0	0	0	0	0	0	0	0	15	0	0	2	0	2	0	2	0	0	0	51	3	0	0	0	3	0	0	0	0	3	13	0	4	7	2	3	0	0	0	0	0	0	0	0	0	0	10	0	1	86	2	0	1	4	0	0	0	2	0	5	0	0	12	591	218	0	0	11	0	0	22	2	3	12	0	0	0	1	0	0	0	0	0	0	1	0	0	0	0	0	0	0	0	0	0	0	0	64	0	2	31	11	0	0	0	0	0	0	0	49	0	0	2	0	4	0	0	2	2	0	0	0	10	3	21	0	0	0	0	18	2	0	0	0	1	0	0	0	0	0	0	3	0	0	11	0	0	0	27	0	0	0	0	2	0	0	0	17	2	0	0	46	0	0	0	0	2	0	15	0	8	0	0	4	13	7	0	0	0	0	0	0	1	0	0	3	19	1	46	0	0	3	0	2	0	0	88	0	0	0	0	4	0	7	0	0	0	0	0	0	1	0	6	0	0	0	0	0	0	0	0	6	0	0	0	17	0	7	0	0	24	2	0	18	0	7	0	0	0	0	0	0	1	0	0	0	0	0	0	0	1	0	0	0	0	0	0	0	0	6	0	1	0	0	0	0	0	0	2	26	0	7	0	0	0	0	0	28	0	0	0	1	0	0	0	2	1	0	0	0	29	0	2	0	0	1	0	9	0	0	0	0	0	0	0	0	7	0	0	0	4	0	0	11	0	0	0	0	60	2	37	0	0	0	0	0	0	0	0	0	0	0	0	34	3	0	1	0	0	0	0	0	0	54	2	91	3	16	45	2	0	0	1	0	0	20	1	2	2	8	0	0	0	0	0	0	2	0	10	2	0	49	5	14	62	0	0	0	0	22	0	6	0	16	0	0	0	0	0	0	0	0	0	0	0	0	0	0	0	12	0	0	0	0	0	0	94	12	0	0	29	0	19	11	26	0	9	0	0	7	0	13	23	0	0	0	0	0	24	2	37	0	0	3	0	0	0	21	0	0	12	0	0	0	0	2	0	0	0	0	20	0	0	0	0	0	12	0	8	0	0	0	0	0	2	17	0	0	0	0	0	5	0	0	0	2	0	0	0	0	0	0	0	0	0	0	0	0	0	0	0	68	0	0	0	0	0	0	4	0	72	0	1	0	0	22	0	2	0	0	0	0	0	0	1	0	0	3	0	0	3	0	0	0	0	0	14	0	4	0	6	462	0	40	1	0	0	7	0	0	3	0	0	0	93	0	4	0	0	0	0	0	0	0	0	0	0	0	0	0	4	0	0	2	0	0	0	0	4	9	0	0	22	0	0	0	0	0	0	0	0	2	0	0	0	0	0	0	0	0	0	0	0	0	0	0	0	0	5	0	2	0	0	0	0	0	0	0	0	0	0	0	0	0	0	0	0	0	0	0	0	113	0	0	0	0	0	0	6	0	2	0	0	12	0	0	3	0	0	0	0	0	0	2	0	0	0	0	0	0	0	0	0	0	0	0	6	0	0	0	0	0	14	0	0	0	0	0	0	0	2	0	0	0	2	0	0	0	117	2	0	0	0	0	0	0	3	0	0	0	0	0	6	0	0	0	0	0	0	0	0	28	0	4	0	0	0	0	8	0	0	0	0	0	22	0	0	0	0	13	0	0	0	0	0	0	0	10	0	0	0	2	20	89	0	0	0	0	0	0	0	0	5	0	0	11	0	0	0	0	5	0	0	0	0	22	0	6	0	2	2	0	0	0	0	3	0	0	5	0	31	0	0	4	0	0	0	0	0	0	0	0	0	0	0	0	0	0	0	0	0	2	0	3	0	0	0	0	0	32	0	0	2	0	0	4	68	0	5	0	0	0	1	0	0	6	0	0	0	0	9	0	16	0	0	0	109	0	0	0	0	0	0	0	2	0	54	0	0	0	0	0	0	47	2	20	0	2	0	0	0	0	0	4	1	0	4	2	12	12	5	4	0	0	9	0	24	4	0	1	10	85	0	32	0	0	1	6	0	0	0	0	83	3	4	21	0	164	0	0	0	31	0	109	0	0	0	0	0	0	21	4	2	0	0	0	0	0	0	0	5	0	5	43	0	0	0	0	0	26	0	0	0	7	0	6	1	70	2	0	19	0	3	0	0	25	0	2	0	0	0	0	0	0	0	0	0	0	0	0	22	2	0	0	0	0	38	14	3	2	3	0	215	7	0	0	1	1	2	0	0	0	0	0	0	0	1	11	0	0	0	0	8	0	8	0	8	0	0	0	0	0	0	0	0	0	0	0	0	1	0	0	0	0	4	0	0	0	0	1	0	0	0	0	0	0	0	0	0	0	0	9	1	0	7	0	0	2	0	0	0	0	3	0	2	0	6	2	0	0	0	0	1	1	27	4	0	0	0	2	0	2	0	0	0	0	5	38	0	0	2	0	0	2	6	2	2	4	4	2	2	0	2	1	0	0	2	2	0	0	0	0	0	0	4	0	0	2	0	0	0	0	0	1	1	0	0	1	0	0	16	6	0	0	0	0	0	0	0	0	4	3	4	56	4	0	0	0	0	16	0	0	0	23	0	37	22	0	0	0	0	0	0	1	13	0	4	0	138	0	0	0	5	0	0	0	0	0	0	28	5	23	95	0	12	0	0	0	2	3	1	0	8	0	1	25	2	48	2	32	0	0	0	1	3	0	0	0	0	0	0	0	0	0	0	0	0	0	17	0	0	0	0	0	0	0	28	0	0	0	63	2	12	0	0	39	0	0	0	0	2	0	121	0	9	14	36	0	0	23	0	25	0	18	0	0	0	0	0	9	0	0	0	0	1	3	5	0	0	0	0	1	0	0	1	0	2	16	3	20	0	564	53	0	0	8	0	1	0	0	0	0	0	1	0	0	0	0	0	0	0	14	0	0	0	33	6	0	0	24	0	0	0	0	4	0	0	0	0	0	1	0	0	4	0	0	51	0	0	0	0	3	0	61	53	12	25	0	0	6	1	0	0	9	0	0	0	0	4	0	0	0	121	0	0	0	39	7	22	4	1	0	0	0	0	2	0	0	14	0	0	4	0	0	0	0	0	34	26	11	0	0	0	14	0	0	2	1	0	0	0	0	15	2	0	0	28	0	0	47	50	9	1	0	0	25	0	0	0	5	1	0	6	0	1	0	3	0	255	52	1	0	0	0	36	2	14	4	8	0	0	0	7	12	0	0	0	0	0	0	395	0	35	21	90	10	30	19	0	0	199	9	0	30	1	0	0	22	21	0	0	0	0	0	1	0	0	0	0	12	2	0	0	0	0	0	7	5	171	57	1	4	0	37	0	86	75	52	2	0	67	0	0	0	2	0	0	0	0	0	0	0	0	0	0	24	1	2	0	1	0	0	1	0	0	0	20	0	4	0	0	39	0	90	0	11	7	52	26	0	11	0	0	0	0	303	39	3	0	1	0	2	0	63	0	0	0	0	0	1	23	2	0	0	0	0	0	0	13	64	0	2	0	0	0	0	2	0	10	0	0	0	0	0	39	2	11	10	77	0	0	0	0	0	0	4382	0	983	0	9	0	0	15	8	8	0	0	0	0	0	0	0	0	45	0	7	0	0	0	0	0	0	0	5	1	0	0	134	0	0	4	0	0	0	0	0	0	1	904	0	0	0	0	3	0	0	1	0	2	0	0	0	0	0	0	0	0	0	0	0	0	0	1	2	0	3	0	23	0	0	1	0	8	0	0	0	147	0	0	0	0	0	0	0	0	72	0	0	1	3	0	1	2	0	0	0	0	417	2	0	10	8	0	0	0	0	0	0	12	13	17	4	0	0	0	0	2	0	0	16	3	0	0	0	75	0	0	1	1	0	0	0	0	0	0	0	0	0	3490	0	24	0	1	587	0	2	205	16	145	49	477	470	545	8	488	190	223	0	2	36	22	9	8	1	1	37	0	2288	0	0	213	0	1	74	2	0	0	44	32	60	0	0	0	0	4	40	0	0	0	12	5	29	0	13	14	25	5	44	0	0	0	24	5	18	6	0	0	0	0	0	0	0	0	0	0	54	1	0	0	0	8	1	0	130	0	2	0	3	3	23	2	0	0	2	0	0	25	0	0	0	0	0	0	166	0	29	0	0	0	29	3	0	48	2	1	0	4	124	811	0	10	1	4	54	0	7	19	0	1	0	57	3	0	4	5	1	23	0	5	61	2	0	0	0	49	1	0	0	12	1	0	0	7	0	25	0	0	0	95	0	0	1	8	0	0	11	4	0	0	3	0	0	0	0	1	0	0	0	0	4	0	0	34	0	1	0	30	0	3	23	12	0	0	1	0	0	9	0	2	30	0	0	0	10	35	0	17	69	0	0	5	1	0	0	2	0	0	0	0	2	0	9	11	21	24	14	1	0	0	0	0	0	0	0	0	21	0	0	0	0	0	0	0	0	2	26	1	0	10	0	0	0	0	0	0	6	0	6	0	0	0	0	0	0	2	0	0	1	0	0	0	0	0	0	0	8	0	0	0	0	1	0	4	5	2	0	0	6	3	0	0	0	0	0	0	1	10	0	0	2	0	0	0	0	10	1	1	5	0	5	2	3	0	0	0	0	0	1	0	0	0	65	0	0	61	2	0	0	45	4	43	0	0	0	0	0	7	0	18	1	5	7	0	0	0	0	2	185	0	0	0	0	3	160	282	12	88	4	48	94	0	120	0	48	1	9	6	262	295	144	23	151	139	54	59	23	0	76	0	0	44	20	30	0	0	87	2	138	385	3	44	6	517	0	2	28	3	65	44	0	23	0	0	0	0	322	30	0	61	50	111	104	0	1	39	104	299	4736	0	15	22	0	0	0	0	5	2	0	0	0	3	0	51	116	149	2	0	6	0	0	0	0	0	6	7	5	8	0	15	0	6	82	170	0	13	98	45	0	0	0	0	1	37	36	3	1	34	1	0	0	38	4	3	20	2	0	0	0	24	0	0	0	81	0	0	0	1	0	0	0	38	3	1	0	0	3	17	0	2	2	0	0	20	0	0	2	24	0	0	0	0	0	0	0	0	2	2	0	0	0	0	0	0	2	0	0	0	1	2	0	8	48	17	9	2	0	0	0	0	0	0	0	0	5	0	0	0	0	0	0	0	0	0	0	0	1	0	0	0	0	25	0	0	0	0	0	0	0	0	0	0	0	0	0	0	0	2	31	0	0	0	0	0	0	170	0	14	22	0	76	15	40	0	0	0	0	0	0	0	0	0	0	1	0	0	72	0	8	1	0	0	0	1	0	1	1	0	0	6	2	1	6	0	0	0	0	78	37	0	0	0	8	1	0	4	8	26	0	31	0	0	5	0	4	40	2	2	0	0	0	5	12	2	0	2	2	2	34	2	0	0	5	0	0	6	82	59	10	4	1	0	0	7	22	1	0	0	0	1	0	0	0	1	0	1	0	0	0	0	0	9	17	0	51	0	0	0	0	0	0	0	1	1	0	140	0	0	0	0	0	0	0	0	0	71	24	3	0	7	4	1	1	1	0	0	1	11	0	0	2	0	0	1	0	2	0	0	0	10	0	0	19	0	15	2	0	0	3	0	0	0	0	0	1	9	2	0	0	20	0	2	0	0	0	0	0	3	5	1	0	35	40	24	0	0	6	0	0	2	0	0	4	0	0	0	0	0	0	0	0	0	0	0	2	0	0	0	0	36	7	0	2	0	0	0	0	0	8	3	4	30	0	1	0	0	2	0	0	0	3	0	0	0	3	0	0	0	0	4	33	0	0	24	2	0	0	2	26	0	11	0	0	76	0	0	28	0	0	0	0	0	0	1	0	1	48	0	2	69	0	21	0	0	0	0	115	0	0	0	0	0	424	0	0	0	0	0	0	0	1	2	1	0	6	0	0	0	0	0	0	1	6	0	0	13	7	0	0	0	0	35	0	0	0	5	0	30	17	0	6	0	0	362	0	57485	0	0	1	0	0	16	0	0	0	0	0	0	0	0	0	0	40	0	0	0	0	12	11	44	0	0	3	16	2	0	0	0	0	0	0	0	2	6	18	0	15	2	0	0	0	0	4	1	3	2	0	0	3	0	2	37	10	57	58	5	10	22	0	7	2	0	0	0	0	72	11	9	21	2	0	0	0	0	3	0	26	198	0	0	66	0	0	0	0	9	0	0	8	0	71	0	0	59	5	0	0	42	53	0	0	31	1	0	0	0	3	0	0	0	0	0	1	0	20	46	19	36	28	0	3	32	0	553	0	0	81	8	115	16	22	9	89	43	0	0	12	0	0	46	0	0	0	22	5	24	45	2	3	0	0	1	94	30	1	10	4	0	0	0	0	0	0	0	0	0	0	0	6	89	6	5	0	10	0	0	0	1	0	0	0	0	2	11	4	2	1	0	0	2	0	0	0	4	0	10	0	0	0	6	0	12	18	0	4	0	0	0	2	55	0	0	0	1	0	0	0	0	3	1	0	0	0	0	0	2	12	0	1	4	20	0	0	4	0	0	0	4	2	0	12	0	8	0	0	0	80	5	0	0	2	1	70	1	0	7	5	0	107	0	0	0	5	0	2	0	0	0	9	0	0	0	0	0	0	0	0	0	0	3	0	0	0	0	2	1	0	0	3	0	0	0	0	0	0	0	0	0	0	0	0	0	0	0	0	0	0	6	6	0	1	0	0	0	0	0	3	3	0	3	0	7	38	20	1	68	0	0	0	15	29	45	10	21	0	0	5	0	3	0	1	0	0	16	1	9	4	0	0	0	0	0	0	0	0	57	0	0	0	11	2	0	0	0	0	0	1982	37021	0	0	0	0	0	0	0	27	2	24	4	0	9	0	27	10	0	1990	0	0	0	7	3	1	33	1	453	0	1	18	0	675	6	2	9	0	0	0	0	0	80	0	0	33	26	34	0	0	0	68	2	0	0	0	0	0	0	3	0	0	0	2	0	16	9	0	0	0	0	7	0	0	0	3	0	1	0	2	0	0	0	0	0	0	0	47	93	19	29	57	32	21	129	0	0	4	8	28	13	0	0	1	2	2	0	4	0	0	0	0	0	15	0	0	5	0	0	0	1	0	2	1	15	0	0	0	6	16	5	0	0	51	0	0	0	0	1	0	0	0	49	0	49	0	0	0	6	2	2	0	0	0	3	0	0	0	0	0	0	0	0	0	5	155	0	0	2218	0	1	2	6	0	0	0	1	0	2	0	0	0	0	0	4	0	0	0	0	0	0	0	0	0	0	0	8	0	0	4	0	7	12	22	146	17	41	0	0	0	0	0	0	0	0	0	0	0	0	0	0	0	3	11	43	0	15	0	12	0	0	0	0	0	0	0	1	0	16	0	0	91	0	0	0	2	0	11	0	0	17	0	0	0	1	10	0	3	3	7	0	112	1	0	9	20	3	3	5	0	0	34	0	0	2	0	14	13	0	0	0	0	0	0	140	0	0	0	0	357	0	0	0	0	0	11	0	1	1	0	0	5	2	0	1	1	0	0	0	0	3	19	0	0	0	6	113	13	0	0	0	1	0	0	0	0	17	0	0	0	1	0	0	27	2	0	0	0	0	3	0	0	0	16	8	0	60	3	0	0	0	1	0	3	17	4	2	4	0	0	2	0	0	422	0	1	3	0	16	2	0	0	6	73	13	2	3798	0	14	69	12	0	36	0	132	35	46	0	0	0	0	2	6	3	0	0	0	5	0	0	3	0	11	0	8	80	0	4	1	0	11	275	0	5	0	0	0	36	28	0	0	0	0	52	0	0	13	0	1	0	6	15	0	0	0	0	34	4	2	0	0	1	2	0	0	0	5	0	3	0	0	0	9	0	0	0	0	2	0	1	4	0	14	7	27	0	3	12	14	21	17	17	59	0	0	0	0	0	0	0	1	0	489	0	0	0	57	30	36	5	3	224	2	0	24	17	2	2	6	0	0	0	5	0	1	0	0	17	345	38	0	0	0	0	0	0	5	0	0	0	2	0	1	1	0	0	0	0	0	0	0	0	0	0	0	0	4	0	0	0	0	0	0	0	0	0	0	0	0	0	0	2	0	0	0	0	0	0	0	0	0	0	0	0	11	0	0	0	7	0	0	0	0	0	0	6	0	0	0	41	1	0	7	0	0	6	497	9	79	48	0	0	4	0	7	1	1	12	0	0	0	0	9	0	3	0	0	9	0	3	15	0	4	5	0	1	7	17	12	41	5	0	2	1	0	0	0	0	0	51	5	3	0	7	1	35	3	0	49	2	0	51	0	0	1	0	12	75	100	46	0	20	2	16	0	4	0	45	0	2	0	0	0	0	0	0	0	0	0	0	20	0	11	11	0	0	0	5	0	4	7	0	0	0	0	23	0	14	0	5	17	0	2	58	4	61	0	0	0	1	0	0	0	3	2	82	0	572	4	0	0	72	0	4	0	0	0	0	0	1	0	0	0	0	0	1	20	23	0	8	15	38	718	7	0	7	0	0	0	0	0	0	0	8	0	0	3	40	0	0	0	4	0	17	0	0	0	0	0	0	35	14	0	19	23	3	1	0	0	0	0	33	0	73	0	5	123	0	0	0	26	0	3	0	1	0	1	9	0	0	0	0	0	8	2	0	0	0	0	0	2	0	2	0	0	0	0	0	0	0	0	3	0	0	0	0	0	0	0	3	0	8	0	208	22	0	12	18	7	12	1	11	4	0	0	0	3	0	0	2	0	0	0	0	0	0	0	0	27	0	0	0	0	0	1	0	0	0	0	0	35	0	0	0	0	10	0	0	0	0	0	0	7	0	0	8	1	0	0	0	3	0	0	0	0	1	0	3	0	0	7	1	4	2	6	4	38	0	0	0	0	0	0	0	0	10	0	50	0	0	0	3	0	13	75	0	0	0	0	51	0	0	0	0	0	0	0	0	5	0	0	0	3	0	0	0	0	0	0	0	0	0	3	0	0	0	0	0	18	0	0	300	0	0	0	0	0	0	0	0	0	0	0	0	0	37	0	0	0	0	0	0	0	0	2	0	0	0	0	0	0	0	3	0	0	0	59	0	0	0	0	0	0	3	0	0	11	1	0	0	0	0	0	0	0	0	752	0	0	0	0	0	0	0	0	0	0	1	0	0	2	0	0	0	0	0	0	0	0	0	0	0	0	0	0	0	0	0	3	0	0	0	0	0	3	90	0	0	0	0	18	0	0	0	0	0	0	0	0	0	0	0	0	0	0	0	29	0	0	0	2	0	0	0	0	97	0	0	0	0	0	0	0	0	0	0	0	0	24	0	0	1	0	0	0	0	0	0	0	0	0	0	0	0	11	0	0	0	0	2	1	0	0	0	0	4	0	0	0	0	0	0	0	0	0	0	0	0	0	4	0	18	0	0	0	0	0	0	0	0	0	2	13	0	0	0	0	25	0	11	0	0	0	0	0	0	2	0	1	0	0	0	0	4	0	0	4	0	2	0	3	2	0	0	51	3	0	0	0	0	0	2	0	5	7	7	10	0	0	2	0	0	13	0	0	28	0	0	0	0	0	0	0	0	6	0	0	0	0	6	6	0	0	0	0	4	5	10	0	0	0	0	1	4	0	0	0	0	0	10	0	0	52	0	1	4	0	4	0	10	0	10	7	0	0	1	0	0	0	1	4	0	0	0	2	2	89	0	2	0	5	3	0	1	8	28	4	4	0	3	0	43	0	1	0	1	0	3	0	0	0	0	17	0	2	0	0	0	0	0	0	0	261	13	11	0	0	1	0	0	33	0	18	0	378	10	0	0	0	11	0	0	0	0	2	0	0	0	0	0	1	6	0	3	0	2	5	0	0	0	2	0	2	0	0	0	0	0	0	0	0	0	0	0	0	0	0	0	0	0	0	0	5	0	34	0	0	0	0	0	0	7	4	2	0	0	0	0	4	1	0	0	2	0	0	0	21	0	3	0	4	1	2	0	0	0	0	0	19	0	0	1	0	1	0	21	1	0	0	195	0	1	0	0	0	0	0	0	0	0	399	0	16	0	0	0	0	0	0	0	0	0	0	0	0	0	0	3	0	0	0	0	0	46	103	3	52	73	0	0	0	0	0	0	4	0	4032	0	2	0	22	0	0	0	0	0	9	0	0	0	0	0	0	0	0	0	0	18	21	0	80	0	3	39	49	0	0	0	0	0	0	0	2	0	0	0	1	0	0	0	0	2	0	3	0	4	27	0	0	15	0	0	0	0	0	0	5	11	10	39	34	125	0	32	35	1670	1	33	1	4	61	1	0	0	2	0	0	0	0	0	2	26	6	1	0	0	0	67	5	0	0	0	48	0	0	0	0	0	0	2	0	5	0	4	6	0	28	0	0	0	0	2	0	0	0	10	0	7	0	0	0	3	0	0	18	0	27	0	0	0	0	7	0	12	0	0	0	4	2	0	0	9	0	0	1	1	6	12	63	0	0	0	0	0	0	0	0	0	0	0	0	0	0	4	0	0	2	35	2	0	10	0	1	9	31	3	0	2	0	6	10	4	25	52	0	0	0	0	17	1	3	23	5	52	13	0	0	0	5	0	0	0	1	4	1	103	14	26	0	1	0	0	2	6	8	7	0	0	0	0	0	7	5	0	11	7	5	4	15	0	0	0	0	3	0	8	10	11	27	0	0	30	19	24	0	0	0	0	0	0	0	6	0	0	81	0	4	0	0	0	0	3	39	2	6	0	0	0	0	1	0	0	0	0	3	0	0	0	0	0	0	15	5	79	0	38	1	2	0	4	0	14	0	4	0	9	0	0	0	11	0	2	15	3	3	2	0	4	0	21	92	0	0	2	0	0	6	0	0	9	0	0	0	0	8	19	1	0	12	2	20	0	1	1	0	0	1	2	2	16	0	0	0	27	0	0	191	0	31	4	0	26	6	0	0	0	0	0	30	0	0	2	1	0	0	0	0	0	4	8	2	0	0	120	0	16	0	0	0	0	0	0	0	0	0	0	23	21	4	0	0	26	0	0	77	0	5	65	38	0	0	340	73	0	49	47	5	64	36	8	3	0	0	0	2	0	0	0	2	2	0	0	0	13	0	0	0	0	0	0	6	0	0	0	0	0	12	0	6	1	0	13	0	0	0	0	0	0	0	0	0	0	0	0	0	0	0	0	0	0	0	0	0	0	0	0	0	0	37	5	0	0	0	0	0	14	0	0	0	0	0	0	0	0	0	0	0	0	0	0	0	0	0	0	27	14	0	81	0	0	0	13	0	0	0	42	44	36	5	0	2	42	0	0	0	0	2	1	0	0	0	0	0	0	14	8	7	3	0	34	54	0	1	0	4	1	11	2	10	0	0	0	0	0	0	0	0	0	0	0	0	0	0	0	20	1	15	0	8	0	1	8	4	0	20	3	12	0	0	0	0	0	0	2	22	0	0	0	0	0	0	0	6	8	2	0	0	44	0	5	7	0	0	0	0	0	0	7	0	1	0	376	0	1	0	0	2	204	0	0	0	0	21	0	1	0	2	4	0	0	0	41	0	8	10	8	0	7	6	0	2	0	32	0	2	0	4	0	0	7	1	11	55	0	4	0	3	2	43	2	0	6	16	15	0	20	5	7	0	15	0	0	8	3	0	0	0	0	0	0	26	0	0	0	2	6	0	6	0	1	0	0	0	0	0	0	0	0	1	0	0	3	0	0	0	0	0	0	0	0	1	0	0	0	0	0	5	0	4	7	0	7	0	0	0	0	0	6	2	2	7	35	0	0	0	3	31	64	24	70	26	4	0	205	204	0	2	159	0	40	0	0	0	0	2	0	19	0	21	22	9	0	2	25	0	0	2	11	2	0	0	16	19	296	0	0	0	0	0	0	0	16	0	1	1	0	0	0	0	0	0	0	3	0	145	0	24	23	12	0	13	1	6	0	0	0	0	0	1	0	0	0	0	0	87	0	0	19	4	8	30	2	834	0	0	0	0	6	84	0	32	54	21	14	8	21	0	19	9	0	0	0	5	0	0	0	4	2366	43	15	0	0	0	7	0	0	15	0	0	0	0	0	16	0	61	6	0	0	0	141	19	2	2	0	4	36	13	48	0	2	2	0	0	0	20	23	0	1	1	0	0	0	0	0	2	1	0	0	0	0	0	0	0	0	0	0	0	0	0	206	0	1	0	0	258	7	4	0	1	0	3	19	1	0	0	0	21	8	2	10	2	0	4	0	0	0	5	0	0	10	0	0	0	3	0	2	20	24	0	0	39	0	0	108	22	6	10	0	0	0	0	0	0	0	0	7	0	0	0	53	0	0	0	0	0	0	0	11	0	27	0	3	2	8	0	0	14	1	21	0	0	5	6	8	0	0	8	0	7	1	54	96	18	37	0	39	0	0	0	0	0	2	0	0	0	0	2	2	0	5	0	0	0	0	6	0	0	0	18	0	2	30	0	4	1	1	1	1	122	0	170	0	0	148	0	0	6	0	0	0	3	0	1	72	0	0	0	0	1	0	3	3	0	0	12	1	34	0	2	0	14	0	16	163	0	0	0	0	7	7	0	0	44	7	82	42	54	138	64	51	30	25	24	143	80	19	0	56	23	0	0	2	3	0	1	0	0	0	0	71	0	0	3	0	0	2	4	2	0	0	0	0	0	0	0	0	0	0	0	0	0	0	1	0	0	0	0	0	0	0	0	0	1	0	5	0	0	7	2	0	57	0	227	75	6	32	2	8	0	10	0	0	0	0	15	13	0	0	33	1	0	0	0	0	0	4	0	194	13	28	0	0	0	0	0	0	0	0	0	0	1	0	0	0	4	17	9	0	69	0	9	4	5	6	0	0	7	0	0	41	0	26	0	5	2	30	0	18	0	0	1	0	0	0	0	11	0	0	1	0	0	0	0	0	3	25	0	0	0	14	10	4	0	7	2	4	0	2	0	0	0	0	0	0	0	0	0	0	0	2	14	0	2	0	0	0	0	0	0	0	0	0	0	0	2
LakWasMet49_LOW8_2_rpkm	0	0	0	0	0	6	43	2	0	0	0	0	2	0	0	0	0	0	20	0	0	0	0	38	0	0	0	0	2	9	0	5	0	2	2	4	2	0	0	0	0	0	0	0	40	39	103	4	0	4	0	8	0	0	0	7	8	44	96	30	74	0	0	0	0	0	0	0	28	232	0	1	0	0	0	0	0	0	0	0	0	11	0	0	0	0	0	1	0	0	0	0	24	0	28	0	0	0	0	0	0	0	1	0	0	0	0	0	0	0	0	0	107	5	36	0	0	0	0	0	0	1	1	2	0	0	1	2	0	0	0	29	15	0	0	0	0	0	27	0	0	0	0	0	0	0	0	0	4	1	0	6	4	1	12	0	1	49	10	1	11	0	0	1	17	0	0	2	0	3	0	0	0	0	0	0	0	0	0	1	0	0	0	0	0	1	0	0	0	1	1	2	7	5	0	0	1	10	12	49	35	0	2	0	0	0	67	0	36	2	4	1	65	7	23	0	1	0	0	7	2	2	5	0	1	1	0	1	3	0	0	0	0	0	1	0	6	4	18	3	0	0	12	9	49	27	0	0	6	27	4	4	10	0	2069	97	0	0	0	0	2	3	0	17	7	1	0	0	0	95	118	0	1	0	0	0	0	0	112	19	0	33	15	70	39	0	0	0	9	1	0	0	0	0	0	0	0	0	2	0	0	53	58	0	24	0	45	17	56	0	23	0	75	3	0	0	0	0	95	0	0	0	0	0	8	13	2	0	0	0	0	0	0	0	0	0	0	1	0	0	0	0	12	11	4	1	28	0	0	0	1	1	2	0	1	0	0	0	0	59	4	0	1	0	0	15	4	45	4	2	0	9	0	0	3	2	0	3	0	0	0	0	1	4	2	0	103	0	0	0	1	0	37	0	0	6	6	0	0	25	0	6	0	1	79	0	1	0	0	0	0	34	13	0	0	31	45	2	0	0	0	1	1	0	0	0	0	0	0	0	2	1	0	0	0	0	0	0	24	0	91	7	0	0	1	108	0	1	0	0	0	214	30	735	0	25	5	3	0	14	0	0	1	8	0	44	19	0	0	0	10	51	13	0	0	0	7	3	42	0	5	0	2	0	0	0	3	48	105	10	0	0	136	69	8	0	0	0	0	0	0	0	1	0	1	0	0	0	0	0	0	0	0	0	0	0	0	0	0	0	0	0	0	0	0	0	0	0	0	3	0	0	0	4	16	0	21	0	0	26	0	10	1	6	29	1	0	0	2	0	0	0	0	0	0	5	2	0	0	0	0	4	0	0	5	0	20	0	27	0	0	1	0	4	10	2	3	65	0	34	26	80	25	8	54	0	2	1	16	0	0	0	1767	0	10	1	0	0	2	0	17	0	0	1	11	7	0	73	0	9	0	141	43	283	0	0	52	0	145	0	56	43	21	17	0	2	1	6	0	1	9	22	0	0	0	0	0	0	0	0	0	61	0	0	0	0	0	7	3	0	58	0	2	15	0	0	0	0	0	0	1	116	0	34	0	0	0	0	3	15	3	25	0	0	1	0	2	0	0	0	3	0	45	0	0	0	2	0	0	19	0	0	5	0	0	0	0	2	0	2	0	0	0	1	0	0	1	0	37	0	0	0	0	0	7	4	0	0	7	5	1	1	1	6	0	0	6	0	3	0	0	4	2	0	0	0	0	0	0	5	0	42	3	0	33	31	10	0	5	29	0	0	0	1	0	10	0	0	16	1	0	3	0	11	0	0	1	0	0	0	0	0	0	0	0	29	0	0	0	0	0	0	0	0	0	0	3	0	0	16	1	1	0	0	0	1	13	0	0	4	0	0	0	0	39	0	81	1	0	1	0	0	0	0	0	0	4	0	0	0	0	0	0	1	8	1	0	5	0	0	0	0	0	0	0	0	1	17	19	0	0	0	0	0	0	0	0	8	35	4	0	0	3	0	0	0	1	1	0	12	30	6	0	0	0	0	1	0	0	1	0	0	0	0	0	0	0	0	15	11	0	0	0	1	0	2	2	0	0	0	0	0	0	5	2	0	0	0	0	0	0	0	1	0	0	0	1	0	0	0	0	0	0	0	31	34	70	20	16	0	0	0	0	0	0	2	0	0	0	0	2	0	0	0	0	0	0	0	0	13	0	0	0	8	11	0	1	0	0	0	1	0	0	0	0	0	0	0	0	0	0	0	2	0	0	3	0	0	2	0	0	6	3	33	3	35	27	0	0	0	34	4	29	0	107	0	0	1	0	0	0	1	1	0	0	0	0	0	0	0	0	1	0	0	2	0	1	0	0	0	0	0	0	0	0	0	0	89	0	0	0	81	9	0	0	1	0	0	1	33	0	0	0	0	0	0	0	0	11	0	0	0	0	0	0	0	0	12	0	1	0	0	0	0	1	0	0	0	0	0	2	0	0	4866	0	0	0	0	35	0	75	0	0	0	2	0	11	0	10	5	0	5	0	0	0	0	0	0	0	16	0	0	0	0	0	0	0	0	0	0	0	0	0	0	0	1	17	0	1	11	0	0	0	0	3	0	0	2	0	0	0	2	0	0	0	0	11	11	3	0	1	0	0	0	0	4	0	0	0	0	0	0	0	2	0	0	0	0	0	0	0	0	0	0	1	0	0	0	0	1	0	2	0	0	0	0	0	0	0	0	13	3	0	0	1	0	1	1	0	0	1	0	5	0	0	0	0	0	0	0	0	0	18	4	124	144	3	0	0	22	0	0	1	19	0	0	1	0	0	0	0	0	8	0	0	0	0	1	0	0	0	0	5	0	0	0	0	0	19	2	0	0	0	0	0	0	0	4	1	0	3	0	10	9	0	0	1	1	0	0	0	0	0	152	166	0	0	0	5	0	2	0	0	23	0	0	0	0	0	0	0	0	52	1	1	4	4	7	0	11	1	2	0	5	0	4	0	0	2	0	0	0	1	0	0	6	0	0	0	2	1	0	3	0	0	0	1	2	0	7	0	0	0	1	1	0	0	0	0	0	0	0	25	0	0	0	2	0	0	0	0	0	0	13	3	0	88	41	46	8	0	0	9	0	0	0	0	3	0	7	0	5	2	0	1	0	10	10	0	1	0	0	2	0	9	0	11	1	0	26	0	0	21	25	0	3	8	3	0	0	0	0	4	0	23	0	8	12	4	70	22	10	23	0	0	1	67	20	0	0	0	0	0	18	7	0	5	0	1	1	0	10	14	11	0	0	21	0	0	0	0	0	4	2	3	0	0	0	10	3	11	41	1	0	28	0	3	3	0	1	0	1	0	18	5	2	0	1	0	0	0	0	0	2795	79	16	31	0	2	0	0	0	0	0	2	39	0	2	2	19	0	0	0	0	68	21	89	4	0	0	0	69	0	0	0	0	0	0	0	0	156	17	12	31	55	18	0	6	230	19	0	0	0	0	0	0	64	0	0	0	0	43	0	9	2	0	0	0	0	9	0	1	0	0	0	0	12	0	0	0	0	0	0	3	8	19	0	0	0	0	0	1	0	0	0	0	0	0	1	0	0	0	3	0	0	0	0	0	0	2	0	0	0	0	0	0	0	0	0	0	0	0	0	0	0	0	0	0	0	0	0	0	0	0	0	0	0	37	0	0	9	0	0	0	0	218	0	10	4	0	0	72	0	3	0	2	1	0	0	0	41	0	5	0	0	1	0	0	0	0	0	3	60	0	0	0	7	0	0	1	1	0	1	0	0	0	0	1	0	216	7	1	0	0	0	21	0	0	0	47	1	0	1	2	0	0	1	1	1	0	0	0	6	14	36	0	7	2	0	0	0	13	0	11	2	23	3	0	6	0	0	0	0	4	0	0	8	0	87	6	104	63	98	6	64	1	0	0	0	1	6	47	0	0	9	4	118	0	0	0	2	0	0	0	0	35	77	0	129	10	0	4	0	1	2	1	11	0	121	1	6	0	0	0	0	0	0	56	0	2	145	1	0	0	12	2	1	21	0	17	5	1	14	6	0	4	7	266	75	19	0	4	2	8	11	3	0	0	2	20	2	0	33	0	1	5	0	0	0	0	6	0	2	9	0	0	0	0	0	0	0	12	0	0	0	0	0	0	17	0	0	0	8	0	71	59	0	3	4	0	0	2552	5	0	1	0	0	0	0	0	1	0	0	0	0	4	0	0	0	12	0	0	0	0	0	1	1	2	0	29	0	0	0	1	0	4	3	0	0	0	4	0	6	8	10	0	30	0	0	0	1	0	0	0	22	0	0	21	6	0	1	0	52	199	0	10	0	51	142	0	21	12	29	0	23	8	13	9	22	3	0	5	0	0	0	0	0	0	0	0	0	0	0	0	0	0	5	0	1	9	0	15	355	0	0	0	0	0	0	0	1	0	0	0	0	0	5	0	0	0	5	2	12	0	1	0	0	0	0	0	0	0	0	1	6	0	0	0	0	0	0	0	0	0	0	0	0	0	0	3	0	0	1	0	0	0	2	0	0	0	0	0	43	0	1	0	1	0	1	0	10	0	12	5	40	11	0	0	0	0	0	0	0	0	0	7	0	0	17	0	1	1	0	1	0	0	0	0	0	1	1	0	3	1	4	1	13	3	0	9	1	0	0	0	10	8	13	0	4	0	0	0	0	1	1	0	0	0	1	0	1	0	0	0	0	0	0	4	0	0	0	0	0	0	19	1	0	0	0	1	1	0	4	55	5	0	0	0	0	0	0	0	1	0	0	3	1	0	0	0	2	3	0	0	2	0	0	22	36	0	0	2	0	0	0	36	0	0	0	0	0	0	0	0	0	0	0	25	0	0	0	0	0	7	0	0	2	16	0	41	53	73	4	0	3	0	0	0	7	0	82	8	0	0	0	0	0	17	0	4	0	0	0	0	0	0	0	0	1	1	0	2	0	0	0	0	0	0	0	0	1	0	18	27	0	0	0	0	0	0	0	0	0	0	0	0	0	0	0	0	21	1	3	6	0	1	1	0	0	1	0	0	0	509	0	1	29	50	4	0	5	0	17	5	0	0	0	0	0	3	101	0	0	4	1	0	0	0	0	0	4	0	14	0	0	0	0	18	0	0	31	0	5	0	0	1	0	0	0	34	0	0	0	1	0	1	0	0	0	0	0	1	0	0	15	3	0	12	2	0	0	0	3	2	0	0	2	0	3	2	0	0	3	0	0	0	0	3	147	0	0	0	0	0	0	1	0	3	0	1	0	0	0	0	0	0	0	0	0	1	0	0	0	0	0	0	0	0	0	0	3	0	0	0	0	0	0	3	0	0	0	0	1	1	9	0	8	0	24	0	1	0	0	0	0	2	2	0	0	0	0	0	28	123	45	221	278	61	138	157	5	159	62	49	260	81	42	85	3	177	640	3	47	4	547	364	390	227	743	57	154	74	144	3	154	9	0	0	0	0	0	0	0	0	0	0	9	187	0	0	0	0	0	0	0	0	1	0	0	0	0	0	0	11	0	0	0	0	15	0	1	0	6	1	0	0	0	0	49	0	3	0	0	0	1	1	0	0	0	0	1	0	0	14	0	0	0	0	1	2	1	18	10	0	0	1	0	0	0	8	0	0	0	1	0	1	0	0	198	0	0	3	0	2	0	0	0	0	0	0	0	0	1	7	1	0	0	0	1	0	0	0	0	0	0	0	0	0	0	2	0	3	0	26	0	0	5	10	0	1	0	0	0	0	0	0	0	0	0	0	0	4	1	1	0	0	5	0	0	0	3	3	1	1	1	1	0	0	2	1	0	24	0	0	1	0	0	0	2	0	0	0	4	0	1	7	0	0	0	0	0	3	0	1	0	0	0	0	0	0	0	0	0	1	0	2	0	0	7	0	0	0	0	0	2	0	0	0	0	5	0	2	0	1540	1	0	1	0	0	0	0	0	0	0	0	0	0	5	0	0	7	0	3	40	0	0	0	0	5	0	0	79	11	0	0	5	0	37	0	0	5	1	3	0	0	0	0	0	0	2	0	0	0	0	1	0	1	0	2	0	0	0	2	0	0	0	0	0	0	0	0	0	1	0	2	0	0	0	0	0	23	0	1	0	0	19	0	0	83	217	5	0	6	0	0	0	0	0	0	0	0	0	0	0	0	0	0	0	74	1	0	0	0	1	0	4	0	0	0	0	38	43	0	0	0	0	80	0	0	0	0	0	0	0	0	0	0	0	0	0	124	7	0	0	0	0	0	0	1	2	0	0	57	4	4	1	0	2	0	0	7	8	0	4	0	0	0	0	0	0	0	0	3	0	1	0	224	0	0	0	0	0	1	0	1	0	0	0	0	0	0	0	0	0	0	0	0	0	0	1	0	0	0	0	0	3	2	0	0	0	0	0	0	1	6	0	31	1	2	30	0	3	0	0	8	0	0	0	1	35	0	7	3	0	0	0	0	0	0	0	0	11	0	0	0	0	0	0	29	0	2	34	97	1	0	53	26	5	0	15	0	17	0	28	0	21	1	31	1	47	18	2	1	10	0	11	0	26	0	0	0	9	0	14	0	26	19	10	13	12	4	3	3	0	4	1	1	0	131	0	0	0	1	37	0	15	0	0	0	3	14	10	0	0	0	0	0	0	5	0	0	0	0	4	12	0	0	0	1	36	0	0	0	0	0	0	0	0	9	0	0	3	0	0	6	0	1	0	9	0	0	0	0	0	0	1	0	1361	0	0	21	7	6	0	43	0	26	0	0	0	313	0	0	0	0	7	60	0	8	0	0	1	0	0	0	0	0	0	0	0	7	21	0	75	0	6	0	0	0	66	11	0	0	0	0	4	0	1	0	0	1	0	0	0	0	0	55	0	0	0	139	35	0	1	0	0	0	0	1718	562	244	0	0	0	0	2	0	1	0	15	0	0	0	1	0	1	4	284	32	1	0	0	0	0	0	0	20	0	1	0	0	0	0	0	0	6	0	0	0	0	0	0	0	0	0	0	0	0	40	69	0	0	1	0	0	0	0	8	6	0	0	0	0	0	11	1	0	2	0	0	0	0	0	17	2	0	0	0	0	6	1	1	4	0	0	4	1	3	0	0	0	0	0	1	0	1263	2	0	1	4	1	0	0	0	0	0	0	0	0	0	0	0	1	3	0	0	0	0	0	0	0	0	0	0	0	0	0	0	0	0	0	0	0	1	0	0	0	1	0	0	3	0	0	0	0	0	0	0	0	0	1	0	0	0	0	79	0	0	0	0	0	0	29	0	0	0	0	0	0	37	0	0	0	0	0	2	2	62	9	1	6	0	0	5	0	1	92	0	0	9	1	0	0	0	0	0	0	1	3	2	1	3	0	0	0	0	0	1	0	0	0	21	1	0	0	0	0	0	0	0	1	0	3	0	0	0	0	0	2	0	0	0	0	0	0	0	0	12	0	0	0	11	88	1	1	16	0	0	0	0	0	0	0	0	9	0	0	0	0	4	0	8	0	0	0	0	0	0	1	1	1	141	0	19	31	14	0	21	0	0	0	0	0	0	1	0	0	0	0	0	0	5	0	3	6	0	35	0	11	845	2	0	1	0	0	1	0	2	0	15	0	0	0	0	0	0	378	292	0	2	0	0	0	1	0	0	0	0	0	0	0	0	0	0	2	8	31	7	0	0	0	0	1	0	0	2	16	2	15	0	0	0	0	0	0	0	5	3	0	0	0	0	7	1	0	0	3	0	3	0	1054	14	0	4	3	2	0	0	33	0	0	0	27	0	1	1	0	0	0	0	8	0	0	0	2	13	0	0	0	0	0	0	2	0	0	0	0	0	0	71	0	0	0	0	1	0	0	35	0	0	1	0	0	0	0	0	0	0	0	1	0	0	0	1	0	0	5	6	0	1	0	0	0	0	3	0	0	0	0	0	0	0	1	0	5	1	5	0	3	0	0	11	0	8	0	0	0	0	0	0	0	0	0	0	0	0	0	0	0	0	0	0	0	0	1	0	0	0	0	0	0	0	0	0	0	1	0	0	0	0	3	0	5	0	0	0	36	3	0	3	2	0	1	7	0	0	0	0	0	0	0	0	0	0	1	0	0	0	0	0	0	5	0	0	0	18	0	2	1	0	2	0	0	0	29	0	0	0	0	0	0	2	0	11	0	0	0	0	5	0	0	0	0	10	2	0	0	34	1	0	0	0	0	0	0	0	0	0	0	0	6	0	0	8	0	0	0	0	1	0	0	0	2	0	0	1	0	0	0	0	0	0	0	0	0	0	166	0	1	0	0	0	0	0	0	17	0	41	0	0	0	0	0	0	0	1	0	0	0	0	0	0	0	0	0	0	0	1	0	4	0	0	0	0	0	0	0	0	0	0	0	0	1	0	0	2	0	0	0	0	0	0	1	0	0	0	1	8	0	0	0	0	0	0	1	0	0	1	0	0	0	0	0	0	0	0	0	0	0	0	1	0	0	0	0	0	0	0	0	0	0	1	0	0	0	0	0	0	0	1	0	0	0	0	0	0	0	0	0	0	0	0	0	0	0	0	81	0	0	49	1	0	0	0	0	22	0	0	13	0	0	1	1	0	0	0	0	0	0	0	0	2	0	31	61	5	1	0	27	5	0	0	0	0	0	6	2	6	0	0	0	1	1	0	0	0	0	0	0	0	0	0	0	0	0	7	0	0	0	0	0	0	0	0	0	0	0	0	0	0	0	0	0	0	0	0	0	1	0	88	0	114	2	0	0	0	0	0	0	0	0	0	120	0	0	0	0	0	0	0	0	0	0	0	0	1	0	2	0	0	0	0	0	5	0	0	0	23	0	0	0	0	44	0	0	0	0	0	0	0	0	4	0	0	0	0	0	0	0	0	0	0	0	0	0	0	84	2	0	0	0	0	27	0	1	46	0	0	0	0	0	0	0	0	0	0	0	0	0	0	0	0	1	0	0	0	0	0	2	0	0	0	0	0	0	16	0	0	0	2	0	0	2	0	0	2	0	0	0	0	0	0	0	0	0	0	0	0	0	0	0	0	15	0	0	0	0	0	0	0	0	1	0	0	0	0	0	0	3	0	0	2	0	0	16	0	3	0	1	0	0	0	19	0	0	1	0	0	0	1	0	0	0	0	0	6	42	0	17	0	0	0	0	3	0	0	1	0	2	1	0	0	0	2	0	0	4	0	2	0	0	0	0	0	1	0	2	1	0	26	2	0	0	0	0	0	0	0	0	4	1	4	0	0	2	0	0	0	0	7	1	0	30	0	0	1	0	0	0	0	0	0	0	0	0	0	0	0	0	0	0	0	0	0	0	0	127	1	0	0	0	0	16	0	0	0	0	0	13	0	0	0	0	0	0	0	0	0	20	1	4	0	0	0	0	0	0	0	0	0	0	6	1	1	0	39	1	0	214	304	0	0	3	0	520	1	17	87	1	0	0	0	26	187	0	66	0	17	19	0	245	0	4	0	0	2	0	0	12	13	0	27	0	0	25	0	31	11	21	0	0	12	0	1	0	17	0	0	22	7	0	0	0	0	0	1	0	10	4	0	0	0	0	10	3	1	6	0	0	0	0	0	0	0	0	0	0	5	1	0	1	5	0	12	13	14	0	0	0	5	0	20	1	0	0	0	0	0	0	0	0	0	39	101	0	0	1	0	0	0	0	0	0	0	0	0	0	0	0	2	13	0	0	0	0	0	0	14	1	0	0	0	0	0	2	0	0	0	2	1	9	0	1	0	0	4	0	0	0	7	6	4	0	1	1	0	0	0	24	0	0	2	0	7	1	1	0	0	1	0	1	6	1	0	5	0	0	0	0	66	0	0	0	37	191	287	0	23	5	157	318	0	62	39	22	2	129	568	278	1	42	17	252	42	103	2	291	17	143	0	34	0	1	0	5	0	0	0	0	0	0	0	1	0	5	6	1	0	1	0	0	0	11	0	0	13	3	0	0	0	0	0	1	10	1	1	6	1	0	0	0	0	0	37	1	1	0	0	0	0	0	59	5	0	0	0	1	1	0	9	1	7	0	58	0	1	0	1	3	0	4	339	5	86	0	51	0	0	0	0	0	0	0	0	0	0	0	0	0	0	0	13	0	0	0	0	27	0	0	0	0	72	0	0	11	0	1	0	0	0	0	0	1	0	0	0	0	27	1	0	0	0	1	14	0	1	1	0	1	0	0	0	0	0	0	0	0	0	0	10	0	0	123	1	0	1	0	0	0	0	121	0	0	0	0	2	0	0	0	0	15	0	0	85	0	0	3	0	0	0	1	0	1	0	0	0	0	0	1	0	0	0	0	0	0	0	0	0	0	5	0	0	0	3	0	0	0	0	0	0	0	11	58	0	0	0	0	2	1	1	1	14	5	0	0	29	18	1	0	0	2	1	17	3	0	0	0	2	0	0	0	0	0	0	1	0	0	30	0	2	0	29	0	0	0	0	0	0	0	2	3	0	0	6	0	0	0	0	0	0	0	10	0	24	1	0	0	1	93	0	1	0	0	0	0	0	6	0	5	2	0	19	0	0	0	1	9	0	0	37	0	0	0	1	12	0	9	0	0	0	0	0	0	3	0	17	0	0	0	0	0	0	0	0	1	0	0	0	9	0	4	0	0	3	0	0	0	0	97	0	0	0	0	0	0	4	5	0	0	0	0	0	17	1	0	0	0	0	1	0	0	2	1	0	8	0	0	0	0	0	0	0	19	0	1	0	0	0	0	0	12	0	0	0	0	0	0	0	0	1	0	0	0	0	0	0	1	0	6	1	0	0	0	0	0	0	0	0	0	0	0	0	0	0	0	2	7	10	0	0	0	168	71	6	12	0	0	0	0	0	0	0	0	0	0	0	64	19	0	8	0	0	0	19	0	3	7	13	37	17	20	27	8	1	0	0	0	0	19	1	1	1	0	0	0	0	0	0	0	0	0	18	22	0	32	5	3	0	0	0	0	0	31	0	0	0	0	0	0	3	0	0	0	2	0	0	0	0	1	0	0	1	2	0	0	0	9	0	0	43	30	0	0	4	0	3	5	1	0	0	0	6	0	0	45	2	0	0	0	0	0	1008	0	41	0	0	0	1	0	0	8	14	0	0	0	0	1	0	0	0	0	0	12	1	0	0	2	0	0	2	0	3	0	0	1	0	0	0	0	0	2	2	0	0	0	0	0	0	0	84	0	0	0	4	0	0	0	0	0	0	2	0	0	0	19	0	0	0	0	3	2	0	2	1	0	106	3	0	7	0	27	0	2	0	0	0	0	2	0	0	0	1	0	1	0	0	7	7	0	2	0	0	0	3	142	0	1	0	13	0	2	1	1	3	0	0	0	3	0	76	3	0	0	0	0	0	36	0	0	0	0	0	0	149	0	0	2	0	0	0	0	309	3	0	0	0	0	1	0	0	0	0	1	0	1	0	0	0	0	8	0	0	0	0	0	0	0	0	0	0	0	10	0	0	1	0	0	0	0	0	0	0	0	0	0	0	0	0	0	0	0	0	0	0	28	0	0	0	0	0	0	0	0	1	0	0	14	0	0	0	0	0	0	0	0	0	4	0	0	0	0	0	0	2	0	0	0	3	0	4	0	0	0	0	0	240	0	0	1	0	0	42	0	10	0	0	1	1	1	0	4	91	0	0	0	0	0	0	0	5	0	0	5	0	4	24	0	0	0	0	0	0	0	0	1	0	4	0	0	0	0	0	0	0	6	0	0	41	0	0	0	0	5	0	0	0	0	0	0	0	0	0	0	1	0	8	37	0	0	0	0	0	1	0	0	0	0	0	0	0	0	0	0	0	0	0	0	0	986	0	0	0	3	6	0	0	0	2	2	0	0	4	0	0	0	0	0	8	2	0	0	0	0	26	0	0	0	0	0	0	0	0	0	1	2	0	0	1	0	0	0	2	5	0	0	0	0	0	11	43	0	0	0	0	0	3	0	11	33	0	0	0	0	12	0	14	0	4	0	3	0	0	0	0	0	0	0	1	6	0	0	0	0	0	0	0	102	8	18	5	0	1	0	0	0	0	0	1	0	0	2	20	18	11	113	0	11	29	0	24	0	0	0	58	12	0	123	1	0	0	1	16	0	0	0	112	17	0	1	57	900	0	0	0	3	6	5	0	0	0	4	0	0	9	0	62	0	0	1	0	1	0	0	64	0	0	2	0	0	1	0	0	18	0	4	3	7	1	39	15	20	10	2	37	0	2	1	1	6	1	0	0	0	0	0	1	0	0	0	0	0	3	0	11	1	0	0	0	0	108	35	6	0	0	0	182	0	0	0	24	10	1	8	1	0	1	0	0	0	0	0	0	0	0	0	1	0	16	2	27	0	1	0	0	2	0	0	0	0	0	1	0	0	0	0	0	0	0	0	0	0	0	0	0	0	0	0	0	0	0	0	0	0	1	1	0	0	2	0	0	0	0	0	0	2	0	0	5	0	6	0	0	0	1	0	3	0	54	22	1	0	1	1	0	0	0	0	0	0	1	202	0	0	0	1	0	5	7	2	1	6	0	5	0	0	1	0	0	0	1	2	0	0	0	0	0	0	2	0	0	0	0	0	0	0	0	4	1	0	0	34	0	0	7	3	0	0	0	0	0	0	38	0	0	0	24	42	0	0	0	0	0	4	0	0	0	5	24	28	110	0	73	0	1	0	18	0	63	0	4	0	120	0	5	0	1	0	0	0	0	0	0	41	2	6	20	0	39	0	0	0	0	28	0	0	13	0	0	19	67	50	5	54	2	0	0	0	40	0	6	3	0	0	1	1	7	1	0	0	0	0	2	0	0	0	0	0	0	1	16	0	0	0	30	1	14	1	0	31	4	0	0	1	49	0	17	2	2	3	40	4	0	53	22	52	12	126	1	0	0	0	0	6	0	0	6	1	1	0	1	0	0	0	0	0	2	2	14	0	6	56	38	45	0	48	1	0	0	0	0	1	0	0	0	0	0	0	0	0	0	0	2	0	0	23	14	0	0	11	3	1	0	0	0	0	3	0	67	1	0	0	0	0	6	1	0	2	1	0	31	0	0	0	0	18	0	200	44	18	1	0	0	85	1	0	0	159	22	0	1	0	1	3	0	0	139	0	0	0	168	1	7	4	0	0	10	0	0	4	6	0	7	0	0	0	1	0	1	0	0	57	101	87	0	0	7	0	2	3	1	1	0	1	0	0	37	18	0	0	0	1	0	20	91	44	0	1	26	50	0	0	0	0	0	0	0	0	0	0	1	0	8	9	5	0	0	0	46	7	19	0	0	0	0	0	25	48	2	16	50	0	18	0	132	0	26	24	16	35	9	2	2	8	149	68	0	4	0	0	0	6	3	7	0	1	0	0	0	0	0	0	6	1	0	0	0	0	0	4	15	12	265	465	14	3	0	2	0	6	9	8	0	0	6	0	0	0	1	0	0	0	0	0	1	0	0	0	0	0	0	0	0	3	0	0	0	0	0	0	6	1	30	0	0	59	1	74	3	2	7	7	6	32	39	0	0	0	0	38	41	6	0	0	0	2	8	8	0	1	3	0	0	2	3	0	0	0	0	0	0	0	38	20	0	0	0	0	0	0	0	0	2	0	0	0	0	0	2	1	4	5	39	1	0	0	0	0	0	7	0	5190	0	6	0	3	24	52	0	0	0	0	0	0	0	0	0	23	11	5	0	0	0	0	0	0	1	6	0	0	0	38	0	0	3	0	0	1	0	0	0	0	100	0	0	0	0	0	0	0	0	0	3	3	0	0	0	0	0	0	0	0	0	0	0	0	0	0	1	42	0	32	1	0	9	0	1	1	0	4	17	1	0	0	0	0	0	0	0	13	0	0	2	0	0	0	1	0	0	0	0	150	2	0	8	337	0	0	0	0	43	0	83	12	65	7	0	0	1	0	2	0	3	34	0	0	0	0	96	0	0	0	0	0	0	0	0	0	0	0	1	0	1061	8	27	2	7	718	2	4	60	4	8	3	533	415	428	376	12	10	13	0	2	175	64	38	5	6	0	0	1	1304	0	0	53	1	0	51	12	0	0	122	1	0	1	0	0	0	0	50	0	0	1	11	21	18	69	13	6	6	6	16	0	11	0	49	12	2	42	0	0	0	0	1	0	0	0	0	1	5	0	0	12	1	10	0	2	4	0	0	0	0	0	0	1	0	0	10	0	0	14	37	0	0	0	0	0	42	0	1	0	9	0	5	30	0	53	23	0	0	64	12	56	0	0	2	13	21	2	5	7	0	1	0	13	0	0	70	0	0	5	2	5	119	12	0	9	5	28	29	0	0	29	9	0	0	26	1	3	0	1	0	34	0	0	14	2	4	0	1	3	0	0	38	0	0	2	0	0	0	0	0	0	5	0	0	19	0	0	0	1	0	65	31	16	0	0	0	13	0	46	4	2	3	0	0	1	28	1	0	18	15	0	13	12	10	12	11	5	1	10	8	5	3	2	9	8	141	99	16	0	0	0	0	2	0	0	0	0	0	0	1	2	0	0	1	1	0	0	74	23	0	4	0	1	0	0	0	0	12	5	2	0	0	0	0	0	0	2	0	0	0	0	0	0	0	1	0	0	3	0	0	5	0	0	0	42	9	0	3	0	2	0	0	0	0	0	0	0	0	14	0	0	0	1	0	0	0	1	2	3	0	1	5	2	6	0	0	0	0	0	0	0	0	1	206	0	0	60	0	0	1	11	27	11	0	0	0	0	0	4	0	13	1	38	25	0	0	0	0	0	0	0	1	0	0	10	9	20	6	6	3	2	7	2	3	0	8	7	8	4	21	101	27	10	20	3	4	3	2	0	3	0	0	8	2	1	5	5	23	11	26	38	4	20	10	4	6	4	11	0	4	5	0	11	0	0	0	0	72	35	0	2	3	37	37	0	2	96	207	89	388	0	55	5	0	0	0	0	1	9	2	14	0	6	0	445	94	171	0	0	20	0	0	0	0	0	196	19	57	154	111	31	114	0	31	135	0	9	0	105	19	0	0	0	3	0	44	3	4	14	6	12	1	5	4	46	89	17	0	0	0	1	0	2	10	4	0	0	1	0	1	0	0	4	0	0	0	0	0	18	4	0	2	0	0	6	0	0	0	6	0	0	0	0	0	0	0	0	0	0	0	0	1	0	0	0	0	0	1	1	1	3	1	11	30	0	12	9	0	0	0	0	1	0	0	0	0	0	0	0	0	0	0	0	0	0	0	27	0	1	0	0	0	1	0	0	0	0	0	0	0	0	0	0	0	0	0	0	1	0	9	0	1	0	0	19	0	176	0	16	61	0	30	1	52	0	0	0	0	0	1	0	0	0	1	0	1	0	17	7	30	14	1	0	0	0	0	0	0	0	0	22	8	0	34	0	13	0	0	20	25	0	0	0	27	0	1	23	49	39	22	12	1	0	6	0	0	16	1	43	0	0	0	36	20	7	0	2	15	3	49	30	0	0	50	33	1	1	102	113	14	1	3	0	0	9	0	20	36	0	2	0	0	0	0	14	0	1	0	0	0	0	0	6	0	0	20	0	0	0	0	0	0	7	1	1	0	28	0	0	0	0	0	0	0	0	0	35	14	6	0	2	50	0	23	0	0	1	4	4	1	0	2	1	1	0	0	3	0	0	0	0	2	0	23	28	11	1	0	0	0	0	0	0	0	1	1	45	2	0	0	3	0	0	0	0	0	1	0	6	1	12	0	44	11	6	0	0	10	0	0	4	2	0	0	0	0	0	0	0	0	0	1	2	0	8	0	0	0	0	2	20	0	0	0	0	0	0	0	2	0	2	11	1	0	0	0	0	1	0	1	8	5	1	0	0	10	0	0	0	0	26	17	0	0	13	47	5	0	0	25	0	21	2	3	63	0	0	7	0	1	0	0	0	0	0	0	0	53	43	0	22	2	32	7	0	7	0	16	0	0	0	0	0	0	0	0	0	0	0	0	0	0	0	0	0	0	0	0	0	11	0	1	0	8	0	0	4	3	0	0	0	0	48	7	1	0	0	0	149	80	0	1	0	0	5	0	44761	0	0	0	0	0	17	0	2	0	0	0	0	0	0	0	0	2	0	0	0	0	30	27	52	18	0	0	27	5	0	0	0	0	0	0	1	0	45	96	0	91	12	0	0	0	0	1	2	0	5	0	0	2	0	4	1	14	49	130	6	4	21	0	21	2	0	2	3	1	30	1	3	6	0	0	0	0	2	2	0	273	203	19	17	3	0	0	0	0	112	0	0	2	0	58	15	1	33	1	0	0	101	69	0	0	71	35	0	2	0	2	0	0	0	0	0	1	0	37	63	68	18	130	0	17	9	0	11	35	32	73	237	20	4	85	19	148	3	0	18	50	11	0	6	0	0	0	71	12	124	135	11	0	4	0	0	24	53	8	7	2	0	0	0	0	0	0	0	0	0	0	0	0	3	0	2	0	1	3	0	0	6	1	2	0	0	24	24	14	7	0	3	0	11	0	2	2	6	0	3	0	7	9	11	1	13	14	0	3	0	0	0	16	9	0	0	2	1	1	0	0	0	0	0	0	0	0	0	29	0	3	0	26	8	1	0	0	1	0	0	0	0	0	1	20	0	25	0	0	0	72	34	0	0	1	0	20	0	0	6	0	0	6	0	0	0	1	0	0	0	0	0	1	0	0	0	0	0	0	0	0	3	0	8	0	0	0	0	0	0	0	0	0	2	4	0	0	0	0	0	0	0	0	1	0	0	0	0	0	0	0	2	12	1	2	0	0	0	0	0	1	4	0	1	0	11	6	18	0	66	0	0	0	135	6	18	9	12	0	0	2	2	38	0	0	4	0	7	6	7	3	0	0	0	0	0	0	0	0	1	0	15	0	4	7	73	0	1	0	0	553	983	0	1	0	1	0	0	1	10	6	105	16	1	46	0	23	37	9	2503	1	0	0	21	11	21	39	11	12	0	0	6	1	13	2	3	0	0	0	0	0	0	4	0	7	29	8	12	0	0	0	3	3	0	0	0	0	0	0	0	0	0	0	1	0	34	7	8	0	3	0	0	0	0	0	1	0	0	25	38	0	0	0	0	0	0	0	45	249	68	26	18	4	31	0	32	3	3	4	3	5	0	1	6	0	1	0	1	3	0	0	0	0	27	2	0	0	0	0	0	1	0	2	2	2	0	15	0	29	5	0	8	1	19	0	0	0	0	0	0	0	1	95	0	9	0	0	0	1	2	0	1	7	6	2	0	0	0	0	0	0	0	0	0	6	76	0	0	1558	0	0	3	12	0	0	1	2	0	3	0	0	0	0	1	1	0	0	0	1	0	0	0	0	1	0	0	18	0	0	43	0	5	11	19	89	1	15	0	0	0	0	0	0	0	0	0	0	0	0	0	0	0	0	0	183	0	0	0	2	0	0	2	0	0	0	0	0	0	0	0	0	56	0	0	0	28	1	16	1	0	5	5	2	1	9	1	2	7	15	3	0	31	3	5	11	52	53	17	63	0	0	41	0	0	2	3	6	1	0	0	0	0	0	0	678	0	0	1	0	75	0	0	0	0	0	165	1	59	1	1	0	5	2	0	0	1	0	0	0	0	0	2	0	0	0	0	392	73	0	0	0	0	1	0	0	1	34	0	0	0	0	0	0	15	21	0	0	0	0	16	1	0	0	109	3	0	75	13	0	0	0	0	0	0	13	2	22	17	0	0	4	0	0	2	1	0	2	0	3	1	0	0	11	71	18	4	815	0	0	0	0	0	5	0	30	14	16	0	0	0	0	9	1	8	0	15	0	0	0	0	26	0	0	0	13	24	3	21	8	0	21	75	0	0	0	0	0	3	0	0	0	0	0	33	0	0	10	1	4	0	8	0	0	3	0	0	10	0	0	0	0	10	3	0	0	0	2	32	5	24	0	0	32	3	0	1	0	0	0	12	13	3	37	18	44	27	0	0	14	0	4	36	30	0	1	0	0	0	0	5	0	0	363	1	0	3	18	23	23	0	4	3	0	4	6	6	6	0	120	10	0	1	2	0	2	0	0	169	217	106	0	0	0	0	0	0	0	0	0	0	5	0	2	0	0	0	0	0	0	0	0	0	2	0	1	0	0	0	0	0	0	0	0	0	0	0	0	0	0	0	0	26	0	0	0	0	0	0	0	0	0	0	0	0	3	0	0	0	13	3	27	8	0	3	0	0	3	0	3	8	1	0	1	1	0	24	472	13	43	8	14	13	0	2	2	1	24	6	0	0	0	0	9	1	3	0	0	4	0	1	8	0	25	30	0	1	1	0	0	127	23	0	10	0	0	0	0	0	0	65	27	24	7	97	8	47	19	0	51	3	1	2	0	0	0	0	9	15	87	19	0	27	55	24	0	0	0	7	0	1	0	0	0	1	0	1	0	0	0	0	106	0	0	0	0	1	0	1	1	0	7	7	18	3	1	5	4	109	50	13	16	1	1	379	52	83	0	0	0	0	0	0	0	1	1	91	5	61	37	0	0	5	1	2	0	0	0	0	0	0	0	0	0	0	0	3	0	10	0	2	9	27	45	66	0	23	0	0	0	0	0	3	0	2	0	0	1	19	0	0	0	1	3	0	0	0	0	0	0	0	12	21	0	13	45	1	2	1	0	1	0	3	0	29	0	0	5124	0	0	0	51	0	20	0	2	0	0	4	0	0	0	0	0	0	27	0	0	0	0	0	4	0	0	0	0	0	0	0	0	0	1	4	1	1	0	0	0	0	0	0	0	13	0	19	136	0	15	10	16	43	41	33	9	0	1	0	30	0	0	0	0	0	0	0	0	0	0	0	5	0	0	0	0	13	1	0	1	0	0	0	16	0	0	0	0	2	0	0	0	0	0	0	4	0	0	21	7	0	0	0	0	0	0	0	0	0	0	1	1	0	6	0	17	21	40	1	38	1	0	0	0	0	0	0	0	43	0	136	0	2	3	67	0	44	82	0	0	1	0	0	0	0	0	0	4	0	0	0	0	0	0	0	0	0	0	0	0	0	0	0	0	0	0	0	0	0	0	0	0	0	0	781	0	0	0	0	0	0	0	0	1	1	0	1	0	0	0	0	0	0	1	0	1	0	1	0	0	2	0	0	0	0	0	0	0	0	119	0	0	0	0	0	0	30	0	0	0	0	0	0	0	0	0	0	0	0	0	0	0	0	0	0	3	0	0	2	0	0	1	0	0	25	0	0	0	0	0	0	0	0	0	0	0	0	0	0	0	0	0	0	0	0	0	1	0	97	0	0	0	0	25	0	0	0	0	0	0	0	0	0	0	1	0	1	0	0	0	0	0	0	0	0	0	0	0	26	0	0	1	0	1	0	0	0	0	0	0	0	3	0	0	0	0	0	0	0	0	0	0	0	0	0	0	0	0	0	0	0	0	0	1	1	1	0	0	15	0	0	0	0	0	0	2	1	0	0	1	3	0	251	0	16	3	0	0	0	25	0	30	0	0	2	41	0	1	0	0	261	9	4	0	0	0	0	0	0	0	0	4	1	0	0	9	8	0	0	4	0	0	0	0	18	0	22	0	6	0	0	0	0	0	4	9	10	1	2	0	0	0	0	0	0	113	8	0	0	2	1	0	0	0	3	2	0	4	1	1	1	1	23	42	2	0	0	0	2	15	33	7	1	0	0	0	4	9	1	2	0	1	11	0	0	37	0	1	2	0	2	0	24	0	2	19	0	0	1	0	1	1	10	35	5	0	2	0	0	16	12	3	4	22	73	38	4	104	98	48	23	0	1	10	151	0	4	0	1	0	0	0	0	0	0	4	0	3	0	0	0	1	0	1	0	38	8	6	0	0	3	0	0	21	0	243	0	50	7	0	0	1	8	3	0	1	0	0	0	0	1	0	0	0	6	0	12	0	0	4	0	0	0	4	0	0	0	0	0	0	0	0	0	0	1	0	1	0	0	0	0	0	0	2	0	0	0	1	0	0	0	1	0	0	2	18	2	1	0	2	0	11	0	0	0	1	0	0	0	0	0	5	0	10	0	0	0	0	0	0	0	7	0	0	1	0	0	0	0	0	1	0	34	0	0	1	1	1	0	0	0	0	0	113	0	6	3	0	0	0	0	0	0	0	0	0	0	1	0	0	0	0	0	1	0	0	83	16	2	39	167	1	1	0	0	0	0	2	0	2490	0	2	2	17	0	0	1	0	4	1	1	0	0	0	4	0	0	0	0	0	9	1	4	95	0	12	13	8	0	1	0	0	0	0	0	1	0	0	0	0	3	0	0	0	16	0	2	0	16	17	0	1	2	0	0	0	0	0	0	6	10	13	17	49	48	0	35	40	1315	0	46	7	0	29	0	0	21	19	0	0	0	0	0	0	6	26	0	0	0	0	56	13	0	0	0	9	0	0	0	0	0	4	2	0	15	57	35	0	0	104	0	0	0	0	0	0	0	9	3	1	4	4	37	0	2	2	0	2	0	37	0	0	0	1	11	0	16	0	2	0	3	7	1	5	7	0	1	7	0	4	1	61	41	2	0	0	1	0	0	0	0	0	2	0	0	0	0	0	0	9	39	4	0	0	3	1	6	4	86	0	3	0	0	1	28	3	18	0	1	0	0	12	5	3	130	29	0	0	0	0	0	1	0	0	0	0	5	0	72	38	57	0	34	0	0	16	11	2	1	0	0	0	0	1	23	12	14	0	6	12	0	18	0	6	2	1	6	1	14	36	16	46	3	0	1	149	18	2	0	0	0	0	0	0	72	0	0	162	0	2	0	0	0	1	1	165	4	1	0	0	0	0	0	0	0	0	0	0	0	1	0	0	0	12	22	2	112	0	1	0	0	0	0	0	13	6	0	0	11	0	1	0	3	0	0	45	47	0	156	0	2	0	18	26	0	0	1	1	0	16	0	1	1	0	0	0	0	0	30	13	1	12	6	17	0	0	0	0	0	2	0	0	43	0	0	0	9	0	0	71	0	7	9	0	7	8	0	0	0	1	0	60	17	0	0	10	0	1	4	0	0	2	1	2	0	0	30	159	12	2	0	0	0	0	6	0	0	0	0	2	1	1	73	0	124	1	0	133	23	75	806	14	1	39	53	73	55	83	188	13	129	9	79	3	0	0	0	0	0	1	0	0	0	2	1	0	20	0	0	0	0	0	0	2	1	0	0	0	0	18	0	2	2	2	6	0	0	0	0	0	0	0	0	0	0	0	0	0	0	0	0	0	0	0	0	0	0	1	0	0	1	9	3	0	0	0	0	0	3	0	0	0	0	0	0	0	0	0	0	0	1	0	0	0	0	0	0	15	30	0	205	4	0	0	29	0	0	0	10	20	12	3	0	4	21	0	0	2	0	0	1	0	0	0	0	0	0	0	8	50	0	79	13	16	0	0	0	24	3	20	1	0	1	0	2	3	0	0	1	0	1	4	1	0	1	1	0	18	9	22	1	10	0	1	7	8	0	36	18	0	2	0	0	0	0	0	0	30	0	0	0	0	0	0	0	0	0	4	0	0	50	3	0	25	0	58	0	0	0	0	2	2	1	2	281	15	3	2	0	0	451	0	0	0	1	2	0	19	0	0	58	0	0	0	18	0	29	31	3	0	10	10	0	0	2	6	0	1	0	5	2	0	7	1	2	27	0	4	0	1	0	9	0	0	2	16	17	7	89	27	4	2	0	12	0	9	0	0	17	1	1	0	0	45	0	0	5	11	6	0	6	3	0	0	0	0	0	8	2	0	0	0	0	0	0	0	1	1	0	0	0	0	1	28	0	0	0	0	0	0	3	0	8	0	3	1	1	0	0	0	5	20	0	5	24	0	33	0	0	227	16	87	8	10	0	1	572	412	0	49	104	0	0	0	34	9	0	0	0	15	0	40	57	12	0	1	3	1	1	0	6	20	0	0	1	1	45	0	0	0	0	0	0	0	40	0	2	3	2	7	0	0	0	0	0	0	0	258	3	92	11	22	0	35	1	5	0	0	0	0	0	1	0	0	0	0	0	93	0	0	10	2	0	10	1	476	59	1	0	0	72	39	0	31	18	9	2	5	32	0	17	35	1	0	0	0	0	1	0	21	494	312	10	0	1	0	1	0	0	33	0	0	3	0	4	0	0	129	237	0	0	0	51	25	12	38	0	29	7	7	142	2	2	10	0	0	2	4	2	7	0	0	0	0	0	0	10	1	0	3	0	0	0	0	0	0	0	0	0	0	0	0	198	1	0	0	0	36	30	6	0	0	0	1	7	2	0	0	0	36	34	2	0	55	0	62	14	0	0	2	93	0	4	14	0	0	24	23	81	7	65	50	10	1	1	1	127	5	26	22	0	0	0	0	0	0	0	0	1	0	0	0	0	0	0	0	0	0	0	0	13	0	0	2	5	0	7	0	0	16	3	3	0	1	1	0	1	0	0	2	9	1	7	60	15	1	5	0	1	0	0	0	0	0	0	0	0	0	0	0	0	0	0	0	0	0	0	1	0	0	0	3	0	0	0	0	0	1	1	176	0	4	0	30	0	0	1	0	0	13	8	0	0	0	0	2	1	0	0	0	0	7	7	7	4	0	0	20	7	12	0	26	0	53	3	29	133	1	1	0	0	1	2	0	0	16	7	143	23	29	21	4	42	2	18	10	13	8	23	0	5	8	0	0	0	9	0	0	0	1	3	1	9	1	0	0	0	0	0	2	11	0	0	0	0	0	0	0	0	0	0	0	0	0	1	0	0	0	0	0	0	0	0	0	0	0	0	4	4	0	70	6	0	62	0	14	185	8	118	0	0	0	3	0	0	1	0	1	8	0	0	16	14	0	0	0	3	0	26	0	24	1	11	0	0	0	0	1	0	1	0	0	0	0	0	0	3	1	1	0	0	4	5	5	3	1	2	0	0	3	0	0	108	6	7	0	5	1	21	0	40	0	0	2	3	0	17	0	64	2	1	0	0	0	0	0	0	2	8	0	2	0	25	0	2	1	1	1	12	0	1	0	1	0	0	0	0	0	0	13	4	0	28	93	0	0	0	0	1	2	0	0	3	1	1	1	0	0
LakWasMet52_LOW8_2_rpkm	0	0	0	0	0	11	76	0	0	0	0	5	3	0	3	0	0	0	11	0	0	0	0	18	0	0	0	0	1	3	0	0	0	3	3	3	2	0	0	0	0	0	0	0	20	16	23	5	0	0	1	4	0	0	0	7	1	17	67	8	499	0	0	0	0	1	0	0	10	70	1	1	0	0	0	0	0	0	0	0	0	99	0	0	0	0	0	2	0	0	0	0	9	14	11	0	0	0	0	3	0	0	0	0	0	0	0	0	0	0	0	1	67	7	26	0	0	1	0	0	3	0	0	1	0	0	2	0	0	0	0	28	19	0	0	0	0	0	15	0	0	0	0	0	0	0	0	0	21	1	1	25	4	1	22	0	5	13	4	1	5	3	0	1	17	0	0	2	0	4	0	0	0	0	0	0	0	0	0	0	0	0	0	0	0	2	0	0	0	9	0	1	2	2	0	0	0	10	3	39	23	0	10	0	0	0	40	0	23	4	3	2	35	3	10	0	19	0	0	7	0	1	11	1	0	16	0	0	1	0	0	0	2	0	0	0	15	15	9	6	0	0	9	12	14	18	0	0	17	8	15	3	1	0	1441	671	0	0	0	0	0	0	0	9	14	0	0	0	0	22	53	0	0	0	0	0	0	0	70	44	0	12	17	10	13	0	0	0	6	0	0	0	0	0	0	0	0	1	4	0	0	241	42	0	18	0	25	5	22	0	21	0	30	3	0	0	0	2	0	0	0	0	0	0	4	7	2	0	0	0	0	0	0	0	0	0	0	0	0	0	0	0	4	11	3	1	7	1	0	0	0	1	0	0	2	0	0	0	0	59	14	0	7	0	0	8	11	14	22	2	0	9	0	0	0	3	0	0	0	1	0	0	1	4	0	0	70	0	0	0	0	0	31	1	0	11	61	0	0	9	0	13	0	1	16	0	2	0	0	1	0	6	18	0	1	17	27	1	0	0	0	0	0	0	0	0	0	0	1	0	0	0	1	0	0	0	0	0	8	0	39	36	0	0	12	54	0	0	0	0	1	71	23	96	0	94	24	4	0	22	0	0	0	0	0	24	1	0	0	5	5	31	6	0	0	0	2	4	308	0	16	0	0	0	1	0	0	131	26	9	0	0	48	23	1	0	0	0	0	0	0	0	0	0	0	1	0	0	0	0	0	0	0	0	0	0	1	0	0	1	0	0	0	0	0	0	0	0	0	1	0	0	0	0	5	0	4	0	0	4	0	21	0	2	16	0	0	0	1	0	2	0	0	0	0	9	0	0	0	1	0	0	0	0	5	0	14	0	13	0	0	0	0	3	32	20	34	96	0	41	50	103	47	143	26	0	25	0	3	0	0	0	1	0	2	0	0	0	2	0	8	0	0	0	4	6	0	48	0	7	0	107	77	77	1	0	35	0	168	1	186	44	14	4	0	2	1	3	0	0	3	15	0	0	0	0	0	0	0	0	0	19	0	0	0	0	0	4	1	0	62	0	0	11	0	0	0	0	0	0	6	134	0	472	0	0	0	0	11	16	16	11	1	0	3	1	10	0	0	0	1	0	14	0	0	0	1	0	0	15	0	0	3	1	0	0	0	3	0	4	0	0	0	2	0	2	0	1	6	0	0	0	0	0	2	1	0	0	0	2	0	0	1	6	0	0	4	1	10	0	0	1	1	0	0	0	0	0	0	6	0	24	18	0	23	20	7	0	1	46	0	0	0	1	1	46	0	0	65	1	0	8	0	49	0	3	1	0	0	0	0	0	0	0	0	12	0	0	0	0	0	0	2	0	0	0	1	0	0	6	1	2	0	0	0	0	5	0	0	16	0	1	0	0	314	2	14	0	0	0	0	0	0	0	0	0	10	0	0	0	0	0	0	23	1	1	0	2	2	0	0	0	0	0	0	0	1	14	43	0	0	0	0	0	0	0	0	6	27	18	0	0	3	0	0	0	2	0	0	19	22	2	8	0	0	0	2	0	0	3	0	0	0	0	0	0	2	8	9	43	0	0	0	5	0	1	2	0	0	0	0	0	0	4	1	0	0	0	0	0	0	0	1	0	0	0	0	0	0	0	0	0	0	0	20	24	43	6	9	0	0	0	0	0	0	0	0	0	0	0	15	0	0	0	0	0	0	0	0	37	0	0	0	4	7	0	41	2	0	0	1	0	0	0	1	0	0	0	1	0	0	0	0	0	0	1	0	0	0	0	1	5	4	723	0	14	4	0	0	0	7	1	19	0	49	0	0	2	2	0	0	0	2	0	0	0	0	11	8	0	1	0	0	0	1	0	0	0	0	0	0	0	0	0	0	0	0	51	0	0	0	39	6	0	2	1	0	0	4	15	1	0	1	0	0	0	0	0	99	2	0	0	0	0	0	0	0	12	0	0	0	0	0	1	6	486	0	0	0	0	17	5	0	0	0	0	0	0	104	1	25	0	0	0	5	0	8	1	12	3	0	0	0	0	0	0	0	0	0	2	0	0	0	0	0	0	0	0	0	0	0	0	1	0	0	7	45	0	3	43	0	0	0	0	3	0	0	2	1	0	1	1	0	0	0	0	41	76	13	0	2	0	0	0	0	2	0	0	0	0	0	0	0	3	0	0	0	0	0	0	0	1	0	0	13	0	0	0	0	2	0	2	0	0	0	0	0	0	0	0	9	13	0	0	0	0	0	0	0	0	0	0	0	0	0	0	0	0	0	0	0	1	11	4	78	45	0	0	0	4	0	0	0	6	0	2	1	0	0	0	0	0	23	0	0	0	0	0	0	0	0	0	2	0	0	0	0	0	49	0	0	0	0	0	1	0	0	11	2	0	2	0	18	9	0	0	0	42	0	0	0	0	0	50	42	0	0	0	2	0	21	0	0	5	0	0	0	0	0	0	0	0	19	4	3	3	1	39	1	14	1	2	2	8	0	4	0	0	3	0	0	2	0	0	0	5	0	0	2	3	0	0	2	0	0	0	0	1	0	8	1	1	0	0	1	0	0	0	0	0	0	0	101	0	0	0	0	0	0	0	0	0	6	3	12	0	18	31	23	12	0	0	4	0	0	0	0	6	0	2	0	3	0	0	1	0	8	6	0	0	0	0	21	1	8	0	2	3	1	15	0	0	23	11	11	4	4	5	11	0	0	0	5	0	11	0	4	6	3	31	6	5	35	0	0	0	14	11	0	0	0	0	1	7	2	0	2	0	0	3	0	6	20	10	0	0	8	0	0	0	0	0	1	2	13	2	0	0	7	2	21	34	1	5	20	0	1	4	3	2	0	1	0	5	6	5	0	0	0	0	0	0	0	1042	60	2	20	0	0	0	0	0	0	0	1	111	1	0	1	31	0	1	0	0	31	25	37	18	0	0	0	56	0	0	0	0	1	0	0	0	95	42	13	41	45	25	0	9	148	7	1	0	0	0	0	0	214	1	0	0	0	8	0	3	0	0	0	0	0	8	0	3	0	0	0	0	9	0	0	0	0	0	0	3	11	21	0	0	0	0	0	7	0	0	0	0	0	0	2	0	0	0	2	1	0	0	0	0	0	0	0	0	1	2	0	0	0	0	0	0	0	0	0	0	0	0	0	0	0	0	0	0	0	0	0	0	0	330	0	0	58	0	0	0	0	97	0	10	4	0	0	473	0	5	6	2	1	0	1	0	11	0	7	0	0	0	0	0	0	0	0	9	23	0	0	0	1	1	0	2	0	0	1	0	0	0	0	0	0	82	10	46	0	0	2	27	0	0	0	13	0	0	1	1	1	0	0	0	6	0	0	2	8	10	10	0	9	2	0	0	0	13	0	2	6	11	10	0	19	0	0	0	1	2	0	0	14	0	31	7	102	68	174	34	49	5	0	0	0	2	7	39	0	0	2	12	45	0	0	0	12	1	1	0	0	18	19	0	88	9	0	6	0	8	15	0	3	0	29	1	2	0	0	0	0	0	0	51	0	5	75	0	0	0	4	7	1	43	1	2	8	0	5	3	0	3	32	368	18	37	0	12	0	13	8	2	0	1	5	5	1	0	250	0	1	1	0	0	0	0	6	0	1	3	0	0	0	0	0	0	0	6	0	0	0	0	0	18	0	0	0	0	46	0	347	56	0	6	24	5	0	21930	10	0	11	0	0	0	0	0	2	1	0	0	1	0	0	0	0	9	0	0	0	0	0	1	0	0	0	16	0	0	0	2	0	26	1	0	0	1	6	0	6	6	2	0	7	0	0	0	0	0	0	0	28	0	0	6	15	0	0	0	16	193	0	19	0	17	61	0	21	4	17	1	15	13	38	8	43	19	0	3	0	0	0	0	0	0	0	0	0	0	0	0	0	0	3	0	0	18	0	10	110	0	0	0	0	0	0	0	2	0	0	0	1	0	1	0	0	0	1	2	54	0	1	0	1	0	0	0	0	0	0	1	2	0	0	0	0	0	0	0	0	2	0	0	0	0	0	1	0	0	0	1	0	0	0	0	1	0	0	0	32	0	4	6	1	0	0	0	25	0	19	14	60	3	1	0	0	0	0	0	0	0	0	18	0	0	60	0	0	0	0	8	4	0	0	0	0	1	0	0	3	0	17	4	10	25	0	7	4	0	0	0	2	7	9	5	1	0	0	0	0	0	0	0	0	0	0	0	0	0	0	0	2	0	0	1	1	0	0	0	0	0	4	0	1	0	1	0	0	0	2	323	90	0	0	0	0	0	0	0	2	0	0	6	2	0	0	0	0	3	0	0	1	0	1	0	2	0	0	1	1	0	0	25	1	1	0	0	1	0	0	0	0	0	0	16	0	0	0	0	0	9	0	0	2	5	0	26	25	33	3	0	4	0	0	0	23	0	35	2	0	0	0	0	0	13	0	15	0	0	0	0	0	0	0	0	0	0	0	16	0	0	0	0	0	2	1	0	1	0	18	6	0	0	0	0	0	0	0	0	0	0	0	0	0	1	0	0	17	1	0	1	1	11	3	1	0	2	0	0	0	460	0	1	44	109	32	0	4	0	7	5	0	0	1	0	0	3	37	0	0	0	1	0	0	0	0	0	3	0	9	0	0	0	0	18	0	0	17	0	26	0	0	0	0	0	0	11	1	0	0	0	0	9	1	0	1	0	0	0	1	0	18	35	0	3	2	0	0	0	11	12	0	0	1	0	0	2	0	0	0	0	0	1	0	0	85	0	0	0	0	0	0	0	0	1	1	1	1	0	0	0	0	0	0	0	0	1	0	1	0	0	0	0	0	0	0	0	0	0	0	0	0	0	0	5	0	0	1	2	0	0	8	0	2	0	9	0	1	0	0	0	0	0	0	0	0	0	0	0	140	125	85	280	275	66	135	187	11	179	85	171	402	78	16	82	41	368	703	18	26	3	375	283	238	230	388	58	218	60	102	6	119	11	0	1	0	0	0	0	0	0	1	0	84	58	0	0	0	0	0	0	0	0	2	0	0	0	0	0	0	5	0	0	0	0	5	1	2	0	2	2	0	0	0	0	22	0	1	0	0	1	0	0	0	0	0	0	0	0	0	2	0	0	0	0	1	2	2	7	4	0	0	0	0	0	0	9	0	0	0	1	0	0	0	0	129	0	0	10	0	1	0	0	0	0	0	0	0	0	2	1	0	0	0	0	0	0	1	0	0	0	0	0	0	0	0	0	0	0	1	10	0	0	1	3	0	0	0	0	0	0	0	0	0	0	1	0	0	38	2	1	0	0	1	0	0	0	2	2	0	1	0	1	0	0	0	0	0	41	0	2	2	0	0	0	1	0	0	0	5	0	1	28	0	0	0	0	1	5	0	4	0	0	0	0	3	0	0	0	0	0	0	1	0	0	2	0	0	0	0	0	0	0	0	0	0	5	0	4	0	452	0	0	1	3	0	0	0	0	0	0	1	0	0	3	0	0	3	0	8	18	0	0	0	0	3	0	0	125	8	0	7	1	0	12	0	3	5	4	1	0	0	0	0	0	0	2	0	0	0	0	0	0	0	0	4	0	1	0	1	0	0	0	0	0	0	0	1	0	0	0	1	0	0	0	0	0	12	0	0	0	0	30	0	9	24	193	3	0	1	0	0	2	0	0	0	0	0	0	0	0	0	0	0	0	38	2	0	1	0	1	0	2	0	0	0	0	12	12	1	0	0	0	576	0	0	0	0	0	0	0	0	0	0	0	0	0	47	25	0	0	0	0	0	0	0	0	0	0	17	9	1	1	0	1	0	0	8	9	0	3	0	0	0	0	0	0	0	0	1	1	0	0	97	0	0	0	0	0	0	0	0	0	0	0	0	1	0	0	0	0	0	0	0	0	0	0	0	0	0	0	0	2	1	0	0	1	0	0	0	1	2	0	48	0	0	79	0	1	0	0	3	0	1	0	0	9	0	6	10	0	0	0	0	0	0	0	0	24	0	0	0	0	1	0	26	0	8	17	27	1	0	20	31	5	0	13	0	21	0	26	0	16	0	15	0	20	6	5	0	9	0	6	0	10	0	0	0	10	0	2	0	8	13	10	7	9	5	5	0	1	2	1	2	0	388	0	0	0	1	20	0	10	0	0	0	1	39	3	0	0	0	0	0	0	12	0	0	0	0	5	3	0	0	0	0	144	0	0	0	0	0	0	0	0	12	0	0	0	0	1	3	3	0	0	1	0	0	0	0	1	1	0	0	3395	0	0	17	23	7	0	9	0	11	0	0	0	85	0	0	0	0	1	282	2	46	0	0	5	0	0	1	0	0	3	0	0	10	5	0	152	0	8	0	0	0	41	38	1	0	0	2	0	0	0	0	0	1	1	0	0	0	0	36	0	0	0	36	27	0	0	0	0	0	0	357	872	626	0	0	0	0	5	0	8	0	14	0	1	0	0	1	0	8	580	19	0	0	0	0	0	0	0	34	0	1	0	0	0	0	0	0	7	0	0	0	0	0	0	0	0	0	0	0	1	47	44	0	1	2	0	0	0	1	25	6	0	0	0	0	0	7	1	0	0	0	0	0	0	0	398	0	0	0	0	2	3	1	1	5	0	0	4	0	3	0	0	0	1	0	1	0	2592	0	0	2	1	2	0	0	0	0	0	0	0	0	0	0	9	1	1	0	0	0	0	0	0	0	0	0	0	0	0	0	0	0	0	0	0	0	0	0	0	1	3	1	0	8	0	0	0	0	0	0	0	0	0	0	0	0	0	0	54	0	0	0	0	1	0	39	0	0	0	0	0	0	40	1	0	0	0	0	13	1	22	3	0	23	0	0	2	0	0	27	0	0	39	1	0	0	0	0	0	0	0	2	2	0	0	0	0	0	0	0	0	0	0	0	20	1	0	0	0	0	0	0	0	1	0	11	0	0	0	0	0	4	0	0	0	0	0	0	0	0	7	0	0	0	16	23	1	1	5	0	1	0	0	0	0	0	0	5	0	0	1	0	4	0	2	0	0	0	0	0	1	0	0	0	50	0	13	13	13	0	15	0	1	0	0	0	0	16	0	0	0	0	0	0	5	0	10	11	0	13	0	13	3304	0	0	0	0	0	0	0	2	0	6	0	0	0	0	0	0	171	98	0	8	0	0	0	5	0	0	0	0	0	0	0	0	0	0	0	5	94	4	0	1	0	0	0	0	0	0	13	1	7	0	0	0	0	1	0	1	29	1	0	0	0	0	5	0	0	0	1	0	3	0	464	11	0	3	2	1	0	0	9	0	0	0	17	0	2	1	0	0	0	0	21	1	0	0	2	24	0	0	1	0	0	0	0	0	0	0	0	0	0	40	2	0	0	0	0	0	0	17	0	0	1	0	0	0	0	0	0	0	0	0	0	0	3	1	0	0	0	0	0	1	0	0	1	0	1	0	0	0	0	0	0	0	1	0	2	0	4	1	0	0	0	6	0	3	0	0	1	0	0	0	0	0	0	0	0	0	0	1	0	0	0	0	0	0	1	0	0	0	0	0	0	0	0	0	0	0	1	0	0	0	1	0	3	0	0	0	16	1	0	0	1	0	0	1	0	0	0	0	0	0	0	0	0	0	1	0	0	0	0	0	1	2	0	0	0	6	0	0	2	0	18	0	1	0	9	0	0	0	0	0	0	0	0	2	0	0	0	0	2	0	0	0	0	6	0	0	0	43	11	0	0	0	0	0	0	0	0	0	0	0	7	0	0	107	0	0	0	0	0	0	0	0	441	0	0	0	0	0	1	0	0	0	1	0	0	0	46	0	1	0	0	0	0	0	0	7	0	26	0	0	0	0	0	1	0	3	0	0	0	0	0	0	0	2	0	0	0	0	0	1	0	0	0	0	0	0	0	0	0	0	0	0	0	0	0	0	2	0	0	0	0	0	0	0	0	0	0	2	0	0	0	0	0	0	0	0	0	0	0	0	0	0	0	0	0	0	0	0	0	0	0	0	0	0	0	0	0	0	0	0	0	1	0	0	0	0	0	0	0	14	0	0	0	0	0	0	0	1	0	0	0	0	0	0	0	0	16	0	0	19	0	0	0	0	0	2	0	0	11	2	0	3	0	0	0	0	0	0	0	0	0	0	0	49	26	1	1	0	6	26	0	0	0	0	0	3	7	2	0	0	0	0	4	0	2	0	0	0	0	0	0	3	0	0	0	4	0	1	0	2	0	0	0	0	0	0	0	0	0	0	0	0	0	0	0	0	0	0	0	26	1	28	11	0	0	0	0	0	0	0	0	0	8	0	0	0	0	0	1	0	0	0	0	0	0	0	0	2	0	0	0	0	0	1	0	0	1	3	0	0	0	0	3	0	0	0	0	2	0	0	0	0	0	0	0	0	0	0	0	0	0	0	0	0	0	0	30	0	0	0	0	0	8	0	0	28	0	1	1	0	0	0	0	1	0	0	0	0	0	0	0	0	24	0	0	0	0	1	1	0	0	0	0	0	0	15	0	0	0	0	0	0	0	0	0	0	0	0	0	0	0	0	0	2	0	0	0	0	0	0	0	0	4	1	0	0	0	0	0	0	0	0	0	0	0	0	0	0	1	0	0	3	0	0	1	0	1	0	0	0	0	0	5	0	0	0	0	0	0	0	0	0	0	0	0	30	13	0	4	0	0	0	2	1	0	0	0	0	8	1	0	0	0	0	0	0	18	0	4	0	2	0	0	0	0	0	1	0	0	21	0	0	0	0	0	0	0	0	0	0	2	1	1	0	2	0	0	1	0	16	0	0	13	0	0	1	0	0	0	0	0	0	0	0	0	0	0	0	0	0	0	0	0	0	0	1	32	1	2	1	0	0	2	0	0	0	0	0	17	0	0	0	0	0	0	0	0	0	1	3	4	0	0	0	0	0	0	0	0	0	0	2	2	5	0	18	0	0	38	114	0	0	6	0	534	0	14	68	0	0	0	0	73	605	0	61	0	8	7	0	410	0	6	0	0	0	0	0	8	25	1	34	0	0	8	0	19	38	6	0	0	3	2	7	0	21	0	1	9	3	1	2	0	0	0	0	0	10	14	0	0	0	0	6	0	0	25	0	1	0	0	0	0	0	0	0	0	10	0	0	1	3	0	4	9	17	0	0	0	15	1	2	0	0	0	0	0	0	0	0	0	0	95	50	0	0	1	0	0	1	0	15	5	0	0	0	0	0	0	4	7	1	0	0	0	0	0	30	2	0	0	1	0	0	2	0	0	0	1	0	5	0	0	1	0	15	0	0	0	2	3	3	0	1	0	0	0	0	7	0	0	2	0	14	23	0	0	0	1	0	1	3	7	0	23	0	0	0	0	21	0	0	0	67	43	403	0	16	2	61	383	0	73	64	9	2	526	542	188	0	358	39	172	45	243	2	220	6	254	0	8	0	0	0	8	0	0	0	0	0	0	0	0	0	0	6	1	0	0	0	0	0	27	0	0	5	2	0	0	1	0	0	0	2	0	4	4	1	0	0	0	0	0	194	0	0	0	2	0	0	0	28	3	0	0	0	25	1	0	2	3	2	0	57	0	0	0	1	0	0	1	82	5	25	0	19	0	0	0	0	0	0	0	0	0	0	0	0	0	0	0	14	0	0	0	0	4	0	0	0	0	31	0	0	10	0	1	0	0	0	0	1	0	14	1	108	0	7	0	0	0	0	0	2	0	6	2	0	2	0	0	0	0	0	0	0	0	0	0	56	0	0	76	3	0	0	0	0	0	0	120	0	0	0	0	8	0	0	0	0	5	0	0	25	0	1	1	0	0	1	8	0	0	0	0	0	0	0	0	0	0	0	0	0	0	0	0	0	0	22	0	0	0	2	0	0	0	0	0	0	0	2	71	0	0	0	0	0	4	0	0	5	9	0	0	66	84	9	0	0	1	0	25	2	0	0	0	1	0	0	0	0	0	0	0	0	0	110	2	9	0	23	0	0	0	0	0	0	0	6	3	0	0	2	1	0	0	0	1	0	0	4	0	17	0	0	2	0	64	0	0	0	0	1	0	3	4	0	1	4	0	4	0	0	1	1	29	0	0	11	0	0	0	0	205	0	12	0	0	0	0	0	0	14	0	11	0	0	0	0	0	0	0	0	1	0	0	0	4	0	1	1	1	3	3	0	0	0	32	0	0	1	0	0	0	1	0	0	0	0	0	2	6	0	0	0	0	0	1	0	0	1	6	0	2	0	2	0	0	0	0	0	34	0	2	0	0	0	0	0	1	0	0	0	0	0	0	0	0	0	0	0	0	0	0	1	1	0	5	0	1	0	0	0	0	0	0	0	0	0	1	0	0	0	0	6	4	1	0	0	0	81	75	7	11	0	0	0	0	0	0	0	0	1	0	0	39	5	0	1	0	0	0	15	0	2	8	14	26	15	12	21	7	0	0	0	0	0	4	0	0	3	1	1	0	0	0	0	0	1	0	7	4	0	5	0	4	0	0	0	0	0	63	0	0	0	0	1	0	3	0	0	0	1	0	0	0	0	0	0	0	1	0	0	0	2	1	0	0	29	7	0	0	2	0	1	3	6	0	2	0	3	0	0	14	1	0	0	0	0	2	1310	0	17	0	0	0	0	0	0	7	3	0	0	0	0	0	0	0	1	0	0	3	1	0	0	1	0	0	1	0	1	0	0	0	4	0	2	1	0	0	7	0	0	0	1	2	0	0	12	0	0	0	14	0	0	0	0	0	0	0	0	0	0	25	0	1	1	0	0	0	0	1	0	0	33	1	0	10	0	6	0	1	1	0	0	0	1	0	0	0	2	0	0	0	0	4	5	0	1	0	0	0	1	100	0	3	0	15	0	0	2	0	1	0	0	0	10	0	15	3	0	0	0	0	0	19	0	0	2	0	0	0	89	0	0	0	0	0	0	0	148	0	0	0	0	0	0	0	0	0	0	0	0	0	0	1	0	0	16	0	0	0	0	0	0	0	0	0	0	0	2	0	0	0	0	0	0	0	0	0	0	0	0	0	0	0	0	0	0	0	0	0	0	19	0	0	1	0	0	0	0	1	2	0	0	8	0	0	0	0	0	0	0	0	0	2	0	0	0	0	0	0	0	0	0	0	0	1	1	1	0	0	0	0	107	0	0	0	0	0	11	0	5	0	0	0	0	1	0	5	4	1	0	0	0	0	0	0	9	0	0	48	0	1	22	0	0	0	0	0	1	0	0	0	0	28	0	0	0	0	0	0	0	6	1	0	90	0	0	1	0	1	0	0	0	0	0	0	0	0	0	0	8	0	4	8	0	0	0	1	0	4	0	0	0	0	0	0	0	0	0	1	6	0	2	0	0	2173	0	0	0	23	1	2	0	0	0	1	0	0	6	0	0	0	0	0	0	0	0	0	0	1	37	0	1	0	0	0	0	0	1	0	1	0	0	0	0	0	0	1	5	2	0	0	0	0	0	3	11	0	0	0	0	0	16	0	12	15	0	0	0	0	3	0	10	0	4	0	1	0	0	0	0	0	0	0	3	6	0	0	0	0	0	0	0	47	21	18	11	0	2	0	1	0	0	0	2	0	0	0	39	6	14	65	0	27	19	0	19	0	0	1	37	2	0	40	0	0	0	1	4	0	0	0	62	11	0	6	120	627	0	0	0	1	4	7	0	0	0	3	0	0	3	0	16	0	0	2	0	0	0	0	41	0	1	7	0	0	0	0	0	9	0	5	1	1	2	19	6	19	6	0	19	0	0	0	3	4	0	0	0	0	0	0	0	1	0	0	0	0	1	0	10	0	6	0	0	1	30	16	4	0	0	0	115	0	0	0	32	1	0	3	0	0	0	0	0	0	0	0	0	0	0	0	0	0	79	17	141	1	0	0	0	0	2	0	0	0	0	1	0	0	0	0	1	0	0	0	0	0	0	0	0	0	0	0	1	0	0	0	0	0	4	0	0	0	3	0	0	0	0	0	0	1	0	0	6	0	5	0	0	0	0	0	9	0	39	38	0	1	0	0	0	0	0	0	0	0	1	238	0	0	0	0	0	4	1	2	0	0	0	0	0	0	0	0	0	0	5	10	1	0	0	0	0	1	8	0	0	0	0	0	0	0	1	17	0	0	0	36	0	0	14	25	0	0	0	0	0	0	27	0	0	0	39	25	0	0	0	0	0	1	0	0	0	2	12	4	22	1	22	0	0	0	27	0	193	0	2	0	498	0	24	0	8	0	0	0	0	0	0	43	3	19	13	0	27	0	0	0	0	20	0	0	5	0	0	10	35	16	4	15	4	0	0	0	15	0	4	0	0	0	1	0	2	1	0	0	0	0	7	0	0	0	0	0	0	0	4	0	1	0	18	0	8	1	0	21	11	0	0	0	47	0	6	9	2	1	27	4	1	20	9	29	6	48	22	0	1	0	0	12	0	0	14	0	0	1	0	0	0	0	0	0	0	0	14	3	1	75	26	87	0	20	1	7	0	0	1	1	0	0	0	0	0	0	0	0	0	0	4	0	0	4	11	0	0	2	0	0	0	0	0	0	8	0	274	1	0	0	0	0	2	6	0	0	1	0	15	1	0	0	0	14	0	30	15	6	1	2	0	62	0	0	0	26	54	0	0	1	0	3	0	1	68	0	0	0	38	1	10	3	0	0	17	0	0	3	2	0	4	0	1	7	2	0	1	0	0	39	68	36	0	0	6	1	3	0	3	1	0	2	0	0	20	14	0	0	0	0	0	42	65	204	0	0	11	28	0	0	0	0	0	0	0	0	0	0	0	0	3	13	57	0	0	0	3	5	8	0	0	0	0	0	14	8	0	9	13	0	15	0	30	0	35	9	14	14	18	1	0	3	202	74	0	4	0	0	0	2	0	5	0	0	0	0	0	0	0	0	1	0	1	0	0	0	0	6	62	121	238	616	10	18	0	2	0	2	10	10	0	0	2	0	0	0	0	2	0	0	0	0	0	0	0	0	0	0	0	2	0	10	0	0	0	0	0	0	2	2	10	0	7	38	6	15	3	1	10	4	16	14	13	0	0	0	0	74	26	14	0	0	0	9	3	7	0	11	3	0	0	1	8	2	0	0	0	0	0	0	29	7	0	0	0	0	0	1	0	0	1	0	0	0	0	0	37	2	5	10	33	13	0	0	0	0	0	2	0	4790	0	2	0	0	65	65	1	0	0	0	0	0	0	0	0	10	5	3	0	0	0	0	0	0	2	2	2	0	0	39	0	1	0	0	0	0	8	0	0	0	95	0	0	0	0	0	0	0	0	0	3	4	0	1	0	0	0	0	0	0	0	0	0	0	0	0	2	8	0	9	12	0	37	0	0	2	0	6	27	0	0	0	0	0	0	0	0	25	0	1	0	0	0	0	0	0	0	0	0	53	12	0	6	150	0	2	0	0	19	0	89	6	24	5	0	0	0	0	4	0	7	374	0	0	0	0	37	0	0	0	0	0	1	0	0	0	0	0	0	0	780	11	8	0	9	2516	1	19	21	31	8	0	169	129	118	38	16	11	7	0	12	307	163	167	38	52	0	0	1	614	1	0	8	0	0	35	21	0	0	934	2	0	0	0	0	2	0	37	0	1	0	5	5	40	69	6	12	7	7	7	0	7	0	27	20	2	20	0	1	0	0	0	0	0	0	0	0	599	0	0	13	1	5	0	3	9	0	1	0	4	0	1	3	2	0	4	0	0	2	33	0	0	0	0	0	18	0	1	0	5	0	6	15	0	14	9	0	0	49	67	64	0	0	10	47	38	3	16	26	0	10	0	12	4	0	90	0	0	0	2	3	40	10	0	14	11	24	18	0	0	12	9	0	0	28	8	3	0	0	0	25	0	0	11	1	6	0	1	2	0	0	37	0	0	5	0	0	0	0	0	0	1	0	0	8	0	0	0	1	0	234	4	3	0	0	0	12	0	30	2	0	1	0	0	1	216	0	0	65	97	0	7	9	5	2	7	2	10	3	2	3	14	13	30	2	79	43	9	0	0	0	0	3	0	0	1	0	2	0	2	9	1	0	0	0	0	2	25	143	0	3	0	0	0	0	0	0	4	1	0	0	0	0	0	0	0	2	0	0	0	0	0	0	0	0	0	0	1	0	0	10	0	0	0	14	6	0	0	0	2	21	0	0	0	0	0	0	0	4	1	0	1	0	0	0	0	1	0	5	1	2	5	1	8	0	0	0	0	0	0	0	0	0	144	0	0	33	0	0	1	7	22	7	0	0	1	0	0	28	0	2	9	5	4	0	0	0	0	1	0	0	0	0	0	36	35	12	15	5	14	6	15	17	6	0	22	51	51	22	24	114	121	63	88	10	10	8	7	0	4	0	0	4	5	0	25	56	42	82	15	77	31	16	92	21	108	26	7	11	15	13	9	19	0	0	7	0	65	244	0	3	2	70	30	1	15	721	178	26	637	0	344	6	0	0	0	0	2	10	5	40	0	17	0	372	617	108	1	0	36	0	0	0	0	0	127	17	83	34	62	26	185	9	4	443	0	4	3	25	33	0	0	0	6	0	29	6	13	2	22	10	6	3	6	18	25	21	0	0	0	0	0	0	0	3	0	0	4	0	0	0	0	5	0	0	0	0	0	13	4	0	3	0	0	0	0	0	0	2	0	0	0	0	0	0	0	0	0	1	0	0	2	0	0	0	0	0	1	0	2	0	1	4	11	1	8	76	0	0	1	0	0	0	1	0	0	0	0	0	0	0	0	0	0	0	0	41	0	1	0	0	0	4	1	0	0	0	1	0	0	0	0	0	0	0	1	0	0	0	3	1	0	0	0	15	0	60	1	12	44	0	30	1	21	0	0	0	0	0	0	0	0	0	0	1	0	0	5	12	10	11	2	0	0	0	0	0	0	0	2	7	8	0	43	0	7	0	0	9	24	0	0	0	10	0	0	10	29	21	38	5	2	0	23	0	0	12	2	43	0	0	0	18	7	4	0	2	9	13	8	14	0	2	27	22	3	1	41	182	8	6	0	0	0	20	0	9	10	0	20	0	0	0	0	8	0	1	0	0	0	0	0	3	0	0	9	0	0	0	0	0	0	15	0	1	0	21	0	0	0	0	0	0	0	0	0	7	6	3	0	1	35	0	13	0	0	0	7	9	0	0	5	4	1	0	2	6	0	0	0	0	1	0	13	5	9	2	0	0	0	0	0	0	0	0	0	10	16	1	2	3	0	0	0	0	0	0	0	6	8	37	0	22	11	8	0	0	19	0	0	5	4	0	1	3	0	0	0	0	0	0	0	1	0	4	0	1	0	0	13	16	0	0	0	0	0	1	0	2	0	2	3	2	0	1	0	0	0	0	0	12	0	5	0	3	28	0	1	1	0	8	50	0	0	4	28	9	0	0	13	0	5	9	10	448	0	0	14	0	18	0	0	0	0	0	0	0	13	31	0	19	4	3	4	0	13	0	12	0	0	0	0	0	0	0	0	0	0	0	0	0	0	0	0	0	0	0	0	1	1	1	4	0	6	0	0	2	4	0	0	0	0	21	15	4	0	0	0	89	33	0	0	0	0	1	0	24618	0	0	0	0	0	2	0	72	0	0	0	0	0	0	0	0	1	0	0	0	0	29	10	23	63	0	14	6	19	0	0	0	0	0	0	1	0	8	86	0	61	24	0	0	0	0	0	3	0	1	0	0	1	0	55	2	7	26	68	32	40	18	0	17	7	0	15	0	0	19	6	3	13	1	0	0	0	2	2	0	123	130	71	5	6	0	0	0	0	537	0	0	2	0	24	20	0	48	0	0	0	40	29	1	0	45	41	0	5	0	4	0	0	0	0	0	0	0	64	60	57	24	71	0	26	4	0	13	53	37	94	90	10	14	35	8	118	27	0	12	53	24	0	3	0	0	0	55	19	115	113	19	0	1	0	0	11	12	7	1	8	0	0	0	0	0	0	0	0	0	0	2	2	7	0	1	1	2	4	0	1	11	2	0	0	0	21	9	2	2	4	4	4	5	0	2	0	32	0	2	0	7	7	66	5	2	6	0	1	0	0	0	27	4	0	0	2	0	2	0	0	0	0	0	0	0	0	2	46	0	0	0	10	9	3	0	1	0	0	0	0	0	3	4	8	0	12	0	0	0	28	62	0	1	1	0	38	1	0	4	6	0	2	0	0	0	1	0	0	0	0	0	0	0	0	0	0	0	0	0	0	6	0	3	0	0	0	0	0	0	0	0	0	0	12	1	0	0	0	0	0	0	0	0	0	0	0	0	0	0	0	2	25	0	1	2	0	0	0	0	0	26	0	0	0	4	5	4	0	32	0	0	0	112	3	8	3	5	0	0	1	11	14	0	0	3	1	4	1	3	1	0	0	0	0	0	0	0	0	7	0	10	0	1	18	30	0	0	0	0	241	517	0	0	1	0	0	0	4	2	29	28	23	2	36	0	21	23	3	3	5	0	0	9	6	22	25	3	14	0	0	47	0	26	1	1	2	0	0	0	1	0	3	0	2	73	5	2	0	0	0	19	14	0	0	0	0	0	0	0	0	0	0	0	0	16	1	14	0	17	0	3	9	5	0	1	1	0	19	29	0	0	0	0	0	2	0	30	147	35	7	3	6	32	0	49	1	2	4	20	4	1	6	7	0	2	0	3	11	0	0	0	1	8	0	2	1	0	0	0	6	0	1	5	4	1	11	0	12	1	0	0	0	13	0	0	0	0	1	0	0	0	109	0	2	0	0	0	1	8	0	0	1	1	1	0	0	0	0	0	0	0	0	0	2	11	0	1	0	0	0	5	5	0	0	0	1	0	0	0	1	0	0	0	1	0	0	0	0	0	0	0	0	0	0	0	6	0	0	62	0	4	4	13	35	0	10	0	0	0	0	0	0	0	0	0	0	0	0	0	0	0	0	0	37	0	0	0	0	0	0	0	0	0	0	0	0	1	0	0	0	30	0	0	0	9	3	3	8	0	3	8	3	5	2	1	2	6	36	6	1	22	12	29	37	150	55	69	324	0	0	21	0	0	2	17	14	1	0	0	0	0	0	0	161	0	0	4	0	135	0	0	0	0	0	263	1	4	0	0	1	5	4	0	0	0	0	0	0	0	0	1	0	0	0	0	217	85	0	0	0	1	1	0	0	0	11	0	0	0	0	0	0	10	38	0	0	0	0	4	0	0	0	26	1	0	13	10	0	0	0	0	2	0	6	8	31	3	0	0	3	0	0	24	0	0	3	0	41	1	0	0	8	184	5	19	259	0	0	0	0	0	0	0	34	3	5	0	0	0	2	16	1	6	0	10	0	0	0	0	33	0	4	0	105	90	6	122	1	0	88	124	0	0	0	1	0	2	1	0	0	1	0	10	0	0	3	0	1	0	1	0	0	6	0	0	3	0	0	0	0	9	3	0	0	0	1	158	1	24	0	3	89	3	0	0	0	0	0	15	7	2	21	6	55	99	1	0	38	0	7	17	19	0	0	0	0	1	0	5	0	0	292	0	0	8	13	11	12	0	29	1	0	3	2	4	6	1	60	10	1	0	1	0	5	0	0	162	1379	30	0	0	0	0	1	0	0	0	0	0	0	0	3	25	0	0	0	0	1	0	0	0	6	0	0	0	0	0	0	0	0	0	0	0	0	0	1	0	0	0	0	17	0	0	0	0	0	0	0	0	0	0	0	0	0	0	0	0	4	6	11	7	0	8	8	0	3	0	4	2	11	0	0	0	0	11	22	2	19	2	3	29	0	1	6	0	12	4	0	1	0	0	3	4	1	0	0	8	0	0	6	0	19	16	0	0	3	0	0	34	37	0	14	0	2	1	0	0	0	15	16	6	9	27	9	16	15	1	19	8	1	4	0	0	1	0	3	3	30	7	0	33	7	13	1	0	0	2	1	0	0	0	0	0	234	0	0	0	0	0	40	0	0	0	0	0	0	2	2	1	5	9	7	9	1	2	5	23	33	8	13	5	0	110	57	49	0	0	0	0	0	0	0	4	0	29	8	45	19	0	0	194	0	0	0	0	0	0	0	0	0	0	1	0	0	7	2	48	0	6	26	14	1104	37	0	4	0	0	1	0	1	4	0	1	0	0	0	12	0	0	0	1	3	0	0	0	0	1	0	0	5	51	0	14	29	0	4	1	0	0	0	2	0	13	0	0	1058	0	0	0	15	0	39	0	0	0	0	3	0	0	0	1	0	0	15	0	0	0	0	0	9	0	0	0	0	0	0	0	0	0	0	0	0	0	0	0	0	0	0	1	0	2	0	156	351	0	7	2	5	7	9	13	3	0	1	0	20	0	0	0	0	0	0	0	0	0	0	0	4	0	0	0	0	23	0	0	0	0	1	0	3	0	0	0	0	1	0	0	0	0	0	0	5	0	0	10	9	0	0	0	0	0	0	0	0	0	0	0	0	0	3	0	21	19	36	1	11	0	0	0	0	0	0	0	0	15	0	44	0	1	3	17	0	19	5	0	0	0	0	5	0	0	0	0	3	0	0	0	0	0	0	0	0	0	0	0	0	0	0	0	0	0	1	0	0	0	0	0	0	0	0	267	0	0	1	0	0	0	0	0	0	2	0	2	0	11	0	0	0	0	4	0	0	0	1	0	0	0	0	0	0	0	0	0	0	0	59	0	0	0	0	0	0	12	0	0	0	0	0	1	1	0	0	10	0	0	2	0	0	0	0	1	3	0	0	1	0	0	1	0	0	3	0	1	0	0	0	0	0	0	0	0	0	0	0	0	7	0	0	1	0	0	0	1	1	24	0	0	0	0	5	0	1	0	0	0	0	0	0	0	0	0	2	3	0	0	1	0	0	0	0	0	0	0	0	15	0	0	1	0	2	0	0	1	0	0	0	0	3	0	0	0	0	0	0	0	0	0	0	0	0	0	0	0	0	0	0	0	0	0	1	0	1	0	0	119	0	0	0	0	0	0	3	5	1	1	1	2	1	91	0	96	34	0	0	0	12	0	22	1	1	9	202	0	30	0	0	146	4	11	0	0	3	0	0	3	5	1	10	3	3	0	11	9	0	2	12	0	4	0	0	11	0	12	0	23	0	3	0	1	9	5	1	59	1	16	10	0	1	4	8	10	22	8	6	2	13	6	0	0	2	13	1	7	40	3	5	1	9	36	15	8	0	0	0	57	22	21	7	6	0	31	0	27	1	6	12	1	6	53	0	0	562	0	0	3	0	12	0	277	6	40	20	4	0	6	2	3	5	13	11	18	2	0	0	0	7	2	20	2	24	56	22	12	85	63	56	10	0	1	7	40	0	14	0	0	0	1	0	0	0	0	8	0	3	0	0	0	1	0	4	0	23	8	11	0	0	0	0	3	6	0	54	0	22	1	0	0	0	3	10	0	1	0	0	0	0	11	0	0	0	5	0	3	0	0	10	0	0	0	3	0	0	0	0	2	0	1	0	0	0	0	0	1	0	0	0	0	2	3	41	0	0	0	0	0	0	3	21	0	0	1	22	0	2	1	3	0	44	0	0	0	2	0	0	0	0	0	6	1	3	0	0	0	0	0	0	0	4	0	0	2	0	1	0	0	0	7	0	27	0	4	0	0	0	0	0	0	0	0	51	0	5	4	0	0	0	0	0	0	0	0	0	0	1	0	0	0	0	0	0	0	2	27	20	1	19	26	0	0	0	2	0	0	0	2	829	1	6	14	151	0	0	5	0	3	6	8	0	0	1	39	0	0	1	1	0	1	2	22	549	0	5	18	3	0	0	0	0	0	0	0	0	0	0	0	0	1	0	0	0	18	2	1	0	25	16	0	0	5	0	0	0	0	0	0	7	10	9	8	42	36	0	23	18	2	0	25	11	0	17	1	2	8	17	0	0	0	0	0	0	5	4	0	0	0	0	33	7	1	0	0	2	0	0	0	0	0	0	0	0	36	30	15	1	0	65	0	0	0	0	0	0	0	4	2	0	0	5	6	4	0	14	0	17	1	55	0	0	0	1	6	0	5	0	24	0	2	5	1	3	13	0	1	18	5	13	6	211	46	0	0	0	0	0	0	0	0	0	0	0	0	0	0	0	0	10	8	22	0	0	0	2	4	3	13	0	5	0	0	1	25	3	5	1	0	0	0	3	15	6	107	39	1	0	0	0	0	38	0	0	0	0	1	0	125	102	93	0	24	0	0	8	6	2	1	0	0	0	0	6	71	3	104	3	6	5	27	230	0	15	2	1	5	0	4	10	10	36	6	0	2	30	49	2	0	0	0	0	0	0	69	0	0	42	0	0	0	0	0	0	1	73	5	1	0	0	0	0	0	0	0	0	0	1	1	0	0	0	0	7	9	1	50	3	3	0	0	0	0	0	5	9	0	0	6	0	1	0	3	0	0	76	20	0	74	0	1	0	9	15	0	0	0	1	0	15	0	0	1	0	0	0	0	0	12	13	0	7	3	4	11	0	0	0	0	3	1	0	383	0	0	0	14	0	0	38	0	2	11	0	6	43	0	0	0	0	0	38	7	0	0	2	3	0	7	0	0	1	0	0	0	0	11	54	6	11	1	0	0	0	7	0	0	1	0	1	1	17	19	0	90	4	1	126	18	35	220	16	7	35	14	41	8	57	12	43	62	12	53	10	0	2	0	1	0	15	0	0	0	0	2	2	4	0	0	0	0	0	0	1	2	0	0	1	0	8	0	1	1	5	0	0	0	1	0	0	0	0	0	0	0	0	0	0	0	0	0	0	0	0	0	0	0	0	0	0	1	5	2	0	0	0	0	0	1	0	0	0	0	0	0	0	0	0	0	0	0	0	0	0	0	0	0	5	5	0	40	4	0	0	14	0	0	0	33	11	28	8	0	19	25	3	0	8	0	0	1	0	0	0	0	0	0	0	8	40	1	43	3	8	0	0	0	13	2	9	2	0	0	0	2	1	0	0	0	0	1	9	3	5	3	1	0	14	6	21	5	2	0	4	15	7	0	19	55	0	1	1	0	0	0	0	4	28	0	0	0	1	0	0	0	0	0	2	0	0	55	5	0	10	1	42	0	0	0	0	2	0	1	1	287	3	6	5	0	0	131	0	0	0	2	4	0	14	0	0	49	0	0	0	4	0	25	6	3	0	15	16	0	0	1	4	0	0	0	0	0	1	3	1	7	12	0	8	0	2	0	10	1	0	0	7	4	8	23	7	5	1	4	24	0	5	0	0	49	0	0	0	0	16	0	0	10	6	2	0	2	7	0	0	0	0	0	2	0	0	0	0	1	0	0	0	1	1	0	0	0	0	0	4	0	0	0	0	0	0	4	1	2	0	21	2	0	0	0	0	5	17	3	2	4	0	25	0	0	353	6	71	9	5	0	2	363	176	1	18	42	0	0	0	12	19	0	0	0	9	0	23	20	5	0	1	4	0	0	4	6	15	0	0	0	4	27	7	0	0	0	0	0	0	182	0	1	2	1	2	0	0	0	0	0	0	0	169	41	49	8	8	1	27	4	2	0	0	0	1	0	1	0	0	0	3	0	56	0	1	17	0	0	41	0	360	39	0	0	0	37	8	14	100	40	13	10	12	91	1	20	84	0	0	0	0	0	0	0	6	372	153	6	0	3	0	0	1	0	28	0	0	2	2	1	0	0	35	214	0	0	0	49	52	74	29	8	25	3	10	63	0	0	105	0	0	32	3	0	1	0	0	0	0	0	0	36	4	0	0	0	1	0	0	1	0	0	0	0	0	0	0	157	0	0	0	0	13	17	12	0	0	1	0	5	2	1	0	0	24	14	9	0	36	0	20	6	0	0	12	25	0	22	16	0	0	39	8	26	5	23	41	19	3	9	6	104	4	34	78	0	0	0	0	0	0	0	1	3	0	0	0	2	0	0	0	0	0	0	0	5	0	0	0	3	0	5	0	0	9	0	3	0	0	0	0	4	0	0	1	4	2	2	14	11	3	7	0	1	0	1	0	0	0	0	0	0	0	0	0	0	0	0	0	0	0	0	0	0	0	0	0	0	0	1	0	1	0	1	10	0	5	0	20	0	0	2	0	0	2	2	0	0	0	0	0	0	0	0	0	0	1	2	11	8	0	0	13	8	46	0	11	0	232	0	80	100	0	1	1	0	0	0	0	0	4	44	909	20	13	9	4	39	5	6	9	6	0	3	0	1	2	0	0	5	34	0	0	0	13	0	0	1	1	0	0	0	0	0	1	14	0	0	0	0	0	0	0	0	0	0	0	0	0	0	0	0	0	0	0	0	0	0	0	0	0	0	3	4	0	17	10	0	37	0	16	29	66	57	0	0	0	3	0	0	0	0	0	11	0	0	14	5	1	0	0	3	0	35	0	10	2	15	0	0	0	0	1	0	1	1	0	0	0	0	0	4	0	1	1	0	4	6	1	0	1	1	0	0	0	0	0	30	49	2	0	1	0	7	0	16	1	0	9	4	0	5	0	25	5	1	0	0	0	0	0	0	0	3	0	1	1	139	1	4	0	1	0	8	0	0	0	0	0	0	0	2	0	0	4	5	0	13	29	0	0	1	0	0	3	0	0	4	0	12	2	0	0
LakWasMet56_HOW8_2_rpkm	0	0	0	0	0	12	4	0	1	0	0	2	1	0	0	0	0	6	0	0	0	0	0	37	0	0	0	0	0	11	0	3	0	16	0	9	0	0	0	0	0	0	0	8	116	31	24	6	1	18	3	13	1	0	0	0	0	0	40	5	23	1	0	2	0	0	0	1	0	25	1	0	0	0	1	0	1	0	0	0	0	33	1	0	0	0	0	0	0	0	4	0	6	0	60	6	0	0	0	0	0	0	0	0	0	0	0	1	0	1	0	1	8	0	11	1	0	3	0	0	0	0	1	6	0	0	2	0	0	0	28	200	1	1	0	0	0	0	0	0	3	0	0	5	2	0	0	0	55	0	3	97	0	1	341	0	0	0	87	0	9	23	0	8	0	1	0	4	0	12	0	0	0	0	0	0	0	1	2	0	0	0	0	0	6	5	0	0	0	0	4	5	6	7	1	0	0	16	38	249	1	0	1	0	0	0	2	0	2	0	24	2	14	31	16	0	5	1	0	1	1	0	1	0	0	0	0	0	4	1	0	1	2	0	0	0	8	0	13	0	0	0	50	1	24	0	0	0	0	2	0	6	24	0	743	12	0	0	0	0	1	0	0	7	3	0	2	1	2	75	4	2	8	0	0	5	0	0	3	2	0	176	3	131	100	0	0	0	5	1	3	0	1	0	17	0	0	3	9	0	0	6	19	3	1	1	2	25	6	0	1	0	78	7	0	0	0	0	0	0	1	0	0	0	5	84	0	0	0	0	0	0	0	3	0	0	2	0	0	0	2	7	19	0	8	0	3	4	1	0	1	1	0	0	5	0	0	3	0	2	1	0	0	0	0	29	1	130	0	2	2	34	0	1	8	0	0	23	0	1	0	0	9	1	0	0	40	0	0	0	0	1	170	1	1	3	2	0	0	19	0	11	0	6	14	0	1	0	0	0	0	1	8	414	1	38	3	4	1	1	0	0	0	1	0	0	1	0	2	0	114	1	0	3	0	1	0	0	3	1	27	3	0	0	0	218	0	0	0	0	0	150	0	713	1	1	117	0	0	2	0	1	1	6	1	9	63	0	0	0	8	4	10	6	0	0	22	0	16	0	5	0	10	126	0	4	0	6	10	0	1	1	26	16	1	0	1	0	0	0	0	1	65	1	0	0	0	0	0	0	0	1	0	1	0	0	0	0	1	12	0	0	1	0	1	0	0	0	0	0	0	0	348	19	0	0	1	2	0	12	0	0	1	49	1	1	0	0	0	1	0	0	1	1	0	5	0	7	0	0	0	0	0	1	4	0	0	0	10	0	0	0	0	2	1	2	2	115	5	2	4	27	7	3	32	0	1	2	32	0	0	0	8	5	13	14	0	0	3	0	31	0	0	0	5	8	0	27	0	4	0	424	16	358	0	1	42	1	277	5	3	3	4	26	0	9	0	8	1	7	4	0	0	0	1	1	0	0	1	1	1	103	0	0	0	1	0	22	14	0	4	1	3	5	2	0	0	0	0	3	0	9	0	0	0	1	1	0	2	1	0	18	0	0	2	0	0	0	0	1	0	0	2	1	0	0	2	0	0	8	3	0	2	0	0	0	0	0	1	1	0	3	0	16	0	0	1	0	5	0	1	12	0	3	67	3	0	1	7	2	2	0	2	3	4	0	0	0	24	0	0	0	0	0	0	1	0	0	0	1	0	10	4	1	2	45	1	0	0	19	0	0	1	0	0	2	0	0	16	3	0	1	0	2	0	0	3	0	0	0	0	0	0	0	0	311	0	0	0	1	0	0	17	32	0	0	0	0	0	0	0	3	2	0	0	3	6	1	0	2	0	0	0	0	15	6	135	0	1	0	1	0	1	0	6	0	0	0	0	0	1	0	0	0	23	0	0	0	4	31	13	0	0	0	0	0	0	37	25	0	0	0	0	0	0	0	0	0	39	51	0	0	0	0	0	0	0	0	0	0	55	0	0	2	0	1	0	0	11	0	0	0	0	0	0	0	0	0	8	0	0	0	0	0	1	0	0	0	0	4	0	0	0	1	0	0	0	0	2	0	0	0	0	8	0	0	0	0	0	0	0	0	0	6	4	5	2	2	2	0	0	1	0	1	0	0	0	0	0	0	2	0	0	0	0	0	1	0	0	0	1	0	0	27	15	0	0	1	0	0	0	1	0	0	1	0	0	0	1	0	0	0	0	0	0	2	0	0	0	1	0	1	14	90	1	6	1	4	0	0	39	50	4	0	6	0	0	2	0	0	0	0	0	0	0	0	0	0	0	0	0	1	1	0	0	0	0	0	0	1	0	1	0	0	0	0	0	60	1	0	0	24	1	0	0	1	0	0	1	0	21	0	0	0	0	1	0	1	9	0	1	0	0	0	0	0	0	0	1	0	0	0	0	1	1	0	0	0	0	1	0	2	0	11	0	0	0	1	2	1	2	0	0	3	2	1	2	1	1	2	0	0	0	0	0	0	0	0	2	21	0	0	0	0	0	0	1	0	0	1	0	0	0	0	3	2	6	0	0	4	0	9	0	0	3	0	0	25	0	0	0	2	0	0	0	0	5	7	35	0	1	0	7	0	0	5	1	0	0	0	0	0	0	1	0	0	0	0	0	1	0	0	0	0	2	0	2	0	0	0	0	0	0	0	0	0	0	0	1	0	46	0	0	0	8	0	7	0	1	0	0	0	18	0	1	0	0	1	1	0	1	4	28	4	2	14	0	0	0	259	1	0	0	0	0	4	6	1	0	0	0	1	0	0	0	0	1	3	0	0	0	1	2	0	0	0	0	0	7	0	0	0	0	0	0	0	0	0	2	0	5	0	114	1	0	1	1	0	1	0	3	0	2	24	105	0	0	1	0	0	4	0	0	29	0	2	0	0	0	0	0	1	0	67	0	3	66	13	0	18	0	0	0	0	0	34	4	0	30	0	0	2	0	0	0	9	1	0	8	0	2	0	0	0	0	3	2	7	0	7	1	0	0	0	0	0	1	1	0	1	0	0	5	0	0	3	1	0	3	0	0	1	0	2	2	0	23	3	22	2	0	0	35	1	0	1	1	2	1	8	0	0	3	0	1	0	51	13	0	0	0	0	1	1	9	0	1	1	1	2	0	0	18	74	3	0	10	0	0	0	0	0	20	0	9	0	29	24	10	72	3	1	29	0	0	8	0	1	0	0	2	0	0	10	4	0	19	1	0	1	7	3	2	6	0	0	28	0	2	0	0	0	0	2	3	0	0	1	1	0	0	37	2	0	10	0	4	8	0	0	0	0	2	10	0	0	0	0	0	0	0	1	6	38	14	128	80	0	2	3	0	0	0	0	1	58	3	2	1	16	0	1	0	8	160	342	21	22	1	0	4	64	0	0	1	0	1	0	0	0	50	3	32	5	114	5	0	3	0	30	0	0	0	0	1	0	5	68	0	0	0	7	0	93	0	0	0	1	0	2	0	2	0	0	0	0	17	0	0	0	0	0	0	14	1	4	0	0	0	1	0	0	0	0	0	0	0	0	1	2	0	0	15	0	1	0	0	0	0	7	0	1	0	16	0	0	0	0	0	0	0	0	0	0	0	0	0	0	0	0	0	0	0	0	0	0	0	10	0	0	9	0	12	2	0	39	0	29	179	0	0	14	1	12	2	1	0	0	1	0	27	3	22	0	1	0	0	0	1	0	0	0	5	0	0	0	9	1	0	1	2	1	0	0	0	0	1	1	0	31	1	0	1	0	36	0	0	0	0	2	1	0	0	0	1	0	0	3	1	0	11	0	2	29	8	0	1	16	0	0	0	1818	0	7	1	3	0	0	0	0	0	0	1	0	0	0	0	0	32	15	27	45	92	26	7	28	0	0	0	1	1	3	0	0	2	7	55	0	0	1	1	1	2	1	0	23	32	0	51	0	1	93	0	2	0	10	3	0	21	1	0	1	0	0	0	1	0	56	0	2	0	3	0	0	2	2	6	3	3	0	1	0	0	1	0	4	98	145	11	26	0	0	2	13	0	2	0	0	0	0	1	0	12	0	1	0	0	6	0	4	1	8	9	9	0	0	0	0	0	0	0	3	0	0	1	0	2	0	12	0	0	0	0	0	39	0	0	2	29	6	2	741	0	1	1	0	0	0	0	0	3	64	0	0	3	6	1	0	0	6	1	0	0	0	0	0	0	13	0	50	1	2	0	0	1	0	0	0	0	1	0	0	1	7	0	2	14	0	2	0	0	1	0	0	16	1	0	20	1	0	3	1	118	6	27	3	0	24	31	0	10	1	59	0	12	3	0	0	3	0	0	12	0	0	0	0	0	0	0	0	0	0	0	1	0	0	1	12	1	3	0	4	44	0	0	0	0	0	0	0	0	0	0	0	0	0	47	0	0	1	2	3	2	12	0	0	0	0	0	0	3	0	0	78	22	0	1	0	0	0	0	0	0	0	0	0	0	0	5	22	0	0	2	15	1	0	0	0	0	0	0	0	95	0	12	28	2	0	7	0	15	2	5	46	491	5	0	0	0	0	0	0	0	0	0	0	0	0	1	0	0	0	0	0	0	0	0	0	0	3	0	1	0	0	2	0	47	2	0	30	20	0	21	0	32	8	44	1	2	0	0	1	1	1	0	0	0	0	4	0	22	0	0	2	14	0	0	0	2	0	1	3	0	1	0	0	0	0	2	0	0	4	1	16	0	0	0	0	0	0	0	0	10	0	2	92	0	0	30	0	0	2	0	0	1	1	1	9	776	0	0	18	4	0	1	19	0	1	0	0	0	0	0	0	1	0	0	3918	0	0	0	0	1	13	0	0	2	3	1	13	12	12	0	3	0	0	0	0	6	0	6	0	0	4	0	0	1	3	0	0	0	0	0	0	0	0	1	0	1	0	1	1	0	0	0	0	0	4	0	0	0	0	1	277	0	0	0	21	0	1	5	0	0	0	0	5	7	0	0	0	2	0	0	0	0	0	1	8	1	9	2	0	0	56	0	7	4	7	1	4	0	3	29	0	0	0	0	0	0	0	184	0	2	1	1	0	0	0	0	0	9	149	20	0	0	0	4	6	0	1	5	0	0	0	3	2	0	0	0	49	0	0	0	2	3	0	0	0	4	1	0	0	0	0	9	1	0	6	0	0	0	0	0	3	0	0	2	1	1	2	0	0	5	0	0	2	0	2	9	1	0	1	0	0	0	36	0	1	0	2	6	0	0	1	0	0	0	0	0	1	1	1	0	0	0	0	0	0	0	0	1	1	0	0	1	0	0	1	0	0	1	6	1	2	0	0	9	0	0	0	4	0	0	0	0	1	3	2	1	0	1	1	9	22	35	9	15	12	9	4	5	63	10	41	8	13	3	9	3	20	24	0	10	1	13	11	10	108	29	45	5	2	10	4	4	31	0	0	0	0	0	0	4	0	0	0	3	73	0	0	0	0	0	0	0	0	0	0	0	0	0	0	0	2	0	0	0	8	7	0	44	0	84	5	0	0	2	0	3	0	0	0	1	1	0	0	0	0	0	0	0	0	0	8	0	0	0	0	3	19	1	14	1	0	1	3	0	0	0	0	0	0	4	1	0	1	0	0	9	0	0	0	0	0	0	0	0	1	0	0	0	0	32	6	0	13	0	0	0	22	1	0	0	1	1	1	2	0	0	1	0	5	0	196	0	0	7	148	0	0	1	0	0	2	0	0	0	0	1	0	0	2	13	0	0	0	0	1	1	0	58	19	23	0	1	11	15	11	21	19	0	9	0	12	2	0	0	0	0	0	0	0	12	0	2	0	1	0	0	0	0	0	0	0	0	0	0	0	1	0	0	0	0	0	0	26	0	1	1	0	2	1	0	0	2	1	6	2	0	9	0	3	0	447	16	0	0	41	1	0	0	0	0	22	0	0	1	1	0	0	4	0	0	0	0	1	0	0	4	0	0	18	9	0	3	0	0	65	0	1	0	0	0	0	0	1	0	2	0	6	0	4	0	0	3	0	1	0	0	0	0	0	0	0	0	0	0	0	0	1	0	0	0	0	1	0	3	0	0	1	10	0	1	0	0	1	4	1	31	31	0	11	0	0	0	0	0	0	0	3	0	0	0	1	0	0	0	1	17	4	10	24	0	0	0	7	0	0	14	0	21	168	1	0	0	1	4	0	0	0	0	2	0	0	0	0	0	0	1	0	25	0	0	0	0	0	1	0	0	1	0	58	7	2	2	0	0	2	0	2	57	0	0	2	0	1	0	4	0	0	0	0	44	1	0	0	26	0	0	0	1	0	0	0	1	0	0	0	0	0	1	0	2	2	0	0	1	0	0	1	0	0	0	4	0	5	0	0	0	1	0	0	0	6	4	0	55	0	0	20	1	1224	0	1	0	0	1	0	0	17	1	7	1	1	0	0	0	0	0	0	0	3	0	0	0	0	0	0	273	0	79	1	39	2	0	1	3	4	1	0	0	1	0	7	0	1	25	2	1	1	8	0	0	10	0	0	0	0	1	0	0	11	1	1	0	35	25	3	26	31	79	23	39	1	48	16	33	0	3	3	0	0	11	3	0	26	0	8	3	1	30	2	0	0	0	0	0	0	3	0	0	0	0	2	12	0	0	0	1	5	0	0	0	0	0	0	0	0	0	0	0	6	0	3	18	7	0	0	0	0	0	0	0	0	0	0	0	18	1	1	39	16	11	0	25	1	1	1	0	13	72	0	0	1	0	1	0	0	1	0	1	0	0	0	0	0	3	223	0	1	51	3	1	27	0	3	1	0	0	22	27	0	0	2	1	7	0	1	0	1	3	0	1	12	0	0	1	0	0	0	64	3	0	0	0	0	1	0	1322	22	9	1	0	0	0	0	2	0	0	132	0	0	0	2	1	0	169	386	49	2	0	0	3	0	3	0	37	5	1	0	0	0	6	0	0	1	0	0	0	0	0	0	0	0	0	0	0	0	67	5685	0	2	0	0	0	0	0	4	1	1	0	0	0	1	9	3	0	0	0	0	10	2	0	29959	80	101	1	0	0	1	0	0	0	0	0	8	0	0	0	0	0	0	0	0	0	896	1	0	1	0	5	0	1	0	0	0	0	0	0	0	0	3	0	4	0	0	0	0	1	0	0	0	0	0	0	0	0	0	0	0	1	0	0	0	0	0	0	1	0	0	0	0	18	0	0	0	0	0	0	0	0	13	0	0	0	3	0	0	0	2	0	0	118	0	1	0	0	0	1	120	5	0	1	0	1	1	1	27	4	0	0	0	0	10	4	0	53	1	0	1	0	2	0	0	0	0	0	0	6	0	4	0	0	0	0	0	0	0	0	0	0	0	3	0	0	0	0	0	0	0	1	0	2	0	1	0	0	0	0	0	0	1	0	0	1	1	0	16	2	1	11	1	71	0	0	18	0	0	0	0	0	0	1	0	6	3	0	1	0	17	0	50	0	0	0	0	1	0	0	0	0	3	0	3	31	0	2	0	0	6	0	0	2	0	1	0	0	2	0	0	0	1	0	3	11	0	0	1	36	1	0	0	0	0	0	0	0	12	14	50	0	1	0	0	0	0	60	41	2	12	0	0	0	1	0	2	1	0	0	0	1	4	4	0	24	0	0	3	0	0	0	0	0	0	0	0	55	3	12	1	4	0	1	0	0	2	0	12	0	0	0	0	10	0	0	0	0	0	8	0	6	0	0	19	0	1	0	0	51	0	3	0	5	0	1	0	0	0	0	0	94	0	0	0	0	0	0	1	0	0	0	0	1	0	1	0	1	0	0	105	0	0	0	0	0	0	0	85	0	0	0	4	0	4	0	0	0	0	0	0	0	0	0	0	1	0	0	0	1	2	0	0	0	0	1	0	0	0	0	1	0	0	0	0	0	1	2	0	4	0	0	6	0	0	1	0	0	0	0	1	0	0	0	0	0	0	0	0	0	0	1	1	6	0	1	1	0	0	0	0	0	0	0	0	0	0	1	0	0	0	0	1	0	1	0	0	33	0	1	3	2	0	0	0	0	0	0	0	0	0	0	0	0	0	7	1	0	0	0	1	0	0	1	1	1	7	0	2	2	0	35	1	0	0	32	0	0	0	0	0	1	2	1	5	0	0	0	0	3	0	1	0	2	13	1	0	2	2	1	0	0	0	0	2	0	0	0	1	0	0	1	0	0	0	0	0	0	1	0	0	0	0	15	0	0	0	0	0	0	1	0	0	0	1	0	0	0	0	1	0	0	0	1	0	0	4	2	12	1	0	0	4	0	12	0	1	0	0	0	0	0	0	0	322	0	0	0	0	0	1	0	0	1	1	1	0	0	0	0	0	0	0	0	0	0	1	0	0	0	0	0	0	0	0	1	0	0	17	0	0	6	0	0	4	0	0	0	2	1	0	0	0	0	0	3	0	8	0	0	0	0	0	0	0	0	0	0	0	0	0	1	1	1	0	0	0	0	0	0	1	0	0	0	0	0	4	0	1	0	0	0	0	0	0	0	0	193	0	1	7	2	1	1	1	0	11	1	0	13	0	3	248	1	12	1	0	2	0	0	1	0	2	0	18	31	7	1	0	1	153	0	0	0	0	0	75	3	2	0	0	0	0	0	0	3	0	0	0	0	0	0	2	1	0	0	6	0	0	0	0	0	0	1	1	3	1	0	0	0	0	0	1	0	0	0	0	0	0	0	35	0	18	0	0	1	0	0	0	0	0	0	0	8	0	0	0	0	0	3	0	0	0	0	0	0	0	0	0	1	0	0	0	0	5	2	0	0	69	0	0	0	0	1	18	0	0	0	1	0	1	0	3	112	0	0	2	0	1	0	0	0	0	0	0	1	0	6	0	0	0	4	3	3	0	0	337	0	0	0	0	0	0	0	0	0	0	0	1	0	0	0	0	0	0	1	0	0	0	1	0	0	0	0	0	1	108	2	0	0	0	0	3	1	0	0	0	1	0	0	0	0	0	0	0	0	0	1	2	0	0	4	0	4	0	0	0	0	0	1	55	0	0	0	0	0	0	0	0	0	0	0	0	0	0	12	1	6	2	3	1	0	0	17	0	0	0	0	0	0	0	0	1	0	0	1	3	3	0	8	0	3	0	2	1	1	1	0	0	0	1	0	0	0	0	0	0	22	0	1	1	2	1	0	0	0	0	0	2	0	79	0	3	0	0	0	0	0	0	0	1	1	9	5	0	11	0	0	0	0	10	0	0	18	0	1	3	0	7	0	1	0	2	0	0	5	1	1	0	0	1	1	0	0	0	0	0	27	0	0	0	0	0	44	0	0	0	0	0	0	0	0	0	0	0	0	1	0	0	5	1	1	1	0	9	0	0	0	0	1	0	0	2	0	1	0	63	10	9	348	633	0	0	2	0	20	1	2	3	1	0	1	0	4	16	0	23	1	2	127	0	77	0	0	0	58	2	0	0	2	0	0	1	0	1	1	0	0	0	53	0	0	1	0	0	0	6	0	0	0	0	0	0	0	0	0	0	0	62	1	2	0	0	0	30	0	0	1	0	3	0	0	1	2	0	0	0	0	1	0	0	2	8	0	0	1	33	0	0	0	18	0	3	1	0	0	0	2	1	1	0	0	3	5	38	1	0	0	0	0	2	0	0	1	0	0	0	0	0	0	17	4	0	1	0	0	0	0	1	5	0	1	0	0	0	4	0	0	0	1	4	8	0	1	2	0	0	3	0	0	0	0	6	0	5	1	0	1	0	65	0	0	4	0	33	0	1	3	0	13	0	2	163	0	0	0	0	0	0	1	4	0	0	0	152	104	43	0	3	15	2	62	0	7	18	17	4	8	116	13	0	45	25	12	10	2	3	27	1	12	0	55	0	69	0	0	0	0	0	0	5	0	0	1	4	1	2	1	0	3	0	0	0	3	1	2	5	7	0	0	1	4	0	1	0	0	2	43	0	1	0	0	0	0	770	2	1	0	0	0	2	0	80	3	1	0	0	0	0	0	9	1	5	0	13	0	1	0	0	0	0	45	51	0	170	196	23	0	1	0	1	20	0	5	0	0	0	0	0	0	0	0	5	5	0	0	0	7	3	0	0	0	10	0	0	0	0	3	1	1	0	2	3	99	0	1	1	4	1	1	0	0	2	2	555	1	5	2	0	17	0	0	0	0	0	0	0	0	0	0	2	0	0	73	0	0	1	1	0	0	0	3	0	24	2	0	3	250	127	1	0	4	2	1	11	1	2	9	0	4	1	8	0	0	0	0	0	1	1	1	0	0	0	0	0	1	0	0	0	0	3	49	0	0	1	10	0	0	0	0	0	0	0	12	0	0	8	0	11	3	3	2	13	0	1	0	25	9	18	0	0	2	0	8	0	0	0	2	2	0	0	0	2	0	0	0	0	0	9	0	1	1	31	0	0	0	0	7	0	0	0	8	0	0	0	0	0	0	0	0	0	1	58	0	0	0	0	11	0	2	0	1	7	1	0	0	1	0	1	18	4	0	18	0	0	6	1	1	0	1	131	0	25	2	0	4	1	7	0	0	0	0	0	0	1	0	7	0	0	0	0	0	0	0	0	1	0	0	3	19	2	2	1	0	17	5	0	3	0	2	0	3	0	0	0	2	14	1	0	1	0	0	0	4	1	0	0	0	0	0	0	0	3	13	1	0	1	0	2	0	0	0	1	41	1	2	0	3	0	0	0	46	1	0	0	0	0	0	0	20	0	0	1	0	2	0	0	1	0	2	0	12	0	0	0	0	0	0	0	0	0	0	0	1	0	0	2	25	5	2	0	1	155	2	12	0	0	0	0	0	0	0	0	0	4	0	0	182	2	0	1	0	2	1	0	0	1	68	1	150	1	8	88	1	1	0	0	0	0	45	0	1	2	4	4	0	1	0	0	1	22	1	16	8	0	3	12	28	98	0	0	0	0	31	0	13	0	23	0	0	1	0	0	0	0	0	0	0	0	1	0	0	1	3	0	1	0	0	5	0	36	0	0	0	0	0	3	5	52	0	3	0	2	0	0	49	1	3	0	0	0	0	3	5	97	0	0	87	6	0	0	25	0	2	4	0	0	2	0	2	1	10	0	2	4	0	0	0	1	0	51	0	3	2	0	0	0	0	5	5	1	0	1	0	0	5	0	1	0	0	12	0	0	0	1	0	1	0	2	1	0	0	3	0	0	23	7	11	0	1	0	0	3	3	57	0	8	11	0	22	1	3	0	11	2	0	0	0	0	6	2	0	0	0	0	1	0	3	1	1	120	1	2	0	1	206	0	4	0	0	0	8	0	17	5	1	0	1	5	0	1	0	0	0	0	0	2	1	0	0	2	0	1	0	19	1	0	1	1	0	0	0	9	3	0	0	21	0	1	0	3	2	0	4	5	0	0	2	0	0	3	0	0	0	0	0	0	0	0	0	0	0	1	0	1	0	0	0	0	0	0	0	0	0	0	0	0	0	2	0	0	0	0	0	0	27	0	0	0	0	0	49	2	0	4	0	0	3	0	0	0	0	1	0	0	0	0	25	0	0	0	1	1	0	1	0	0	0	0	0	0	1	0	0	0	9	15	0	0	0	1	0	2	2	1	0	1	0	0	1	0	0	33	0	0	1	0	1	0	0	2	0	0	11	0	0	5	0	0	1	0	0	1	0	0	22	0	2	0	0	0	1	0	0	0	0	0	0	122	0	0	0	0	2	0	0	18	2	0	0	0	0	0	0	1	0	20	31	0	0	1	0	2	0	5	0	2	0	0	0	1	0	0	0	0	0	0	0	0	7	91	0	0	0	0	0	0	0	0	25	0	0	4	0	0	0	0	0	1	0	0	0	0	0	11	0	1	0	0	0	0	0	0	0	0	10	0	24	0	5	1	0	0	106	0	0	1	0	0	11	6	0	0	0	0	0	2	0	0	0	0	5	0	0	1	0	19	0	0	0	446	0	0	0	1	0	0	1	2	0	0	0	0	0	0	0	0	24	1	11	0	6	0	0	2	1	1	15	1	1	0	2	18	34	36	4	0	0	17	0	28	0	0	0	9	24	0	3	2	0	0	3	0	0	0	0	279	7	4	0	1	68	0	0	0	19	2	38	0	0	0	1	1	0	17	2	1	0	0	1	0	4	0	2	1	0	0	46	0	0	0	0	0	7	4	6	0	0	1	19	0	126	6	0	14	0	6	0	0	25	0	0	0	0	2	0	1	2	1	2	0	0	3	11	25	12	3	0	0	1	26	26	0	1	10	0	259	8	0	0	0	1	1	0	1	0	1	0	0	0	0	31	0	0	0	0	4	0	6	0	19	13	0	11	1	0	1	0	0	0	0	0	0	2	0	0	0	0	0	0	0	0	0	0	0	0	1	1	1	0	0	0	0	1	0	3	1	0	3	0	1	3	0	1	0	0	16	0	2	35	1	0	1	0	0	0	2	0	37	2	0	6	3	0	2	1	1	0	0	0	4	19	0	0	13	0	0	17	6	27	3	6	1	4	4	0	11	0	0	3	2	2	0	0	0	0	11	0	0	0	1	0	0	0	0	0	0	0	4	0	0	1	0	0	4	2	0	0	0	0	0	1	2	0	2	0	5	6	2	0	0	0	0	2	0	0	0	7	0	10	5	0	1	0	1	0	1	3	15	2	1	0	17	0	0	0	3	0	3	0	0	0	0	10	2	15	0	0	9	0	0	0	2	9	0	0	21	0	0	15	4	60	1	22	0	1	0	1	15	0	0	0	0	0	0	0	1	1	8	0	0	0	7	0	0	0	1	0	1	5	3	0	0	0	30	1	10	0	0	43	1	0	0	0	4	0	3	2	4	19	28	3	9	18	0	24	1	32	0	3	0	0	2	36	0	0	1	0	1	0	0	0	0	0	0	0	0	4	0	0	2	7	18	16	0	134	0	0	0	30	3	0	0	0	0	0	0	0	0	0	0	0	0	0	0	11	8	7	0	0	1	1	0	11	0	0	0	0	6	0	0	0	3	0	1	0	2	2	0	0	67	0	0	0	0	5	0	214	299	7	3	0	0	1	1	1	1	7	2	0	1	1	1	0	0	0	8	0	0	0	41	21	20	10	0	0	1	0	0	2	0	0	9	0	0	2	0	0	2	5	0	39	25	15	3	1	6	3	6	2	6	2	0	1	0	0	13	3	0	3	677	3	0	39	64	4	1	4	1	8	0	0	0	1	0	4	0	0	0	0	1	0	176	44	1	10	5	0	116	7	0	5	0	0	0	0	14	6	1	0	1	0	0	0	607	1	31	40	74	47	28	38	1	1	593	6	0	28	2	0	1	25	43	0	2	0	0	0	0	2	0	0	3	122	1	0	0	1	0	0	4	2	135	104	3	1	0	13	0	117	13	32	0	0	22	0	0	0	0	0	0	0	0	0	0	0	0	1	0	0	0	1	2	6	1	0	11	0	0	0	6	0	23	0	1	55	1	2	0	10	4	76	18	2	1	0	0	1	0	518	56	1	4	2	4	0	1	96	0	0	3	0	0	2	14	0	1	0	0	3	0	0	15	63	0	0	1	0	0	0	0	0	0	0	0	0	0	0	3	0	1	2	32	5	0	0	0	0	0	338	0	970	0	10	0	1	25	4	7	0	0	0	0	0	0	0	0	43	0	10	1	0	0	0	0	0	0	0	3	0	0	146	0	0	5	0	0	1	0	12	0	2	1	0	0	0	1	0	0	0	1	0	5	1	0	4	0	0	0	1	0	0	0	0	0	0	0	2	0	1	0	3	2	0	1	0	0	1	0	0	27	1	0	0	1	0	1	0	1	143	0	0	2	0	1	1	0	1	0	0	0	281	1	0	94	5	0	0	1	0	1	0	12	33	12	1	1	0	0	7	3	1	0	4	1	0	0	2	90	0	0	2	1	1	5	0	0	0	0	0	0	2	664	0	11	0	1	114	0	2	291	2	50	70	2002	1698	513	2	78	22	81	0	0	8	8	2	9	3	5	142	0	2866	1	3	2	2	0	70	0	0	0	24	14	7	0	0	0	0	0	0	0	2	0	11	58	23	3	3	18	14	4	12	0	0	0	29	2	2	10	1	2	0	0	8	0	0	0	1	1	47	1	0	0	0	17	1	0	1	0	2	1	2	2	2	0	0	0	3	0	0	11	0	0	0	0	0	0	0	0	10	0	1	0	24	3	0	170	0	0	0	3	49	856	1	0	2	2	3	0	0	4	0	16	0	37	2	1	7	0	0	23	1	11	133	7	1	0	1	87	3	0	0	11	0	0	0	21	0	25	0	1	1	209	0	0	0	0	4	0	7	6	0	0	4	1	0	4	0	0	0	0	2	0	0	0	1	14	0	1	2	3	0	19	2	6	0	0	30	2	0	22	0	0	44	0	1	1	5	19	0	84	27	0	0	8	0	1	1	0	2	0	0	0	1	1	2	17	75	51	52	1	0	1	0	0	0	3	1	0	0	0	0	13	0	0	0	1	0	0	56	5	1	14	0	0	1	0	0	0	8	1	0	0	0	0	0	0	0	1	0	0	0	0	0	0	0	1	0	1	70	0	0	1	0	0	0	10	2	0	0	0	6	38	0	0	0	1	0	0	0	7	1	0	13	0	0	0	0	6	1	2	0	3	5	0	9	0	0	2	1	0	0	0	0	3	77	3	1	0	0	0	0	11	0	206	0	0	0	0	0	1	0	11	0	14	6	0	0	0	1	1	142	1	0	0	0	3	23	85	9	17	0	2	87	0	36	0	46	0	0	0	202	83	228	5	3	21	13	9	10	0	54	0	1	11	4	9	1	0	60	1	10	238	0	58	0	134	1	1	17	0	52	14	0	45	0	2	0	0	168	1	4	24	17	123	90	0	3	3	67	311	3145	0	3	21	0	0	0	0	1	0	0	0	0	2	0	272	128	173	21	0	4	2	0	0	0	0	17	5	12	3	2	4	16	6	63	146	0	8	75	13	2	0	0	0	5	19	27	7	2	216	0	4	1	57	0	1	4	2	0	0	1	26	0	0	1	57	1	0	1	0	0	0	0	31	3	2	0	0	0	35	2	3	1	0	2	0	0	1	1	123	0	0	0	0	0	0	0	1	1	1	1	0	1	0	0	0	0	0	3	1	1	5	0	23	41	38	52	1	1	0	1	0	0	0	0	0	0	0	1	0	1	4	0	0	0	0	0	2	0	1	1	0	0	49	0	0	0	1	1	0	0	0	0	0	0	0	0	0	0	1	72	0	6	0	0	0	0	466	5	35	78	0	162	2	20	0	0	0	0	0	0	0	0	0	1	0	1	0	15	2	12	1	0	1	1	1	0	0	0	0	6	17	0	1	1	0	7	0	0	46	46	0	0	0	9	0	0	25	0	90	1	21	1	0	0	0	5	57	0	12	0	0	0	6	23	2	1	8	2	0	22	2	0	1	5	2	0	7	39	11	1	0	0	0	0	3	29	13	6	0	0	1	0	0	0	0	0	3	0	1	0	0	0	6	7	0	8	0	0	0	0	1	0	0	0	3	0	67	2	0	0	0	1	0	0	0	0	86	9	1	0	1	2	0	0	2	2	1	0	0	0	0	1	1	0	0	1	0	1	0	0	0	0	0	8	0	33	0	0	2	1	0	0	1	0	0	0	46	2	0	0	54	0	1	0	0	3	0	0	3	16	0	0	35	38	24	0	0	4	0	0	0	1	2	1	1	1	0	67	1	1	0	0	0	0	0	1	0	0	0	1	48	3	0	1	0	0	0	2	2	31	1	4	344	0	0	0	0	0	0	1	0	3	0	3	0	1	0	0	1	0	6	0	0	0	76	3	1	0	0	63	1	16	2	0	45	0	1	32	2	0	1	1	0	0	2	0	0	7	1	0	15	0	7	1	0	25	0	123	0	0	0	1	0	7	1	0	0	1	2	1	0	3	1	1	0	0	0	0	1	0	2	1	0	0	1	1	12	9	0	0	0	0	20	0	0	0	0	1	10	54	0	5	0	0	212	0	62005	0	0	0	0	0	25	0	1	0	0	0	0	0	0	0	0	73	0	0	0	0	1	0	7	2	0	1	14	0	0	0	1	0	0	0	2	0	21	39	1	4	0	0	0	0	0	25	1	0	2	0	0	1	0	4	53	8	4	6	2	1	23	0	1	0	0	0	0	2	527	31	57	130	1	0	6	3	1	4	0	6	177	8	0	5	0	0	0	0	1	1	1	3	0	33	2	0	23	3	1	1	10	23	0	0	14	0	0	0	0	2	0	0	0	0	0	0	0	10	8	2	12	13	5	11	49	0	161	0	7	208	43	4	2	38	2	169	256	0	1	12	3	1	18	0	6	0	67	55	86	12	64	1	8	0	0	139	77	1	2	0	0	0	0	0	0	1	0	0	0	0	1	121	27	1	13	0	4	0	0	0	27	0	0	0	0	3	6	15	1	0	1	2	1	0	0	1	6	0	2	1	0	0	7	7	39	14	0	11	1	0	0	5	24	0	0	0	9	0	0	1	0	0	1	0	0	0	1	0	0	0	0	3	15	45	0	0	6	21	1	0	0	0	0	14	0	7	0	0	0	22	7	0	0	7	1	73	3	1	7	3	0	0	2	0	0	0	0	0	1	0	0	1	0	0	0	4	0	0	0	0	2	1	4	1	1	0	0	1	5	0	0	0	4	8	0	2	0	0	0	0	1	2	0	7	0	0	6	0	0	2	0	27	0	0	2	1	0	0	1	0	2	0	5	0	0	23	25	1	53	0	1	2	13	34	32	13	5	0	1	2	3	43	0	0	0	0	20	0	4	0	0	0	0	0	0	0	0	0	134	0	0	3	9	2	2	0	0	0	0	4054	13933	0	1	1	2	0	0	0	14	1	66	2	1	2	0	77	12	0	12	0	1	0	26	9	2	30	0	370	0	0	6	0	1717	1	0	0	0	0	5	1	1	128	2	0	15	29	72	0	5	0	61	2	11	1	0	2	0	6	5	0	0	0	2	0	5	7	0	0	2	0	19	7	5	0	0	2	1	1	1	0	0	1	1	0	2	0	11	94	5	24	60	70	11	35	0	0	9	3	35	31	0	1	4	0	26	0	1	0	0	0	0	0	28	0	1	1	0	3	0	1	0	6	0	14	1	2	2	3	2	22	0	0	6	0	0	1	0	1	0	1	5	160	1	34	0	0	0	0	0	1	0	2	1	0	0	4	0	2	0	0	0	0	1	4	30	0	0	0	0	0	0	9	0	0	0	5	2	3	0	0	0	1	0	0	0	0	1	0	0	0	0	0	0	0	2	2	0	0	3	0	4	10	47	120	51	27	0	0	0	0	0	0	0	0	1	0	0	0	0	0	0	0	0	49	0	0	0	0	0	2	0	0	0	0	0	0	1	10	0	0	99	0	0	1	8	0	17	1	0	17	0	1	0	10	10	0	10	5	5	12	37	2	1	3	31	11	1	7	0	0	2	3	0	1	0	13	18	0	0	0	0	1	0	87	0	0	0	1	450	0	0	0	1	1	7	1	7	0	0	0	1	2	0	0	0	0	0	0	0	1	5	0	0	1	3	139	6	0	0	0	0	1	0	0	2	12	0	0	0	0	0	1	14	1	0	0	0	0	1	1	25	0	7	0	0	8	1	1	0	0	0	0	0	4	0	8	18	1	1	1	0	0	51	1	1	1	0	2	4	0	0	3	8	3	0	11443	0	35	189	9	0	20	1	156	33	165	0	0	1	0	3	0	4	0	7	0	2	0	0	2	0	0	0	0	74	1	10	1	1	3	384	0	8	0	0	0	14	1	0	2	3	0	0	0	0	25	0	0	0	5	6	0	0	0	0	81	0	1	0	0	1	2	1	0	0	1	12	2	1	0	0	2	0	1	0	0	0	1	1	1	7	16	33	24	1	1	8	26	8	35	24	84	1	0	0	0	2	0	1	0	0	16	1	0	5	147	34	13	8	1	166	0	0	24	24	0	0	7	2	0	0	0	0	0	0	0	5	18	17	3	0	0	0	4	1	0	1	0	0	5	2	4	2	0	0	1	1	0	0	0	0	0	0	0	0	1	1	0	0	0	0	0	12	0	0	0	0	1	0	3	5	0	0	0	1	0	0	0	2	0	0	0	0	2	0	0	0	13	0	7	0	0	0	29	0	0	2	1	0	1	0	0	0	1	2	2	11	28	7	0	3	2	1	1	4	7	7	0	0	0	0	4	0	3	1	20	25	0	9	5	0	1	7	0	6	9	1	4	60	3	0	1	0	0	0	0	0	0	61	1	15	0	18	0	70	4	0	90	1	3	21	1	0	1	0	33	76	44	1	0	17	3	26	0	19	5	57	0	1	0	0	0	1	0	0	0	0	0	0	16	0	21	10	0	0	0	7	0	2	18	1	5	2	0	8	1	7	0	9	24	1	2	140	2	35	0	1	0	0	0	3	0	3	2	58	1	48	1	0	0	8	0	0	0	0	0	0	0	0	0	0	4	0	0	1	70	26	3	24	25	37	1098	3	0	2	0	0	0	0	0	5	0	5	0	0	1	51	0	0	5	4	3	13	0	0	0	0	0	1	79	29	0	1	25	0	0	0	4	0	0	151	0	42	0	13	11	0	0	0	23	0	1	0	1	0	0	0	0	0	0	0	0	0	1	0	0	0	0	0	1	0	0	0	0	0	2	1	0	0	2	0	1	1	0	0	1	0	0	0	1	14	0	279	9	1	21	8	3	39	13	19	11	0	0	0	1	0	0	1	1	0	0	0	0	1	0	0	73	0	1	0	0	1	0	0	0	1	5	2	32	0	0	0	0	7	1	0	0	0	1	0	4	0	1	26	0	0	0	0	0	0	0	1	0	0	0	2	6	1	5	0	1	2	3	1	45	0	0	0	35	0	0	0	1	1	0	56	0	0	2	28	0	15	330	0	0	0	0	0	0	1	1	0	2	0	4	1	1	0	0	0	2	0	0	0	0	1	0	1	0	0	6	2	0	0	0	0	2	2	0	650	0	0	0	2	0	1	0	0	1	2	0	0	0	0	2	0	0	0	0	0	0	0	0	0	0	0	0	0	0	0	1	0	0	0	33	0	2	4	0	0	0	9	1	0	9	0	0	4	3	0	3	0	1	0	20377	0	0	0	1	0	1	0	0	0	4	1	0	0	0	0	1	0	0	0	0	0	0	0	0	0	1	0	0	0	2	0	1	0	0	0	0	0	0	0	0	0	0	0	10	1	0	3	0	0	0	0	0	0	0	0	0	0	0	0	36	0	1	3	0	0	0	0	0	0	0	0	0	0	0	0	0	0	0	0	1	0	49	0	0	0	0	0	0	0	0	0	0	0	0	0	0	0	0	0	0	0	0	21	0	0	0	2	0	213	0	0	0	0	0	0	0	0	5	0	1	1	2	4	0	18	0	0	0	0	0	0	1	1	0	1	3	2	0	1	0	190	0	28	0	0	1	0	0	0	5	0	1	0	0	0	0	3	1	0	0	0	0	0	0	0	0	1	62	1	0	0	0	12	1	0	0	4	1	1	1	0	0	1	1	0	0	1	0	0	0	1	0	0	0	0	1	0	8	0	0	0	0	1	18	0	0	0	0	1	1	3	0	0	0	0	1	3	1	0	1	0	0	0	0	0	6	0	0	6	0	1	0	4	0	2	0	0	0	1	0	1	2	1	0	1	1	1	0	1	163	0	3	3	2	1	0	0	8	34	1	1	0	0	0	57	0	1	0	0	0	3	0	1	0	0	4	0	0	0	0	0	0	0	0	0	698	8	11	0	0	0	0	0	43	1	330	0	11	13	0	3	0	12	2	0	1	0	0	0	0	0	5	0	1	7	0	14	0	0	0	0	0	2	0	1	0	1	0	0	0	1	0	0	0	0	0	1	0	0	0	0	0	0	0	0	0	0	50	2	0	0	0	3	0	3	8	0	0	0	1	0	1	1	1	0	0	2	0	0	317	0	30	0	26	0	0	0	0	0	0	0	0	1	0	0	0	0	0	8	0	0	0	23	0	0	0	0	0	0	0	0	0	0	238	0	1	0	0	0	1	1	2	0	0	0	0	0	0	0	0	3	0	0	0	0	2	71	8	1	4	52	0	0	0	0	0	0	4	0	90	0	1	0	21	0	0	0	2	9	15	6	0	2	1	0	0	0	0	0	0	17	6	0	47	1	3	4	47	0	0	0	0	0	0	2	4	6	0	0	0	1	0	0	0	1	1	1	0	2	100	0	1	8	0	0	0	2	0	0	2	3	25	14	76	72	0	93	99	2	0	33	4	11	43	0	0	6	4	0	2	0	0	0	1	38	11	0	2	0	0	112	4	1	0	0	80	0	0	0	0	0	2	0	2	9	1	1	122	0	25	0	0	0	1	1	0	0	0	4	0	5	0	9	1	3	0	0	19	0	4	0	0	0	10	19	0	11	0	2	0	43	32	7	8	19	2	0	1	7	2	1	28	2	0	0	0	2	1	0	0	1	0	2	0	0	0	5	0	0	8	115	2	0	9	0	1	18	32	43	0	0	0	1	14	1	16	30	0	1	1	0	33	7	25	39	3	273	0	0	0	1	1	0	4	3	1	6	2	57	3	17	0	2	1	0	0	0	9	10	0	0	0	0	1	3	56	0	2	7	3	0	2	1	1	4	1	46	1	4	15	18	17	0	0	5	51	7	1	0	1	0	0	0	0	2	4	0	32	0	2	0	0	3	3	10	69	16	11	0	0	1	0	2	0	0	1	0	0	0	1	1	3	0	8	6	7	74	0	9	0	0	0	1	0	2	0	3	0	19	0	3	0	4	0	1	10	0	4	2	0	0	0	20	101	0	0	0	0	0	5	0	0	13	0	0	0	0	0	30	0	1	6	1	22	0	0	1	0	0	0	2	1	5	0	2	0	16	0	0	70	0	17	11	0	5	12	0	0	0	0	0	45	1	0	1	0	0	1	0	0	0	1	0	3	0	0	172	2	17	0	3	0	0	0	3	0	0	0	0	5	30	3	2	0	52	10	1	127	7	5	26	97	10	4	166	14	4	108	1189	74	65	9	4	16	0	0	0	0	1	0	0	1	6	0	0	0	9	0	0	0	0	0	0	1	3	1	0	1	0	9	3	4	7	5	3	0	0	0	0	0	0	0	0	0	0	0	7	0	1	0	0	0	0	0	0	0	0	0	0	0	0	17	49	0	0	0	0	0	1	1	0	0	0	0	0	0	0	0	0	0	3	0	0	0	0	0	0	25	27	0	46	6	4	0	12	0	0	0	19	5	37	4	9	3	68	2	0	4	0	3	4	0	0	0	0	0	0	1	19	7	7	4	56	51	0	2	0	10	1	11	0	2	8	0	0	2	0	0	4	0	1	0	0	0	1	1	1	2	0	22	1	4	0	3	29	33	0	25	4	111	0	0	7	0	0	0	6	16	0	1	0	0	0	0	0	11	2	6	1	0	46	49	1	5	0	2	0	0	0	0	5	0	2	0	18	4	0	0	0	6	158	0	0	1	1	9	2	0	0	0	3	1	0	0	4	0	0	9	49	0	7	1	0	3	1	40	0	1	0	0	0	1	2	3	1	16	1	0	0	0	0	2	4	0	0	7	8	7	27	5	12	0	22	1	1	3	0	0	1	0	11	0	0	17	0	1	0	5	3	0	4	0	1	3	0	0	0	1	0	3	0	0	0	0	0	1	0	0	0	0	0	0	0	3	0	0	0	0	0	0	1	3	4	0	3	0	0	0	0	1	27	0	2	22	29	0	3	0	7	4	113	6	87	18	0	16	27	9	0	3	17	7	55	0	1	2	9	1	0	13	0	6	9	3	2	0	0	0	0	2	9	2	0	0	19	15	174	0	0	0	3	0	0	0	2	0	1	1	2	3	0	0	0	0	1	5	3	227	0	25	2	8	0	16	8	6	0	0	0	0	0	3	0	0	0	1	0	34	1	9	41	1	1	11	1	68	2	2	0	0	1	8	0	33	50	51	6	4	26	0	6	6	1	0	0	0	0	3	2	21	363	17	5	0	12	1	1	0	0	20	0	0	0	1	1	3	0	13	7	0	0	0	228	6	1	5	0	0	14	31	41	0	0	3	0	0	0	2	18	2	0	1	2	0	0	0	0	8	1	2	0	3	0	0	3	0	0	1	0	0	2	0	145	0	0	0	0	319	3	2	1	0	1	11	0	1	0	0	0	5	10	0	10	4	0	21	0	0	1	29	7	1	0	0	0	0	2	2	1	18	11	7	8	0	0	0	26	13	12	9	0	0	0	1	0	0	0	0	4	1	0	1	32	0	0	0	0	0	0	0	10	0	2	2	20	2	16	0	1	17	0	31	0	0	6	0	10	0	0	0	0	0	10	62	210	8	11	0	36	0	0	0	0	6	1	0	0	0	2	0	1	0	2	0	0	0	0	4	0	0	0	29	0	0	0	1	4	0	1	2	0	70	0	275	2	0	72	0	0	0	0	0	0	0	0	2	75	0	0	0	0	0	0	2	2	8	0	5	2	2	1	0	0	21	0	18	10	1	45	0	0	10	1	0	0	20	2	246	21	47	38	3	19	19	14	10	35	6	36	0	38	7	0	0	0	1	0	1	0	0	0	2	3	0	1	0	0	0	0	2	2	0	0	0	0	1	2	0	1	0	0	0	0	0	0	0	2	0	0	0	1	0	0	0	0	1	1	1	0	0	9	0	0	35	2	279	169	1	70	0	0	0	11	0	0	3	0	0	24	0	0	12	14	2	0	0	1	0	9	0	12	30	14	0	0	0	0	1	0	0	0	1	0	0	0	0	0	22	20	45	0	45	0	7	6	3	4	2	0	0	1	1	45	0	1	0	2	5	31	0	76	0	0	0	14	0	0	0	12	1	0	0	0	0	1	0	0	0	35	0	0	0	11	3	2	1	1	1	10	0	2	0	2	0	0	0	0	0	0	1	6	1	21	8	0	0	0	2	0	0	0	0	0	0	1	2	2	4
LakWasMet61_LOW9_2_rpkm	0	0	0	0	0	10	76	3	0	0	0	1	3	0	1	0	0	0	26	0	0	0	0	40	0	0	0	0	1	11	0	0	0	3	1	6	3	0	0	0	0	0	0	3	90	34	150	6	0	2	1	12	0	0	0	4	14	89	107	36	111	0	0	0	0	0	0	0	39	307	0	3	0	0	0	0	0	0	0	0	0	3	0	0	0	0	0	1	0	0	0	0	13	4	23	0	0	0	0	0	0	0	0	0	0	0	0	0	0	0	0	1	178	9	45	0	0	0	0	0	2	1	0	5	0	0	1	0	0	0	0	33	24	1	0	1	0	0	47	0	0	0	0	0	0	0	0	0	3	0	1	6	1	1	4	0	2	88	6	3	19	1	0	2	26	0	0	4	0	3	0	0	0	0	0	0	0	0	0	0	0	0	0	0	1	4	0	0	0	2	3	0	5	1	0	0	3	9	11	77	64	0	6	0	0	0	131	1	52	1	3	1	90	4	36	0	3	0	0	15	0	0	11	1	3	5	0	0	1	0	0	0	8	0	0	0	16	7	13	6	0	0	12	18	53	45	0	0	12	34	2	4	5	0	3345	171	0	0	1	0	2	6	0	32	11	0	10	3	1	120	171	0	1	0	0	0	0	0	203	35	0	35	25	83	57	0	0	0	12	1	0	0	0	0	1	0	0	1	1	0	0	92	90	2	40	1	66	18	108	0	49	0	85	1	0	0	0	0	2	0	0	0	0	2	5	10	3	1	0	0	1	0	0	0	0	0	0	0	0	0	0	0	1	15	5	4	49	1	0	0	1	0	1	0	4	0	0	0	0	165	9	0	5	0	0	20	5	71	7	1	0	2	0	0	0	6	0	0	0	3	0	0	0	10	3	0	93	0	0	0	0	0	41	1	0	4	5	0	0	9	0	9	0	1	75	0	1	0	0	1	0	68	9	0	1	45	83	2	2	0	0	1	0	0	0	0	0	0	1	0	0	0	0	1	0	0	0	0	48	0	178	9	0	0	5	142	1	2	0	0	0	399	51	369	0	47	5	8	0	17	1	0	1	16	2	99	19	0	0	1	16	78	7	1	0	0	14	6	79	0	10	0	1	0	0	0	1	72	172	15	0	0	242	92	7	0	0	0	0	0	0	0	0	0	1	0	0	0	0	0	0	0	0	0	1	0	0	0	0	0	1	0	0	0	0	0	0	0	0	7	0	0	0	6	28	0	33	0	0	31	0	17	1	3	55	0	0	0	1	0	0	1	1	0	0	2	0	0	0	0	0	0	0	0	5	1	30	0	49	0	0	0	0	2	23	2	1	95	0	67	33	129	50	9	101	0	6	1	15	0	0	0	7	0	14	2	0	1	2	0	18	0	0	0	12	12	0	118	0	13	0	223	66	375	0	0	92	0	182	2	96	90	20	20	0	2	0	9	0	1	15	30	0	0	0	0	0	0	0	0	2	38	1	0	0	0	0	14	4	0	86	0	2	14	0	0	1	0	0	1	2	207	0	12	0	0	0	0	11	22	2	38	3	0	1	0	2	0	0	0	5	0	105	0	0	0	1	0	0	22	0	0	6	0	0	0	0	1	0	1	0	1	0	0	0	2	1	0	29	0	0	0	0	0	6	3	0	0	3	15	0	2	3	7	0	0	8	0	6	1	0	5	0	0	0	0	1	0	0	6	0	31	6	0	45	32	15	0	9	51	1	0	0	0	0	24	0	0	24	0	0	3	0	18	0	0	1	0	0	0	0	0	0	0	0	32	0	0	0	0	0	0	1	0	0	0	0	0	0	29	0	2	0	0	0	0	19	0	0	7	0	0	0	0	69	0	125	1	0	3	0	0	1	0	0	0	5	0	0	0	0	0	0	13	15	1	0	8	1	0	1	0	0	0	0	0	0	26	26	0	0	0	0	0	0	0	0	10	23	2	0	0	0	0	0	0	0	1	0	16	50	13	0	0	0	0	1	0	1	0	0	0	0	0	0	0	0	0	10	10	0	1	0	1	0	1	3	0	0	0	0	0	0	5	1	0	0	0	0	0	0	0	0	0	0	0	1	0	0	0	0	0	0	0	58	47	75	18	22	0	0	0	0	0	0	4	0	0	0	0	0	0	1	0	0	0	0	0	0	9	0	0	0	6	19	0	7	2	0	0	0	0	0	0	0	0	0	0	0	0	0	0	1	0	0	2	0	0	3	0	0	7	1	39	0	41	36	0	0	0	30	10	46	0	192	0	0	1	1	0	0	0	1	0	0	0	0	1	2	0	1	1	0	0	1	0	1	0	0	0	0	0	0	0	0	0	0	186	0	0	0	99	15	0	0	1	0	0	2	43	1	0	0	0	0	0	0	0	7	0	0	1	0	0	0	0	0	21	0	1	0	0	0	4	1	0	0	0	0	0	1	0	0	1	0	0	0	0	58	2	123	0	0	0	4	0	22	0	10	5	0	6	0	0	0	0	0	0	0	22	1	0	0	0	0	0	1	0	0	0	0	0	0	0	0	2	16	0	0	6	0	0	0	0	2	0	0	3	0	0	0	3	0	0	0	0	15	11	2	0	4	0	0	0	0	1	0	0	0	0	0	0	0	0	1	0	0	0	0	0	0	0	0	0	4	0	0	0	0	1	0	2	0	0	1	0	0	0	0	0	10	6	0	0	0	0	1	0	0	0	0	0	1	0	0	0	0	1	0	0	2	2	8	7	145	135	4	0	0	28	2	0	0	37	0	3	7	0	0	0	0	0	12	0	0	0	0	0	0	0	0	0	1	0	0	0	0	0	37	0	0	0	0	0	0	0	0	4	0	0	3	0	5	11	0	0	0	0	0	0	3	0	0	295	294	0	0	2	13	0	7	0	0	26	1	0	0	0	1	0	0	0	66	2	4	4	3	8	0	5	2	2	2	10	0	4	0	0	3	0	0	0	0	0	0	11	0	0	1	2	1	0	4	0	0	0	1	1	0	15	0	1	0	0	1	0	0	0	0	2	0	0	44	0	0	0	0	0	1	0	0	0	0	4	6	0	96	56	67	16	0	0	10	0	0	0	0	4	0	13	0	8	2	0	2	0	11	13	0	2	0	0	5	0	8	0	15	2	0	36	0	0	62	25	2	2	13	5	2	0	0	0	4	0	36	0	8	13	6	106	35	28	34	0	0	2	66	22	0	0	0	0	1	25	7	0	3	0	0	1	0	10	18	17	0	0	24	0	0	0	0	0	8	3	5	0	0	0	12	7	8	58	1	1	49	0	3	7	0	0	0	1	0	24	4	2	0	1	0	0	0	0	2	5381	172	14	50	0	1	0	0	0	0	0	1	42	0	3	1	13	1	0	0	1	58	14	233	5	0	0	0	91	0	0	0	0	1	0	0	0	212	27	13	49	69	27	0	9	484	23	0	0	0	0	0	0	127	0	0	0	0	74	0	3	3	0	0	0	0	12	0	2	0	0	0	0	17	0	0	0	0	0	0	1	7	33	0	0	0	0	0	4	0	1	0	0	0	0	3	0	0	0	3	0	0	0	0	0	0	2	0	1	0	0	0	0	0	0	0	0	0	0	0	0	1	0	0	0	0	0	0	0	0	0	0	0	0	73	0	0	25	0	0	0	0	492	0	3	6	0	0	127	0	4	1	1	1	0	1	0	74	0	7	0	0	1	0	0	0	0	0	3	117	0	0	0	3	0	0	2	0	0	0	0	0	0	0	1	0	246	10	7	0	0	0	32	0	0	0	51	1	0	0	2	0	0	1	0	2	0	0	0	12	20	49	0	7	0	1	0	0	11	0	17	2	28	1	0	14	0	0	0	0	6	0	0	13	0	153	8	157	81	251	8	109	2	0	0	0	4	6	72	0	0	13	8	162	0	0	0	5	1	0	0	0	62	122	0	181	16	0	3	0	4	3	0	9	0	46	0	0	0	0	0	0	0	0	65	0	1	259	1	0	0	3	2	3	39	2	33	5	0	22	7	0	1	14	406	93	30	0	2	1	8	25	2	0	0	3	41	1	0	58	0	0	9	0	0	0	1	6	0	10	18	0	0	0	0	0	0	0	1	0	0	0	0	0	0	1	0	0	0	4	0	135	46	0	6	3	0	0	5062	7	0	3	0	0	0	0	0	1	0	0	0	0	5	0	0	0	4	1	0	0	0	0	1	0	0	0	45	0	0	0	0	1	2	2	0	0	0	12	0	5	11	17	0	41	0	0	0	1	0	0	0	26	0	0	19	14	0	1	0	41	469	1	13	0	93	186	0	30	17	12	1	28	13	23	17	25	2	0	7	1	0	0	0	1	0	1	0	0	0	0	0	0	0	0	0	0	9	0	26	465	0	0	0	0	0	0	0	0	0	0	0	0	0	5	0	0	0	2	1	21	0	2	0	1	0	0	0	1	0	0	0	5	0	0	0	0	0	0	0	0	0	1	0	0	0	0	5	0	0	1	2	0	0	0	0	0	0	0	0	36	0	3	0	3	0	1	0	14	0	9	9	22	10	0	0	0	0	0	0	0	0	0	14	0	0	73	0	1	0	0	2	0	0	0	0	0	2	2	0	3	2	6	1	15	5	0	8	2	0	0	0	7	6	6	0	3	0	0	0	0	2	1	1	0	0	0	0	0	0	0	0	0	0	0	4	0	0	0	0	0	0	26	0	1	0	2	1	1	0	10	85	0	0	0	0	0	0	0	0	0	0	0	1	4	0	0	0	4	2	0	0	0	0	0	6	15	0	0	2	0	0	0	39	1	2	0	0	0	0	0	0	0	0	0	35	0	0	0	0	0	4	0	0	2	18	1	48	84	105	8	0	10	0	2	0	7	0	207	13	0	0	0	0	0	26	0	10	0	0	0	0	0	0	0	0	0	0	0	3	0	0	0	1	0	3	0	0	0	0	27	32	0	0	0	1	0	0	0	0	0	0	0	0	1	0	0	0	23	0	3	25	0	1	0	0	0	2	2	0	0	681	0	1	9	36	13	0	7	0	20	8	0	0	0	0	0	4	149	0	0	0	0	0	0	0	0	0	4	0	19	0	0	0	0	31	0	0	56	0	10	0	0	1	0	0	0	52	1	0	0	0	0	1	2	0	0	0	0	0	1	0	40	2	0	12	4	0	0	0	3	2	0	0	3	0	0	4	0	0	2	0	0	0	0	3	226	4	0	0	0	0	0	1	0	4	0	1	0	0	0	0	0	0	0	0	1	4	0	1	0	0	0	0	0	0	0	0	3	0	0	0	0	0	0	3	0	0	6	1	0	0	18	0	2	0	19	0	0	0	0	0	0	1	0	0	0	0	0	0	29	229	70	399	574	144	226	346	7	319	146	88	525	137	80	178	3	312	1542	15	101	4	1168	895	686	655	1586	115	215	128	286	6	326	8	0	0	0	0	0	0	0	0	1	0	22	293	0	0	0	0	0	0	0	0	1	1	0	0	0	0	0	17	0	0	0	0	19	0	3	0	5	1	0	0	0	0	5	0	2	0	0	1	0	1	0	0	0	0	1	0	0	18	0	0	0	0	1	2	0	24	12	0	0	0	0	0	0	11	1	0	1	2	0	0	0	0	412	0	0	3	0	2	0	0	0	1	0	0	0	1	0	8	0	0	0	0	1	0	0	0	0	0	0	0	1	0	0	0	0	9	0	14	0	0	5	10	0	0	0	0	0	0	0	0	1	0	1	0	0	4	3	1	0	0	11	0	1	0	3	1	1	0	0	3	0	0	0	0	0	9	0	2	2	0	0	0	0	0	0	0	7	0	1	9	0	0	0	0	0	3	0	2	0	0	0	0	0	0	0	0	0	0	0	2	0	0	2	0	0	0	0	0	0	0	1	0	0	5	0	2	0	2177	0	0	0	0	0	0	0	0	0	0	1	0	0	20	0	0	9	0	0	49	0	0	0	0	6	0	0	87	10	0	1	7	0	38	0	1	1	3	3	0	0	0	0	0	0	8	0	0	0	0	1	0	1	0	4	0	0	0	1	0	0	0	0	0	0	0	0	0	3	0	2	0	0	0	0	0	31	0	1	0	0	28	0	2	93	227	10	0	5	0	0	0	0	0	0	0	0	0	0	0	0	0	0	0	78	1	2	3	0	0	0	6	0	0	0	0	61	59	0	0	0	0	122	0	0	0	0	0	0	0	1	0	1	0	0	0	237	16	0	0	0	0	0	0	0	3	0	0	73	5	9	2	0	2	0	0	9	12	0	5	0	0	0	1	0	0	0	0	2	0	0	0	224	0	0	0	0	1	0	0	0	0	0	0	0	0	0	0	0	0	0	0	0	0	0	1	0	0	0	0	0	5	9	0	0	0	0	0	0	2	3	0	36	0	1	12	0	4	0	0	7	0	1	0	0	68	0	12	4	0	0	0	0	0	0	0	0	22	0	0	0	0	0	0	34	0	3	56	130	2	0	80	39	8	0	17	1	29	0	37	0	30	0	40	1	67	21	2	2	18	0	23	0	49	0	0	0	5	0	9	0	21	12	4	12	9	4	6	3	0	7	6	1	0	203	0	0	0	1	21	0	8	1	0	0	1	8	12	0	0	0	0	0	0	4	0	0	0	0	6	13	0	0	0	1	63	0	0	0	0	0	0	0	0	14	0	0	4	0	1	6	1	1	0	7	2	0	0	0	0	0	0	0	906	0	0	33	5	9	0	56	0	52	0	0	1	372	0	0	0	0	7	36	0	16	0	0	3	0	0	1	0	0	2	0	0	9	41	0	93	0	8	0	0	0	113	26	1	1	1	0	0	0	0	0	1	1	0	0	1	0	0	66	0	0	0	214	77	0	0	0	0	0	0	2334	848	421	0	0	0	0	4	0	3	0	15	0	0	1	2	0	0	26	358	27	1	0	0	0	0	0	0	5	0	0	0	0	0	0	0	0	11	0	0	0	0	0	0	0	0	1	0	1	0	31	63	0	1	1	0	0	0	0	11	5	0	0	0	0	0	6	0	0	0	0	0	0	0	0	21	0	0	0	0	0	8	0	0	4	0	0	1	1	3	0	0	0	0	0	0	2	1554	1	0	2	2	1	0	0	0	0	0	0	0	0	0	0	2	1	0	0	0	0	0	0	0	0	0	0	0	0	1	0	0	0	0	0	0	0	0	0	0	0	2	0	0	2	0	0	1	0	0	0	0	0	0	0	0	0	0	0	75	0	0	0	0	1	0	30	0	0	0	0	0	0	33	1	0	0	0	0	5	4	13	7	1	7	0	0	4	1	0	72	0	0	19	0	0	0	0	0	0	0	0	1	1	0	14	0	0	0	0	0	0	0	0	0	32	1	0	0	0	0	0	0	0	0	0	1	0	0	0	0	0	3	0	0	0	0	0	0	0	0	31	0	0	0	14	98	0	3	26	0	0	0	0	0	0	1	0	8	0	0	1	0	7	0	5	0	0	0	0	0	1	0	1	0	207	0	31	25	17	0	49	0	0	0	0	0	0	4	0	0	0	0	0	0	2	0	6	11	0	55	0	13	1340	5	0	1	0	0	0	1	4	0	9	0	0	0	0	0	0	97	322	0	4	0	0	0	3	0	0	0	1	0	0	0	0	0	0	1	10	44	10	0	0	0	0	1	0	0	0	12	1	18	0	0	0	0	0	0	0	8	6	0	0	0	0	6	1	0	0	0	0	1	0	1767	21	0	4	0	0	0	0	57	0	0	0	51	0	1	0	0	0	0	0	16	0	0	0	5	16	0	0	0	0	0	0	3	0	0	1	1	0	0	88	0	0	1	0	0	0	0	41	0	0	0	0	0	0	0	0	0	0	0	0	0	0	0	0	0	0	4	14	0	1	0	0	0	0	0	0	0	0	0	0	0	0	0	0	4	0	7	0	3	0	0	9	0	9	0	0	0	0	0	2	0	0	0	0	0	1	0	0	0	0	0	0	0	0	1	0	0	0	1	0	0	0	0	1	0	2	0	0	0	0	6	0	5	0	0	0	49	5	0	1	1	0	0	7	0	0	0	0	0	0	0	0	0	0	1	0	1	0	0	0	0	13	0	0	0	6	0	0	2	0	0	0	0	0	44	0	0	0	0	0	0	0	0	3	0	0	0	0	1	0	0	0	0	10	3	0	0	36	4	0	0	0	0	0	0	0	0	0	0	0	23	0	0	28	0	0	0	0	0	0	0	0	2	0	0	1	0	0	0	0	0	0	0	0	0	1	321	0	2	0	0	0	0	0	0	26	0	48	0	0	0	0	0	2	0	6	0	0	0	1	0	0	0	0	0	0	0	0	0	5	0	0	0	0	0	0	0	0	0	0	0	0	0	0	0	0	0	3	0	0	0	0	0	0	0	0	4	20	0	0	0	2	0	0	1	0	0	0	0	0	0	0	0	0	0	0	0	0	0	0	0	0	0	0	0	0	0	0	0	0	0	2	0	0	0	1	2	0	0	2	0	0	0	0	0	0	0	0	0	0	0	0	1	0	0	1	86	0	0	86	0	0	0	0	0	5	0	0	29	0	0	3	0	0	0	0	0	0	0	0	0	0	0	50	79	6	1	0	43	6	0	0	0	0	1	14	16	4	0	0	0	0	2	0	1	0	0	0	0	1	0	0	0	0	0	3	0	0	0	0	0	0	0	0	0	0	0	0	0	0	0	0	0	0	0	0	0	0	0	81	1	147	2	0	0	0	0	0	0	0	0	0	187	0	0	0	0	0	1	0	0	0	0	0	0	1	0	1	0	0	0	0	0	3	0	0	0	71	0	0	0	0	72	1	0	0	0	1	0	0	0	2	5	0	0	0	0	0	0	0	0	0	0	0	0	0	102	0	0	0	0	0	6	0	3	23	0	0	0	0	0	0	0	0	0	0	0	0	0	0	1	0	0	0	0	0	0	0	1	0	0	0	0	0	0	11	0	0	0	0	0	1	0	0	0	4	0	0	0	0	0	0	0	0	0	0	0	0	0	0	0	0	20	0	0	0	0	0	0	0	0	1	0	0	0	0	0	0	0	0	0	2	0	0	18	0	1	0	1	0	0	0	32	0	0	1	0	0	0	1	0	0	0	0	0	6	65	0	4	0	0	0	0	3	0	0	4	0	3	1	0	0	0	1	2	0	8	0	4	0	0	0	1	0	2	0	2	1	0	31	0	0	0	0	0	0	0	0	0	8	0	0	2	0	3	1	0	0	0	12	0	0	46	0	0	0	0	0	0	0	0	0	0	0	0	2	0	0	0	0	0	0	0	0	0	0	150	1	0	2	0	0	22	0	0	0	0	0	22	0	0	0	0	0	0	0	0	0	7	0	10	0	0	1	0	0	0	0	0	0	0	11	1	5	0	50	1	0	174	354	0	0	4	0	1006	0	17	150	1	0	0	0	48	242	0	116	0	24	18	0	321	0	4	0	0	3	0	0	23	18	0	39	0	0	28	0	41	19	14	0	0	11	3	1	0	32	1	0	31	6	0	0	0	0	0	1	0	15	3	0	1	0	0	20	1	1	7	0	0	0	0	0	0	0	0	0	0	5	0	0	1	6	0	5	20	6	0	0	0	6	0	5	1	0	0	0	0	0	0	0	0	0	72	92	0	3	2	3	0	2	0	5	1	0	0	0	0	0	0	3	29	0	0	0	0	0	0	21	0	0	0	0	0	0	1	0	0	0	0	0	10	0	0	0	0	5	0	1	0	10	19	6	0	1	8	0	0	0	24	0	0	1	0	4	2	1	0	0	1	0	0	6	2	0	10	0	0	1	1	115	0	0	0	53	384	613	0	35	5	377	896	1	218	72	25	2	385	963	614	1	94	38	434	125	194	3	402	27	266	1	45	0	2	0	6	0	0	0	0	0	0	0	0	0	4	11	2	0	0	0	0	0	18	0	0	5	5	0	0	0	0	0	0	7	1	1	13	1	0	0	0	0	0	23	0	1	0	1	0	0	0	58	7	0	1	0	10	0	0	7	1	11	0	76	0	0	0	0	3	0	2	404	5	110	0	20	0	0	0	0	0	0	0	0	0	0	0	0	0	0	1	15	0	0	0	0	29	0	0	0	0	92	0	0	17	0	2	0	0	0	0	3	0	1	1	0	0	43	0	0	0	0	0	19	0	7	3	0	3	0	0	0	0	0	0	0	0	0	0	3	0	0	229	1	0	1	0	0	0	0	212	0	0	0	0	5	1	0	0	0	20	0	0	117	0	1	2	0	0	0	1	2	2	0	0	0	0	0	1	0	0	0	0	0	0	0	2	0	0	6	0	0	0	5	0	0	0	0	0	0	0	11	87	0	0	0	0	2	2	1	0	24	7	0	0	39	81	0	0	0	5	0	26	1	0	0	0	0	0	0	0	0	0	0	1	0	0	41	2	2	0	39	0	0	0	0	0	0	0	1	6	0	0	8	0	0	0	0	0	0	0	7	0	35	1	0	0	4	174	0	2	0	0	0	0	0	9	1	4	2	0	9	0	0	0	2	15	0	0	69	0	0	0	1	34	0	13	0	0	0	0	0	0	3	0	19	0	0	0	0	0	0	0	0	5	0	0	0	11	2	0	0	0	1	1	0	0	0	269	0	1	0	0	1	0	1	3	0	0	0	0	1	27	0	2	0	0	0	1	0	0	1	2	0	11	1	0	0	0	0	0	0	16	0	1	0	1	0	0	0	4	0	1	0	1	0	0	0	0	1	0	0	0	0	1	0	1	0	6	0	0	0	0	0	0	0	0	0	0	0	0	0	0	0	0	4	10	13	0	0	0	353	119	10	29	0	0	0	1	0	0	0	0	0	0	0	89	39	0	12	0	0	0	30	0	4	14	13	41	11	17	27	11	1	0	0	0	0	26	0	2	0	0	0	0	0	0	0	0	0	0	23	27	0	43	6	2	3	0	0	0	0	31	0	1	0	1	0	0	0	0	0	0	3	0	0	0	0	0	0	0	0	3	0	0	1	5	0	0	51	64	0	0	3	0	3	7	1	0	2	0	12	0	0	64	3	1	0	0	0	0	554	1	36	0	0	0	0	0	0	7	12	0	1	0	0	1	0	0	0	0	0	4	1	0	0	1	0	0	1	2	3	0	0	0	0	0	0	1	0	2	3	0	0	0	0	0	0	0	30	0	0	1	5	0	0	0	0	0	0	0	0	0	0	55	0	0	2	0	3	1	0	0	0	0	232	5	0	6	0	29	0	3	0	0	0	0	2	0	0	0	1	0	0	0	0	1	6	0	1	0	0	0	2	189	0	4	0	12	0	1	0	1	1	0	0	0	5	0	80	4	0	0	0	0	0	49	0	0	1	0	0	0	300	0	0	0	0	0	0	0	756	2	0	0	0	0	1	0	0	0	0	0	0	0	0	0	0	0	10	0	0	0	0	0	0	0	1	0	0	0	12	0	1	0	0	0	0	0	0	0	0	1	0	0	0	0	0	0	0	0	0	0	0	35	0	0	1	0	0	0	0	0	1	0	0	13	0	0	0	1	0	0	0	0	0	6	0	0	0	0	0	0	0	0	0	0	1	0	1	0	0	0	0	0	560	0	0	0	0	0	48	0	21	0	0	0	1	1	0	8	3	0	0	0	0	0	0	0	11	0	0	15	0	2	34	0	0	0	0	0	1	0	0	0	0	11	0	0	0	0	0	0	0	2	0	0	81	0	0	0	0	5	0	0	0	0	0	0	0	0	0	0	2	0	10	30	0	0	0	0	0	3	0	0	1	0	0	0	0	1	0	0	3	0	0	0	0	1780	0	0	0	5	6	0	0	0	0	2	0	0	6	1	1	0	0	0	18	1	0	0	0	0	11	1	0	1	0	0	0	0	0	0	1	0	0	1	1	0	0	1	4	12	0	0	0	0	0	18	40	0	0	0	0	0	9	0	21	51	0	0	0	0	14	0	21	0	3	0	1	0	0	0	0	0	0	0	0	16	0	0	0	0	0	0	0	166	15	41	5	0	1	0	0	0	0	4	1	1	0	3	19	19	14	177	0	20	39	0	33	0	0	0	74	3	0	232	0	1	0	1	26	0	0	0	121	21	0	4	51	2409	0	0	0	3	4	11	0	0	0	7	0	0	10	1	111	0	0	0	0	0	0	0	56	0	0	1	0	0	0	0	0	23	0	6	4	11	1	63	30	28	14	2	62	0	1	0	1	4	0	0	0	0	1	0	2	1	0	0	0	0	2	0	12	0	0	0	0	0	147	48	10	0	2	5	282	0	0	0	32	10	0	11	0	0	0	0	0	0	0	0	0	0	0	0	0	0	14	3	47	1	0	1	0	0	3	0	0	0	0	0	0	0	0	0	1	0	0	0	0	0	0	0	0	0	1	0	1	0	0	0	0	0	2	1	0	0	4	0	0	0	0	0	0	1	0	0	4	0	7	0	0	0	0	0	4	0	69	29	0	0	0	0	0	0	0	0	0	0	3	369	0	0	1	1	0	12	20	3	1	5	0	0	1	0	2	2	0	0	3	1	0	0	0	0	1	0	6	0	0	0	0	0	0	0	0	8	3	0	0	57	0	0	7	8	0	0	0	0	0	0	63	0	0	0	31	47	0	0	0	0	0	3	0	0	0	1	75	27	109	1	86	0	1	0	16	0	82	0	1	0	37	0	7	0	0	0	0	0	0	0	0	37	3	6	25	0	43	0	0	0	0	34	0	0	22	1	0	28	132	64	10	85	3	0	0	0	36	0	11	7	0	1	2	2	7	0	0	0	1	0	2	0	0	0	0	0	0	1	17	1	0	0	53	2	14	4	0	54	6	1	0	0	92	0	8	2	2	6	52	5	0	70	37	60	16	150	6	0	0	0	0	8	0	0	10	1	2	0	1	0	0	0	0	0	2	0	19	0	8	87	59	58	0	17	1	0	0	0	0	0	0	0	0	0	0	0	0	0	0	0	3	0	0	13	14	0	0	8	3	0	0	0	0	0	5	0	76	0	0	0	0	0	11	1	0	2	1	0	43	0	0	0	0	34	0	230	41	29	1	1	0	136	2	0	0	216	26	0	0	1	0	5	0	0	124	0	0	0	281	6	6	3	0	0	17	0	0	2	3	1	7	0	0	1	0	0	0	1	0	84	153	130	0	1	7	1	6	6	3	2	0	2	0	0	48	33	0	1	1	4	0	30	133	59	0	1	44	34	0	0	0	1	0	0	0	0	0	0	0	0	5	5	5	0	1	0	47	3	23	0	0	0	0	0	46	54	3	29	88	0	16	0	163	0	35	24	16	45	18	1	2	13	178	133	0	5	0	0	0	8	2	12	0	3	0	0	0	0	0	0	5	1	0	0	0	0	0	6	20	22	344	1034	16	7	1	1	0	3	2	7	0	0	3	0	0	0	0	1	0	0	0	0	0	0	0	0	0	1	0	1	0	2	0	0	0	0	0	0	7	1	32	0	3	71	3	65	3	2	18	4	13	49	66	0	0	0	0	18	51	10	0	0	0	4	13	3	0	4	4	0	0	2	5	1	0	0	0	0	0	0	47	19	0	0	0	0	0	0	1	0	1	1	0	0	0	0	12	0	2	9	121	2	0	0	0	0	0	6	0	10335	0	4	0	5	30	66	0	0	0	0	0	0	0	0	0	52	14	6	0	0	0	0	0	0	0	6	3	0	0	58	0	0	4	0	0	0	1	0	0	0	49	0	0	0	0	0	0	0	0	0	7	3	0	0	0	0	0	0	0	0	0	0	0	0	0	0	2	70	0	44	4	0	13	0	0	0	0	8	36	0	0	0	0	0	0	0	1	10	0	0	0	0	0	0	3	0	0	0	0	70	4	0	3	564	0	0	0	0	55	0	108	6	135	21	0	0	1	0	0	0	2	79	0	0	0	0	131	0	0	0	1	0	1	0	0	0	0	1	2	1	1519	16	30	1	13	1407	2	10	96	8	16	2	702	668	613	382	26	16	20	0	4	246	115	53	9	10	0	0	0	1649	1	0	49	1	0	70	21	0	0	253	0	0	0	0	0	0	0	20	0	0	0	23	13	17	91	17	6	7	10	13	0	11	0	66	17	2	63	0	0	0	0	0	0	0	0	0	0	6	0	0	16	2	5	0	4	1	0	0	0	0	0	0	1	0	0	10	0	0	11	60	0	0	0	0	0	42	0	0	0	11	1	8	54	0	67	36	0	0	103	19	41	0	0	3	32	28	1	5	13	0	2	0	20	1	0	123	0	0	8	5	5	164	22	0	19	11	26	29	0	0	57	14	0	0	24	4	3	1	3	1	40	0	0	18	2	9	0	0	2	0	0	51	0	0	3	0	0	0	0	0	0	6	0	0	31	0	0	1	1	0	139	21	20	0	0	0	23	0	84	4	4	8	0	0	1	31	0	0	19	33	0	28	18	12	12	16	6	1	14	10	4	1	5	6	3	196	141	22	0	0	0	0	2	0	0	0	0	1	4	0	3	0	0	0	1	0	0	62	24	0	4	0	1	0	0	0	0	18	3	3	0	0	0	0	0	0	1	0	0	0	0	0	0	0	1	0	0	3	0	0	11	0	0	0	52	9	1	2	0	1	0	0	0	1	0	0	0	0	22	0	0	0	1	0	0	0	0	1	2	0	2	6	3	12	0	0	0	0	0	0	0	0	5	299	0	0	43	0	0	1	4	35	11	0	0	2	0	0	6	0	12	7	121	43	0	0	1	0	0	0	0	1	0	0	13	5	4	1	4	1	0	2	3	1	0	6	8	11	3	7	19	17	5	11	2	6	1	2	0	1	0	0	2	1	1	9	5	9	14	6	16	3	4	5	1	4	4	2	1	5	6	2	8	0	0	2	0	18	27	2	1	0	14	12	0	3	81	68	9	79	0	31	1	0	0	0	0	0	23	4	15	0	7	0	569	168	255	1	0	20	0	0	0	0	0	240	21	63	261	182	52	168	0	50	271	1	4	0	132	31	0	0	0	3	0	63	2	4	14	7	13	2	1	3	49	141	14	0	0	0	1	1	0	23	3	0	0	2	0	1	0	0	4	1	0	0	0	0	23	5	0	1	0	0	0	0	0	0	3	0	0	0	0	0	0	0	0	0	0	0	0	0	0	0	0	1	0	0	0	1	2	1	13	31	0	27	29	0	0	0	0	0	0	1	0	0	0	0	0	0	0	0	0	0	0	0	57	0	2	0	0	0	0	0	0	0	0	0	0	0	0	0	0	0	0	1	0	0	0	5	0	0	0	0	30	0	198	2	17	78	0	36	3	85	0	1	0	0	0	1	0	0	0	1	0	0	0	13	12	39	15	0	0	0	0	0	0	0	0	1	37	7	0	85	0	17	0	0	20	44	0	0	0	27	0	0	20	78	77	35	15	1	0	7	0	0	24	3	51	0	0	0	43	27	8	0	1	28	8	38	30	0	0	40	117	14	3	161	206	17	4	0	0	0	11	0	34	41	0	5	0	0	0	0	19	0	1	0	0	0	0	0	6	0	1	14	1	0	0	0	0	0	10	1	1	0	14	0	0	0	0	0	0	0	0	0	19	17	3	0	2	64	0	32	2	0	1	5	7	1	0	1	1	1	0	0	6	0	0	0	2	6	0	22	30	14	2	0	0	0	0	0	0	0	0	3	78	3	0	2	0	0	0	0	0	1	0	0	6	2	18	0	38	11	8	0	0	17	0	1	4	1	0	0	2	0	0	0	0	3	1	1	1	0	4	0	0	0	0	0	32	0	0	0	0	0	1	0	6	0	3	11	2	1	1	0	0	0	0	0	13	3	3	1	0	14	0	0	0	0	35	21	0	0	11	78	8	0	1	31	0	21	5	9	107	0	0	6	0	2	0	0	0	0	0	0	0	70	84	0	35	4	41	10	0	0	0	4	0	0	0	0	0	3	0	0	0	0	0	0	0	0	0	0	0	0	0	0	0	11	0	2	0	21	0	0	2	6	0	0	1	0	64	13	1	0	1	0	211	113	0	0	1	0	5	0	39923	0	0	0	0	0	25	0	4	0	0	0	0	0	0	0	0	2	0	1	0	0	56	30	73	47	0	4	30	4	0	0	0	0	0	0	1	0	36	163	0	209	35	0	0	0	0	0	2	0	5	0	0	2	0	10	4	9	125	630	27	6	27	0	31	2	0	3	9	0	33	3	6	6	0	0	0	1	0	2	0	496	165	25	21	4	0	0	0	0	84	0	0	1	0	63	16	0	34	0	0	0	115	68	0	0	101	58	0	1	0	2	0	0	0	0	0	0	0	37	114	189	16	262	0	36	5	1	5	85	53	146	437	5	2	114	30	207	10	0	34	47	26	0	0	1	0	3	129	11	230	347	7	0	3	0	0	18	59	22	10	4	0	0	0	0	0	0	0	0	0	0	1	1	3	0	2	0	4	6	0	0	7	1	0	0	0	30	24	9	3	1	5	2	16	0	5	1	13	0	3	0	13	11	5	1	18	14	0	4	0	0	0	16	5	0	0	0	1	1	0	0	0	0	0	0	0	0	3	24	1	3	0	22	10	2	0	0	0	1	0	0	0	0	0	30	0	39	0	0	0	103	72	0	0	3	0	8	1	0	4	3	0	13	0	0	0	0	0	0	1	0	0	2	0	0	0	0	0	0	0	0	4	0	10	0	1	0	0	0	0	0	0	0	0	10	0	0	0	0	0	0	0	0	0	0	0	0	0	0	0	1	5	17	1	1	1	0	0	0	1	1	2	0	0	0	10	5	18	0	49	0	0	2	308	6	12	6	13	0	0	2	1	99	1	0	6	0	8	10	10	2	0	0	0	0	0	0	0	0	2	0	12	0	4	7	75	0	0	0	0	665	1597	0	1	0	4	0	0	1	4	8	133	21	1	79	0	41	43	10	12	1	0	0	19	2	28	53	13	11	0	0	7	0	5	0	0	0	0	0	1	0	0	3	0	10	24	9	18	0	1	0	2	5	0	0	1	0	0	0	1	0	0	0	1	0	81	7	20	0	2	0	1	3	0	0	1	1	0	34	49	0	0	0	0	0	0	0	41	284	208	23	10	6	43	0	30	1	5	1	2	6	0	1	14	0	1	0	1	4	0	0	0	1	39	5	1	0	0	0	0	3	0	2	1	2	0	22	0	30	1	0	13	1	24	0	0	0	0	0	0	0	0	154	0	4	0	1	0	1	3	0	0	6	6	0	0	0	0	0	1	0	0	0	0	8	61	0	0	2	0	0	5	18	0	0	1	1	0	1	0	0	0	1	0	0	0	0	0	0	0	0	1	0	1	0	0	38	0	0	75	0	4	15	8	72	3	8	0	0	0	0	0	0	0	0	0	0	0	0	0	0	0	0	0	382	0	0	0	2	3	0	0	0	0	0	0	0	0	0	0	0	36	0	0	0	53	1	20	2	0	9	9	2	0	3	4	1	4	26	5	0	11	6	18	24	97	60	30	179	0	0	102	0	0	3	4	6	0	0	1	0	0	0	0	699	1	1	3	0	99	0	0	0	0	0	329	1	88	1	0	0	17	5	0	0	1	0	0	0	0	0	4	0	0	0	1	735	142	0	0	0	2	0	0	0	0	46	0	0	0	1	0	0	11	36	0	0	0	0	17	0	2	0	177	4	0	121	29	1	0	0	0	0	0	17	6	33	24	0	0	5	0	0	2	0	0	1	0	3	2	0	0	22	70	15	6	1138	0	0	1	0	0	9	0	9	21	11	0	0	0	0	4	1	4	1	18	0	0	0	0	41	0	1	0	19	73	4	39	11	0	40	90	0	0	0	0	0	4	0	0	0	1	0	10	0	0	8	1	3	1	9	0	0	5	0	0	12	12	0	0	0	9	3	0	0	0	3	42	12	25	0	1	38	3	0	1	0	0	0	15	23	2	53	19	93	66	0	0	28	0	8	51	32	0	0	0	0	1	0	7	0	0	732	0	0	8	24	26	30	0	14	4	0	13	10	7	27	0	168	10	0	0	3	0	3	0	0	267	248	177	2	0	0	0	1	0	1	0	0	0	3	0	1	0	0	0	0	0	0	0	0	0	2	0	0	0	1	0	0	0	0	1	0	0	0	0	0	0	0	0	2	6	0	0	0	0	0	0	0	0	0	0	0	0	2	0	0	0	13	2	44	12	0	7	1	0	3	0	8	5	2	0	0	0	0	36	11	17	93	10	13	27	0	2	4	0	69	11	0	0	0	0	4	1	4	0	0	6	0	1	26	0	68	43	0	0	2	0	0	119	23	0	22	0	0	0	0	0	0	109	49	31	14	169	14	90	27	0	81	2	1	7	0	0	0	0	10	4	135	34	0	50	69	24	0	0	0	5	0	0	0	0	0	0	0	0	0	0	0	0	150	0	0	0	1	0	0	1	1	2	5	19	18	8	1	5	5	163	72	17	30	2	6	686	142	86	0	0	0	0	0	0	0	1	0	136	8	77	67	0	0	6	0	1	0	1	0	0	0	0	0	0	0	0	0	3	1	20	0	5	13	27	27	83	0	13	0	0	0	0	0	1	0	0	0	1	0	24	0	0	0	2	3	0	0	0	1	0	0	0	15	24	0	20	84	1	3	2	0	1	0	2	0	13	0	0	8188	0	0	0	57	0	18	0	5	0	0	4	0	0	0	0	0	0	35	0	0	0	0	0	5	0	0	0	0	0	0	0	0	0	0	3	1	2	0	0	0	0	0	1	0	15	0	30	102	0	16	5	23	36	58	5	4	0	1	0	66	0	0	0	0	0	0	0	0	0	0	0	5	0	0	0	0	10	0	0	1	0	1	0	3	0	0	0	0	6	0	0	0	0	0	0	4	0	0	25	8	0	0	0	0	0	0	0	0	0	1	0	0	0	7	0	19	30	63	0	49	1	0	0	0	0	0	0	0	39	0	292	0	0	2	103	0	81	17	0	0	2	0	0	0	0	1	0	5	0	0	0	0	0	0	0	0	0	0	0	0	0	0	0	0	0	4	0	0	0	0	0	0	0	0	1198	0	0	0	0	0	0	0	0	0	1	0	1	0	1	0	0	0	0	3	0	0	0	1	0	0	6	0	0	0	2	1	0	0	0	118	0	0	2	0	0	0	70	0	0	0	0	0	0	0	0	0	0	0	0	0	0	0	0	0	0	5	0	0	4	0	1	3	0	0	44	0	0	0	0	0	0	0	0	0	0	0	0	0	0	4	0	0	0	0	0	0	1	2	143	0	0	0	0	21	3	0	0	0	0	0	0	0	0	0	0	5	0	0	0	1	0	0	0	0	0	0	0	0	31	0	0	0	0	0	0	0	0	0	0	0	0	1	0	0	0	0	0	0	0	0	0	1	0	0	0	0	0	0	0	0	0	0	0	1	0	1	1	0	34	0	0	0	0	0	1	2	2	0	0	0	4	0	529	0	18	13	0	0	0	49	0	31	0	0	3	63	0	4	0	0	585	13	2	0	0	0	0	0	2	0	0	4	3	2	0	17	11	0	1	3	0	0	0	0	30	0	25	0	14	0	0	0	1	3	8	6	21	3	4	0	0	1	0	0	1	120	12	1	0	5	5	0	0	1	2	0	4	7	2	1	2	3	50	86	1	0	0	0	16	18	69	8	0	0	4	0	5	3	2	2	0	3	12	0	0	94	0	0	0	0	4	0	36	0	7	31	1	0	1	1	1	2	12	79	14	2	0	0	0	18	11	7	0	34	116	82	7	148	181	124	35	0	0	9	246	0	8	0	0	0	3	0	0	0	0	5	0	1	0	0	0	1	0	0	0	15	16	9	0	0	1	0	3	8	0	374	0	56	10	0	0	0	8	3	0	0	0	0	0	0	2	0	0	0	4	1	29	0	0	13	0	0	0	10	0	0	0	0	1	0	5	1	1	0	1	0	0	0	0	0	0	1	2	0	0	0	1	1	1	0	0	7	1	0	1	13	0	2	0	6	0	7	0	0	0	0	0	0	0	0	0	10	0	14	0	0	0	0	0	0	0	7	0	0	0	0	0	0	0	0	0	0	52	0	1	0	0	0	0	0	0	0	0	209	0	13	6	1	0	0	0	0	0	0	0	0	0	0	0	0	0	0	0	1	0	0	127	14	1	64	215	0	1	0	1	0	0	3	0	2703	1	7	3	39	0	0	2	0	8	4	4	0	0	0	6	0	0	0	0	0	8	1	3	127	0	5	24	3	0	0	0	0	0	0	0	1	0	0	0	0	1	0	0	0	18	0	2	0	27	11	0	5	11	0	0	0	0	0	0	4	12	14	11	58	52	0	66	51	8	0	74	6	1	36	0	1	31	30	0	0	0	0	0	0	6	42	0	0	0	0	69	21	0	0	0	17	0	0	0	0	0	4	0	0	22	71	55	0	0	169	0	0	0	0	0	0	1	10	2	1	6	7	59	0	1	5	0	4	0	40	0	0	0	2	15	0	26	0	1	0	5	5	1	1	8	0	0	11	1	3	1	98	76	1	0	0	0	0	0	0	0	0	1	0	0	0	0	0	0	9	48	7	0	0	2	0	6	2	116	0	5	0	1	0	77	6	13	0	0	0	0	13	3	5	167	37	0	0	0	0	1	3	0	0	0	0	3	0	84	53	103	0	54	0	0	23	12	1	0	0	0	0	1	2	50	17	31	1	2	15	2	34	0	9	2	0	4	3	39	55	49	63	10	0	2	208	30	2	0	0	0	0	0	0	110	0	0	245	0	2	0	0	0	0	1	228	6	1	0	0	0	0	1	0	0	0	1	1	1	0	0	0	0	21	31	5	117	0	0	0	0	0	1	0	21	4	0	0	15	0	0	0	4	0	1	87	111	0	200	0	2	0	28	21	0	0	1	1	0	21	0	0	0	0	0	0	0	0	45	18	2	15	10	21	1	0	0	0	0	0	1	0	37	0	0	1	9	0	0	31	0	9	15	0	8	5	0	0	0	0	0	112	38	0	0	10	0	0	3	0	0	0	0	5	0	0	23	264	16	8	0	0	0	0	10	0	0	0	0	2	0	0	102	0	230	0	1	253	7	188	1197	35	6	54	50	147	6	132	51	28	245	22	157	4	0	0	0	2	0	6	0	1	0	2	2	1	27	0	0	0	0	0	0	3	1	0	0	0	0	29	0	1	5	1	0	0	0	0	0	0	0	0	0	0	0	0	0	0	0	0	0	0	0	0	0	0	0	0	0	0	0	11	6	0	0	0	0	0	6	0	0	0	0	0	0	0	0	0	0	0	1	0	0	0	0	0	0	9	40	0	286	2	1	0	35	0	0	0	11	12	12	5	0	7	22	2	0	2	0	1	1	0	0	0	0	0	0	0	13	77	1	135	17	17	0	1	0	39	6	25	0	0	1	0	3	6	0	0	3	0	0	4	2	2	2	0	0	29	12	35	2	19	0	5	18	14	0	45	27	0	0	0	0	0	0	0	0	61	0	0	0	0	0	0	0	0	2	20	0	0	86	3	0	38	0	84	0	0	0	0	1	0	1	0	361	5	4	3	0	0	574	0	0	0	2	3	0	22	0	0	89	0	0	0	20	0	50	26	2	0	18	7	0	0	0	4	0	0	0	0	0	0	9	0	11	42	0	11	0	3	0	13	0	0	2	16	14	10	136	46	4	4	0	13	0	21	0	0	24	3	0	0	0	75	0	0	7	16	6	0	13	5	0	0	0	0	0	2	2	0	0	1	0	0	1	0	0	1	0	0	0	0	1	35	0	0	0	0	0	0	4	0	5	0	9	0	1	0	0	1	11	40	1	0	45	0	49	0	0	329	13	104	12	26	0	0	993	467	0	67	103	0	0	0	55	14	1	2	0	30	0	55	86	9	0	2	6	0	0	2	6	32	0	0	0	2	88	0	0	0	0	0	1	0	78	0	2	2	0	16	0	0	0	0	0	0	0	450	6	139	21	40	0	80	1	7	0	0	0	0	0	4	0	0	0	1	0	24	0	0	18	1	0	8	0	660	111	1	0	0	158	37	1	16	8	2	5	6	50	1	53	65	29	0	0	0	0	1	2	41	808	554	1	0	2	0	1	0	0	91	0	0	6	1	3	0	0	106	300	0	0	0	72	37	30	72	1	52	3	12	221	3	2	25	0	0	8	3	1	16	0	0	0	0	0	0	12	3	0	5	0	1	0	0	0	0	0	0	0	0	0	0	355	0	0	0	0	45	62	12	0	0	0	0	6	0	0	0	0	27	31	8	0	75	0	82	25	0	2	10	156	1	7	25	0	0	43	21	94	5	84	155	13	0	1	3	176	5	32	36	0	0	0	0	1	0	0	0	4	0	1	0	0	0	0	0	1	0	0	0	22	0	1	3	8	1	13	0	0	24	4	6	0	2	0	0	4	0	0	0	3	1	3	82	25	3	3	0	0	0	0	0	0	0	0	0	0	0	0	0	0	0	0	0	0	0	0	2	0	0	0	0	0	0	0	0	0	1	0	260	0	1	0	10	0	0	1	0	0	37	15	0	0	0	0	4	0	0	0	0	0	10	6	7	4	0	0	6	8	14	0	28	0	109	2	55	66	1	2	0	0	0	2	0	0	7	13	90	22	23	6	4	56	4	14	19	15	2	6	0	2	13	0	0	1	11	0	0	0	1	2	0	11	0	0	0	0	0	0	1	13	0	0	0	0	0	0	0	0	0	0	0	0	0	0	0	0	0	0	0	0	0	0	0	0	0	0	5	5	0	101	10	0	66	0	21	233	20	178	0	0	0	6	0	0	0	0	0	10	0	0	20	12	5	0	0	4	0	34	0	18	2	21	0	0	0	0	1	0	1	1	0	0	0	0	0	5	6	1	0	0	3	5	1	1	3	1	0	0	3	0	0	267	6	8	0	3	0	28	0	75	1	1	2	6	0	37	0	92	5	2	1	0	1	0	0	0	0	9	0	1	0	30	0	2	0	2	0	13	0	1	0	0	0	0	0	0	0	0	18	1	0	32	114	0	0	0	0	1	2	0	0	1	1	6	2	1	1
LakWasMet62_LOW9_2_rpkm	0	0	0	0	0	9	39	1	0	0	0	6	6	0	2	1	0	0	20	0	0	0	1	36	0	0	0	0	3	6	0	0	0	6	4	6	4	0	0	0	0	0	0	0	43	49	50	19	0	1	0	5	0	0	0	10	2	49	70	18	330	0	0	0	1	1	0	0	13	104	0	1	0	0	0	0	0	0	0	0	0	57	0	0	0	0	1	2	0	0	0	0	15	5	14	0	0	0	0	1	0	0	0	0	0	0	0	0	0	0	0	0	100	17	29	2	0	0	0	0	13	1	0	3	0	0	1	0	0	0	0	34	17	0	0	0	0	0	21	0	0	0	0	2	0	0	0	0	35	1	1	40	3	1	53	0	5	23	10	4	7	4	0	0	22	0	0	4	0	8	0	0	0	0	0	0	0	0	0	0	0	0	0	0	0	1	0	0	0	10	1	0	6	1	0	0	1	10	4	61	39	0	8	0	0	0	44	0	31	7	6	3	63	3	15	0	13	1	0	15	0	1	14	1	1	25	0	1	0	0	0	0	13	0	0	0	39	25	10	6	0	0	10	10	23	30	0	0	21	20	15	6	2	0	2577	495	0	0	0	0	1	0	0	25	18	0	0	0	3	50	57	0	2	0	0	0	0	0	87	42	1	38	25	16	29	0	0	0	8	0	2	0	0	0	1	0	0	2	2	0	0	378	56	0	19	0	36	7	50	0	24	0	51	4	0	0	0	1	58	0	0	0	1	0	4	16	5	0	0	0	0	0	0	0	2	0	2	0	0	0	0	0	2	23	3	1	25	9	0	0	3	2	1	0	1	0	0	0	0	75	13	0	6	0	0	18	12	21	30	1	0	7	0	0	2	5	0	0	0	2	0	0	1	4	1	0	121	0	1	0	1	0	55	0	0	26	37	0	0	1	0	20	0	1	39	0	2	0	0	1	0	18	19	0	3	26	37	1	1	0	0	0	0	0	0	0	0	0	1	0	2	1	0	0	0	1	0	0	12	0	83	40	0	0	25	161	1	1	0	0	0	158	24	389	0	74	17	3	0	22	0	0	0	6	1	34	9	0	0	6	6	68	11	1	0	0	10	9	491	0	12	0	0	0	0	0	0	157	57	12	0	0	96	64	4	0	0	0	0	0	0	0	0	0	0	0	0	0	0	0	0	0	0	0	1	0	0	0	0	3	1	0	0	0	0	0	0	0	0	2	0	0	0	3	18	0	19	0	0	24	0	23	0	6	63	1	0	0	1	0	4	0	0	0	0	13	1	0	0	0	0	1	0	0	5	4	31	0	34	0	0	0	0	4	38	17	26	221	0	149	113	206	101	50	81	0	31	1	10	0	0	0	765	0	6	1	1	0	2	0	42	0	0	0	5	8	0	66	0	10	0	165	81	125	1	0	70	1	212	2	175	58	9	8	0	3	3	6	0	1	6	21	0	0	0	0	0	0	0	0	0	18	0	0	0	0	0	6	2	1	72	0	2	14	0	0	0	0	0	0	8	179	0	262	0	0	0	0	18	16	8	20	1	0	2	0	11	2	0	1	2	0	21	0	0	0	2	0	0	14	0	0	6	5	2	0	0	1	0	4	0	1	0	3	1	3	1	0	8	0	0	0	0	0	1	3	0	0	0	6	0	0	4	7	0	0	4	1	21	0	0	1	3	0	0	0	0	0	0	7	0	34	14	1	33	44	11	0	3	52	0	0	0	0	0	32	0	0	44	0	0	4	0	83	0	3	5	0	0	0	0	0	0	0	0	21	0	0	0	0	0	0	0	0	0	0	0	0	0	10	3	1	0	0	0	0	9	0	0	17	0	1	0	0	233	4	43	0	0	0	0	0	0	0	0	0	12	0	0	0	0	0	0	50	11	1	0	4	1	0	0	0	0	0	0	0	0	28	43	0	0	0	0	0	0	0	0	8	22	8	0	0	4	0	0	0	4	0	0	28	48	7	35	0	0	0	3	0	1	3	0	0	0	1	0	0	1	16	51	53	0	1	0	2	0	0	11	0	0	0	0	0	0	8	3	0	0	0	0	0	0	0	0	1	0	0	0	0	0	0	0	0	0	1	33	29	57	14	18	0	0	0	0	0	0	2	0	0	0	0	6	0	0	0	1	0	0	0	0	33	0	0	1	8	14	0	20	3	0	0	1	0	0	0	0	0	0	0	0	0	0	0	0	0	0	3	0	0	0	0	0	11	4	319	0	22	8	0	0	0	10	5	32	0	87	0	0	4	2	0	0	0	1	0	0	0	0	7	7	0	0	0	0	0	3	0	0	0	0	0	0	0	0	0	0	0	0	91	0	0	0	56	16	0	0	1	0	0	3	55	2	0	1	0	0	0	0	0	38	2	0	0	0	0	0	0	0	14	0	0	0	0	0	2	5	217	0	0	0	0	8	2	0	1720	0	0	0	0	209	0	40	0	1	0	3	0	11	0	23	4	0	3	0	0	0	0	0	0	0	5	0	0	0	0	0	0	0	0	0	0	0	0	0	0	0	5	42	0	2	46	0	1	0	0	4	0	0	2	0	0	5	2	0	0	0	0	35	70	24	1	4	0	0	1	0	0	0	0	0	0	0	0	0	3	0	0	0	0	0	0	0	0	0	0	11	0	0	0	0	2	0	1	0	0	0	0	0	0	0	0	5	16	0	0	1	0	1	1	1	0	0	0	2	1	0	0	0	0	0	0	2	2	8	10	285	131	0	0	0	9	2	0	0	13	0	2	1	0	0	0	0	0	28	0	0	0	0	1	0	2	0	0	4	0	0	0	0	0	54	0	0	0	0	0	0	0	0	38	1	0	1	0	4	10	0	0	1	1	0	0	3	0	0	122	139	0	0	2	6	1	46	0	0	8	0	0	0	0	0	0	1	0	35	9	7	3	1	67	3	23	3	2	6	6	0	5	0	0	4	2	0	0	0	0	0	13	0	0	1	2	1	0	3	0	0	0	2	1	0	11	1	0	0	0	0	0	0	0	0	0	0	0	74	0	0	0	0	0	2	0	0	1	0	3	20	0	48	44	57	29	0	0	6	0	0	0	0	4	1	7	0	5	2	0	0	0	20	12	0	1	0	0	14	0	10	0	9	4	0	25	0	0	62	16	5	6	12	7	10	0	0	0	5	0	15	0	6	10	7	33	13	11	50	0	0	2	57	23	0	0	0	0	2	15	3	0	3	2	1	9	0	9	24	23	0	1	50	0	0	0	0	0	4	5	19	0	0	0	14	4	22	50	1	4	32	0	3	4	3	2	0	0	0	14	5	1	0	0	0	0	0	0	1	3398	76	7	27	0	1	0	0	0	0	0	3	149	2	2	2	23	0	0	0	1	49	33	83	26	0	0	0	102	0	0	0	0	1	0	0	0	165	45	18	69	67	31	0	5	263	20	0	0	0	0	0	0	159	0	0	0	0	14	0	3	1	0	0	0	0	12	0	2	0	0	0	0	25	0	0	0	0	0	0	5	12	27	0	0	0	0	0	5	0	0	0	0	0	0	3	0	0	0	5	0	0	0	0	0	0	1	0	1	0	2	0	0	0	0	1	0	0	0	0	0	0	1	0	0	0	0	0	0	0	0	1	2	0	286	0	0	90	0	1	0	0	230	0	10	1	0	0	691	0	1	5	4	1	0	1	0	16	0	8	0	0	1	0	0	0	0	0	7	54	0	0	0	3	0	0	2	0	0	0	0	0	0	0	3	0	97	19	77	0	0	5	38	0	0	0	30	1	0	1	0	0	0	1	0	9	0	0	3	11	13	16	0	9	3	0	0	0	10	0	4	4	23	7	0	23	0	0	0	1	8	0	0	11	0	75	8	286	144	723	47	168	3	0	0	0	5	7	47	0	0	3	9	96	0	0	0	14	1	1	0	0	20	41	0	119	12	0	4	0	4	15	1	4	0	24	1	1	0	0	0	1	1	0	112	0	1	89	0	0	0	17	9	2	146	0	1	9	0	11	2	0	7	33	438	27	49	0	8	0	15	9	3	0	0	5	13	0	0	250	0	2	3	0	0	0	1	14	0	2	12	0	0	0	0	0	3	0	0	0	0	0	0	0	0	9	0	0	0	33	0	776	61	0	6	1	5	0	38636	10	0	12	0	0	0	0	0	6	0	0	0	5	1	0	0	0	9	0	0	0	0	0	0	0	1	0	30	0	0	0	2	1	25	2	0	0	1	7	0	4	7	5	0	20	0	0	0	1	1	0	0	36	0	0	8	17	0	1	0	16	235	0	28	0	35	93	0	42	5	27	1	26	15	30	10	56	26	0	5	0	0	0	0	0	0	1	0	0	0	0	0	0	0	1	1	0	26	0	19	337	1	0	0	0	0	0	0	2	0	0	0	3	0	6	0	1	0	1	2	49	0	2	0	1	0	0	0	0	0	0	1	3	0	0	0	0	0	0	0	0	1	0	0	0	1	0	3	0	0	1	1	0	0	0	0	0	0	0	0	40	1	2	8	0	0	0	0	19	0	20	11	172	4	2	0	0	1	1	0	0	0	0	27	1	0	31	0	1	0	0	10	8	0	0	0	0	1	1	0	4	0	15	2	15	23	0	7	3	0	0	0	8	5	4	6	1	0	0	0	0	0	0	0	0	0	0	0	0	0	0	0	1	0	0	2	1	0	1	0	0	0	6	0	1	0	2	0	0	0	3	353	8	0	0	0	0	0	0	0	0	0	0	8	4	0	0	0	5	5	0	0	4	0	0	0	3	2	0	4	0	0	2	27	1	1	0	0	0	0	0	0	0	1	0	30	1	0	0	0	0	11	0	0	5	12	0	32	47	46	2	0	3	0	0	0	28	0	85	8	0	0	0	0	0	10	0	12	0	0	0	0	0	0	0	0	0	0	0	3	0	0	0	0	0	1	2	0	0	0	23	9	0	0	0	0	0	0	0	0	0	0	0	0	0	0	0	0	13	0	0	3	0	13	4	1	0	0	3	0	0	639	0	0	33	112	35	1	10	0	15	7	0	0	0	0	1	4	88	0	1	2	0	0	0	0	0	0	3	0	14	0	0	0	0	28	0	0	24	0	32	0	0	0	0	0	1	18	2	0	0	0	0	5	0	0	0	0	0	1	0	0	34	17	0	6	4	0	0	0	17	27	0	0	1	0	1	2	0	0	3	1	1	0	0	2	192	2	0	0	0	0	0	1	0	1	2	2	0	0	0	0	0	0	0	0	0	0	0	2	0	0	0	0	0	0	0	0	1	0	0	0	0	0	1	11	0	0	0	1	1	0	15	0	1	0	9	0	1	0	0	0	0	2	1	0	0	0	0	0	117	244	127	222	504	171	260	338	13	206	166	106	532	162	42	182	24	304	727	18	76	6	560	694	271	549	859	191	256	86	183	6	233	10	0	1	0	0	0	0	0	0	0	0	87	66	0	0	0	0	0	0	0	0	1	1	0	0	1	0	0	10	0	0	0	0	12	0	6	0	11	0	0	0	1	0	10	0	2	0	1	0	0	1	0	0	0	0	0	0	0	3	0	0	0	0	1	2	2	13	8	0	0	0	0	0	0	12	0	0	4	0	0	0	1	0	244	0	0	8	0	2	1	0	0	0	0	0	0	0	2	2	0	1	0	0	0	0	0	0	0	1	0	0	0	0	0	0	0	2	2	19	0	0	4	4	0	0	0	0	0	0	0	0	1	0	1	0	0	36	12	7	0	0	6	0	0	0	2	1	0	2	0	1	0	0	0	0	0	47	0	1	0	0	0	0	1	0	0	0	8	0	1	38	0	0	0	0	0	5	0	1	0	0	0	0	1	0	0	0	0	0	1	2	0	0	3	0	0	0	0	0	0	0	0	0	0	4	0	3	0	978	0	0	8	9	0	0	0	0	0	1	0	0	0	1	0	0	3	0	7	46	0	0	0	0	8	1	1	105	7	0	4	1	0	20	0	3	4	6	5	0	0	0	0	0	0	6	0	1	0	0	0	0	0	0	6	0	1	0	1	0	0	0	0	0	0	0	1	0	0	0	0	0	0	0	0	0	35	0	0	0	0	18	0	9	46	261	4	0	2	0	0	0	0	0	0	0	0	0	0	0	0	0	0	0	54	3	1	1	0	1	0	2	0	0	1	0	22	27	0	0	0	0	477	0	0	0	0	0	1	0	0	0	1	0	0	0	123	24	0	0	0	1	0	0	0	0	0	0	48	7	5	2	0	2	0	0	12	14	0	3	0	0	0	0	0	0	0	0	4	0	0	0	420	1	0	0	0	1	1	0	0	0	0	0	0	1	0	0	1	0	0	1	0	0	0	1	0	0	0	0	0	3	1	0	0	0	0	0	0	3	4	0	28	0	0	65	0	1	0	1	7	0	0	0	0	26	0	12	11	1	0	0	0	0	0	0	0	40	0	0	0	0	0	0	49	0	7	46	64	6	0	40	54	10	0	44	0	53	0	63	1	35	2	45	1	34	8	8	0	20	0	15	0	26	0	0	0	12	0	9	0	6	10	9	12	16	3	9	2	0	6	3	4	0	360	0	0	0	3	9	0	13	1	1	0	1	14	7	0	0	0	0	0	0	10	0	0	0	0	7	5	0	0	0	0	156	0	0	0	0	0	0	0	0	19	0	0	0	0	1	5	4	1	0	4	0	0	0	0	3	0	0	0	3617	0	0	20	25	13	0	22	0	16	0	0	0	157	0	0	0	1	2	139	0	45	0	1	6	0	0	0	0	0	9	0	0	10	11	0	228	0	15	0	0	0	59	47	0	0	0	1	1	0	1	0	1	2	1	0	7	0	0	46	0	0	0	50	34	0	1	0	0	0	0	647	685	530	1	0	0	0	5	0	5	0	14	0	0	0	1	1	0	15	577	25	0	0	0	0	0	0	0	29	0	0	0	0	0	1	0	0	5	0	0	0	0	0	0	0	0	1	0	0	0	39	56	0	0	2	0	0	0	0	39	6	0	0	0	0	0	13	1	1	0	0	0	0	0	0	187	1	0	0	0	1	3	0	0	3	0	0	4	0	4	0	0	0	1	0	2	2	3372	1	0	2	0	0	0	0	0	0	0	0	0	0	0	0	4	3	0	0	0	0	0	0	0	0	0	0	0	0	0	0	0	0	0	0	0	0	0	0	0	1	1	0	0	7	0	0	0	0	0	0	0	0	0	0	0	0	0	0	68	0	0	0	0	3	0	40	0	0	0	0	0	0	22	1	0	0	0	0	24	1	45	5	1	20	0	0	5	1	0	46	0	0	44	0	0	0	0	0	0	0	0	1	9	4	1	0	0	0	0	0	0	0	0	0	45	0	0	0	0	0	0	0	0	1	0	12	2	0	0	0	0	3	0	0	0	0	0	0	0	0	14	0	0	0	18	43	0	7	8	1	2	0	0	0	0	0	0	9	0	0	1	0	9	0	1	0	0	0	0	0	0	0	1	1	187	0	10	51	12	1	19	0	3	1	0	0	0	9	0	0	0	0	0	0	6	0	39	23	0	27	1	21	2874	1	0	1	0	0	0	0	2	0	8	0	0	0	0	0	0	92	320	0	2	0	0	0	6	0	0	0	1	0	0	0	1	0	0	1	8	85	12	0	0	0	0	0	0	0	0	14	0	11	0	0	0	0	2	0	0	19	1	0	0	0	0	6	0	0	0	1	0	4	0	757	39	0	4	1	2	0	1	21	0	0	0	19	0	3	0	0	0	1	0	51	0	0	1	6	20	1	0	2	0	0	0	0	0	0	0	0	0	0	53	0	0	0	0	0	0	0	31	0	0	0	0	0	0	0	0	0	0	0	0	0	0	0	1	3	0	1	2	0	2	0	0	0	0	0	0	2	0	0	0	0	0	2	0	2	0	4	0	1	0	0	5	0	4	0	0	1	0	0	1	0	0	0	0	0	0	0	1	0	0	0	0	2	0	2	0	0	0	0	0	0	0	0	0	0	1	0	0	0	0	1	0	8	0	0	0	35	2	0	2	0	0	0	1	0	0	0	0	0	0	0	0	0	0	0	0	0	0	0	0	0	6	0	0	0	8	0	1	1	0	9	0	0	0	27	0	0	0	0	0	0	0	0	3	0	1	0	0	0	0	0	0	0	7	3	0	2	36	9	0	0	0	0	1	0	0	0	0	0	0	10	0	0	58	0	0	0	0	0	0	0	0	6	0	0	1	0	0	1	0	0	0	0	0	0	0	227	0	3	0	0	0	0	0	0	4	2	63	0	0	0	0	0	6	0	8	0	0	0	1	0	0	0	1	0	0	0	0	0	2	0	0	1	0	0	0	0	1	0	0	0	0	0	0	0	0	4	0	0	0	0	0	0	0	1	0	4	3	0	0	0	0	0	0	1	0	0	0	0	0	0	0	0	0	0	0	0	0	0	0	0	0	0	0	0	1	0	0	0	0	0	0	0	0	0	0	0	0	0	4	0	0	0	0	0	1	0	0	0	0	0	0	0	0	0	0	34	0	0	57	1	0	2	0	0	3	0	0	11	0	1	9	0	0	1	0	0	0	0	0	0	0	0	32	52	4	0	0	33	8	0	0	0	0	2	10	5	4	0	0	0	0	6	0	2	0	0	0	0	0	0	1	0	0	0	6	0	2	0	2	0	0	1	0	0	0	0	0	0	0	0	0	0	0	0	0	0	0	0	23	0	56	12	1	0	0	0	1	0	0	0	0	7	0	0	1	0	0	3	0	0	0	0	0	0	0	0	4	0	0	0	0	0	0	0	0	1	18	0	0	0	0	22	0	0	0	0	3	0	0	0	2	6	0	0	0	1	0	0	0	0	0	0	0	0	0	65	0	0	0	0	0	3	0	1	45	0	1	0	0	0	0	0	0	0	0	0	0	2	0	0	0	5	0	1	0	2	1	5	0	0	0	0	0	0	25	0	0	0	0	0	3	0	0	0	2	0	0	0	0	0	0	0	1	0	1	0	0	0	0	0	0	9	0	0	0	0	0	0	0	0	0	0	0	0	0	0	0	0	0	0	3	0	0	10	0	1	0	0	0	0	0	15	0	0	0	0	0	0	0	0	4	0	0	0	42	69	0	12	0	0	0	0	2	0	0	0	0	9	6	0	0	0	0	0	0	38	0	13	0	0	0	0	0	1	0	1	2	0	18	0	0	0	0	0	0	0	0	0	2	3	7	0	0	4	0	0	0	0	20	1	0	22	0	0	0	0	0	0	0	0	0	0	0	1	1	0	0	0	0	0	0	0	0	0	0	57	2	9	2	0	1	9	0	0	0	0	0	31	0	0	0	0	0	0	0	0	0	3	1	3	1	0	0	0	0	0	0	0	1	0	7	2	6	1	33	1	0	34	166	0	0	6	0	493	0	26	110	0	0	0	0	85	515	0	123	0	10	40	0	709	0	4	0	0	4	0	0	14	30	0	44	0	1	14	0	32	40	13	0	0	4	1	4	0	23	0	0	12	5	1	1	0	0	0	2	0	17	20	0	0	0	0	16	1	0	28	0	1	0	0	0	0	0	0	0	0	14	0	0	0	4	0	0	33	14	0	0	0	30	0	0	1	0	0	1	0	0	1	0	1	0	114	79	0	1	2	0	0	0	1	13	6	0	0	0	0	0	0	12	16	0	0	0	0	0	1	25	1	0	0	0	0	0	0	0	0	0	2	1	10	0	0	1	1	24	1	0	0	6	7	5	0	1	16	0	0	0	14	0	0	3	0	13	15	0	0	0	1	0	4	5	3	0	34	0	0	3	0	50	0	0	0	119	154	455	0	31	5	151	656	2	244	100	38	2	597	529	218	1	402	68	317	121	146	4	244	11	304	0	15	0	0	0	5	0	0	0	0	0	0	0	0	0	0	11	2	0	0	1	0	0	52	1	0	4	3	0	0	2	0	0	0	2	0	4	9	1	0	0	0	0	0	37	0	1	0	2	0	0	0	33	7	0	0	0	27	0	0	5	2	5	0	47	0	0	0	0	3	0	2	252	4	40	0	17	0	0	0	1	0	0	4	1	0	0	0	0	0	0	2	28	0	2	0	0	25	0	0	0	0	37	0	0	13	1	1	0	0	0	0	1	0	18	1	34	1	7	0	0	0	0	3	6	0	13	0	1	5	0	0	0	0	0	0	0	0	0	0	41	0	0	110	3	0	0	0	1	0	0	202	0	0	0	0	8	0	0	0	0	16	0	0	52	0	2	3	2	0	2	0	0	0	0	1	0	0	0	0	0	0	0	0	0	0	0	0	1	0	16	0	0	0	2	0	0	0	0	0	0	0	4	100	0	0	0	0	1	3	2	0	13	8	0	0	94	273	0	0	0	0	0	19	3	0	0	0	4	0	0	0	0	0	1	1	0	0	160	3	11	0	24	0	0	0	0	0	0	0	2	8	0	0	6	2	0	0	0	0	0	0	6	0	22	2	1	1	2	135	1	0	0	0	0	0	4	6	0	6	10	0	4	0	0	1	2	19	0	0	31	0	0	0	1	138	0	11	0	0	0	0	0	0	18	0	8	0	0	0	0	0	0	0	0	1	0	0	0	6	1	2	0	0	12	1	0	0	0	85	0	0	3	0	0	0	1	2	0	0	0	0	0	13	0	0	0	0	0	0	0	0	1	6	0	4	0	2	0	0	0	0	0	25	0	2	0	0	0	0	0	1	0	0	0	0	2	0	0	0	0	0	0	1	0	0	0	3	0	4	1	1	0	0	0	0	0	0	0	0	1	0	0	1	0	0	6	4	3	1	0	0	169	88	14	21	0	0	0	0	0	0	0	0	1	0	0	59	11	0	5	0	0	0	21	0	4	22	12	39	20	20	38	15	0	0	0	0	0	17	0	0	0	1	2	0	0	0	0	0	1	0	15	11	0	9	1	5	0	0	0	0	0	52	0	0	0	1	1	0	5	0	0	0	1	0	0	0	0	1	0	0	0	0	0	0	7	2	0	0	91	27	0	0	0	0	2	2	6	0	11	0	6	0	0	28	1	0	0	0	0	5	1501	2	24	0	0	0	0	0	0	6	10	0	0	0	0	0	0	0	1	0	0	1	3	1	0	3	0	0	4	0	2	0	0	0	0	0	2	0	0	2	4	0	0	0	0	7	0	0	10	0	0	0	16	0	0	0	1	0	0	0	0	0	0	32	0	2	1	0	0	0	0	0	1	0	127	9	0	9	0	11	0	0	1	0	0	0	0	0	1	0	0	0	1	0	0	2	8	1	2	0	0	0	1	211	0	1	0	14	0	1	1	0	0	0	0	1	20	0	36	3	0	0	0	0	0	19	0	0	4	0	0	0	307	0	0	0	0	0	0	0	258	1	0	0	0	0	0	0	0	0	0	0	1	1	0	1	0	0	15	0	0	0	0	0	0	0	0	0	0	0	8	0	0	0	0	0	0	0	2	0	0	0	0	0	0	0	0	0	0	0	0	0	0	20	0	0	0	0	0	0	0	0	2	0	0	11	0	0	0	0	0	0	0	0	0	5	0	0	0	0	0	0	0	0	0	0	2	0	1	0	0	0	0	0	284	0	0	0	0	0	32	0	5	0	0	0	1	3	0	2	41	1	0	2	0	0	0	0	10	0	0	70	0	3	49	0	0	0	0	0	9	0	0	2	0	27	0	0	0	0	0	0	0	5	1	0	216	0	0	0	0	3	0	0	0	0	0	0	0	0	0	0	2	0	9	18	0	0	0	0	0	3	1	0	0	0	0	0	0	0	0	0	3	0	0	0	0	2368	0	0	0	19	0	1	0	0	0	2	0	0	9	1	0	0	0	0	2	3	0	0	0	0	28	2	3	1	0	3	0	0	0	0	0	0	0	0	0	0	1	0	5	7	0	0	0	0	1	4	22	0	0	0	0	0	15	0	30	34	0	0	0	0	2	0	12	0	4	2	0	0	0	0	0	0	0	0	0	7	0	0	0	0	0	1	0	85	20	61	17	0	0	0	1	0	0	4	1	0	0	3	63	5	30	117	0	30	48	0	27	0	0	1	64	1	0	66	0	1	0	2	11	0	0	0	86	14	0	9	118	1701	0	0	0	4	2	22	0	0	0	3	0	0	7	0	25	0	0	5	0	1	0	0	81	0	1	6	1	0	0	0	0	10	0	13	2	2	3	28	11	29	13	0	27	0	0	0	6	1	0	0	0	0	0	0	1	0	0	0	0	0	0	0	12	0	3	0	1	1	53	41	6	2	1	0	185	1	0	0	23	5	0	4	0	0	0	0	0	0	0	0	1	0	0	0	1	0	24	13	109	1	0	0	0	1	5	0	0	0	0	1	0	0	0	0	1	0	0	0	0	0	0	0	0	0	0	0	0	0	0	0	0	0	3	1	0	0	5	0	0	0	0	0	1	1	1	0	13	0	5	0	0	1	0	0	11	0	58	46	1	0	0	1	0	1	0	0	0	0	4	316	0	0	0	0	0	6	2	8	0	5	0	4	1	0	1	0	0	0	3	10	0	0	0	0	1	0	8	0	0	0	0	0	0	0	0	19	0	0	0	67	0	0	11	21	0	0	0	0	0	0	26	0	0	1	82	62	0	0	0	0	0	6	0	0	0	6	25	10	57	0	48	0	0	0	37	0	201	0	4	0	296	0	16	0	15	0	1	1	0	0	0	57	2	19	13	0	35	0	0	0	0	34	1	0	9	0	0	24	81	35	6	33	3	0	0	0	25	0	5	2	0	0	0	1	4	0	0	0	0	0	5	0	0	0	0	0	0	0	5	0	3	0	38	0	16	4	0	55	14	0	0	1	93	0	7	9	5	8	47	7	0	37	23	50	11	91	24	0	1	0	0	17	0	0	19	4	1	0	1	0	0	0	0	0	0	0	21	4	5	137	48	81	0	36	0	7	0	0	1	0	0	0	0	0	0	0	0	1	0	0	5	0	0	7	13	0	0	4	0	1	0	0	0	0	6	0	215	1	1	0	0	0	8	3	0	2	2	0	31	1	0	1	0	15	0	88	31	37	0	7	0	152	0	0	0	63	56	0	0	0	0	7	0	0	81	0	0	0	96	3	6	2	0	0	16	0	0	0	0	0	11	0	3	4	2	0	0	0	0	82	81	62	0	1	7	0	1	1	4	5	0	5	0	0	37	20	0	0	0	0	0	78	152	151	1	0	25	30	0	0	0	0	0	0	0	0	0	0	0	0	1	5	31	0	1	0	10	5	23	1	0	0	0	0	25	20	2	17	27	0	23	0	49	0	54	26	24	40	26	2	1	19	302	148	0	6	1	1	0	6	0	17	0	6	0	0	0	0	0	0	2	0	0	0	0	1	0	7	58	95	324	600	24	15	1	0	0	8	5	16	0	0	4	0	0	0	0	3	0	0	2	0	0	0	1	0	0	0	0	3	0	8	0	0	0	0	0	0	2	1	22	0	8	43	9	22	5	4	28	6	14	30	37	0	0	0	0	155	41	13	0	0	0	12	7	9	0	9	3	0	0	2	7	2	0	1	0	1	0	0	40	17	0	0	0	0	0	2	1	0	2	0	0	0	0	0	37	3	8	11	84	11	0	0	0	0	0	8	0	8500	0	8	0	6	73	66	0	0	0	0	0	0	0	0	0	23	5	6	0	0	0	0	0	1	1	5	7	0	1	99	0	0	3	0	0	0	8	0	0	0	159	0	0	0	0	0	0	0	0	0	5	5	0	1	0	0	0	0	0	1	0	0	0	0	0	0	2	19	0	30	10	0	47	0	0	2	0	10	31	0	0	0	0	0	0	0	1	30	0	0	0	0	0	0	1	0	0	0	0	86	13	0	3	239	0	2	0	0	27	0	94	5	46	7	0	0	0	0	4	0	8	374	0	0	0	1	61	0	0	0	0	1	1	0	0	0	0	0	1	0	1687	27	23	0	12	2467	1	21	52	61	32	4	395	264	291	79	44	15	34	0	16	286	196	196	47	50	0	0	1	1899	2	0	13	3	0	63	42	0	0	867	4	0	0	0	0	2	2	59	0	3	0	7	12	30	75	17	10	13	10	8	0	7	0	62	19	2	34	0	4	0	0	0	0	0	0	0	0	214	0	0	31	4	6	0	3	7	0	0	0	1	0	3	2	6	0	7	0	1	6	45	0	0	0	0	0	29	0	1	0	5	0	8	26	0	38	16	0	0	56	87	69	0	0	14	105	59	4	19	37	0	13	0	17	4	0	105	0	0	3	3	6	61	14	0	26	36	28	25	0	0	20	12	0	0	19	8	4	0	1	0	33	0	0	14	0	5	0	0	3	0	0	41	0	1	9	0	0	0	0	0	0	0	0	0	17	0	0	3	2	0	526	9	8	0	0	0	18	0	47	4	1	3	0	0	1	119	1	0	37	58	0	29	12	12	5	18	3	6	4	7	3	7	14	35	5	128	113	12	0	0	0	0	2	0	0	1	0	0	0	3	15	0	0	0	0	0	5	65	67	0	2	0	0	0	0	0	0	5	0	1	0	0	0	0	0	0	2	0	0	0	0	0	0	0	0	0	0	3	0	0	13	0	0	0	28	7	0	1	0	4	0	0	0	0	1	0	0	0	9	0	0	0	0	0	0	0	2	0	3	0	1	7	0	13	0	0	0	0	0	0	0	0	3	196	0	0	29	1	0	1	8	26	6	0	0	0	0	0	28	0	11	14	28	13	0	0	0	0	1	0	0	0	0	0	25	37	9	13	1	18	4	14	18	6	0	18	31	86	18	22	130	106	44	69	11	8	6	5	0	4	0	0	3	5	2	39	49	19	86	6	52	34	12	64	15	83	26	3	8	20	11	6	19	0	0	8	0	26	276	0	4	0	77	30	1	12	537	162	13	549	0	332	5	0	1	1	0	0	16	4	33	0	25	0	516	497	195	1	0	31	0	0	0	0	0	231	24	110	79	153	59	259	2	22	952	0	4	9	43	31	0	0	0	14	0	43	4	11	5	17	14	5	4	6	32	63	15	0	0	0	0	0	0	0	1	0	0	4	0	0	0	0	7	0	0	0	0	0	33	5	3	1	0	0	2	0	0	3	5	0	0	0	0	0	0	0	0	0	0	0	0	2	0	0	0	0	0	3	0	2	1	1	11	28	3	20	71	1	0	1	0	0	0	1	0	0	0	0	0	0	0	0	0	0	0	0	58	0	1	0	0	0	1	1	0	0	0	0	0	0	0	0	0	0	0	1	0	2	0	7	0	0	0	0	17	0	83	2	18	61	0	46	2	47	0	1	0	0	0	1	0	0	0	0	1	0	0	3	16	15	14	2	0	0	0	0	0	0	0	3	15	8	0	70	0	16	1	0	16	58	0	0	0	19	0	0	14	56	35	49	9	2	0	18	0	0	23	4	73	0	0	0	38	22	9	1	1	15	17	13	18	0	1	39	87	5	1	77	216	12	9	1	0	0	17	0	19	37	0	14	0	0	0	0	15	0	8	0	0	0	0	0	8	0	0	8	0	0	0	0	0	0	9	1	2	0	23	0	0	0	0	0	0	0	0	0	8	11	12	0	1	40	0	23	1	0	1	20	11	1	1	12	4	1	1	2	5	0	0	0	1	1	0	15	7	19	4	0	0	1	0	0	0	0	0	2	20	11	2	8	4	0	0	0	0	1	0	0	5	14	25	1	19	9	11	0	0	16	0	1	7	4	0	0	9	0	0	0	0	2	0	0	4	0	3	0	0	0	0	4	23	2	0	0	0	0	0	0	8	0	2	5	3	0	0	0	0	1	0	0	16	2	4	0	2	26	0	2	0	0	27	39	0	0	1	57	15	0	0	31	0	13	13	14	591	0	0	9	0	23	0	0	0	0	1	0	0	24	44	0	34	8	14	4	0	1	0	7	0	0	0	0	0	0	0	0	0	0	0	0	0	0	0	0	0	0	0	0	1	4	0	5	0	10	0	0	3	8	0	0	0	0	32	12	2	0	0	1	163	71	0	1	0	0	5	0	51974	0	0	0	0	0	2	0	26	0	0	0	0	0	0	0	0	1	1	0	0	0	45	19	57	56	0	12	19	15	0	1	0	0	0	0	1	0	22	94	0	98	21	0	0	0	0	1	4	0	4	0	0	4	0	20	7	16	95	299	66	33	25	0	7	5	0	7	0	0	25	2	10	15	0	1	0	0	1	5	0	356	85	60	9	8	0	0	1	0	449	0	1	4	0	38	19	0	84	0	0	0	52	38	0	0	117	85	0	5	0	8	0	0	0	0	0	0	0	93	163	95	39	224	0	207	7	1	6	121	131	124	253	5	6	35	13	202	34	0	45	36	30	0	1	3	1	0	79	30	250	366	14	0	0	0	0	16	30	8	3	6	0	0	0	0	0	0	0	0	0	0	2	3	14	0	4	2	2	3	0	5	12	2	0	0	0	29	16	3	2	3	4	6	9	0	3	0	56	0	1	0	10	9	38	7	14	4	0	2	0	0	0	28	5	0	0	1	0	1	0	0	0	0	0	0	0	0	1	44	0	0	0	14	10	3	0	3	2	0	0	0	2	5	0	15	0	21	0	0	0	69	89	0	1	2	0	89	0	0	8	6	0	4	1	0	0	2	0	0	1	0	0	1	0	0	0	0	0	0	0	0	5	0	10	0	1	0	0	0	0	0	0	0	0	8	0	0	0	0	0	0	0	0	1	0	0	0	0	0	1	0	6	35	0	2	2	0	0	1	0	2	36	0	1	0	4	29	13	0	17	0	0	0	163	5	10	4	9	0	0	2	4	24	0	1	2	1	9	5	3	2	0	0	0	0	0	0	0	0	3	0	22	0	2	20	98	0	0	0	0	622	1777	0	1	1	1	0	0	7	2	31	83	26	0	61	0	35	42	6	990	6	0	0	5	15	30	58	7	21	0	0	41	2	28	1	0	3	0	1	4	0	0	2	0	7	62	7	8	0	0	0	33	24	0	2	0	0	0	0	0	0	0	0	0	0	34	1	15	0	19	0	2	11	1	0	1	1	0	28	43	0	0	0	0	0	0	1	38	147	49	16	11	7	20	0	44	4	1	8	167	8	2	8	8	0	1	0	4	5	0	0	0	3	15	0	4	0	0	0	0	8	0	0	2	4	0	14	0	13	0	1	3	2	22	0	0	0	0	4	2	0	0	160	0	6	0	0	0	0	8	0	0	1	3	0	0	1	0	1	0	1	1	0	0	4	23	0	0	813	0	0	6	11	0	1	1	2	0	1	0	0	0	0	0	0	0	0	0	1	0	2	0	0	1	0	1	6	1	0	103	0	6	6	16	47	1	13	0	0	0	0	0	0	0	0	0	0	0	0	0	0	0	0	0	90	0	0	0	2	1	0	0	0	0	0	0	0	0	0	0	0	23	0	0	0	24	6	7	8	0	4	15	3	6	0	3	4	10	42	7	1	6	48	95	89	483	200	99	772	0	0	45	0	0	3	18	22	4	0	1	0	1	0	0	352	0	0	8	0	180	0	0	0	0	2	542	0	6	0	1	0	13	8	0	0	0	0	0	0	1	1	1	1	0	1	0	356	71	0	0	0	1	0	0	0	0	17	0	0	0	1	0	0	14	60	0	0	0	0	12	0	0	0	68	2	0	36	12	0	0	0	0	3	0	15	13	27	9	0	0	4	0	0	33	0	0	3	0	13	1	0	0	6	100	6	16	734	0	1	0	0	0	3	0	42	8	6	0	0	0	2	14	0	11	0	9	0	0	0	0	41	0	3	0	68	158	4	140	3	0	85	140	0	3	0	0	0	2	0	0	0	1	0	23	0	0	5	1	2	0	1	0	0	4	0	0	9	0	0	0	0	18	5	0	0	0	2	207	1	36	0	4	86	5	0	0	0	0	0	17	9	2	30	10	75	96	3	0	33	0	10	36	36	0	0	0	0	3	0	16	0	0	633	0	0	19	33	13	21	0	44	2	0	4	3	2	8	0	134	15	0	0	1	0	5	0	0	162	681	79	0	0	0	0	2	0	1	0	0	2	1	0	2	0	0	0	0	0	2	0	0	0	5	0	1	0	0	0	0	0	0	0	0	0	0	0	1	0	0	0	0	21	0	0	0	0	0	0	0	0	0	0	0	0	3	0	0	0	14	8	25	6	0	11	6	0	5	0	7	1	7	0	1	0	0	28	274	4	38	7	5	30	0	2	6	0	22	7	0	0	0	0	2	4	3	0	0	9	0	0	6	0	51	17	0	0	3	0	0	75	30	0	22	0	1	1	0	0	0	39	22	14	14	85	11	30	18	0	49	7	0	7	0	0	1	0	3	9	53	11	0	47	23	54	0	0	0	4	0	0	0	0	0	0	81	0	0	0	0	0	62	0	0	0	0	0	0	1	1	1	9	13	17	17	5	8	7	48	41	18	26	3	1	240	65	72	0	0	0	1	0	1	0	2	0	57	10	67	44	0	0	74	0	0	0	0	0	0	0	0	0	0	1	0	0	8	3	109	1	18	53	25	97	60	0	4	0	0	0	0	0	6	0	4	0	0	0	17	0	0	0	1	1	0	0	0	0	0	0	0	9	69	0	22	61	0	5	2	0	1	0	4	0	16	0	0	3637	0	0	0	28	0	48	0	2	0	0	3	0	0	0	3	0	0	24	0	0	0	0	0	11	0	0	0	0	0	0	0	0	0	0	0	0	2	0	0	0	0	0	0	0	5	0	182	245	0	7	2	19	25	32	1	3	0	3	0	35	0	0	0	0	0	0	0	0	0	0	0	5	0	0	0	0	26	0	0	0	0	0	0	3	0	0	0	0	1	0	0	0	0	1	0	6	0	0	27	7	0	0	0	0	0	0	0	0	0	1	0	0	1	4	0	31	32	47	0	23	0	0	0	0	0	0	0	0	46	0	121	0	1	2	32	0	55	28	0	0	0	0	6	0	0	0	0	4	0	0	0	0	0	0	0	0	0	0	0	0	0	0	0	0	0	9	0	0	0	0	0	0	0	0	730	0	0	0	0	0	0	0	0	0	5	0	2	0	4	0	0	0	0	4	0	0	0	0	0	0	4	0	0	0	0	0	1	1	0	89	0	0	0	0	0	0	18	0	0	0	0	0	1	1	0	0	5	1	0	0	0	0	0	0	0	9	0	0	1	0	0	1	0	0	11	0	1	0	0	0	0	0	0	0	0	0	0	0	0	13	0	0	0	0	0	0	1	1	28	0	1	0	0	16	1	0	0	0	0	0	0	0	0	0	1	1	1	0	0	1	0	0	0	0	0	0	0	0	22	0	0	0	0	0	0	0	0	0	0	0	0	14	0	0	1	0	0	0	0	0	0	0	0	0	0	0	0	0	0	0	0	0	0	1	0	1	0	0	141	0	0	1	0	0	0	3	4	0	4	2	3	0	112	0	120	41	1	0	0	23	0	17	1	0	14	268	0	22	0	0	261	4	3	0	0	3	0	0	7	3	1	14	7	4	0	12	7	0	3	14	0	5	0	0	17	0	18	0	43	0	1	0	0	5	6	4	64	1	9	3	0	3	1	0	4	59	16	3	0	9	7	0	0	4	18	2	9	54	4	9	3	4	30	36	3	0	0	1	77	35	48	4	9	0	22	0	21	1	3	11	0	5	27	0	0	473	0	1	0	0	6	0	167	5	29	36	3	0	4	3	4	5	16	22	49	1	1	1	0	17	6	26	0	36	94	64	14	106	149	125	23	0	0	10	116	0	14	0	0	0	5	0	0	0	0	9	0	1	0	0	0	1	0	5	0	121	16	14	0	0	0	0	3	3	0	89	0	26	8	0	0	0	5	13	0	1	0	0	0	0	8	0	0	1	1	0	13	0	1	25	0	0	0	5	0	0	0	0	0	0	5	0	0	0	0	0	3	0	0	0	0	3	13	1	0	0	0	3	0	0	1	28	0	0	1	44	1	3	0	5	0	48	0	0	1	0	0	0	1	0	0	17	1	10	0	0	0	0	0	0	0	8	0	0	9	0	1	0	0	0	9	0	45	0	6	0	0	0	0	0	0	0	1	120	0	8	4	0	0	0	0	0	0	0	0	1	0	1	0	0	0	0	0	0	0	1	52	13	3	33	75	0	1	0	0	0	0	0	1	1503	0	8	15	198	0	0	4	0	2	20	6	0	0	0	32	0	0	0	0	1	8	4	25	395	0	4	31	2	0	0	0	0	0	0	0	1	0	0	0	0	1	0	1	0	18	1	0	0	28	10	0	5	11	0	2	0	0	0	0	4	18	10	9	48	50	0	43	43	617	0	43	11	0	43	1	8	9	26	0	1	0	0	0	0	6	9	0	0	0	0	46	12	2	0	0	7	0	0	0	0	0	6	0	0	40	57	20	0	0	91	0	0	4	0	0	0	0	12	2	1	3	6	18	4	1	16	1	16	0	54	0	0	0	1	12	0	11	0	13	0	4	3	0	0	32	0	1	19	5	18	3	396	62	3	1	0	0	0	0	0	0	0	1	0	0	0	0	0	0	6	33	25	0	1	1	5	3	2	36	0	8	0	0	0	57	11	11	0	1	0	0	6	8	8	141	31	0	0	0	0	2	16	0	0	0	0	1	0	109	63	86	0	33	0	0	14	9	3	1	0	0	0	2	5	65	8	63	1	5	7	20	126	0	9	5	0	5	1	9	20	32	92	11	0	2	54	47	4	0	0	0	0	0	0	65	0	0	105	0	0	0	0	0	0	0	134	10	0	0	0	0	0	0	0	0	0	1	0	0	0	0	0	0	20	19	0	85	4	2	0	0	0	1	0	11	6	0	0	8	0	3	0	2	0	0	52	34	0	113	0	1	0	15	36	0	0	0	1	0	22	0	0	0	0	0	0	0	0	26	19	1	9	4	17	9	0	0	0	0	2	0	0	158	0	0	1	23	0	0	44	1	5	14	0	11	36	0	0	0	0	0	63	30	1	3	6	4	0	15	0	0	1	0	3	0	0	24	67	17	28	0	0	0	0	15	0	0	0	0	1	2	15	32	0	147	3	0	239	9	61	405	101	7	55	13	43	2	93	2	57	196	9	127	7	0	2	0	0	0	16	0	1	0	0	2	2	11	0	0	0	0	0	0	1	4	1	0	2	0	16	0	1	4	10	6	0	0	0	0	0	0	0	0	0	0	0	0	0	0	0	0	0	0	0	0	0	0	0	0	0	1	17	2	0	0	1	0	0	0	0	0	0	0	0	0	0	0	0	0	0	1	0	0	0	0	0	0	7	14	0	106	8	1	1	41	0	0	0	51	11	52	13	1	21	40	1	0	16	0	0	1	0	0	0	0	0	0	0	12	70	2	71	5	18	0	0	0	18	2	11	2	0	0	0	2	3	0	0	1	0	0	13	4	6	3	2	0	40	17	53	9	6	0	12	22	14	0	29	70	1	0	0	0	0	0	0	7	47	0	0	0	0	0	0	0	2	1	2	0	0	78	3	0	21	0	70	0	0	0	0	5	0	2	2	279	2	6	7	0	0	228	0	0	0	4	2	0	16	0	0	78	0	0	8	9	0	45	13	0	0	29	25	0	0	0	6	0	0	0	5	0	2	3	1	15	31	0	5	0	2	0	11	2	0	1	8	6	8	66	13	6	3	3	14	0	12	0	0	37	3	0	0	0	23	0	0	10	11	5	0	6	4	0	0	0	1	0	0	0	0	0	1	0	0	0	0	2	1	0	0	0	0	0	23	0	0	0	0	0	0	3	0	6	0	34	3	0	1	0	0	5	22	1	1	14	0	37	0	0	465	7	82	13	14	0	3	495	477	1	27	69	0	0	0	32	35	0	2	0	16	0	41	31	8	0	1	5	1	1	7	10	29	0	0	3	12	43	10	0	0	0	0	0	0	155	0	2	3	0	4	0	0	0	0	0	0	0	286	31	99	17	20	0	46	3	8	0	0	0	0	0	4	0	0	0	5	0	42	0	4	21	1	0	51	0	512	77	1	0	0	65	12	6	110	24	16	21	20	98	1	14	79	2	0	0	0	0	2	1	16	510	215	13	0	2	0	0	1	0	45	0	0	3	4	0	0	0	61	240	0	0	0	133	48	49	67	5	31	8	12	148	1	1	160	0	0	23	2	2	2	0	0	0	0	0	0	28	2	0	0	0	1	0	0	0	0	0	0	0	0	2	0	172	0	0	0	0	30	27	15	0	0	3	1	3	1	0	0	0	23	23	17	1	52	0	32	15	0	1	17	52	1	29	17	0	1	49	19	70	5	54	120	28	2	9	14	174	6	42	79	0	0	0	0	0	0	0	1	4	0	0	0	4	0	0	0	0	0	0	0	9	1	0	1	12	1	10	0	0	16	0	7	0	1	1	0	4	0	0	0	1	0	1	31	14	3	10	0	1	0	0	1	0	0	0	0	0	0	0	0	0	0	0	0	0	0	0	0	0	0	0	2	0	1	1	0	3	1	0	1	0	9	0	17	1	0	2	0	1	12	3	0	0	0	0	1	0	0	0	0	0	3	10	14	16	2	0	3	29	43	0	31	0	608	0	244	292	0	3	2	0	2	1	0	0	23	70	1181	43	27	0	9	76	13	16	12	14	0	2	0	1	19	0	0	3	33	0	0	0	7	1	0	5	1	0	0	0	1	0	0	24	0	0	0	0	0	0	0	0	0	0	0	0	0	0	1	0	0	0	0	0	0	0	0	0	0	0	6	8	0	34	17	0	66	0	26	75	56	103	0	0	0	4	0	0	1	0	0	12	0	0	12	11	1	0	0	3	0	39	0	12	3	17	0	0	0	0	1	0	2	1	0	0	0	0	0	10	1	1	0	0	5	6	5	1	1	0	0	0	2	0	0	90	31	3	0	3	0	19	0	32	2	3	8	5	0	7	0	55	8	1	0	0	1	0	0	1	0	5	1	7	0	101	2	4	0	0	1	15	0	1	0	0	0	0	0	0	0	0	12	5	0	17	64	0	0	0	0	0	3	0	0	0	0	15	2	0	0
LakWasMet63_LOW9_2_rpkm	0	0	0	0	0	0	2	0	0	0	0	190	0	0	0	0	0	0	0	0	0	0	1	1	0	0	0	0	0	1	0	0	0	1	0	1	0	0	0	0	0	0	0	0	2	2	7	1	0	0	0	3	0	0	0	0	0	1	4	1	15	0	0	0	0	0	0	0	0	5	0	0	0	0	3	0	0	0	0	0	0	0	0	0	0	0	0	0	0	0	0	0	2	0	2	0	0	0	1	0	0	0	0	0	0	0	0	0	0	0	0	0	4	0	1	0	0	1	0	0	0	0	0	11	0	0	1	0	0	0	0	1	0	0	0	0	0	0	1	0	1	0	0	1	0	0	0	0	1	0	0	2	0	0	0	0	0	0	1	0	0	0	0	0	1	0	0	0	0	1	0	0	0	0	0	0	0	0	0	0	0	0	0	0	0	0	0	0	0	0	1	0	1	0	6	0	0	8	2	4	1	0	1	0	0	0	2	0	0	0	0	6	3	0	0	0	2	0	0	0	1	0	1	0	0	0	0	0	1	0	0	0	0	0	1	0	5	1	1	0	0	0	1	0	1	4	0	0	3	4	1	3	1	0	107	28	0	0	0	0	1	0	0	5	0	0	1	0	4	3	1	0	0	0	0	0	0	0	3	1	0	2	0	1	4	0	0	0	10	1	1	0	0	0	0	0	0	1	0	0	0	2	6	0	2	0	0	37	3	0	2	0	2	0	0	0	0	0	0	0	0	0	1	0	1	8	0	0	1	0	0	0	1	0	0	0	0	0	0	0	0	0	0	0	1	0	0	0	0	0	0	0	0	0	1	0	0	0	0	6	2	0	4	0	0	1	1	2	1	2	0	2	0	0	0	0	0	1	0	1	0	0	0	0	1	0	6	0	0	0	0	0	14	0	0	5	2	0	0	8	0	3	0	0	8	0	3	0	0	1	0	10	32	1	0	1	0	1	0	0	0	0	0	0	0	0	0	0	0	0	0	1	0	0	3	0	0	0	0	0	16	2	0	0	0	5	0	0	0	0	0	4	1	7	0	4	0	0	0	2	0	0	0	0	0	1	0	0	0	0	1	3	5	0	0	0	1	0	5	0	4	0	0	0	1	0	0	1	1	0	0	0	6	9	0	0	0	0	0	0	0	0	0	0	1	0	0	0	0	0	0	0	0	1	0	0	0	0	0	0	2	0	0	0	0	0	0	0	0	0	0	0	0	0	0	0	1	1	0	0	0	0	0	4	2	0	0	0	0	0	0	0	0	0	0	0	0	0	0	0	0	0	0	0	0	0	1	0	2	0	0	0	0	1	2	2	14	8	1	3	3	27	5	3	3	0	0	3	2	0	0	0	2	0	0	1	0	0	0	0	0	0	0	0	0	2	0	3	0	0	0	13	6	21	2	0	5	1	19	1	7	2	5	0	0	0	0	0	0	0	1	4	0	0	0	0	0	0	0	0	0	4	0	0	0	0	0	1	0	1	1	0	0	2	0	0	0	0	0	0	0	6	0	3	0	0	1	0	0	0	0	1	0	0	1	0	0	0	0	0	0	0	10	0	0	0	0	0	0	19	0	0	4	1	0	0	0	3	0	0	0	0	0	0	1	0	0	0	0	0	0	0	0	0	0	2	0	0	2	1	0	0	1	1	0	0	1	1	1	0	0	0	0	0	0	0	0	0	0	0	0	2	1	0	1	1	1	0	0	3	0	0	0	0	0	0	0	0	9	1	0	0	0	3	0	0	0	0	0	0	0	1	0	0	0	2	0	0	0	0	0	0	0	0	0	0	0	0	0	0	0	12	0	0	0	0	1	0	0	1	0	0	0	0	12	0	2	0	1	0	0	0	0	0	0	0	1	0	0	0	0	0	0	0	3	0	0	1	0	0	0	0	0	0	0	0	0	5	2	0	0	0	0	0	0	0	0	0	5	3	0	0	0	0	0	0	0	0	0	2	1	0	0	0	0	0	0	0	0	0	0	0	0	0	0	0	1	3	2	2	0	1	0	0	0	0	0	0	0	0	0	0	0	0	1	0	0	0	0	0	0	0	0	1	0	0	0	0	0	0	0	0	0	0	9	2	1	1	0	0	0	0	0	0	0	0	0	0	0	0	0	0	0	0	0	0	0	0	0	0	0	0	0	2	1	1	0	1	0	0	0	0	0	0	0	1	0	0	0	0	0	0	1	0	1	0	0	0	0	1	0	0	0	3	0	2	0	0	0	0	2	1	0	0	2	0	0	0	0	0	0	0	33	0	0	0	0	0	0	0	0	1	0	0	0	0	0	0	0	0	0	0	0	0	0	0	0	7	0	0	0	1	1	0	1	11	0	0	2	0	1	0	0	0	0	0	0	0	0	4	0	0	0	0	0	0	0	0	0	0	9	0	0	0	0	0	0	0	0	0	0	0	0	5	3	0	0	0	0	0	4	0	0	0	2	0	0	0	0	0	0	0	0	0	0	0	0	0	0	2	0	0	0	0	0	0	0	0	0	0	0	0	0	0	1	4	0	0	0	0	0	2	0	0	1	0	0	1	0	0	12	1	0	0	0	0	0	1	2	0	1	0	0	0	0	1	0	0	0	0	0	0	0	1	0	0	0	0	0	0	0	0	0	0	1	0	0	0	0	4	0	0	0	0	0	0	0	0	0	0	0	0	0	0	0	0	1	0	4	0	0	0	1	0	0	0	0	0	0	0	0	0	1	2	6	3	1	0	0	1	2	0	0	0	0	4	1	0	0	0	0	0	1	1	0	0	0	0	0	0	0	0	0	0	0	0	0	0	4	0	0	0	0	0	0	0	0	2	0	0	2	0	29	0	0	0	0	0	0	0	5	0	0	7	4	0	0	1	0	0	0	0	0	1	0	0	0	0	0	0	0	0	1	0	1	4	0	523	0	2	0	0	1	1	0	1	0	0	0	1	0	0	0	0	0	0	0	0	0	0	0	0	0	0	0	2	0	2	0	2	1	2	0	0	0	0	0	0	0	0	0	0	7	0	0	0	1	0	0	0	0	0	0	2	0	0	3	2	2	0	0	0	0	0	0	0	0	0	0	0	0	0	0	0	0	0	1	0	0	0	0	0	0	0	31	0	0	0	0	0	0	0	0	0	0	0	1	0	0	0	0	0	0	0	3	1	0	2	0	2	2	0	6	0	0	0	0	3	0	0	0	0	0	1	0	0	0	0	0	0	0	0	0	0	0	0	2	0	0	0	0	0	0	0	0	0	0	0	1	0	6	8	2	0	1	0	1	1	0	0	0	0	0	2	1	0	0	0	0	0	0	0	0	116	6	0	5	0	0	0	0	0	0	0	0	3	1	4	1	11	0	0	0	2	23	20	10	4	2	0	0	2	0	0	0	0	0	0	0	0	7	1	6	4	8	2	0	3	2	0	0	0	0	0	0	0	2	0	0	0	0	2	0	1	0	2	0	0	0	1	0	9	0	0	0	1	2	0	0	0	0	0	0	0	0	2	0	0	0	0	0	3	0	0	0	0	0	0	5	0	0	0	0	0	0	0	0	0	0	6	0	0	0	2	0	0	0	0	0	0	0	0	0	0	0	0	0	0	0	0	0	0	0	0	0	0	0	5	0	0	1	0	0	0	1	4	0	1	0	0	0	17	0	0	0	3	1	0	0	0	4	0	4	0	0	0	0	0	0	0	0	0	56	0	0	0	0	0	0	0	0	0	0	0	0	0	0	0	0	8	0	0	0	0	5	1	0	0	0	1	1	0	0	0	1	0	0	0	2	1	1	0	0	0	5	0	5	0	0	0	0	1	0	1	0	1	1	0	0	0	0	0	0	0	0	0	1	0	8	4	9	8	16	1	10	2	0	0	0	0	1	1	0	0	1	1	4	0	0	0	1	1	5	0	0	0	4	0	7	1	0	0	0	0	1	3	0	0	5	0	0	0	0	0	0	0	0	8	0	0	1	0	0	0	3	0	1	5	0	1	0	1	0	0	0	1	6	17	2	10	0	1	0	0	0	1	0	0	0	0	0	0	15	0	0	0	0	0	0	0	0	0	1	1	0	0	0	0	0	3	0	4	0	0	0	0	0	0	1	0	0	0	1	0	5	29	0	1	0	0	0	264	0	0	2	0	2	0	0	0	1	0	7	0	0	1	0	0	0	12	0	0	0	0	0	0	0	0	0	2	0	0	0	0	1	1	0	0	0	1	0	0	0	0	0	0	0	0	0	0	0	0	0	0	6	0	0	1	2	0	0	0	2	5	2	24	0	1	21	0	3	0	37	6	3	0	0	0	3	1	0	0	1	0	0	0	0	0	0	0	0	0	0	0	0	0	0	0	0	4	0	1	9	0	0	0	0	0	0	0	1	0	0	0	0	0	0	0	0	0	1	4	1	0	0	0	0	0	0	0	0	0	0	0	2	0	0	0	10	0	0	0	0	0	0	0	0	0	1	0	0	0	0	0	0	0	0	0	0	0	0	0	21	0	0	0	0	0	1	0	1	0	0	1	4	1	0	0	0	0	0	0	0	0	0	1	0	0	1	0	0	0	0	0	0	0	0	0	0	0	0	0	0	2	1	0	1	1	0	1	1	0	0	0	1	27	3	0	0	0	0	0	0	0	0	0	0	0	1	0	0	0	0	0	1	0	0	0	0	0	0	0	0	0	3	0	0	0	1	0	0	0	0	5	0	0	0	0	0	0	0	0	2	0	0	2	0	0	0	0	1	0	0	0	36	0	0	0	4	0	0	2	1	0	0	41	0	3	0	0	0	0	0	0	0	0	0	3	0	0	0	0	0	0	0	0	1	2	0	17	2	0	0	0	0	0	0	0	1	0	3	0	0	0	0	0	0	1	0	1	0	0	0	0	0	0	0	0	0	0	0	0	0	0	0	0	0	1	0	0	0	0	1	3	0	0	0	0	0	0	0	0	0	0	0	0	0	0	1	0	2	0	0	0	0	0	1	0	0	2	0	0	0	59	0	0	4	8	1	0	0	0	0	0	0	0	0	0	0	1	3	0	0	0	0	0	0	2	1	0	3	0	0	0	0	1	0	4	0	0	7	0	1	0	0	1	0	0	0	0	0	0	0	0	0	0	0	0	0	0	0	0	0	0	3	0	0	0	0	0	0	0	0	0	0	0	0	0	0	0	0	0	0	0	0	0	0	2	6	0	0	0	0	0	0	0	0	0	15	10	0	0	0	0	0	0	0	0	1	0	0	0	0	0	0	0	0	0	0	0	2	0	0	0	0	0	0	0	1	0	0	0	0	0	0	0	0	0	2	0	1	0	0	0	0	0	1	0	0	0	0	0	3	29	24	21	13	15	15	11	6	17	6	22	3	10	2	4	0	10	21	0	5	0	22	57	4	35	40	8	7	4	5	2	14	11	0	0	0	0	0	0	0	0	0	0	2	18	0	0	0	0	0	0	0	0	0	0	0	0	0	0	0	0	0	0	0	0	0	0	6	0	8	0	0	0	0	0	1	0	0	0	6	0	0	0	0	0	0	0	0	0	0	1	0	0	0	0	0	0	1	4	3	0	0	1	0	0	0	1	0	0	0	0	0	0	0	0	3	0	0	0	15	0	0	0	0	0	0	0	0	0	20	0	0	0	0	0	0	0	0	0	0	1	0	0	0	0	0	0	0	1	7	28	0	0	4	4	0	0	0	0	0	0	0	0	0	0	0	0	0	1	1	0	0	0	0	0	0	0	0	1	1	0	0	0	0	0	1	0	0	4	0	0	0	0	0	0	0	0	0	0	1	0	0	1	0	0	0	0	0	0	0	1	0	0	0	0	1	0	1	0	0	0	0	0	0	0	2	0	0	0	0	0	1	0	0	0	0	4	1	1	0	66	0	1	0	1	0	0	0	0	0	0	1	0	0	1	0	0	0	0	0	0	0	0	0	0	11	0	0	46	3	0	0	0	0	11	0	0	0	0	0	0	0	0	0	0	0	2	0	0	0	0	0	0	1	0	1	0	6	0	0	0	0	0	0	0	0	0	0	0	1	0	1	0	0	0	0	0	2	0	0	0	0	1	0	0	4	9	0	0	0	0	0	0	0	0	0	0	0	0	0	0	0	0	0	0	4	0	2	4	0	0	0	0	0	0	0	0	3	1	0	0	0	0	8	0	0	0	0	0	0	0	0	0	0	0	0	0	4	0	0	0	0	0	0	0	0	0	0	0	3	1	0	0	0	0	0	0	11	0	0	1	0	0	0	0	0	0	2	0	0	1	0	0	1	0	0	0	0	0	0	0	0	0	0	0	0	0	0	0	0	0	0	0	0	0	0	3	0	0	0	0	0	1	0	0	0	0	0	0	0	0	0	0	16	0	0	5	1	0	0	0	11	1	0	0	0	6	0	0	0	0	0	0	0	0	0	0	0	0	0	0	0	0	0	0	2	0	1	1	7	0	0	2	4	1	0	3	0	0	0	2	0	2	0	0	0	1	2	2	0	1	0	2	0	1	0	0	0	3	0	1	0	2	3	1	2	1	2	1	0	0	0	0	3	0	0	1	0	0	1	1	1	2	0	0	0	0	1	1	0	0	0	0	0	0	0	0	0	0	0	1	0	0	0	0	0	8	0	0	0	0	0	0	0	0	6	0	0	0	0	1	0	0	0	0	0	0	0	0	0	0	0	0	0	24	0	1	3	17	16	0	3	1	1	0	0	0	4	0	0	1	0	0	0	0	0	0	0	0	0	0	0	0	0	0	0	0	0	1	0	22	0	0	0	0	0	1	1	0	0	0	7	0	0	0	0	0	0	0	1	0	0	0	6	0	0	0	3	1	0	0	0	0	0	1	57	11	1	2	0	0	0	0	0	1	0	6	0	0	0	4	0	0	6	45	3	0	0	0	0	0	0	0	2	0	0	0	0	0	0	0	0	0	0	0	0	0	0	0	0	0	0	0	1	0	8	14	0	2	0	0	0	1	10	0	1	0	0	1	0	0	0	0	0	1	0	0	0	0	0	19	0	0	0	0	0	0	0	0	18	2	0	0	0	1	0	0	0	0	0	0	0	82	0	0	1	0	0	0	0	0	0	0	0	0	0	0	0	2	0	1	0	0	0	0	0	0	0	0	0	0	0	0	1	0	0	0	0	0	0	0	0	0	0	1	0	0	1	0	0	0	0	0	0	0	0	0	0	0	0	0	0	26	0	0	0	0	0	0	5	0	0	0	0	0	0	54	0	0	0	0	0	0	1	11	2	0	1	0	0	2	0	0	7	0	0	2	0	0	0	0	0	0	0	0	6	0	0	0	0	0	0	0	0	0	0	0	0	27	0	0	0	0	0	0	0	0	1	0	7	0	0	0	0	0	3	0	0	1	0	0	0	0	0	2	0	1	0	0	1	0	1	1	0	0	0	0	0	1	0	0	0	0	0	0	0	0	0	1	0	0	0	0	0	0	0	0	0	1	0	0	1	0	0	0	0	1	0	0	0	0	1	0	0	0	0	0	0	0	0	0	1	0	1	0	7	2	0	0	0	0	0	0	0	0	1	2	0	0	0	0	0	0	4	16	0	1	0	0	0	0	0	0	0	0	0	0	0	0	0	0	2	0	1	0	0	0	0	0	0	0	0	0	0	2	0	0	0	0	0	0	0	1	0	0	0	0	0	0	1	4	0	0	0	0	0	0	1783	0	0	0	0	1	0	3	4	0	0	0	1	0	12	0	1	0	0	0	9	0	0	0	5	6	0	0	0	0	0	0	1	0	0	0	0	0	0	23	0	0	0	0	0	0	0	17	0	0	0	2	0	0	0	0	0	0	0	0	0	0	0	0	0	0	0	0	0	0	0	0	4	0	0	0	0	0	0	0	0	0	1	0	7	2	0	0	1	0	0	1	0	1	0	0	0	0	0	0	0	0	0	0	0	0	0	0	0	0	0	0	1	0	1	0	0	0	0	0	0	0	0	0	0	0	0	0	0	0	0	0	2	0	0	0	21	0	0	1	0	0	1	0	0	0	0	0	0	0	0	0	0	0	0	0	0	0	41	0	0	0	0	0	0	2	0	0	0	0	0	0	0	0	3	0	0	1	0	0	0	0	0	0	0	0	0	0	0	0	0	0	0	1	0	0	0	0	0	0	0	0	0	0	0	0	0	0	0	0	0	0	0	15	0	0	0	0	0	0	0	0	28	0	0	0	0	0	0	0	0	0	0	1	0	0	8	0	1	0	0	0	0	0	0	0	9	2	0	0	0	1	0	0	0	0	0	0	0	0	0	0	0	0	0	0	0	0	0	2	0	0	1	0	0	0	0	0	0	0	0	0	0	0	0	0	29	0	1	0	0	0	0	0	0	0	0	0	0	0	0	0	0	0	0	0	0	0	0	0	0	0	0	0	1	0	0	0	0	0	0	0	0	0	0	0	0	0	0	0	0	0	0	0	0	0	0	1	0	0	0	0	0	0	0	0	0	0	0	0	0	0	0	0	0	0	8	0	0	1	0	4	0	0	0	0	0	0	11	0	0	1	0	0	1	0	1	0	1	0	0	0	0	5	3	0	0	0	0	0	0	0	0	0	3	1	1	1	0	0	0	0	0	0	0	0	0	0	0	0	0	0	0	0	0	0	0	0	0	0	1	0	0	0	0	0	0	0	0	0	0	0	3	0	0	0	0	0	0	1	0	2	1	0	0	0	0	0	0	0	0	0	4	0	0	0	0	1	0	0	0	0	0	0	0	0	0	1	0	0	0	0	0	0	0	0	0	2	0	0	0	0	0	0	0	0	0	0	0	0	0	0	13	0	0	0	0	0	0	0	0	0	0	0	1	0	5	0	0	0	0	0	19	0	0	7	0	9	0	0	0	0	0	0	0	0	0	0	11	0	0	3	2	0	0	0	1	0	8	0	0	0	0	0	0	2	0	0	0	0	0	0	0	0	0	0	0	0	0	0	0	0	0	0	0	0	0	0	0	0	0	0	2	9	0	0	0	0	0	0	0	1	0	0	0	0	0	0	0	0	0	1	0	0	0	0	0	0	0	0	0	0	0	0	0	0	0	0	0	0	0	0	0	0	0	1	0	0	2	0	0	0	0	1	0	0	2	0	23	3	0	0	0	0	1	0	9	0	25	2	0	0	0	0	0	0	0	1	1	2	0	0	0	0	0	0	0	0	0	0	2	2	0	0	10	0	0	0	0	1	0	0	0	0	0	2	1	0	0	0	0	0	0	0	0	0	0	0	0	0	0	0	0	0	0	0	15	0	1	1	0	1	1	1	0	0	0	0	3	0	0	0	0	0	0	0	0	0	5	0	1	0	0	0	0	0	1	0	1	0	0	1	0	0	0	4	1	0	17	19	0	0	0	0	17	0	10	2	0	0	0	0	0	13	0	2	0	0	5	0	20	0	2	0	0	0	0	0	2	0	2	2	0	1	0	1	2	4	2	0	0	0	0	5	0	0	0	0	1	0	0	1	0	0	0	0	0	0	1	0	0	0	0	1	0	0	1	0	0	0	0	0	1	0	0	0	0	0	0	0	0	3	0	2	0	2	0	0	0	1	2	3	0	0	0	0	0	0	0	0	0	0	5	4	0	0	0	0	0	0	0	2	0	0	0	0	0	0	0	2	2	0	0	0	0	0	0	0	0	0	0	1	0	0	3	0	0	0	0	1	2	0	0	1	0	0	0	0	0	0	0	0	0	1	0	0	0	0	0	0	0	1	0	1	0	1	0	0	0	0	1	0	0	0	1	0	0	0	0	1	0	0	0	29	13	30	0	1	6	5	36	3	2	1	6	10	19	42	6	0	14	4	8	8	8	0	18	8	7	2	1	0	10	0	0	0	0	1	0	0	0	0	0	1	0	0	0	0	0	0	0	0	4	0	0	3	0	0	4	0	0	0	0	0	0	0	1	1	0	0	0	0	0	3	0	0	0	0	0	0	0	9	1	0	0	0	2	0	0	0	0	1	0	1	0	0	0	0	0	0	0	4	0	1	0	18	0	1	0	0	0	0	0	0	0	0	0	0	0	0	1	0	0	0	1	0	0	0	0	0	0	2	0	0	0	0	0	0	0	0	0	0	0	0	0	80	0	0	1	0	0	0	6	0	0	2	0	0	1	0	0	0	0	1	0	0	0	1	0	0	0	0	3	4	0	0	0	0	0	0	1	0	0	0	0	2	0	0	0	0	1	0	0	2	0	3	0	0	0	0	0	0	0	0	0	0	0	0	0	0	0	0	0	0	0	0	0	0	0	0	0	0	0	1	0	0	0	0	0	0	0	0	3	0	0	0	0	0	2	1	0	0	2	0	0	1	3	0	0	0	18	0	4	0	0	0	0	2	0	0	0	0	0	0	0	0	0	1	0	0	0	2	0	0	0	0	0	0	0	2	0	0	0	0	1	0	0	0	0	0	2	1	0	0	0	0	1	0	1	0	0	0	0	0	0	1	0	0	1	14	0	2	0	0	0	0	0	0	2	2	0	0	0	0	0	0	3	0	0	0	0	0	0	0	0	0	0	0	0	0	0	0	0	0	0	0	0	0	0	0	0	0	0	1	0	0	0	0	1	0	0	0	0	0	0	0	0	0	0	0	0	0	0	0	0	0	0	0	1	0	0	1	13	0	0	0	0	0	0	0	0	0	1	0	0	0	1	0	0	0	0	0	0	0	1	0	0	0	0	6	0	0	0	0	0	0	0	0	0	0	0	0	0	1	0	0	0	0	0	1	0	0	0	0	0	0	0	0	0	0	0	14	6	1	0	0	0	0	0	0	0	0	0	0	0	0	7	0	0	0	0	0	0	0	0	0	0	0	2	0	1	0	0	0	0	0	0	0	0	2	0	0	0	0	0	0	0	0	0	0	0	2	2	0	1	0	0	0	0	0	0	0	4	0	1	0	0	0	0	1	0	0	0	0	0	0	0	0	1	0	0	1	0	0	0	0	0	0	0	5	94	0	0	2	0	0	0	68	2	1	0	1	0	0	0	0	0	0	0	0	0	1	0	15	0	0	0	5	0	0	3	0	0	0	0	0	2	0	0	0	0	0	2	1	0	0	0	0	0	1	0	0	0	0	0	0	0	0	0	0	0	7	0	0	0	0	0	0	0	45	0	0	0	4	0	0	0	0	0	0	0	0	0	0	1	0	0	0	0	0	0	0	1	0	0	3	12	0	0	0	1	0	0	3	0	0	0	0	0	0	0	1	0	0	0	0	1	1	0	4	0	0	0	0	27	0	0	0	7	0	1	1	0	1	0	0	1	3	0	3	16	0	0	0	0	2	8	0	0	5	0	0	0	5	0	0	0	0	0	0	0	31	1	0	0	0	0	0	0	5	0	0	0	0	0	0	0	0	0	2	0	0	0	0	0	0	0	0	0	0	0	1	0	0	1	0	0	0	0	0	0	0	0	0	0	0	0	0	0	0	0	0	0	0	45	0	0	0	0	0	0	0	0	0	0	0	2	0	0	0	0	0	0	0	1	0	1	1	0	0	0	1	0	0	0	0	0	4	0	0	0	0	0	1	0	7	0	0	0	0	0	1	0	0	0	0	0	0	0	0	0	1	0	0	0	0	0	0	0	1	0	0	1	0	1	0	0	0	0	0	0	0	0	0	0	0	2	0	0	0	0	0	0	0	1	0	0	1	0	0	0	0	0	0	0	0	0	0	0	0	0	0	0	0	0	2	0	0	0	0	0	0	0	0	0	0	0	0	0	0	0	0	0	0	0	0	0	0	1	0	0	0	2	0	0	0	0	0	6	0	0	2	1	0	0	0	0	0	0	0	0	0	0	1	0	0	0	0	0	0	0	0	0	0	0	0	0	0	0	0	0	0	0	0	0	0	0	0	89	1	0	0	0	0	0	1	0	3	1	0	0	0	0	2	3	2	0	1	0	0	0	0	0	0	0	0	0	0	0	1	0	0	0	0	0	0	16	2	0	0	0	0	0	0	0	1	1	0	0	0	0	335	1	3	3	0	2	2	0	4	0	0	0	3	1	0	2	5	0	0	0	1	0	0	0	11	0	0	3	215	80	0	0	0	17	1	0	0	0	0	0	0	0	0	0	5	0	0	0	0	0	0	0	4	0	0	1	0	0	0	0	0	1	0	79	0	0	0	1	0	5	0	0	2	0	0	0	0	1	0	0	0	0	0	0	0	2	0	0	0	0	0	0	0	0	0	0	0	0	1	2	0	0	0	1	33	1	0	0	0	0	0	0	0	0	0	0	0	0	0	0	0	0	0	0	0	0	0	0	7	0	0	2	0	0	0	0	0	0	0	0	0	0	0	0	1	0	0	0	0	0	0	0	0	0	0	0	0	0	0	0	0	0	1	1	1	0	0	0	0	0	0	0	0	0	0	0	0	0	0	0	0	0	5	0	1	0	2	1	0	0	0	0	0	0	0	0	0	0	3	105	0	0	0	0	0	18	0	4	0	2	2	3	0	0	0	0	0	0	2	2	0	0	0	0	0	0	0	0	0	0	0	0	0	0	0	0	0	0	0	2	0	0	3	0	0	0	0	0	0	0	1	1	0	0	4	4	0	0	0	0	0	1	0	0	0	2	0	0	1	2	2	0	0	0	0	0	6	0	1	0	9	0	0	0	7	0	1	0	1	0	0	3	0	2	2	0	2	0	0	0	0	2	0	0	1	1	0	1	4	0	1	1	0	0	0	0	1	0	1	0	0	1	5	0	0	0	0	0	0	0	0	0	0	0	0	0	0	0	0	0	0	0	2	0	2	1	0	3	1	0	0	0	8	0	2	1	0	12	2	0	0	1	1	4	1	5	0	0	0	0	0	0	0	0	0	0	0	0	0	0	0	0	0	0	1	1	1	0	0	28	12	6	0	36	0	0	0	0	0	0	0	0	0	0	0	0	0	0	0	0	1	0	0	1	2	0	0	0	1	1	0	0	0	0	1	0	2	0	0	0	0	0	0	0	0	0	0	0	0	0	0	1	0	2	0	6	7	0	1	1	0	4	0	0	0	3	2	1	0	0	0	0	0	0	4	0	0	0	9	17	6	2	0	0	6	0	0	1	0	0	7	0	3	0	1	0	0	0	0	3	3	3	0	0	7	1	0	0	0	1	0	2	0	0	4	0	0	0	0	0	0	2	6	5	1	1	0	4	0	0	0	0	0	0	0	0	0	0	0	0	3	3	1	0	0	0	4	0	0	0	0	0	0	0	4	0	1	0	1	0	0	0	6	0	3	0	3	1	10	5	0	0	29	5	0	0	0	0	0	1	1	1	1	0	0	0	0	0	0	0	0	0	1	0	0	0	0	1	2	2	47	82	1	0	0	0	0	0	2	2	0	0	1	0	0	0	0	0	0	0	0	0	0	0	0	0	0	0	0	0	0	1	0	0	0	0	0	0	0	0	1	0	0	6	0	0	0	0	1	3	4	0	0	0	1	0	0	1	10	0	0	0	0	1	0	0	0	0	0	0	0	0	12	0	1	2	0	0	0	0	9	0	0	0	0	0	0	0	0	0	0	0	0	0	0	0	10	1	1	1	76	2	0	0	0	0	0	2	0	456	0	0	0	0	17	6	0	0	0	0	0	0	0	0	0	1	0	2	0	0	0	0	0	0	19	2	1	0	1	9	0	0	1	0	0	0	0	0	0	1	6	1	0	0	0	0	0	0	0	0	0	0	0	1	0	0	0	0	1	0	0	0	0	0	0	0	7	1	0	2	1	0	0	0	0	0	0	0	4	0	0	0	0	0	0	0	0	7	0	0	0	0	0	0	0	0	0	1	0	99	0	0	2	7	0	0	0	0	0	0	6	1	0	1	0	0	0	0	0	0	0	0	0	0	0	1	10	0	0	0	1	0	1	0	0	0	0	0	0	0	68	1	0	0	0	52	0	0	0	1	2	0	20	13	6	0	1	2	2	0	0	2	1	1	1	1	0	0	0	47	0	0	0	0	0	3	0	0	0	11	8	0	0	0	0	12	0	2	0	0	0	0	4	4	4	3	2	3	0	1	0	0	0	3	0	2	1	1	0	0	0	0	0	0	0	0	0	2	0	0	0	0	1	0	0	2	0	0	0	0	0	0	0	0	0	0	0	0	1	3	0	0	0	0	0	11	0	0	0	0	0	7	2	0	0	0	0	0	1	3	12	1	0	0	5	29	0	6	1	0	1	0	2	0	0	3	0	0	0	0	0	17	1	0	2	2	7	0	0	0	2	0	1	0	23	0	0	0	0	1	0	0	0	0	0	0	0	0	0	0	0	1	0	0	1	0	0	0	1	0	0	0	0	0	0	0	0	5	0	0	9	1	1	0	0	1	5	0	0	0	0	2	0	0	0	7	0	0	8	14	0	0	0	0	1	15	0	0	1	0	0	1	14	0	2	6	6	2	1	0	0	0	1	0	0	0	0	0	0	5	0	0	0	0	0	1	29	3	0	0	2	0	0	0	0	0	0	0	0	0	1	0	0	0	0	0	0	0	0	0	0	0	0	0	1	0	0	0	0	0	0	0	0	0	12	0	0	0	1	0	0	0	0	0	0	0	0	0	1	1	0	0	0	0	0	0	0	0	0	0	0	2	0	0	0	0	0	0	0	0	0	0	0	15	0	0	0	0	0	0	1	0	3	0	0	0	0	0	1	0	1	0	6	0	0	0	1	0	1	0	0	0	0	0	3	5	2	1	0	0	0	1	0	1	0	2	0	1	1	1	16	5	2	5	1	0	1	1	0	1	0	0	1	4	0	2	0	2	1	2	2	0	3	0	10	2	0	2	2	0	1	2	5	0	0	0	0	15	4	0	0	0	1	0	0	0	17	7	13	19	0	3	2	0	0	0	0	0	1	0	119	0	2	0	105	43	9	0	0	64	0	0	0	0	0	5	1	2	3	3	0	12	0	1	137	0	1	1	3	1	0	0	0	0	0	24	1	0	1	1	7	0	0	0	2	3	0	0	0	0	1	0	0	0	3	1	1	0	0	0	0	0	4	0	0	0	0	0	1	0	1	0	0	0	0	0	0	0	1	0	0	0	0	0	0	0	0	0	0	0	0	0	0	0	0	0	0	4	0	1	0	1	0	1	0	1	8	0	0	11	0	0	0	0	0	0	0	0	0	0	0	0	0	0	0	0	1	0	1	0	0	0	1	0	0	0	0	0	0	0	0	0	0	0	0	0	0	0	0	0	0	0	0	0	0	0	3	0	3	1	0	1	2	1	0	0	0	0	0	0	0	0	0	0	0	0	0	2	0	2	0	0	0	0	1	0	0	0	0	1	0	0	0	4	0	0	0	0	3	1	0	0	0	4	0	0	4	1	4	18	0	0	0	1	0	0	5	1	6	0	0	0	1	0	0	0	0	0	1	1	64	0	0	6	3	0	0	8	6	1	0	3	9	0	6	2	2	1	0	0	1	0	0	0	0	0	1	0	0	0	1	0	1	0	0	4	1	0	0	0	0	0	7	7	2	0	4	0	0	0	0	0	0	0	0	0	2	3	0	0	2	2	0	0	0	0	1	0	0	0	0	1	0	0	0	0	0	0	0	0	0	0	0	1	2	0	0	0	0	0	0	0	0	0	0	1	0	1	0	0	5	0	0	0	0	0	1	0	2	49	0	1	6	1	2	0	0	0	0	0	0	2	0	0	0	0	0	0	1	1	0	0	0	0	0	0	1	0	0	0	4	11	0	0	0	0	1	0	6	0	3	0	0	0	0	0	0	1	3	0	4	0	3	0	0	2	0	0	0	0	1	3	0	0	1	1	0	0	0	2	0	2	1	0	26	0	0	5	0	0	0	0	0	0	0	0	0	5	1	0	1	0	0	0	0	14	0	2	0	0	0	0	0	0	0	0	0	0	0	0	0	1	0	0	2	0	0	0	0	0	0	0	0	0	0	1	0	0	0	0	0	0	4	1	0	0	0	0	15	4	0	0	0	0	0	0	3396	0	0	0	0	0	1	0	2	0	0	0	0	0	0	0	0	0	0	0	0	0	3	1	9	2	0	0	2	0	0	0	0	0	0	0	2	0	0	4	0	4	1	0	0	0	0	1	0	0	1	0	0	2	0	1	1	1	6	5	2	0	2	0	3	0	0	1	0	0	9	4	9	8	0	0	0	1	1	3	0	7	2	2	0	2	0	0	0	0	0	0	1	1	0	6	1	0	15	0	0	0	6	2	0	0	7	0	0	0	0	1	0	1	0	0	0	0	0	3	9	4	8	10	0	3	5	1	3	3	14	12	26	3	3	1	1	12	9	0	0	3	1	0	0	0	0	0	6	6	7	50	6	0	0	0	0	8	0	0	1	1	0	0	0	0	0	1	0	0	0	0	0	0	1	0	0	0	1	0	0	0	0	0	0	0	0	1	0	1	0	0	0	0	0	0	8	0	1	1	0	1	0	0	0	0	1	0	0	0	0	0	0	2	0	0	0	0	2	0	0	0	0	1	0	0	0	0	0	13	0	0	0	1	0	10	0	0	0	0	0	0	0	0	1	1	1	1	0	0	1	2	6	0	5	1	0	0	0	0	0	2	0	0	1	0	0	0	0	0	1	0	0	0	0	0	0	0	0	0	0	0	1	0	2	0	0	0	0	1	1	0	0	0	0	3	0	3	0	0	0	0	1	0	0	0	0	0	0	0	0	0	3	2	0	0	5	0	0	0	0	0	1	0	0	0	1	0	0	0	6	0	0	0	7	1	0	1	1	0	0	0	0	2	0	0	0	0	5	0	6	0	0	0	0	0	0	0	0	0	0	0	140	0	1	2	1	0	0	0	0	2	20	1	0	0	0	0	0	0	1	0	4	1	0	1	0	1	2	1	4	0	1	0	1	1	1	0	0	2	0	0	0	0	2	0	0	0	0	0	0	0	0	0	0	0	4	2	0	0	0	0	1	0	0	0	0	0	0	0	0	0	0	0	0	0	0	0	0	0	0	0	0	1	11	0	0	1	1	1	1	0	0	0	0	0	0	0	5	23	2	0	1	3	2	4	8	1	1	1	4	6	0	0	4	0	0	0	0	0	1	0	0	1	1	0	1	0	0	0	0	0	0	0	0	1	0	1	1	1	0	0	0	0	0	0	0	0	0	1	0	0	0	25	0	1	0	0	0	0	0	0	0	0	0	0	0	0	0	9	0	1	0	0	0	0	12	0	0	0	0	2	1	2	0	0	1	2	0	4	0	0	0	0	2	1	0	0	0	0	0	6	0	0	0	0	0	0	0	0	2	0	2	0	0	5	0	1	0	0	0	0	0	0	0	0	0	0	0	0	0	0	0	0	2	4	0	0	0	0	0	0	0	0	0	0	0	0	0	0	0	0	9	0	0	0	2	0	1	2	0	0	0	0	0	5	12	0	0	13	28	1	5	3	2	5	28	9	1	22	0	0	2	0	2	0	0	5	0	0	0	0	0	0	0	49	0	0	0	0	27	0	1	0	0	0	3	2	4	1	0	0	0	1	0	0	2	0	0	0	0	0	0	0	0	0	0	24	5	0	1	0	0	0	0	0	0	2	0	0	0	0	0	0	1	2	0	0	0	0	3	0	0	0	2	0	0	1	0	0	0	0	0	0	0	4	1	2	0	0	0	0	0	0	1	0	1	0	0	1	0	0	0	0	6	2	1	11	0	0	0	0	0	0	0	6	0	2	0	0	0	0	7	0	4	0	3	0	0	0	0	1	0	24	0	6	4	0	4	0	0	0	7	0	0	0	0	0	1	0	0	0	1	0	0	0	0	0	0	0	0	0	0	0	1	0	0	0	0	0	0	0	0	0	0	0	0	0	4	0	2	0	0	3	0	0	0	0	0	0	0	0	0	1	0	2	3	0	0	3	5	1	9	65	0	0	0	0	0	0	0	0	0	16	0	0	1	1	18	3	0	0	1	0	2	0	2	0	1	4	2	0	0	1	0	0	0	0	6	19	1	0	0	0	0	0	0	0	0	0	0	14	1	1	1	0	0	0	0	0	0	0	0	1	0	0	0	0	0	0	0	0	0	0	0	0	0	0	0	0	0	1	3	0	0	0	0	0	0	0	0	0	0	0	0	0	0	0	0	1	0	2	0	0	1	0	0	0	0	0	0	0	0	0	0	0	0	4	2	2	0	0	1	0	2	0	1	0	1	0	0	0	0	0	0	0	0	0	0	0	0	0	0	5	1	0	0	2	0	0	3	1	0	2	0	0	0	0	0	0	1	0	5	1	3	0	0	0	0	3	0	1	0	0	0	0	0	0	0	8	4	0	2	2	4	0	0	0	0	0	0	0	0	0	1	0	0	0	0	0	0	5	0	0	0	0	0	2	0	0	2	5	3	3	3	0	1	0	2	0	0	3	0	0	5	1	3	0	0	0	0	0	0	0	1	1	4	0	42	1	0	0	0	0	0	0	0	0	0	0	0	0	0	0	0	0	0	1	0	0	1	2	2	46	2	0	0	0	0	0	0	0	4	0	3	0	0	1	0	0	0	0	0	0	0	0	0	0	0	0	33	4	1	0	2	5	0	0	1	0	0	0	0	0	17	0	0	67	0	0	0	0	0	1	0	0	0	0	0	0	0	0	0	0	0	1	0	0	0	0	0	3	0	0	0	0	0	1	1	1	0	2	1	0	0	0	0	0	0	0	0	0	1	6	1	8	0	0	2	1	2	1	4	2	0	3	0	1	0	0	0	0	0	0	0	0	0	0	0	1	0	0	1	0	42	0	0	0	0	0	0	1	0	0	0	0	0	0	0	0	0	0	0	0	0	0	3	0	0	0	0	0	0	0	0	0	0	0	0	0	0	1	0	0	4	1	1	2	0	0	0	0	0	0	0	2	1	0	9	0	1	3	1	0	4	121	0	0	0	0	4	0	0	0	0	0	0	0	0	0	0	0	0	0	0	4	1	0	0	0	0	0	0	0	0	0	0	0	0	0	0	0	24	0	0	0	0	0	2	0	0	0	3	0	1	0	0	0	0	0	0	1	0	0	0	0	0	0	0	0	0	0	0	0	1	0	0	3	0	0	0	0	0	0	3	0	0	0	0	0	1	0	0	0	0	0	0	1	0	0	1	0	0	0	0	0	1	0	0	0	0	0	0	0	0	0	0	0	0	0	0	0	0	0	0	0	0	130	0	0	0	0	0	0	0	0	0	0	0	0	0	0	0	0	0	0	0	0	0	0	0	0	0	6	1	0	0	0	0	0	0	0	0	0	0	0	4	0	0	0	0	0	0	0	0	0	0	0	0	0	0	0	0	0	0	0	0	0	0	0	0	0	0	0	0	0	0	0	0	0	0	0	0	0	1	0	2	0	0	0	0	0	0	1	0	0	0	0	0	0	2	0	0	3	0	0	0	0	1	1	0	0	1	18	0	1	0	0	8	0	7	0	0	0	0	0	0	0	0	0	0	0	0	0	0	0	0	0	0	0	0	0	0	0	0	0	0	0	0	0	2	0	1	0	0	0	0	1	0	0	0	0	0	5	0	0	1	0	0	0	0	0	0	1	1	1	0	0	0	0	1	0	1	0	0	0	2	0	0	0	0	0	97	0	1	0	0	0	0	0	3	0	0	33	0	2	0	0	1	0	8	0	0	1	0	0	0	0	0	0	0	1	4	0	0	0	0	2	0	1	1	2	3	3	0	9	7	0	1	0	0	0	8	0	0	0	0	0	2	0	0	0	0	3	0	4	0	0	0	1	0	0	0	22	0	0	1	0	1	0	1	0	0	5	0	13	1	0	0	0	17	0	0	0	0	0	0	0	0	0	0	0	1	1	1	0	1	7	1	0	0	0	0	0	0	0	2	0	0	0	0	0	0	0	0	1	0	0	0	0	0	0	0	0	0	1	0	0	0	1	1	0	4	3	0	0	0	0	0	0	0	0	0	0	0	0	0	0	0	1	5	4	0	0	0	0	1	0	0	0	0	0	1	0	0	0	0	0	0	0	8	0	0	0	0	0	0	0	0	0	0	3	0	1	0	0	0	0	0	0	0	0	0	0	0	0	0	0	1	0	0	0	0	0	9	4	0	2	2	0	1	0	0	0	27	1	0	40	0	0	0	6	0	0	0	0	1	3	4	0	0	0	1	0	0	0	0	0	1	1	2	24	0	19	9	1	0	0	0	0	0	0	0	0	1	0	0	0	2	0	0	0	4	0	0	0	0	0	0	0	0	0	0	0	0	0	0	9	2	2	0	2	3	1	3	4	6	0	2	3	0	3	0	0	2	1	0	0	0	0	0	0	7	0	0	0	0	0	2	0	0	0	0	1	0	0	1	0	0	1	0	0	3	1	1	9	0	4	0	0	0	0	0	0	0	1	1	0	0	0	13	0	0	2	0	0	0	20	0	0	0	2	0	0	2	0	3	0	21	20	1	6	4	0	0	1	0	18	0	12	1	0	0	0	0	0	0	0	0	0	0	0	0	0	0	0	0	3	1	0	0	1	0	0	0	0	5	0	0	0	0	2	2	1	3	0	0	0	0	1	2	2	6	1	0	0	0	0	1	1	0	0	1	0	0	0	4	3	3	0	1	0	0	0	0	0	0	0	0	1	0	1	1	3	1	0	0	2	0	4	0	0	0	0	3	0	1	5	1	0	0	1	3	7	4	0	0	0	1	0	0	0	4	0	0	6	0	0	0	0	0	0	0	3	0	0	0	0	0	0	0	0	0	0	0	0	0	0	0	0	0	2	0	0	5	0	1	0	0	0	0	0	2	2	0	0	3	0	0	0	1	0	0	3	1	0	2	0	0	0	3	3	0	0	0	0	0	2	0	0	0	0	0	0	0	0	0	1	0	2	0	6	0	0	0	0	0	0	0	0	2	0	0	0	0	0	0	7	0	2	0	0	2	1	0	0	0	0	0	3	0	0	0	0	0	0	1	0	0	1	1	2	0	0	0	2	2	3	0	0	0	0	8	0	0	0	0	0	1	0	1	0	7	6	0	10	9	4	17	18	0	1	8	11	1	18	10	9	13	1	2	1	0	0	0	1	0	1	0	0	0	0	0	0	0	0	0	0	0	0	0	1	1	0	0	0	0	0	0	0	0	8	0	0	0	0	0	0	0	0	0	0	0	0	0	0	0	0	0	0	0	0	0	0	0	0	0	0	0	0	0	0	0	0	0	0	0	0	0	0	0	0	0	0	0	0	0	0	0	0	0	0	0	1	0	1	0	1	6	0	0	0	2	0	0	0	5	1	1	0	0	1	3	0	0	0	0	0	0	0	0	1	0	0	0	0	8	3	0	0	0	3	0	0	0	1	3	1	0	0	0	0	2	0	0	0	0	0	0	28	0	0	1	0	0	2	0	9	2	0	0	7	5	1	0	3	1	0	0	0	0	0	0	0	55	4	0	0	0	0	0	0	0	0	0	2	0	0	10	5	0	1	0	4	0	0	0	0	1	1	0	0	16	6	2	0	0	0	16	0	0	0	0	0	0	1	0	0	2	0	0	0	1	0	0	0	1	0	0	0	0	0	0	1	0	1	0	0	0	1	1	3	1	1	5	0	0	0	0	2	0	0	0	1	3	0	2	0	0	0	1	32	0	1	0	0	0	0	1	0	0	2	0	0	0	2	1	0	0	0	0	0	0	0	0	0	0	0	0	0	0	0	0	0	1	0	0	0	0	0	0	1	0	0	0	0	0	0	1	0	0	0	1	0	0	0	0	0	0	7	0	0	0	0	3	0	0	7	1	6	2	0	0	0	30	10	0	2	8	0	0	0	22	2	0	0	0	4	0	0	1	0	3	0	1	0	0	0	15	2	0	0	0	0	1	0	0	0	0	0	0	0	5	0	0	0	0	1	0	0	0	0	0	1	0	11	0	5	1	2	0	3	0	0	0	0	0	0	0	0	0	0	0	49	0	1	0	2	1	10	1	4	1	37	2	0	0	0	1	2	0	8	1	4	4	0	11	1	9	2	1	0	0	0	0	0	0	4	84	80	0	0	2	0	0	0	0	0	0	0	0	2	0	0	0	4	7	0	0	0	18	6	2	3	0	4	2	5	8	0	0	5	0	0	3	0	0	2	0	0	0	0	0	1	0	0	0	0	0	0	0	0	0	0	0	0	0	0	0	0	5	0	0	0	0	4	2	19	0	0	0	0	0	0	0	0	0	3	3	0	0	4	0	1	0	0	0	2	3	1	0	0	0	0	0	1	0	0	17	7	1	1	0	0	13	0	9	3	0	0	0	0	0	0	0	0	0	0	0	0	1	0	0	0	0	0	0	0	1	0	0	0	0	0	1	0	0	1	0	0	0	0	0	0	2	0	0	1	1	0	0	3	1	0	2	0	1	0	0	0	0	0	1	0	0	0	0	0	0	0	0	0	0	0	0	0	0	0	0	0	0	0	1	0	1	0	0	3	0	3	0	4	0	0	3	1	1	0	2	0	0	0	0	2	0	0	0	0	1	0	2	2	2	2	0	21	0	3	0	0	0	3	0	0	1	0	1	4	0	0	0	1	0	0	2	46	3	3	2	0	1	0	2	0	0	0	0	0	0	3	0	0	0	0	0	0	0	0	0	0	5	1	0	4	0	0	0	0	0	0	0	0	0	0	0	0	0	0	0	0	0	0	0	0	0	0	0	0	0	0	0	0	0	3	0	0	0	0	1	0	0	3	0	6	4	1	6	0	0	0	0	0	0	2	0	0	35	1	0	4	0	0	0	0	3	1	2	0	3	0	5	0	0	0	0	1	0	1	1	0	0	0	0	0	2	0	1	4	0	1	4	0	1	0	0	0	0	0	0	1	4	0	1	0	1	0	1	0	1	0	0	0	1	0	0	0	3	1	0	0	0	0	0	0	0	0	0	0	2	0	1	0	0	0	0	0	0	0	0	0	0	0	0	0	0	0	0	0	0	0	3	4	0	0	0	0	0	0	0	0	0	0	0	5	1	0
LakWasMet69_HOW9_2_rpkm	0	0	0	0	0	0	0	1	0	0	0	4	3	3	0	0	0	8	1	0	0	0	1	8	0	0	0	0	1	3	0	0	0	6	1	6	0	1	0	0	0	0	0	5	10	5	9	10	0	5	1	3	0	0	0	0	0	0	9	40	0	9	0	0	0	0	0	0	0	2	0	0	0	0	0	0	2	0	0	0	0	17	2	0	0	0	0	0	0	0	0	0	0	0	8	1	0	0	0	2	0	0	0	0	0	3	0	0	0	0	3	0	2	0	10	0	0	3	0	0	0	0	1	1	0	0	12	1	0	0	2	59	14	0	0	0	0	0	0	0	0	0	0	4	4	0	0	0	11	0	2	6	0	1	43	0	1	0	20	0	4	1	1	7	1	0	0	6	0	17	0	0	0	0	0	0	0	0	0	0	0	0	0	0	0	41	0	0	0	0	4	5	0	4	0	1	3	12	3	60	0	0	0	0	0	0	5	0	1	0	2	0	5	6	6	0	6	0	0	8	3	0	0	7	0	0	2	0	28	0	1	6	2	0	0	0	2	0	3	0	0	0	11	1	8	1	1	1	0	0	0	1	20	0	120	23	0	0	0	0	4	2	1	10	0	0	144	2	1	36	57	0	45	0	0	1	0	0	1	0	0	4	1	4	1	0	0	0	6	0	0	0	0	0	0	0	0	5	15	0	0	18	7	0	2	0	6	8	10	0	0	0	21	6	0	0	1	0	121	0	0	0	0	0	6	3	1	0	0	0	0	0	0	0	0	0	0	9	0	0	0	2	12	2	6	0	1	1	13	0	0	0	0	0	0	0	0	0	0	79	0	0	1	0	0	2	1	40	1	0	0	26	0	8	27	0	0	2	0	1	0	2	5	1	3	0	5	0	0	0	0	0	52	0	0	10	3	0	0	3	1	6	0	2	3	0	0	0	1	0	0	3	1	34	0	6	0	4	1	7	0	0	3	0	0	0	0	0	0	0	0	0	0	0	0	11	0	0	2	0	10	2	0	0	0	41	0	1	0	0	0	27	0	433	0	2	21	1	0	0	0	0	0	0	1	4	5	0	0	0	4	18	3	0	0	0	6	2	2	0	11	2	22	758	0	2	0	23	15	0	0	0	29	23	0	0	6	0	0	0	0	0	11	0	0	4	0	1	0	0	0	0	0	0	0	0	0	0	0	16	0	0	0	0	0	0	0	0	0	0	1	0	44	6	0	0	2	2	0	7	0	1	1	15	4	0	0	1	0	3	2	0	1	1	0	3	0	2	0	0	0	2	0	0	6	0	0	0	3	0	0	1	0	0	4	2	0	37	8	2	2	64	12	0	11	0	0	8	80	0	0	0	1332	0	91	2	1	0	6	0	8	0	0	1	2	2	0	11	0	36	1	83	53	77	1	0	16	0	92	1	1	1	1	8	0	6	0	2	0	0	0	0	0	0	3	0	0	0	4	7	2	37	1	0	0	8	2	2	3	3	0	0	4	8	1	0	2	0	0	0	0	5	0	0	0	0	1	0	1	0	0	15	9	0	0	0	0	4	1	0	2	0	7	2	0	0	2	0	0	9	0	0	1	0	0	0	0	0	0	1	0	10	0	18	2	2	5	0	0	0	0	6	0	0	8	8	0	0	23	12	0	0	3	9	3	1	0	0	6	2	0	0	1	0	0	0	0	1	0	1	0	2	8	1	3	10	1	0	0	5	0	0	10	0	0	0	2	0	5	5	0	1	0	7	0	0	0	0	0	0	0	0	0	0	2	33	0	0	0	0	0	0	5	2	0	0	0	0	0	0	0	4	1	0	0	1	0	1	0	0	0	0	0	0	4	2	39	0	0	0	2	0	0	0	0	0	0	0	0	0	0	0	0	0	15	0	0	0	34	13	1	0	0	1	0	0	1	13	17	0	0	0	0	0	0	0	1	0	7	26	0	0	0	0	0	0	0	1	0	0	9	0	0	18	0	0	0	0	5	0	0	0	0	0	0	0	0	4	4	0	0	0	0	0	1	0	3	0	0	1	0	0	0	0	0	0	2	0	0	0	0	34	3	24	0	0	1	1	0	0	0	0	0	1	1	7	2	8	2	0	0	3	0	0	0	0	0	0	0	0	0	0	0	0	0	0	0	0	0	0	0	0	0	6	2	0	0	0	0	0	0	0	0	0	2	0	0	0	0	0	0	0	0	0	0	0	0	0	1	3	1	0	4	31	0	11	0	1	0	0	3	15	0	0	84	0	0	0	0	0	0	2	0	0	0	0	0	0	0	0	0	0	1	0	0	0	0	0	0	3	0	0	0	0	0	0	0	18	0	0	0	14	1	0	0	2	0	0	17	0	10	0	0	0	0	0	2	0	3	0	0	0	0	0	0	0	0	0	0	0	0	0	0	0	1	0	0	0	0	0	0	0	0	2308	0	0	0	0	0	0	0	0	0	1	1	0	0	0	9	3	0	0	0	0	0	0	0	0	0	15	0	0	2	0	0	0	0	1	0	0	0	0	0	0	0	6	21	0	0	90	0	46	0	0	0	0	0	40	0	0	29	2	0	0	0	0	0	2	16	0	0	0	0	1	0	1	0	0	0	0	0	0	0	0	0	0	0	0	0	0	0	2	0	0	0	0	0	0	0	0	0	0	0	0	0	0	0	0	0	0	4	0	0	0	94	4	0	0	0	0	0	1	0	0	0	0	0	6	1	0	0	0	8	2	5	9	0	0	0	31	4	0	0	0	0	2	4	0	0	0	0	0	0	0	0	0	2	0	0	0	0	0	0	0	1	0	0	0	2	0	0	0	0	0	0	0	0	0	1	0	10	0	17	1	1	2	39	0	3	0	3	0	0	0	11	0	0	2	0	0	4	0	0	15	0	9	0	0	0	0	1	0	6	21	0	64	25	1	1	4	0	2	0	0	0	25	11	4	18	0	0	0	0	1	0	3	0	0	1	1	2	0	0	0	0	0	0	3	0	0	3	0	0	0	1	0	3	0	0	1	0	0	3	0	0	1	1	0	3	0	0	0	0	3	11	0	11	11	6	1	0	0	4	9	0	0	5	0	0	1	0	0	2	0	0	0	11	1	0	1	0	0	0	0	14	0	0	4	6	3	0	4	6	12	2	0	4	1	0	0	0	0	37	0	0	0	5	9	9	13	1	1	66	0	0	4	1	1	0	0	0	2	0	2	4	0	7	0	0	13	10	2	11	2	2	0	14	0	0	0	0	0	0	2	0	0	0	6	0	0	0	10	8	0	13	0	0	5	0	0	0	1	0	17	0	0	0	0	0	0	0	0	2	0	8	43	89	0	2	2	0	0	0	0	0	26	11	0	0	12	0	0	0	1	115	158	0	9	0	3	7	17	1	0	2	0	3	0	0	0	20	2	8	4	42	2	0	0	0	6	0	0	0	0	0	0	1	5	0	0	0	2	0	16	0	0	1	0	1	8	0	1	0	0	0	0	2	0	0	0	1	0	0	2	1	7	0	0	0	0	0	0	0	0	0	0	0	0	0	31	0	0	4	0	0	0	0	0	0	4	0	1	0	2	0	0	0	0	0	0	0	0	0	0	0	0	0	0	0	0	0	0	1	0	0	0	0	0	0	0	2	0	0	0	0	3	2	6	56	0	1	4	0	5	1	0	1	0	0	0	2	0	10	0	0	0	0	0	2	0	0	1	2	1	0	0	5	0	0	2	0	0	0	0	0	0	0	4	0	22	2	0	0	0	7	0	0	1	0	0	2	0	0	1	1	0	0	1	0	2	4	0	5	16	0	0	0	1	0	0	0	37	0	5	2	0	0	0	0	0	0	0	0	1	0	0	0	0	9	17	264	27	13	5	0	11	0	0	0	1	0	2	0	0	1	1	12	0	0	0	0	2	0	0	0	22	6	0	11	1	1	63	0	3	0	11	5	0	3	0	0	0	0	0	0	1	0	13	1	0	0	3	0	0	2	0	2	3	4	0	2	0	0	0	0	0	26	74	6	37	0	0	0	0	0	3	0	0	0	0	0	0	2	0	0	0	1	3	0	2	0	3	4	4	0	0	0	0	0	0	0	0	0	0	1	0	1	4	31	0	0	0	2	0	1	0	0	0	5	0	5	30	2	1	0	0	2	0	0	0	6	9	0	0	0	3	0	0	0	3	1	0	0	0	0	12	0	300	0	8	0	4	0	0	0	2	4	0	0	0	6	0	4	17	1	18	28	0	3	0	0	0	0	1	15	1	1	4	3	0	0	0	74	6	15	2	1	5	20	0	10	0	81	0	1	2	0	0	5	0	0	3	3	0	0	0	0	0	0	0	0	0	0	0	0	0	0	6	1	16	0	1	21	0	0	0	0	0	0	0	0	0	0	0	0	0	26	0	0	0	6	3	0	1	1	0	0	0	0	3	0	0	1	13	10	0	0	0	0	0	0	0	0	0	0	0	0	1	0	7	0	0	1	156	3	0	0	0	0	0	0	0	61	0	18	10	11	2	0	0	21	0	0	44	150	4	0	0	0	0	0	0	0	0	0	0	0	0	2	0	0	0	0	0	0	0	0	0	0	1	0	0	0	65	0	0	4	0	0	5	32	0	3	0	112	3	6	0	0	0	0	0	0	0	0	0	0	0	1	0	6	0	0	0	2	0	3	0	0	0	2	4	0	4	0	0	0	0	2	0	0	8	0	2	0	0	0	0	0	0	0	0	0	2	0	37	0	0	3	1	0	1	0	0	0	0	2	0	248	0	0	8	3	0	6	110	0	0	0	0	0	2	2	0	0	0	0	4098	0	0	0	0	0	14	0	0	0	4	0	8	90	13	0	4	2	0	0	0	3	0	1	0	0	0	0	0	0	0	0	1	0	0	1	0	0	0	0	0	0	0	0	0	0	0	0	0	0	4	0	0	5	0	0	79	0	0	0	9	0	23	5	0	0	0	0	0	62	0	0	0	6	1	0	0	0	2	6	2	18	11	2	0	0	2	0	5	4	10	1	0	0	0	8	0	0	0	0	0	0	0	44	0	1	2	1	0	0	0	0	0	20	62	8	0	0	0	0	8	0	5	0	0	4	0	46	0	0	0	0	15	0	0	0	0	2	0	2	0	0	3	0	0	0	0	0	2	0	3	0	0	0	0	0	6	0	0	5	1	3	0	0	0	1	0	0	0	0	3	5	0	0	1	0	0	0	0	0	0	1	0	36	0	0	1	0	0	0	0	0	0	2	1	0	0	0	2	0	0	1	0	1	0	0	1	2	1	0	3	0	0	2	5	0	1	0	0	10	1	0	1	1	1	1	0	0	0	1	0	0	0	0	0	3	24	791	0	8	0	4	0	0	22	1	14	5	4	0	8	1	6	23	0	5	0	22	19	0	50	13	14	5	4	8	0	2	8	1	1	0	0	0	0	0	0	0	0	0	18	0	0	0	0	0	0	2	0	0	0	0	0	0	1	0	0	0	0	0	3	3	0	18	0	14	1	0	0	16	0	0	0	0	0	6	0	0	0	1	0	0	0	0	1	3	3	0	0	0	0	1	11	0	6	1	0	3	0	0	0	0	0	1	0	2	4	0	0	0	0	13	0	0	1	0	0	0	0	0	2	1	0	0	0	8	7	0	11	0	0	0	7	0	17	0	3	0	0	1	1	0	1	0	7	0	50	1	0	3	27	0	0	0	0	0	0	0	1	1	0	1	0	0	0	2	1	0	0	1	1	1	0	17	4	6	0	0	2	5	3	2	2	1	4	0	3	0	9	0	0	0	0	0	0	21	0	1	0	0	0	0	0	0	0	0	0	0	0	4	0	0	0	0	0	0	0	0	7	0	0	3	0	0	0	0	0	2	0	0	0	0	7	0	8	0	76	2	0	0	0	3	0	0	0	0	10	0	0	0	2	0	0	2	0	9	0	0	0	0	0	17	0	0	26	6	1	1	1	0	33	2	0	13	1	0	0	0	1	0	1	0	12	0	6	0	0	1	0	2	0	1	4	0	0	0	0	0	0	1	0	0	15	2	0	0	0	0	0	2	0	0	0	2	0	1	0	0	6	144	14	29	19	0	20	0	0	0	0	0	0	0	0	15	2	0	0	0	0	1	0	4	4	5	6	0	0	0	0	0	0	0	0	6	24	1	0	0	2	0	0	0	0	0	4	0	0	0	0	0	0	6	0	10	1	0	0	0	0	0	0	6	2	0	24	5	1	1	0	2	1	0	0	30	0	0	0	0	0	0	10	0	0	0	0	13	5	0	0	7	0	0	0	1	0	0	0	3	0	0	0	0	0	3	1	0	0	12	1	0	0	0	6	0	0	0	0	0	0	0	0	0	0	0	1	0	2	1	0	95	0	0	20	0	43	0	9	4	0	0	0	0	9	1	1	0	0	0	0	0	0	0	1	0	1	0	0	5	0	0	0	65	0	69	0	21	2	0	0	3	4	1	2	0	0	0	97	1	0	5	0	0	0	3	0	1	18	2	3	0	3	0	0	0	7	0	2	0	22	11	3	22	7	3	7	4	0	8	3	2	0	0	4	0	0	8	1	0	7	0	1	1	1	21	3	2	0	0	0	0	11	28	2	0	0	0	12	2	0	0	0	1	4	0	0	0	0	0	0	0	0	0	0	0	15	0	4	11	17	3	0	0	0	0	0	0	1	1	0	0	10	1	0	66	46	7	0	13	2	3	2	0	5	22	0	2	0	0	0	0	0	1	0	0	0	0	0	0	7	1	65	0	0	18	0	1	18	0	1	0	0	0	31	10	0	0	1	2	4	0	0	0	0	5	0	2	7	1	7	3	1	2	0	28	0	1	0	0	0	0	0	185	11	3	3	0	0	0	0	0	0	0	34	0	0	0	2	0	0	38	59	10	0	1	0	0	0	0	0	31	1	3	0	0	0	13	0	0	0	0	0	0	0	0	0	0	0	0	0	0	0	203	212	0	2	0	0	0	0	1	1	0	0	0	0	0	0	1	1	0	9	0	0	1	1	0	4022	15	43	0	0	0	1	0	0	0	0	0	5	0	0	0	0	0	0	0	1	0	391	0	0	2	0	4	0	0	0	0	0	0	2	0	0	0	0	0	0	0	0	0	0	0	0	0	0	0	0	0	0	0	0	0	0	0	1	0	0	0	1	0	20	0	0	0	0	4	0	0	0	0	0	0	0	0	3	0	0	0	2	0	0	0	0	0	0	471	0	0	0	0	0	4	45	6	0	1	0	0	1	1	206	6	0	2	0	0	10	18	0	26	2	0	0	0	4	0	0	0	0	0	0	10	0	0	0	0	0	0	1	0	2	0	0	0	0	1	0	0	0	0	0	0	0	0	0	4	0	12	1	0	0	0	0	0	3	0	1	0	1	1	4	4	0	0	2	11	0	0	8	0	0	0	5	0	0	1	1	2	0	0	5	0	29	2	11	0	0	0	0	0	0	0	0	0	0	0	0	9	0	68	19	3	5	0	0	0	0	0	0	0	0	5	0	0	0	0	0	4	0	0	0	309	6	0	0	0	0	0	0	0	45	4	11	0	0	0	0	0	0	5	0	4	3	0	0	0	0	0	0	0	0	0	0	8	11	39	0	12	0	1	7	0	0	0	0	0	0	0	0	6	13	2	3	0	0	0	0	0	0	0	28	0	0	0	0	3	0	0	0	0	0	2	1	12	0	0	5	0	1	0	0	31	0	12	0	0	0	4	0	0	0	0	0	32	0	0	0	0	0	0	0	0	0	1	0	3	0	0	0	0	0	0	85	3	0	0	0	0	0	0	20	0	0	0	6	0	0	1	0	0	0	2	0	0	0	0	1	0	0	0	3	0	0	0	0	0	0	0	1	0	0	0	0	0	0	0	0	0	0	1	0	19	0	0	3	1	0	0	0	0	0	0	0	0	0	1	0	0	0	0	2	0	0	0	1	5	0	1	0	0	0	2	0	0	2	0	1	0	0	0	0	0	0	0	0	1	2	0	0	4	0	1	4	0	0	0	0	0	0	0	0	0	0	0	0	0	0	1	0	0	0	0	0	0	0	2	7	1	0	0	2	3	0	2	0	0	0	0	0	0	0	0	0	0	13	0	7	0	0	0	1	0	0	0	0	0	15	0	0	0	2	0	0	0	0	0	4	0	0	0	0	0	0	0	0	0	0	0	0	0	0	1	0	0	0	3	0	0	0	0	0	0	1	0	0	0	0	0	2	0	0	0	0	0	0	2	0	2	0	2	0	0	0	1	1	0	0	0	0	0	0	0	1	0	0	0	40	0	0	0	3	0	3	0	0	0	2	0	0	0	0	0	0	0	0	0	0	0	4	0	0	1	0	0	0	0	0	2	0	0	2	0	0	0	0	0	0	0	0	2	1	0	0	2	0	0	0	5	0	0	0	0	0	0	0	0	0	3	0	0	0	0	0	0	0	0	0	0	0	0	0	0	3	0	0	0	0	0	7	0	0	0	0	0	2	0	4	0	0	64	0	0	27	0	12	0	0	0	14	0	0	0	0	0	170	0	7	3	0	0	0	1	0	0	0	0	0	0	5	0	0	0	31	0	0	0	0	0	26	0	0	0	0	0	1	0	0	4	0	0	0	0	0	0	0	7	0	0	1	0	0	0	0	0	2	0	0	0	12	0	0	0	0	0	0	0	0	0	0	0	0	0	12	0	7	0	0	0	0	0	4	0	0	0	0	0	0	0	0	0	0	0	0	0	0	0	0	0	0	0	0	0	0	0	0	0	0	4	0	0	16	0	0	0	0	2	6	0	0	0	0	1	0	0	7	3	0	0	0	0	0	0	0	0	0	0	0	0	0	0	2	0	0	0	0	0	0	0	100	0	0	0	0	1	0	0	0	0	0	0	1	0	0	0	0	0	0	0	1	0	0	0	0	0	0	0	0	0	26	2	0	0	0	0	0	0	0	0	1	2	0	0	0	0	0	0	0	0	0	0	4	0	0	44	0	0	0	0	0	0	0	10	7	0	1	0	0	0	0	0	0	0	0	0	0	7	0	0	0	2	0	0	0	0	0	3	0	0	0	0	0	0	1	0	0	0	0	0	1	1	0	6	0	1	0	0	0	1	0	0	0	0	0	0	0	0	0	0	0	2	0	1	1	0	0	2	0	0	3	4	3	0	12	0	10	0	0	0	0	0	0	0	0	0	0	17	0	0	0	0	0	0	0	0	0	6	0	0	0	1	3	0	0	0	2	0	0	2	0	0	0	0	0	0	0	0	0	0	2	3	0	1	0	0	0	17	0	0	0	0	0	0	0	0	0	0	0	0	0	0	0	0	0	0	2	0	0	0	0	2	0	0	0	1	1	3	0	0	13	5	13	84	165	1	0	1	0	6	0	2	3	0	0	0	0	18	0	0	2	0	0	49	0	36	0	0	0	419	1	0	0	0	2	0	1	0	1	0	0	2	12	92	0	0	3	0	0	0	0	0	0	0	2	0	0	0	0	0	0	0	8	0	1	0	0	0	3	0	0	0	0	0	0	0	0	0	0	0	0	0	0	0	0	4	70	0	0	0	5	0	0	0	98	1	2	3	0	0	0	0	0	10	0	0	3	5	377	0	0	0	0	0	1	0	6	0	0	0	0	0	0	0	15	8	0	0	0	0	0	0	0	0	1	0	0	0	0	0	0	0	0	0	0	0	0	3	0	2	0	2	0	0	0	1	7	0	1	3	0	1	0	13	0	0	2	0	13	0	0	3	0	4	0	0	23	0	0	0	0	0	0	1	34	0	0	0	29	26	46	0	0	2	0	16	2	0	13	9	4	0	65	10	0	5	6	20	15	0	1	12	8	4	0	12	0	76	0	0	0	0	0	0	2	0	0	0	24	0	5	0	0	2	0	0	0	1	1	0	2	1	1	0	3	81	0	2	0	0	3	10	0	0	0	0	0	0	94	16	0	0	0	1	0	0	80	2	0	0	1	0	0	0	35	2	6	1	8	0	0	0	0	1	0	66	16	0	26	42	3	0	0	0	6	0	0	0	0	0	0	0	0	0	0	0	6	6	0	0	0	9	1	0	0	0	7	0	0	0	14	2	0	0	0	0	4	28	0	4	0	15	0	1	0	0	0	2	31	3	4	10	0	8	0	0	0	0	0	0	0	0	0	0	0	3	0	26	0	0	0	3	1	0	0	7	0	9	0	0	2	46	20	14	0	7	0	0	2	0	0	3	0	0	0	1	0	0	0	0	0	0	0	0	0	0	0	0	0	0	0	0	0	0	0	14	0	0	1	2	0	0	0	0	0	0	1	12	0	0	4	0	19	10	6	0	18	1	0	0	5	0	25	0	0	2	0	26	0	0	0	2	6	0	0	0	0	0	0	0	0	0	0	0	0	1	9	0	0	0	0	1	0	0	1	4	0	0	0	0	0	0	0	0	0	1	14	0	0	0	0	5	0	2	0	1	2	0	0	0	1	0	1	2	0	0	6	0	0	2	0	1	0	3	22	1	15	5	1	0	0	4	0	0	0	0	0	1	0	0	42	0	0	0	0	0	0	0	0	5	0	0	28	18	0	6	2	0	3	7	0	2	0	1	1	23	0	1	3	1	32	1	0	0	0	6	1	41	4	0	0	0	0	0	0	0	0	4	0	0	0	0	0	0	0	0	0	22	1	1	1	0	2	0	0	3	0	0	0	2	0	0	0	7	1	0	2	0	0	0	1	0	0	3	0	2	0	0	0	0	0	0	0	0	0	0	1	3	0	0	1	5	1	5	0	0	25	1	5	0	0	0	0	0	0	0	0	0	1	0	0	26	2	0	4	0	2	1	2	0	2	9	6	19	5	2	16	1	0	0	1	0	0	21	1	0	4	1	2	0	8	0	0	0	5	0	1	3	1	2	3	6	8	0	0	0	1	4	0	2	0	0	0	0	0	0	0	0	0	0	0	0	0	0	0	1	2	0	0	0	0	0	0	0	28	0	0	0	0	0	11	2	9	0	0	0	1	0	0	8	0	0	0	0	0	0	9	2	17	0	1	16	0	0	0	6	0	5	6	0	0	0	0	0	1	3	0	0	8	1	0	0	0	0	69	0	0	0	1	0	0	0	9	0	0	1	0	0	0	23	0	0	0	0	0	0	0	0	0	0	0	0	0	0	0	3	5	0	242	2	0	6	0	0	0	0	1	0	38	0	3	2	0	4	0	1	0	1	39	0	0	0	0	5	1	4	0	1	0	2	0	0	0	30	32	5	2	0	1	122	0	0	0	0	1	9	0	8	2	16	0	2	0	0	1	0	0	0	0	0	0	0	0	0	4	0	0	0	3	0	0	0	0	0	0	0	2	1	0	0	15	0	1	0	3	0	0	28	26	1	0	0	0	0	0	0	0	0	0	0	0	0	0	0	0	0	0	0	7	0	0	0	0	0	0	0	0	0	0	0	0	0	3	0	0	0	0	0	0	13	0	0	0	0	0	1	0	0	0	0	0	3	0	1	0	4	0	2	0	0	0	2	0	0	0	0	0	0	0	0	0	0	0	0	0	0	0	0	0	0	4	0	0	0	0	0	1	0	1	2	2	7	0	0	0	0	66	0	0	0	0	0	0	0	1	0	0	0	0	1	0	0	0	2	0	0	0	0	0	3	0	0	0	0	0	0	0	0	0	0	0	0	5	0	0	0	0	0	0	0	12	0	0	0	0	0	0	0	0	0	18	16	0	0	0	0	0	0	0	0	7	0	0	0	0	0	0	0	2	0	0	0	0	0	29	0	0	0	2	0	0	0	0	11	0	0	3	0	0	0	0	0	0	0	0	0	0	0	0	0	0	0	0	0	0	0	0	0	0	8	0	28	0	0	0	0	0	20	0	0	0	0	0	14	0	0	0	0	0	0	2	0	0	1	0	59	0	0	0	0	2	0	1	1	14	0	0	0	1	0	0	0	0	1	0	0	0	0	0	0	0	75	1	14	0	18	0	0	0	0	0	102	1	0	1	1	10	14	6	0	0	0	4	0	5	0	0	0	5	8	0	12	14	0	0	0	0	0	0	0	39	7	0	4	2	31	0	0	0	6	1	14	0	0	0	2	2	1	5	0	1	0	0	0	0	1	1	0	0	0	0	7	0	0	0	0	2	1	0	2	2	4	6	45	0	45	4	1	8	0	7	0	2	189	3	0	0	0	0	0	3	1	1	0	0	0	3	7	8	0	0	0	0	0	14	57	6	10	3	1	116	21	2	0	0	0	0	0	0	0	0	0	0	0	0	8	0	1	0	0	11	0	3	0	2	3	3	8	0	0	0	0	0	0	0	0	0	1	0	0	0	0	0	0	0	0	0	0	1	0	0	3	0	0	2	1	0	0	0	2	3	0	23	0	0	2	0	0	0	2	3	0	2	6	4	0	1	0	4	0	0	0	12	2	0	32	1	0	0	1	0	0	0	0	4	2	0	0	238	1	0	55	21	17	26	4	7	6	5	0	10	1	0	18	13	6	0	0	0	0	9	0	2	0	0	0	0	0	0	0	0	2	14	0	0	5	0	0	2	0	0	0	0	0	0	0	1	0	3	0	7	3	1	0	1	1	0	0	1	0	1	8	2	12	0	1	3	0	1	0	0	20	0	1	5	0	0	0	0	0	0	0	0	0	0	0	0	7	2	8	0	0	5	0	0	0	1	1	0	0	8	2	0	8	15	13	2	8	1	0	0	2	4	0	0	0	0	1	1	0	0	0	0	0	0	0	1	0	1	1	0	0	23	144	2	0	0	1	3	2	3	0	0	9	2	0	0	0	1	1	2	0	6	15	11	0	1	8	0	10	0	18	0	9	0	0	2	10	0	0	0	0	0	1	0	0	0	2	0	0	0	7	0	1	0	10	249	11	0	12	0	0	0	8	12	1	0	0	0	0	0	0	0	0	1	0	1	0	0	8	5	4	0	0	22	10	0	5	0	0	1	1	5	0	0	0	0	0	0	0	3	0	0	0	32	1	0	1	1	3	0	32	44	0	4	0	0	4	0	0	0	1	1	0	2	0	3	0	0	0	141	0	0	0	12	8	31	25	0	0	1	0	0	1	0	0	1	0	0	2	0	1	2	17	0	39	10	5	2	1	70	22	6	2	8	5	0	0	0	0	22	0	0	1	17	1	0	6	8	2	3	2	0	2	0	0	0	0	0	8	1	0	0	0	2	0	16	16	7	24	6	0	49	14	0	3	0	0	0	0	39	3	2	9	0	1	0	0	111	0	162	2	10	3	10	7	0	0	73	0	0	19	2	0	0	2	9	3	0	1	0	1	0	1	0	0	0	28	1	0	0	0	0	2	3	0	58	24	10	0	0	3	0	23	11	22	0	0	6	0	0	0	0	0	0	0	0	2	0	0	0	0	0	0	0	0	0	35	1	0	2	1	2	0	0	0	4	0	0	16	1	3	4	4	4	30	6	0	0	1	0	8	0	149	43	0	0	1	3	0	0	36	0	0	2	0	1	1	11	0	0	0	0	0	1	0	4	8	0	0	1	0	0	0	1	0	0	0	0	0	0	0	0	1	1	0	36	3	0	0	0	0	0	183	0	435	0	4	0	1	56	2	4	1	0	0	0	0	0	0	0	18	3	11	1	0	0	0	0	1	0	2	0	0	0	26	0	0	2	0	0	0	0	0	0	2	0	0	0	0	0	1	0	4	7	0	1	9	1	0	0	0	0	2	0	0	0	2	0	0	0	0	2	2	0	3	0	0	0	0	0	0	0	11	12	0	0	0	14	1	0	0	0	76	0	0	0	0	0	1	0	0	0	0	0	109	1	1	10	3	0	1	0	0	2	0	4	8	5	1	0	0	0	4	1	0	0	2	0	0	0	0	25	0	0	3	8	0	0	0	0	0	0	1	0	0	422	0	7	1	8	18	0	3	27	1	21	10	234	138	58	6	24	7	8	0	0	6	0	1	2	1	4	0	0	1209	3	6	1	3	0	22	1	0	0	0	3	4	0	0	0	0	0	0	0	1	0	2	4	98	1	2	3	5	17	5	1	0	0	6	0	0	2	0	0	0	0	2	0	1	0	0	1	17	8	0	0	1	4	0	0	1	0	0	0	0	0	0	1	0	0	0	0	0	6	0	0	0	0	0	0	0	0	3	0	1	0	5	2	0	44	0	0	0	0	21	677	1	0	0	1	8	0	6	17	0	5	0	9	0	0	4	0	0	2	0	5	89	4	0	0	0	37	2	0	1	3	0	0	0	15	4	8	0	0	0	44	2	0	3	0	12	0	1	0	0	0	5	0	0	11	0	4	0	0	0	0	1	0	15	4	0	0	1	3	0	0	0	0	0	0	10	26	6	0	0	14	29	0	0	0	3	2	3	31	32	0	0	5	1	0	0	1	1	0	0	0	0	0	0	4	13	10	30	1	0	0	0	0	0	24	0	0	0	0	0	0	0	0	0	1	0	1	19	4	0	4	0	0	1	0	0	0	21	7	1	0	0	0	0	0	0	0	0	0	1	0	0	0	0	6	0	0	23	0	0	0	0	0	0	1	3	0	0	0	10	14	0	3	0	0	0	0	0	1	0	0	7	0	0	0	0	1	0	9	0	1	19	0	0	0	0	2	12	1	0	0	0	13	2	0	0	3	0	0	0	5	0	50	0	0	6	0	0	2	0	1	0	23	6	0	0	0	0	2	17	0	0	0	0	16	1	20	0	12	0	0	6	0	2	0	11	0	0	2	30	32	6	3	1	6	3	1	2	0	11	0	0	9	0	1	0	0	6	0	2	11	0	65	0	7	0	0	1	0	5	0	0	2	0	0	0	0	5	0	4	6	3	76	5	0	40	3	3	18	236	0	1	8	8	0	0	0	0	0	0	0	0	0	0	2	7	38	1	0	14	0	0	0	0	0	11	17	5	23	0	1	0	0	28	62	0	0	23	4	5	0	3	0	3	5	9	4	2	25	0	7	0	8	0	0	3	2	0	0	0	4	0	0	1	9	0	0	7	0	0	0	0	20	2	0	0	0	1	4	1	3	0	0	0	2	0	0	0	17	0	1	0	0	0	0	0	1	1	1	11	1	0	0	0	0	0	0	25	0	5	4	2	4	6	0	5	4	0	0	15	0	0	6	3	0	0	0	1	0	0	33	1	0	0	1	0	4	0	3	2	0	1	14	0	0	0	2	1	0	0	0	0	0	1	1	0	0	0	0	15	0	0	0	0	1	0	76	12	13	19	0	22	0	5	1	0	0	0	0	1	0	1	0	0	0	0	0	6	13	4	1	0	0	0	0	0	3	0	0	18	3	1	1	2	0	9	1	0	207	11	0	0	0	2	0	0	7	1	19	1	9	0	0	0	0	0	22	3	9	0	0	0	8	9	0	1	7	2	0	10	2	0	0	3	0	0	5	56	6	0	0	1	1	0	0	6	1	2	0	0	3	1	4	2	3	0	1	3	0	0	0	0	1	0	1	5	3	0	0	1	1	0	2	2	18	0	38	4	0	0	1	0	0	0	0	0	31	0	8	0	0	1	0	0	11	1	0	3	1	0	0	2	7	0	0	1	1	0	0	0	0	0	0	2	1	2	0	4	2	1	0	0	3	3	0	1	31	0	0	0	16	0	0	0	0	0	0	4	15	0	0	0	19	11	11	0	0	8	0	1	0	0	0	0	0	9	0	3	3	0	0	1	1	0	0	1	0	0	0	0	2	1	0	1	3	0	0	1	2	11	11	3	9	0	0	0	0	3	0	0	1	3	0	3	1	14	0	0	0	0	0	0	0	0	17	3	2	0	3	40	3	31	0	0	37	0	2	15	0	0	0	0	0	0	1	0	0	6	0	0	4	1	8	0	0	1	0	2	0	1	1	0	0	0	5	0	0	1	0	0	1	1	0	0	0	11	4	0	0	0	43	0	0	1	0	19	13	8	0	0	0	0	2	1	0	0	0	0	3	10	0	1	1	0	33	0	28365	0	0	1	0	0	2	0	0	0	0	0	0	0	0	0	0	13	0	0	0	0	3	2	1	0	2	1	6	1	1	0	0	0	0	0	5	0	6	6	0	3	0	0	0	0	7	14	0	0	1	0	0	4	0	7	53	9	3	3	0	9	15	0	4	1	0	2	0	0	253	13	43	26	0	0	2	236	4	16	0	7	66	0	0	7	0	0	0	0	1	0	2	2	0	13	0	0	5	2	0	0	4	4	1	0	11	0	1	1	0	4	0	0	0	0	0	0	0	12	4	2	7	4	0	10	8	0	25	0	0	20	18	2	0	3	0	23	112	0	4	12	0	0	0	0	8	0	93	35	15	2	6	1	16	0	0	27	12	0	0	0	5	1	0	0	0	0	0	0	0	0	4	606	16	4	1	1	14	0	0	0	4	0	0	0	0	0	5	23	0	0	12	2	0	1	1	0	0	0	1	0	0	0	0	0	20	2	0	11	0	0	0	3	4	0	1	0	0	1	0	0	0	0	2	0	0	0	0	9	0	0	1	6	6	6	0	0	5	16	0	0	2	2	0	2	0	2	0	1	1	18	20	0	1	1	1	23	17	0	6	1	0	2	2	0	1	2	1	0	0	0	0	0	0	0	0	0	0	0	0	0	1	24	0	0	1	1	0	0	3	0	1	0	0	5	0	3	0	0	0	1	1	2	1	1	0	0	0	0	0	0	1	5	1	8	1	0	0	0	6	0	2	1	0	0	2	3	7	0	24	0	2	3	4	8	6	13	3	0	0	1	0	10	0	0	3	1	23	1	28	1	0	0	0	0	0	0	0	0	22	0	0	1	3	0	3	0	0	0	0	9	33	0	0	3	0	0	0	0	2	1	22	4	2	2	0	64	13	0	1096	4	0	0	11	34	11	9	0	228	0	0	32	8	194	0	2	0	0	0	2	0	0	45	0	3	7	5	21	0	3	0	12	2	1	0	0	0	0	0	4	0	0	0	6	0	1	3	2	0	0	0	27	53	1	0	1	7	5	0	5	0	1	0	2	0	0	1	8	25	9	6	36	17	9	11	0	2	50	9	24	59	0	1	0	0	7	0	0	0	0	0	0	0	5	0	0	0	0	0	0	1	0	5	0	0	0	3	0	0	50	3	0	1	6	0	0	8	0	0	1	0	2	31	0	9	0	0	0	0	0	3	0	2	1	0	0	0	0	0	0	0	0	0	0	2	7	0	0	1602	0	1	0	6	2	1	0	26	2	78	2	0	0	2	0	0	0	0	0	0	0	0	0	1	0	0	0	0	0	2	4	0	2	2	1	1	7	10	0	0	0	0	0	0	0	0	0	0	1	1	0	0	0	1	0	22	0	0	0	0	0	3	0	0	0	0	0	0	20	1	1	0	65	0	0	0	5	0	76	0	0	6	0	7	0	1	6	0	2	4	1	0	23	1	7	1	3	0	1	0	0	0	4	0	0	3	0	9	2	0	0	0	0	0	0	19	0	0	0	1	97	0	0	0	0	3	0	0	0	0	0	0	0	1	0	0	3	0	0	0	0	2	4	0	0	0	3	67	2	0	0	0	2	0	1	0	0	9	0	0	0	0	0	9	5	0	0	0	0	0	3	0	13	0	0	1	0	2	2	3	0	0	0	0	1	1	0	2	144	0	0	12	0	0	29	0	0	1	0	2	4	2	0	0	36	1	1	913	0	6	24	2	0	6	0	24	5	13	0	0	0	0	3	0	2	0	2	0	2	1	0	3	0	0	1	4	5	2	0	0	0	1	62	0	2	0	0	0	3	1	3	3	2	1	21	0	0	4	0	0	0	0	4	0	0	0	0	41	2	0	0	0	0	1	0	0	0	0	1	0	7	0	0	2	0	13	0	0	0	0	0	0	2	7	448	5	0	0	0	37	3	27	53	66	0	0	0	0	2	0	3	0	0	9	0	0	6	36	23	5	3	3	37	0	0	11	12	0	0	2	4	0	2	0	0	1	1	0	12	22	10	0	0	0	0	0	0	0	5	8	0	1	0	3	2	0	0	0	0	0	0	0	0	2	2	0	0	0	0	0	0	0	0	0	4	0	0	0	0	7	0	2	8	0	0	0	0	0	0	0	0	0	1	0	0	1	0	1	0	5	1	1	2	0	1	570	1	0	0	2	0	0	0	3	0	1	8	325	13	16	0	0	1	3	0	0	2	5	3	0	0	0	0	0	0	0	1	7	27	0	5	1	0	2	3	0	2	1	0	1	13	1	0	0	0	0	0	0	0	0	17	3	16	3	9	0	17	1	0	24	0	0	5	0	0	0	0	14	14	14	1	0	7	0	21	2	8	1	8	0	0	0	4	0	0	1	3	0	0	0	0	20	0	7	1	0	0	0	1	0	0	9	0	3	3	0	12	1	8	0	2	9	0	3	45	0	8	0	0	0	0	0	0	0	0	0	488	6	24	1	0	0	1	0	0	0	0	0	0	0	0	0	0	3	0	0	0	54	1	0	4	5	5	18	1	0	5	5	0	0	0	0	3	0	41	0	0	13	16	0	0	1	0	0	9	0	0	1	0	0	0	7	4	0	7	11	0	0	0	0	0	2	65	0	76	0	4	11	0	1	0	13	0	2	0	0	0	0	0	0	0	0	0	1	0	0	0	0	0	0	0	2	0	0	0	0	0	0	0	0	0	0	0	1	1	1	0	0	0	0	0	0	8	2	74	1	0	10	4	6	0	23	2	0	0	0	1	1	0	0	0	0	0	0	0	0	0	0	0	16	0	0	0	0	0	0	0	0	0	4	0	615	0	0	0	0	4	0	0	0	0	0	0	0	0	0	4	0	0	0	0	0	0	0	0	0	0	0	0	8	2	0	0	1	6	2	0	17	0	0	0	26	0	0	0	0	3	0	17	0	0	7	6	0	10	79	0	0	0	0	0	0	0	0	0	0	1	0	0	0	1	0	0	6	0	0	0	0	0	0	0	0	0	2	4	0	2	0	0	0	0	0	94	0	3	0	0	0	0	0	0	0	0	0	0	0	0	0	0	0	0	0	0	0	0	0	0	0	0	0	0	0	0	0	0	0	0	15	0	4	1	0	0	0	4	0	0	10	0	0	0	0	0	4	0	0	0	362	0	0	5	0	0	0	0	0	0	1	0	0	0	0	0	0	0	0	0	0	0	0	0	0	1	28	0	0	0	0	0	0	0	0	0	0	0	0	0	0	0	0	0	1	2	0	7	0	0	0	0	2	0	0	0	0	0	0	0	3	0	0	6	0	0	0	0	0	0	0	0	0	0	0	0	0	0	0	0	0	0	10	0	0	0	0	1	0	0	0	0	0	0	0	0	0	0	0	0	0	0	0	4	4	0	0	0	0	50	0	0	0	1	0	0	0	0	3	0	0	0	1	0	0	2	0	1	0	0	0	0	0	3	0	1	0	2	7	1	0	36	1	44	0	0	0	0	0	2	3	0	0	0	0	0	0	1	0	0	2	0	2	1	0	2	0	1	14	0	0	0	0	16	3	0	0	1	7	0	0	0	0	9	0	0	0	0	0	0	0	16	0	0	0	2	0	0	0	0	0	0	3	0	10	0	0	0	0	0	0	2	0	1	0	0	0	0	0	0	3	0	0	0	0	0	0	0	0	4	0	0	0	1	0	0	0	0	0	1	0	0	0	1	0	0	0	0	0	0	26	0	3	0	1	4	0	0	0	18	0	2	0	0	0	19	0	15	0	4	0	1	0	0	0	0	19	0	1	0	0	0	2	0	0	0	116	0	0	0	1	4	0	0	2	0	36	0	35	31	0	6	0	2	8	2	0	0	0	0	0	0	0	0	1	0	0	3	0	1	1	0	2	0	0	0	0	1	0	7	1	0	0	0	0	0	0	1	0	0	0	0	0	2	0	0	0	0	16	0	0	1	0	2	0	2	0	0	0	0	0	0	0	2	0	3	3	0	0	0	66	0	12	0	128	0	0	0	0	0	0	0	0	0	2	0	0	0	0	2	1	0	0	30	0	0	0	0	0	0	0	0	0	0	51	1	0	0	2	0	0	0	0	0	0	0	0	0	0	0	0	0	0	0	0	0	0	12	6	0	2	8	12	0	0	0	2	2	1	0	0	0	1	0	8	0	0	0	0	4	6	26	0	0	0	0	7	0	0	0	0	8	4	0	2	0	6	6	21	0	0	2	0	0	1	17	2	2	0	0	0	0	0	0	0	0	0	0	0	0	28	2	0	1	1	0	0	0	0	0	1	2	9	0	15	21	8	19	11	1028	0	6	4	2	9	0	0	7	3	1	3	0	0	0	3	3	6	0	2	0	0	30	2	0	0	0	43	0	0	1	0	1	0	4	1	4	0	0	35	0	3	0	0	0	0	0	0	0	1	0	0	1	0	4	0	2	0	0	11	0	0	0	0	1	0	3	0	9	0	0	0	5	8	4	0	5	12	1	0	4	14	0	62	3	0	1	3	3	0	0	0	0	0	1	0	0	0	1	0	0	3	76	1	38	3	6	8	5	14	20	0	0	1	10	63	0	1	11	0	0	0	0	11	4	12	5	9	4	0	0	6	0	2	0	6	11	2	35	3	27	2	9	0	17	0	0	4	0	2	2	0	0	0	0	2	3	8	0	0	5	1	0	4	0	0	20	5	5	0	2	4	9	0	1	0	0	9	0	3	0	13	0	0	0	2	4	0	0	8	0	0	0	0	0	1	2	12	2	4	0	0	1	0	14	0	0	0	0	0	0	3	0	0	0	4	7	6	20	0	16	0	2	0	1	0	0	0	1	0	3	0	9	0	6	10	0	2	12	3	9	1	0	0	4	1127	0	0	2	0	0	31	0	0	9	0	0	0	0	0	6	1	0	8	0	7	0	0	1	0	0	1	1	1	17	0	1	0	1	2	0	31	0	2	1	1	0	9	0	0	0	3	0	17	0	0	1	0	0	0	0	0	0	0	1	4	0	0	32	4	3	0	0	4	0	1	1	0	0	0	0	0	182	3	0	0	7	0	0	32	8	18	6	26	9	0	37	0	0	31	434	16	47	6	0	13	0	0	0	3	2	1	0	10	4	0	0	0	1	0	0	0	0	0	0	0	0	0	0	3	0	1	0	6	7	41	7	0	0	0	0	0	0	0	0	0	0	0	0	0	0	1	0	0	0	0	0	0	0	0	0	0	0	8	11	0	0	0	0	0	0	0	0	0	0	0	0	0	0	0	0	0	0	0	0	0	0	0	0	16	8	0	44	1	11	1	0	0	0	0	7	0	10	1	6	0	17	0	0	0	0	0	5	0	1	0	0	0	0	0	12	0	3	9	7	15	0	7	6	6	15	3	0	1	10	0	0	0	0	0	0	0	1	0	2	0	3	3	5	1	6	5	0	9	0	5	2	11	1	4	2	21	0	0	0	0	0	0	4	6	0	0	0	0	0	0	1	2	3	10	0	0	11	7	1	4	0	3	0	0	0	0	8	0	1	0	4	0	0	0	0	39	95	0	0	0	1	19	0	1	0	0	0	0	0	0	4	0	1	27	7	4	1	4	0	1	0	9	0	0	0	2	0	0	2	0	9	6	0	0	0	0	1	1	1	0	0	0	3	3	7	3	5	0	11	0	15	2	2	0	0	4	0	0	1	6	0	1	0	1	1	0	2	0	0	23	0	0	0	0	0	0	0	0	0	0	13	0	0	3	0	0	0	0	1	4	2	0	0	1	0	0	0	7	1	0	0	0	0	0	0	1	6	0	1	24	4	0	0	0	2	2	37	0	7	3	0	1	14	2	0	2	21	0	9	0	0	0	41	0	0	4	0	2	8	0	1	0	0	0	0	7	14	9	1	0	5	7	15	0	0	0	0	0	0	0	1	0	2	0	0	0	0	0	0	0	0	11	9	80	0	7	2	4	0	7	0	1	1	0	0	0	0	0	0	0	0	1	0	8	0	4	563	1	0	6	3	74	0	6	0	0	0	20	0	50	38	8	22	0	62	0	7	2	0	0	0	0	2	0	8	5	207	12	14	0	1	0	0	0	0	6	0	0	0	1	0	1	0	1	28	0	0	0	108	2	3	6	1	0	3	8	24	0	0	2	0	0	0	2	4	4	0	0	0	0	0	0	1	2	0	0	1	1	0	0	1	0	0	0	0	0	3	0	56	1	0	1	0	99	1	2	0	3	0	4	1	2	0	0	0	2	3	3	2	3	0	9	0	0	0	7	0	0	0	0	0	0	3	0	0	6	4	0	25	1	0	0	12	2	5	14	9	0	0	0	0	0	0	1	0	1	0	1	13	0	0	0	6	0	0	0	4	0	2	0	0	0	7	0	0	12	0	32	0	0	3	0	14	0	0	1	0	1	5	15	62	5	3	0	12	0	0	0	0	0	0	0	0	0	0	0	2	0	23	1	0	0	0	1	0	0	0	13	0	2	2	0	0	3	3	0	0	38	0	213	19	0	85	0	0	1	1	0	0	0	8	1	11	0	0	0	0	0	9	14	2	1	0	6	2	2	4	0	0	2	0	2	84	0	0	4	0	3	1	0	0	0	2	21	4	9	4	1	15	3	0	3	5	0	2	0	8	0	0	0	0	3	1	1	0	0	0	0	0	0	0	2	0	0	0	2	6	0	0	0	0	0	0	0	0	0	0	1	0	0	0	1	0	0	1	0	1	0	0	0	0	0	0	2	1	0	4	0	0	11	0	43	43	0	13	0	0	0	1	0	0	4	0	1	14	0	0	25	9	0	0	0	0	1	1	0	47	6	11	0	2	0	0	1	0	0	2	12	0	0	0	0	0	0	1	47	0	12	0	19	46	3	6	0	11	0	0	0	511	2	5	0	3	35	8	0	26	0	0	0	3	0	0	0	7	3	0	24	2	0	0	0	0	0	5	1	2	0	2	4	2	1	0	5	0	0	10	0	2	2	0	0	0	0	3	3	0	1	0	3	0	0	2	0	0	0	0	0	2	0	0	1	1	41
LakWasMet70_HOW9_2_rpkm	0	0	0	0	3	28	4	6	0	0	1	0	1	2	0	0	0	0	2	0	0	0	1	75	0	0	0	0	0	24	0	1	0	33	2	19	1	2	1	0	0	0	0	15	53	73	96	7	7	59	7	20	4	0	0	4	0	1	148	34	30	0	2	1	0	0	0	0	2	90	8	1	5	0	0	0	1	0	0	0	1	6	1	0	0	0	0	2	1	1	0	2	31	0	78	0	2	0	5	0	0	1	15	0	0	0	0	1	0	4	0	0	296	3	46	1	1	271	1	0	0	1	5	15	0	0	30	0	0	1	59	621	6	2	0	3	0	0	3	0	0	0	0	5	35	0	0	0	95	2	15	123	0	4	404	1	1	1	60	0	16	1	2	19	9	1	1	9	4	20	0	0	2	0	0	0	1	2	0	1	0	0	0	0	3	14	0	0	0	2	7	4	16	39	21	0	0	34	48	81	7	3	3	0	0	0	3	0	7	2	27	12	19	50	28	1	86	22	0	0	1	1	1	5	4	3	0	1	49	0	1	7	1	0	0	1	50	3	41	4	0	0	31	4	83	6	0	0	1	2	1	13	23	1	3094	263	0	1	2	1	12	2	3	67	2	0	7	3	5	235	4	0	10	0	0	7	1	1	7	8	0	82	4	165	45	0	0	0	19	5	1	0	0	0	3	0	0	9	8	0	0	146	64	1	9	0	30	91	9	1	5	0	328	48	2	1	0	1	2	0	3	0	0	1	1	53	1	2	13	0	2	0	0	1	0	1	10	2	15	0	1	2	16	3	16	0	17	3	1	0	2	6	5	0	3	0	2	8	0	12	1	0	3	0	0	81	3	164	4	6	1	128	0	0	24	0	0	54	2	8	0	0	16	1	3	0	104	0	0	0	1	0	373	0	1	3	3	0	0	74	0	36	1	8	45	0	1	0	1	1	1	5	6	654	0	55	39	4	9	1	0	0	0	0	0	0	7	0	1	5	146	3	0	1	0	0	2	1	17	0	48	6	0	0	0	345	0	0	0	0	0	179	4	747	0	41	122	10	2	1	1	0	0	12	2	46	35	1	1	0	34	6	17	5	0	0	34	1	5	0	2	6	6	0	1	0	0	7	47	1	0	0	178	78	1	0	0	0	0	0	1	4	27	6	0	0	1	3	0	2	5	0	0	2	3	0	17	0	3	16	0	0	0	2	1	0	0	1	0	1	0	0	211	64	18	0	16	1	0	46	0	1	2	100	22	0	0	0	8	0	1	0	3	1	0	4	4	5	0	0	0	0	5	2	72	0	5	1	154	1	0	2	0	10	3	22	21	253	4	21	30	57	28	4	39	2	1	2	35	0	0	0	24	8	24	17	1	0	3	0	74	0	1	0	20	23	0	45	0	0	0	932	27	246	2	0	570	1	480	9	13	15	189	43	0	30	2	15	0	12	0	4	0	0	1	7	1	0	0	3	0	499	1	0	0	3	3	42	8	2	16	0	9	17	4	0	2	1	8	41	1	16	0	1	0	3	1	0	14	9	1	23	2	3	4	0	1	1	0	0	4	1	2	11	0	0	0	0	1	29	0	0	18	1	1	3	2	7	0	0	0	4	0	2	3	1	8	4	139	0	0	5	1	0	31	7	0	2	23	1	2	1	21	12	1	0	26	1	52	1	0	8	4	0	0	0	1	1	0	0	0	47	18	1	5	133	6	0	0	4	2	0	4	0	0	1	3	0	26	5	0	4	2	64	0	0	13	0	0	0	0	0	0	0	0	120	0	0	0	0	0	0	19	1	0	2	0	0	0	0	15	7	1	0	0	5	18	1	0	10	0	0	1	0	20	19	324	1	3	2	0	1	121	0	1	1	3	0	0	0	0	0	0	0	48	0	1	0	0	33	7	0	0	1	2	0	0	119	37	0	0	0	1	3	0	0	0	3	97	286	0	0	0	1	0	0	1	13	0	4	53	1	0	3	0	5	0	1	12	0	0	0	0	1	0	4	5	0	39	0	0	2	5	2	0	6	149	0	0	0	0	0	1	0	5	2	0	3	0	0	0	0	16	2	0	0	1	8	0	0	0	2	0	6	20	4	8	1	8	0	0	0	0	1	0	0	0	0	0	0	0	0	0	2	0	0	0	0	0	7	0	0	0	22	15	0	0	17	0	0	0	2	0	0	8	0	0	0	3	0	0	1	1	0	0	1	0	2	1	1	2	17	29	499	2	16	0	36	0	0	129	59	3	0	3	0	0	2	0	0	0	1	0	0	1	0	1	0	0	0	1	2	0	0	2	0	2	0	0	0	0	0	0	0	0	0	0	342	1	4	0	72	5	2	2	10	0	0	5	3	27	0	0	0	0	0	1	2	7	9	0	1	0	0	2	0	0	3	0	0	0	0	1	7	1	0	1	0	0	3	0	3	0	143	0	0	0	0	0	5	18	0	4	1	1	3	6	2	3	46	14	2	0	0	0	0	0	0	2	67	6	0	0	0	0	1	0	0	1	1	0	0	0	0	22	22	16	2	1	9	0	1	0	0	4	0	0	18	0	1	2	18	0	0	0	0	3	7	80	0	2	5	136	1	0	5	0	0	0	1	0	0	0	0	0	0	0	2	0	0	0	1	0	0	2	0	0	5	0	0	0	1	1	0	0	0	0	0	15	0	44	3	0	0	2	0	29	1	8	0	0	0	15	2	0	0	0	3	0	0	2	2	77	9	73	94	0	2	0	92	18	1	0	2	0	46	7	0	0	2	0	0	0	0	0	0	0	5	0	1	0	0	9	0	1	0	2	5	9	1	1	0	0	0	0	0	0	2	8	0	19	0	129	9	3	1	1	0	6	4	32	0	22	134	204	0	0	0	13	0	14	0	0	45	0	8	0	0	0	2	0	0	4	114	0	25	69	21	1	88	1	2	2	1	0	39	3	0	24	0	0	4	0	4	0	23	0	2	3	4	9	0	4	0	0	1	3	3	3	7	2	8	0	2	1	0	0	1	1	3	0	0	13	0	0	0	3	0	10	0	0	4	5	3	6	0	126	10	124	19	3	1	38	1	0	2	16	1	0	22	0	1	7	1	0	0	46	29	0	2	0	0	6	2	18	0	11	1	1	1	15	0	7	79	1	2	13	2	1	0	0	0	2	0	88	0	55	125	24	53	47	4	35	0	0	29	1	18	0	2	4	9	1	31	14	0	31	0	3	2	4	6	19	13	56	0	53	0	0	0	0	0	1	16	9	0	0	0	3	1	2	92	0	1	11	0	14	8	1	2	8	3	6	11	0	2	1	0	0	0	0	0	37	240	26	335	71	3	19	0	0	1	0	0	5	111	3	56	1	58	1	0	6	9	362	1262	21	129	2	0	14	205	0	0	0	0	1	0	0	0	350	14	171	15	396	17	1	27	0	19	0	0	0	0	0	0	27	124	0	1	0	11	0	67	0	2	1	1	0	19	0	2	0	0	0	0	18	0	0	2	0	1	0	12	4	3	0	0	0	0	0	3	1	2	0	3	0	0	6	1	0	0	18	1	1	0	0	0	1	16	0	6	1	16	0	0	1	0	0	3	0	0	6	0	0	0	7	0	0	1	0	0	0	0	0	2	1	20	0	0	5	0	0	5	0	104	0	62	244	0	5	29	0	29	2	1	4	0	0	0	106	4	114	0	0	0	0	0	2	1	0	1	25	1	0	0	4	1	1	2	0	0	0	0	0	3	1	27	2	98	6	3	0	0	92	0	0	0	0	34	2	0	0	0	4	4	1	4	0	0	4	1	1	104	25	0	1	38	1	0	13	45490	1	19	2	20	2	0	1	0	0	0	1	0	0	1	0	0	20	22	63	224	390	159	194	263	0	0	2	7	0	9	0	8	3	4	147	0	0	1	3	0	0	4	0	44	68	0	57	2	1	18	0	30	0	12	5	2	28	4	2	3	0	1	0	1	1	100	2	7	3	9	0	5	8	0	9	357	11	0	6	5	0	1	0	1	14	318	25	280	1	3	2	14	0	7	0	0	0	0	0	0	13	0	3	1	2	4	0	8	4	12	2	32	1	0	0	1	0	3	0	4	0	0	3	0	3	0	5	0	0	0	2	0	6	0	1	3	29	0	4	286	1	0	2	0	0	1	2	0	8	28	0	0	0	13	0	0	0	5	0	12	1	2	0	0	0	2	0	55	1	4	0	0	0	4	7	1	0	1	3	0	4	6	1	0	20	1	2	3	2	0	1	0	51	0	0	49	4	0	0	1	507	23	58	2	1	66	229	0	52	0	167	0	41	4	4	0	9	2	0	62	5	0	0	0	8	1	0	0	0	0	3	4	0	0	64	20	0	2	1	5	51	0	0	3	0	1	1	0	0	1	0	0	0	0	10	0	0	1	19	17	14	24	1	0	3	0	4	1	19	0	0	74	25	0	1	0	1	0	1	0	0	0	0	0	0	0	0	14	0	2	4	60	0	1	0	0	0	0	0	0	161	0	49	65	8	4	10	0	46	6	3	47	908	25	7	2	3	0	2	0	0	1	0	6	0	0	4	0	0	0	0	0	0	0	1	0	3	3	1	2	2	0	1	3	35	3	0	63	15	0	15	1	49	61	44	0	5	0	0	0	2	0	0	0	0	0	4	0	45	0	0	1	11	0	6	0	8	0	15	0	1	2	0	1	1	1	1	0	0	0	5	4	2	0	0	0	3	0	0	0	9	0	0	87	0	0	8	0	1	12	0	0	13	0	1	13	369	0	0	378	13	0	0	40	0	0	0	2	0	0	0	0	8	0	0	43	0	0	0	0	2	63	0	1	1	19	0	82	42	23	2	0	0	0	0	2	11	0	93	2	0	0	0	1	2	2	0	2	2	2	1	1	0	3	1	0	11	0	1	1	0	0	0	3	2	4	0	0	0	0	3	158	0	0	0	234	0	1	5	1	0	0	0	0	0	0	0	0	2	0	1	0	0	0	10	0	2	57	12	3	0	26	0	13	15	6	5	5	0	12	42	2	0	0	0	0	0	0	254	3	7	3	13	0	0	0	0	13	18	132	58	0	0	0	12	3	0	1	3	0	4	0	3	1	0	0	1	4	2	1	1	3	4	0	24	0	7	0	1	11	1	1	4	2	0	28	1	0	0	0	3	5	1	0	3	0	0	0	1	2	8	1	1	5	2	16	29	0	0	0	1	0	2	2	0	8	2	6	2	0	2	0	0	7	0	1	0	0	4	5	2	1	1	2	1	0	2	1	1	0	0	0	2	1	0	0	3	0	11	0	22	2	7	0	43	0	38	3	5	0	0	2	0	41	26	4	0	0	0	0	40	141	121	34	118	26	154	38	11	330	26	171	10	27	14	16	14	54	9	2	44	2	54	48	209	332	407	258	41	13	24	43	17	37	0	9	0	0	0	0	1	0	2	0	18	389	2	0	2	0	0	0	1	0	1	17	0	1	0	0	0	2	0	1	0	1	18	0	66	0	685	11	0	0	3	2	1	3	6	1	4	4	0	0	1	0	1	0	0	4	0	33	1	0	15	0	7	37	7	49	8	0	6	8	0	0	0	2	0	3	15	3	1	0	0	1	23	0	0	1	0	6	0	0	3	0	0	0	0	1	19	22	0	18	0	0	1	0	4	0	0	7	0	2	9	1	0	1	1	3	0	168	2	0	8	108	0	0	1	0	1	5	0	1	3	1	0	1	0	1	29	2	0	0	0	2	2	0	121	33	109	3	1	50	26	23	8	11	0	10	3	6	1	10	0	0	2	0	1	0	12	0	5	3	3	0	0	0	3	5	1	1	0	0	1	1	0	0	0	0	0	0	2	33	1	0	4	8	0	0	0	1	7	5	3	2	0	23	0	6	1	766	10	2	1	18	12	1	2	0	0	37	6	0	0	0	19	0	3	0	1	2	3	14	1	1	13	0	0	27	29	0	2	4	0	127	3	2	0	1	0	0	0	0	1	2	0	16	0	5	0	3	2	0	4	0	1	0	0	1	0	0	0	0	0	0	0	0	5	2	0	0	0	0	7	14	0	1	54	0	2	0	0	5	0	6	328	67	0	0	28	0	0	0	0	3	0	12	2	0	1	9	0	0	1	1	81	6	27	49	0	1	3	29	0	1	2	0	122	131	15	0	0	0	2	0	0	1	0	2	0	0	0	0	1	0	0	3	106	4	1	1	0	0	0	0	0	2	0	28	19	4	13	4	1	2	0	2	61	1	0	7	0	0	0	1	0	0	0	0	32	20	0	2	40	3	0	0	8	7	2	0	2	0	2	1	1	1	4	3	3	0	2	2	11	0	2	5	0	0	3	1	0	24	0	0	0	0	1	0	0	10	8	0	310	0	3	28	4	17743	3	3	0	2	2	2	1	54	3	29	3	3	4	0	0	0	0	2	2	2	0	0	0	2	0	0	283	0	0	2	110	7	0	3	8	12	5	4	3	10	2	6	0	12	5	4	1	4	18	8	1	5	12	4	0	7	3	0	1	60	0	23	1	29	74	39	94	112	55	69	56	3	79	67	56	0	4	3	2	0	55	5	11	46	0	31	1	29	118	29	0	1	0	1	0	1	3	1	1	0	0	8	14	1	0	0	3	16	0	0	0	0	0	1	0	0	0	0	0	14	0	4	11	0	12	0	0	18	1	0	1	3	0	0	0	215	1	2	93	77	41	1	42	1	3	0	1	18	91	0	0	0	0	1	0	2	5	0	0	1	1	0	12	0	5	235	1	0	80	4	0	55	1	7	0	0	0	145	70	5	1	0	1	5	1	0	0	1	5	0	4	11	0	0	2	0	0	0	108	8	3	0	0	0	0	0	4112	74	10	4	0	0	0	1	0	3	0	173	2	30	3	28	0	0	6184	388	169	4	1	0	169	0	7	0	306	1	12	0	0	0	16	0	0	2	6	0	1	0	2	1	0	3	0	1	6	1	104	102092	0	0	0	0	2	0	0	6	1	3	0	0	0	0	12	14	0	1	4	0	10	5	0	21149	97	140	2	0	19	1	0	0	0	3	0	75	4	1	0	2	2	1	0	2	3	2914	2	0	4	0	6	0	1	1	1	0	0	0	0	0	0	6	0	15	0	0	0	0	0	1	0	0	0	0	0	0	3	0	0	0	1	0	5	0	0	0	2	0	0	0	0	0	36	0	0	0	1	0	0	0	0	5	5	0	1	23	1	0	0	3	0	0	80	0	0	0	0	0	0	669	4	0	1	0	8	0	8	60	11	0	7	1	0	72	1	0	154	0	0	4	3	0	0	0	0	0	0	0	4	0	0	1	0	0	0	0	0	0	0	0	0	44	3	0	0	0	0	0	0	0	5	0	0	1	2	2	0	0	2	0	0	2	0	0	2	2	0	16	0	0	13	4	53	26	2	16	0	0	0	1	0	0	1	17	12	2	1	2	0	28	1	61	0	0	0	0	0	0	0	40	0	0	0	6	22	0	1	2	0	7	0	0	6	4	1	0	1	0	0	0	0	6	0	12	5	0	6	3	141	8	0	0	0	0	0	3	0	5	17	54	0	4	0	0	0	1	78	189	0	87	0	0	0	2	0	0	0	1	0	0	0	15	2	0	3	1	12	1	0	0	0	0	6	0	0	0	84	0	31	4	0	12	2	1	2	0	0	4	0	0	0	1	40	0	0	1	7	1	23	2	515	0	0	53	2	2	0	0	153	0	4	0	38	2	2	1	0	0	0	0	377	0	0	2	2	1	0	0	0	0	2	3	7	0	2	0	0	0	0	161	5	0	0	1	3	0	0	411	0	0	0	36	0	14	1	0	0	0	0	6	25	0	0	0	4	24	1	1	2	8	0	0	0	0	3	0	0	0	0	3	3	0	0	1	6	1	14	0	7	0	0	86	1	0	1	0	3	0	0	1	0	0	0	0	0	0	1	0	1	0	0	0	1	0	5	0	1	0	18	0	0	26	11	0	2	0	3	1	0	0	0	12	15	1	0	0	49	0	0	91	12	0	1	0	3	0	0	0	0	0	0	0	0	0	2	1	3	1	1	0	3	0	0	0	0	9	0	2	0	1	19	2	8	0	10	0	0	5	0	0	5	0	0	9	0	1	0	0	13	1	0	0	0	76	2	0	5	7	2	0	0	0	0	1	0	1	0	5	0	1	3	1	0	3	0	0	0	1	4	0	0	0	68	1	0	0	0	1	0	2	0	0	0	6	0	0	8	0	4	0	0	0	1	0	0	7	2	6	0	0	0	3	1	9	1	0	1	0	0	0	4	0	0	94	1	0	0	0	0	1	0	0	7	3	0	0	0	0	0	0	0	1	2	2	2	4	0	0	0	0	0	2	0	0	4	0	6	52	0	0	0	0	0	3	15	0	0	16	6	0	1	0	0	0	0	0	40	7	0	0	0	0	0	0	0	0	0	0	0	0	2	2	0	0	0	10	0	2	0	4	0	0	0	0	17	9	0	0	0	0	0	0	0	0	0	2	238	0	1	11	19	3	1	0	0	18	1	1	19	0	13	228	0	0	2	2	16	0	14	0	0	3	0	29	145	39	4	2	0	38	0	1	1	4	0	91	3	45	2	1	10	1	0	1	0	3	0	0	0	0	0	19	0	0	0	25	0	2	0	3	0	3	4	3	0	4	0	1	0	0	0	0	1	0	0	8	0	1	0	46	0	53	0	0	2	0	0	0	0	0	0	0	89	0	0	0	1	0	12	1	0	0	0	0	2	0	0	0	0	0	0	0	0	19	0	0	1	7	0	0	0	1	0	10	0	0	0	0	3	1	0	3	2360	0	3	2	1	3	1	0	0	0	1	0	10	2	292	0	1	0	0	2	6	0	4	386	0	1	0	0	2	2	0	1	0	0	0	0	0	0	1	0	0	0	1	1	0	0	1	0	0	0	0	0	0	144	0	0	1	0	0	0	0	0	0	0	5	2	0	1	2	3	1	0	0	0	0	8	0	0	25	0	35	0	0	0	8	1	0	90	5	2	0	11	0	0	1	1	0	0	0	0	1	0	4	0	14	0	1	0	1	0	56	0	2	0	4	0	0	1	1	0	0	0	0	6	7	0	8	0	4	1	0	0	2	28	0	0	3	0	0	0	0	6	0	0	16	0	164	1	18	0	1	2	9	0	0	7	2	96	0	2	0	0	0	4	0	0	1	6	2	84	9	1	9	0	0	0	0	10	2	0	73	1	1	5	1	0	0	1	0	2	0	2	25	2	0	4	0	0	0	0	0	0	0	1	20	0	3	2	0	0	96	1	0	6	0	0	1	0	0	0	0	0	4	1	0	0	6	1	1	0	0	7	0	0	1	0	1	0	0	51	13	0	1	144	29	50	528	1304	0	0	1	0	25	0	33	10	7	0	1	0	9	24	0	147	1	3	58	0	56	0	0	0	0	2	1	0	7	4	2	8	0	2	5	0	5	8	88	1	1	24	0	2	4	3	9	0	2	0	3	0	0	0	0	1	0	6	2	3	0	0	0	64	26	0	0	0	4	0	0	0	0	0	0	0	0	0	1	0	3	17	2	2	13	93	1	0	0	20	7	21	0	0	0	0	202	0	0	0	0	0	7	85	1	0	0	0	0	78	0	1	3	0	0	0	0	0	1	28	23	0	8	1	0	2	0	0	6	2	1	0	0	0	1	0	0	0	0	2	10	0	2	2	1	2	2	10	0	3	1	16	0	50	2	0	0	0	26	0	0	8	0	65	2	9	1	0	11	0	2	112	0	0	1	0	0	0	1	12	0	2	0	286	634	253	1	1	62	14	46	8	13	77	26	6	34	482	45	0	89	35	88	36	16	2	83	17	129	0	74	0	391	0	1	0	0	0	0	6	3	0	0	0	0	3	1	0	1	0	0	0	3	0	1	4	18	1	0	2	34	0	3	1	1	8	52	0	0	0	0	4	1	221	0	0	0	0	1	1	0	229	18	1	0	0	0	2	0	14	1	15	1	30	0	2	0	0	7	0	30	196	1	154	127	30	0	0	0	5	3	0	0	0	0	0	1	0	0	0	3	9	0	0	1	0	10	0	0	0	1	28	3	0	1	0	1	1	1	0	0	6	78	7	0	0	1	4	14	0	0	1	8	14	5	32	28	3	4	2	1	0	3	1	0	0	1	4	2	2	0	0	184	3	0	1	1	0	0	0	16	1	11	15	1	8	664	319	1	0	26	0	0	61	5	39	19	9	14	1	5	2	2	0	0	0	1	4	1	0	2	0	0	0	0	0	2	0	0	5	98	1	0	9	18	1	1	0	2	0	0	1	84	0	0	9	0	13	9	7	4	16	2	0	0	69	2	33	0	0	3	1	46	0	0	2	2	8	0	0	0	13	0	2	1	0	1	12	0	0	0	101	0	2	0	0	18	0	1	0	19	0	2	0	3	0	0	0	0	2	3	58	0	2	3	0	0	2	4	0	4	2	0	1	0	11	1	4	16	37	0	76	0	0	1	1	4	0	5	166	0	9	1	2	14	1	15	0	2	0	0	0	0	2	0	21	0	2	0	0	0	0	0	4	24	0	0	2	39	0	53	0	0	68	5	0	34	0	7	1	0	11	0	2	2	190	1	2	0	0	5	6	1	2	0	0	1	1	0	0	1	6	16	4	0	1	0	4	0	0	0	2	63	2	18	0	2	0	0	0	29	4	2	0	7	0	0	0	29	3	0	2	0	22	0	8	2	0	1	2	12	0	0	0	0	0	0	0	0	0	0	3	0	5	0	13	15	1	1	0	0	134	5	53	3	0	0	1	4	1	0	0	0	11	0	1	88	13	0	1	0	11	0	3	0	2	59	1	145	4	25	67	3	8	0	0	0	1	108	2	1	6	13	3	3	0	0	1	4	15	2	21	30	8	29	124	32	168	1	0	1	0	24	2	9	0	21	0	0	1	3	0	1	0	0	0	0	3	0	0	3	4	2	0	10	0	1	3	0	194	0	1	0	2	0	35	35	50	0	7	5	3	6	0	31	4	7	0	0	0	2	40	3	87	0	0	37	3	2	0	34	0	2	13	0	0	10	0	21	1	1	0	2	31	0	0	6	2	0	58	0	5	5	0	1	0	0	17	12	2	0	1	0	3	12	1	5	0	11	13	1	0	5	3	1	2	0	2	3	0	3	4	4	2	141	2	6	3	0	0	7	16	0	356	1	5	12	0	39	0	5	0	34	0	0	4	0	4	0	9	6	22	0	0	2	0	2	1	0	128	0	11	0	6	914	1	4	2	0	0	6	3	1	12	0	0	4	271	5	5	11	0	0	0	0	3	1	0	0	2	0	0	0	27	3	4	4	2	0	5	4	2	10	0	0	16	0	1	0	3	3	0	3	1	11	1	7	1	0	3	0	1	0	0	3	0	0	0	0	0	0	5	0	2	0	1	0	0	0	0	0	0	0	0	0	0	0	0	0	0	0	0	0	0	183	1	0	6	0	0	397	17	5	21	0	0	11	0	0	2	0	3	1	0	0	3	19	2	1	0	2	0	0	1	0	0	2	0	0	10	0	0	0	1	0	54	0	2	0	1	1	7	0	1	0	0	4	10	3	0	1	25	0	0	1	2	0	0	0	8	0	0	5	0	0	8	0	0	0	0	0	3	0	0	228	0	8	0	0	1	22	5	1	0	0	0	0	41	0	0	0	0	2	0	0	0	3	0	2	1	229	0	0	0	0	38	44	0	0	0	0	0	0	0	1	5	1	0	68	3	0	0	0	7	0	0	0	0	10	31	3	0	0	0	1	0	0	0	35	0	0	27	3	3	0	0	0	0	0	0	0	0	0	4	0	0	0	0	0	0	0	0	0	0	6	4	0	1	0	0	1	1	92	0	0	3	0	0	29	29	0	0	0	0	0	7	0	1	1	3	1	0	0	3	1	61	1	1	0	0	0	0	0	0	1	0	0	1	0	4	0	3	0	0	0	1	206	5	50	2	3	0	1	5	0	0	38	1	1	0	9	32	60	44	16	1	6	62	0	95	1	2	0	16	83	0	10	6	0	0	8	1	1	0	1	234	6	4	3	1	649	0	0	0	35	0	562	0	13	6	11	0	0	55	29	4	0	0	1	0	64	0	0	2	0	2	55	2	0	2	2	2	65	3	19	3	4	2	28	0	370	4	2	31	0	5	0	1	62	2	0	0	0	6	0	6	9	1	10	2	0	5	16	34	3	3	0	0	1	110	59	3	7	3	6	477	35	1	2	1	0	0	1	1	0	0	0	1	1	0	35	0	2	1	0	21	0	109	2	14	16	2	8	0	2	0	0	0	6	0	1	0	7	0	1	0	0	0	0	0	0	0	0	0	3	3	1	0	8	1	0	0	1	1	11	1	5	2	0	1	47	1	1	1	0	8	0	24	26	24	2	1	0	6	1	2	15	108	5	1	3	5	9	3	27	2	0	3	0	32	28	0	0	4	1	0	45	15	14	4	27	7	13	0	1	12	4	0	31	8	34	0	0	0	1	1	0	0	0	0	0	0	0	0	0	0	4	5	1	0	3	1	0	45	3	3	0	0	0	1	0	7	0	6	11	19	266	14	0	0	1	1	34	0	0	0	32	3	46	44	0	9	0	0	0	2	2	12	1	4	0	394	0	0	0	29	0	3	0	0	0	0	44	8	158	30	0	35	0	0	0	1	18	2	1	22	1	0	78	8	103	6	64	2	0	0	1	38	0	0	0	0	0	10	0	1	0	2	0	0	4	23	0	0	0	1	0	4	20	13	2	0	0	72	4	31	1	0	122	10	1	0	0	12	2	199	2	15	78	115	3	13	86	4	65	7	73	2	14	1	1	0	30	0	0	1	0	3	1	1	17	0	0	0	0	0	0	11	5	3	38	20	78	1	429	178	0	0	29	2	1	1	0	1	0	1	5	0	0	1	0	0	3	0	21	10	6	0	3	5	18	0	49	0	3	0	2	6	14	0	0	3	0	1	0	0	14	0	0	103	2	5	1	3	12	0	681	390	38	34	2	2	7	9	1	0	43	11	1	15	9	3	2	0	0	18	1	2	0	174	54	55	56	0	0	1	0	0	8	0	2	20	0	3	3	1	6	2	18	1	160	129	39	6	6	18	11	4	3	6	45	0	4	0	0	19	4	0	5	1	11	0	76	191	9	3	2	1	45	0	0	32	5	1	7	11	1	1	0	0	0	661	199	0	0	6	0	500	5	11	5	0	0	0	0	5	33	4	0	6	0	4	0	688	0	56	61	68	15	31	35	0	4	405	46	2	80	3	3	0	25	22	9	1	2	1	3	0	8	0	1	1	51	4	1	0	1	0	2	16	3	634	180	5	2	3	51	2	156	76	63	0	0	107	1	0	1	1	0	0	0	0	6	6	6	0	0	0	1	0	29	2	4	1	0	12	1	1	0	15	0	61	0	5	105	3	40	2	17	12	115	39	0	4	3	0	2	0	919	101	6	2	3	1	3	3	124	2	2	9	0	2	1	45	0	4	2	0	5	2	0	49	84	0	1	0	0	0	1	3	1	16	1	1	0	2	0	26	2	3	5	122	3	35	2	1	0	0	2428	0	1951	0	19	0	6	12	16	11	0	0	0	0	0	0	0	1	71	4	27	5	0	0	0	0	2	1	32	6	0	3	447	0	0	6	1	0	8	0	0	0	4	1516	0	0	0	0	0	0	2	0	1	21	1	0	2	1	1	0	1	8	0	0	0	0	0	1	1	2	6	0	31	0	2	2	0	0	1	1	5	159	2	0	0	0	0	7	0	0	181	1	0	11	1	1	2	9	0	0	1	0	1137	0	0	17	22	0	1	9	1	1	0	19	27	56	3	0	4	0	3	13	1	0	10	0	0	1	2	176	0	1	1	1	9	1	0	1	1	0	4	2	0	4021	0	29	3	3	272	0	5	160	13	278	81	510	334	436	0	807	291	481	0	0	33	15	9	31	12	16	255	0	2776	8	3	46	5	1	152	4	0	0	9	46	68	1	1	14	1	1	190	0	3	0	38	8	46	10	54	45	22	2	14	0	3	2	46	9	37	35	6	4	0	2	3	0	2	0	1	1	66	1	0	2	2	29	0	2	26	0	11	0	3	3	34	2	2	0	7	0	0	25	3	0	1	0	3	0	22	0	49	0	1	0	38	9	0	88	2	0	0	6	112	1243	0	11	0	8	11	1	5	16	1	6	0	146	12	0	4	0	1	42	2	21	183	4	1	16	0	102	4	1	0	22	3	1	0	15	3	50	4	0	6	179	0	0	3	2	1	1	14	12	0	3	18	0	2	1	0	9	0	0	3	0	2	0	0	41	0	1	1	2	0	17	59	27	0	0	3	5	0	15	0	2	50	0	0	1	12	72	4	50	105	0	0	21	3	1	2	3	3	1	2	1	1	0	7	46	291	130	109	0	2	0	7	1	0	0	0	0	0	0	6	7	0	0	0	1	1	1	127	3	2	19	0	1	0	0	0	0	20	0	3	0	0	2	1	0	0	5	1	0	1	0	0	0	0	1	1	0	39	0	0	0	0	0	4	38	10	0	1	12	39	23	0	0	0	0	0	0	0	27	2	1	10	0	0	0	0	14	0	1	2	8	14	1	1	0	0	0	1	0	2	0	0	21	134	0	0	30	0	0	1	57	15	134	0	0	1	0	1	10	1	26	1	26	34	0	1	2	0	2	410	0	0	0	0	4	282	261	8	109	0	35	108	1	124	0	41	6	0	2	236	199	128	22	148	70	54	54	32	3	45	0	1	71	17	105	5	2	207	1	292	495	0	116	1	324	2	2	39	1	76	35	3	56	0	0	0	0	251	5	2	60	50	195	63	1	2	6	377	809	5224	0	3	35	4	0	3	1	1	7	3	0	1	0	0	122	33	353	22	0	6	0	0	0	0	0	11	14	9	11	8	12	6	8	104	234	0	12	82	56	4	0	5	0	5	62	53	2	4	105	5	52	5	102	3	1	44	6	1	0	0	54	1	0	1	99	0	0	3	0	0	0	0	70	6	1	0	0	0	43	2	18	4	1	3	3	0	1	13	65	0	1	3	0	0	1	0	0	9	6	2	0	4	0	1	1	4	1	2	2	10	4	1	83	232	196	233	18	0	0	1	2	0	0	3	0	2	0	0	0	1	0	2	0	0	0	0	2	1	3	2	0	0	62	0	2	3	1	2	0	0	0	0	0	0	4	7	0	1	1	72	1	3	0	0	5	38	251	1	30	174	0	159	3	116	2	0	0	0	0	2	0	0	2	0	0	1	0	38	4	35	2	0	0	1	0	0	1	2	2	8	12	0	1	10	1	12	1	1	212	178	0	0	1	22	0	0	38	4	139	3	24	0	0	3	0	0	39	2	39	0	0	0	8	38	3	3	16	20	4	65	4	0	3	41	10	0	8	238	173	28	3	0	0	0	9	137	74	10	0	1	0	3	0	5	2	1	45	0	0	3	0	0	22	10	6	47	0	0	0	0	0	0	10	18	4	0	183	7	0	1	2	3	0	0	1	0	226	23	1	0	6	7	1	2	7	4	20	2	4	0	0	2	0	0	13	1	1	3	1	0	1	3	0	56	6	51	2	2	1	2	0	0	0	3	3	0	18	6	3	0	46	0	4	1	0	1	0	2	38	8	1	3	131	131	59	2	0	5	1	0	1	0	0	2	0	2	0	1	7	2	1	2	2	2	3	5	0	0	0	0	57	57	0	3	0	0	1	2	2	30	2	24	5920	0	4	2	0	2	0	1	0	16	10	1	3	3	0	0	1	0	16	20	0	1	96	7	5	0	1	65	0	34	1	3	318	0	10	23	0	0	0	0	0	0	4	2	4	85	1	0	47	3	35	1	1	3	0	131	0	0	0	0	0	1130	0	0	0	0	0	0	0	3	22	4	0	3	1	2	2	2	0	1	0	3	1	10	44	22	0	1	1	0	49	6	1	0	1	0	43	43	0	6	8	1	784	2	76262	0	0	1	0	0	54	0	9	0	1	0	0	0	0	1	0	53	0	2	0	1	5	4	125	4	1	5	32	2	0	1	0	0	0	0	0	2	41	52	1	7	2	0	0	0	0	0	2	1	4	0	0	7	0	3	41	20	92	133	7	43	40	0	29	2	1	6	1	4	224	129	67	141	2	0	0	12	13	25	0	13	339	13	0	264	0	0	0	0	4	2	3	10	1	121	5	0	53	13	1	0	70	88	3	0	117	7	0	0	1	0	0	0	1	1	0	2	1	52	140	17	343	331	0	14	367	0	1496	6	221	1050	51	83	110	168	145	665	235	0	10	83	2	2	68	0	2	0	259	115	307	635	169	14	21	1	2	254	92	4	5	2	1	0	1	0	0	0	0	0	0	0	5	4	59	0	22	1	15	2	2	0	24	0	0	0	0	12	34	24	13	0	1	2	2	0	0	0	0	0	10	0	1	1	2	0	38	25	0	12	0	1	0	10	92	1	2	4	6	1	0	10	0	3	2	0	0	0	1	2	2	43	2	9	20	34	0	0	9	1	0	0	5	2	2	64	1	21	4	0	1	102	15	0	0	4	4	164	2	0	17	12	0	16	3	0	0	1	1	0	1	0	0	9	0	0	0	8	0	4	0	0	7	0	5	2	0	0	0	0	4	1	1	0	1	0	0	5	1	0	0	0	9	1	4	1	1	0	1	0	0	0	3	40	1	9	12	0	17	0	1	0	1	2	4	13	14	55	47	7	183	3	3	8	22	79	131	34	103	0	3	4	2	22	0	1	7	1	26	0	16	5	0	0	0	0	0	0	1	0	66	0	1	1	14	5	2	0	0	0	0	14204	85613	0	2	3	0	0	1	0	58	3	146	2	5	15	0	77	39	2	22	1	1	0	27	27	3	70	3	494	0	0	15	1	566	2	1	4	0	3	1	0	0	138	0	5	138	97	89	0	45	0	100	2	4	6	0	2	0	79	9	0	1	2	5	0	15	26	6	0	3	0	31	1	2	0	5	12	3	2	7	0	0	0	0	0	22	1	171	450	69	80	95	99	89	463	0	1	5	15	54	45	1	0	2	3	14	0	1	0	2	0	0	2	51	0	1	3	0	10	0	4	0	19	2	15	5	5	0	2	33	18	2	1	23	0	0	1	1	3	0	1	8	101	2	100	0	0	0	2	1	1	1	47	0	0	0	2	0	1	1	2	2	0	0	2	98	1	0	2	0	2	0	18	1	0	1	22	12	3	1	2	0	28	0	1	0	0	1	0	0	1	0	0	2	0	7	4	0	0	6	0	40	121	285	759	185	164	1	0	0	0	0	0	0	0	6	0	0	0	0	1	1	7	16	106	0	0	0	4	1	6	7	0	0	0	0	1	2	36	0	0	173	0	0	6	17	1	15	0	0	56	2	9	2	3	7	2	25	86	48	0	754	0	1	23	33	0	3	16	0	0	63	4	0	6	2	177	94	4	0	0	3	0	0	252	1	4	0	0	784	1	1	0	1	1	10	0	7	3	0	0	1	7	1	0	0	0	0	0	0	93	11	0	0	10	12	493	7	0	0	0	1	1	0	0	2	35	0	0	1	0	0	9	101	5	3	1	0	0	16	0	0	0	68	10	0	108	6	4	0	2	0	0	0	25	6	29	1	1	2	6	0	0	1144	2	3	3	8	13	15	0	0	18	236	36	1	1152	3	50	146	30	2	106	0	530	70	154	0	0	4	0	59	2	26	0	28	1	109	0	0	7	0	6	0	4	84	1	6	2	0	8	235	0	6	4	1	0	78	39	6	2	1	0	1	1	0	20	0	4	1	13	20	1	3	0	0	60	10	24	0	0	2	1	2	0	0	4	0	2	7	0	3	17	1	0	1	0	2	1	2	4	15	62	22	74	14	1	60	79	32	51	55	191	0	0	0	1	1	0	2	0	0	865	4	1	6	125	85	112	20	5	460	2	6	64	49	3	0	18	8	0	1	0	0	0	0	0	20	1602	95	8	0	0	0	0	3	5	0	24	0	7	8	21	10	0	1	0	1	0	0	0	3	1	2	0	1	1	4	0	0	1	4	9	0	0	0	0	0	0	0	4	7	0	0	0	0	0	0	0	2	0	0	0	1	7	0	0	0	38	3	18	3	0	5	4	4	1	4	0	5	4	0	69	0	0	15	18	22	226	26	1	1	5	1	0	0	25	27	0	0	1	0	27	2	8	0	0	38	0	16	45	1	3	15	1	5	13	14	36	183	8	0	1	0	0	1	0	0	0	111	3	24	4	35	4	80	14	1	131	2	7	15	9	0	1	1	43	187	146	51	0	46	21	80	1	24	1	19	0	3	8	0	0	3	2	15	1	0	0	0	33	5	7	28	0	0	2	15	3	9	30	1	38	7	0	51	6	91	3	34	49	3	10	146	3	122	2	0	1	1	0	9	0	2	3	138	6	100	3	0	0	20	1	4	0	2	0	0	0	0	0	0	3	5	4	3	60	36	2	33	54	85	1187	7	0	9	0	0	0	0	0	18	21	10	0	0	2	82	0	0	4	7	2	18	0	1	2	1	0	0	17	21	1	14	189	1	1	1	0	0	2	100	0	44	0	8	742	0	1	0	39	2	4	0	0	0	1	2	0	0	0	1	0	20	1	0	0	0	0	0	4	0	3	2	1	1	2	2	1	0	3	3	4	8	0	1	0	1	1	0	4	9	1	314	24	0	73	95	39	88	41	41	21	0	3	0	2	8	0	0	0	0	0	0	0	0	0	0	45	0	3	0	1	0	1	0	0	3	13	1	33	0	0	0	0	31	3	1	0	0	0	0	6	2	2	54	1	0	1	0	0	0	0	1	1	1	1	3	11	7	4	0	5	13	7	13	107	2	0	2	1	0	0	0	3	8	0	102	1	2	6	7	0	60	260	1	0	0	0	19	0	1	2	0	0	2	0	0	0	0	0	0	9	0	16	0	0	0	0	0	0	0	20	0	0	0	0	0	15	1	0	358	0	0	0	73	0	1	1	0	0	0	1	0	0	117	11	1	4	0	4	0	0	1	1	0	0	0	0	0	0	0	1	0	0	0	56	0	1	1	2	0	0	47	0	0	30	2	0	0	27	0	19	0	3	0	364867	2	0	0	0	2	5	1	1	1	1	2	0	1	2	2	2	0	0	1	0	0	0	0	0	0	0	0	1	3	12	0	0	1	0	0	0	0	0	95	0	0	1	1	62	1	0	0	0	1	0	0	2	1	0	5	0	0	0	0	41	0	0	6	3	0	2	0	0	11	0	0	2	2	0	0	0	0	0	0	0	0	42	2	0	0	0	0	0	0	0	0	0	0	0	0	0	0	5	0	0	0	0	5	2	1	0	6	0	10	0	0	1	0	0	0	2	3	5	2	0	1	2	13	0	6	2	1	0	0	2	1	3	0	0	3	2	1	3	1	0	56	0	199	0	0	1	1	0	0	1	2	1	1	1	0	1	2	16	4	3	1	1	0	0	4	1	4	90	2	0	0	0	79	1	2	0	1	2	0	3	0	0	2	0	0	2	2	0	36	0	4	0	0	2	3	2	4	10	2	2	0	1	2	10	0	2	3	0	3	0	13	1	1	0	1	4	7	4	4	1	2	2	20	0	0	10	0	1	8	1	1	0	6	0	0	1	0	0	3	2	1	2	1	0	0	2	0	1	3	116	2	9	0	12	17	14	6	31	154	1	0	0	5	3	112	0	2	0	1	0	2	0	0	0	0	60	0	7	0	0	0	18	0	1	1	564	11	7	0	2	10	0	0	109	0	86	0	127	29	0	6	0	29	0	0	1	1	1	0	0	0	0	0	4	8	0	25	0	4	4	4	0	3	4	0	2	0	0	3	0	0	0	0	0	0	0	1	0	0	0	0	0	0	0	1	0	4	51	6	1	1	0	4	0	12	32	0	0	0	2	0	1	4	0	0	3	1	0	1	180	5	7	0	13	0	0	0	1	5	0	0	1	0	3	4	1	1	0	0	6	0	0	247	1	0	0	1	0	0	10	0	0	1	572	1	17	1	3	0	0	7	1	0	1	0	3	0	4	0	0	12	0	0	2	0	0	73	47	3	135	35	0	0	0	2	0	2	21	0	6224	0	2	1	21	0	0	1	0	23	23	20	0	1	1	0	2	6	1	0	0	30	23	1	58	0	6	17	73	2	1	0	2	0	1	0	2	17	0	0	0	0	0	1	2	1	3	4	0	3	87	0	2	13	0	0	0	2	1	0	26	5	40	45	62	126	6	100	151	10	0	158	2	47	184	2	0	9	3	0	6	0	1	0	6	82	19	0	0	1	0	163	6	0	0	1	159	0	0	0	0	0	6	0	0	21	3	8	52	0	113	0	0	0	1	1	0	4	3	5	4	11	1	12	2	6	4	1	60	0	11	0	0	2	47	23	0	30	0	5	12	16	19	1	0	4	4	0	1	5	7	1	26	52	1	0	0	0	8	1	0	0	0	7	1	1	0	12	0	0	9	103	2	1	13	0	7	53	60	51	0	2	0	1	35	0	50	142	0	4	9	0	36	9	22	62	8	64	25	0	1	0	5	0	3	5	2	9	0	198	6	125	0	3	0	0	6	1	23	24	0	0	0	0	10	27	6	0	17	21	13	3	31	2	3	0	29	47	0	15	60	40	73	0	2	72	60	37	0	0	1	1	0	0	1	17	0	0	261	0	14	0	10	6	3	31	112	24	15	1	1	0	1	6	0	0	3	3	3	1	2	0	0	0	7	32	14	136	1	40	7	2	1	2	1	8	0	17	0	21	0	1	0	33	5	4	43	3	13	7	0	1	0	39	243	0	0	2	1	1	12	0	1	11	1	0	0	1	24	45	3	0	26	0	43	1	2	3	0	1	1	2	0	39	0	2	1	50	0	0	526	1	70	4	0	29	6	0	0	1	2	0	81	3	0	2	1	0	1	1	0	0	6	32	11	0	0	240	52	24	8	1	0	4	0	0	0	0	0	0	14	25	9	4	0	382	14	0	470	15	54	258	387	12	55	1267	388	8	625	865	27	196	53	25	34	0	0	4	3	0	2	0	3	2	1	0	1	28	1	0	0	0	0	0	2	0	0	0	2	0	17	4	9	20	19	0	0	0	0	0	0	3	0	0	2	0	0	0	0	1	0	0	0	0	1	0	0	0	0	0	3	0	25	16	0	0	1	0	0	3	0	0	0	0	0	0	0	1	0	0	0	0	1	0	0	0	2	0	118	30	0	363	7	0	0	16	0	1	0	89	59	98	8	15	4	96	2	0	3	1	5	17	0	0	0	0	0	0	12	50	12	17	8	113	162	0	2	0	20	1	44	1	22	1	2	12	0	0	6	0	2	6	17	1	1	1	0	0	53	6	67	2	18	0	12	8	40	0	50	0	38	0	20	22	16	0	0	26	87	1	0	0	1	0	0	0	11	4	16	0	0	55	9	8	60	0	22	0	0	3	2	5	7	1	1	358	1	0	1	0	2	349	0	0	0	2	55	2	5	0	0	1	0	0	0	31	0	1	21	45	0	14	40	0	4	0	42	0	1	1	2	1	1	9	25	4	32	0	2	0	2	0	45	6	0	8	50	24	7	50	13	33	0	11	0	0	17	1	1	10	1	6	0	1	57	0	2	0	2	19	1	46	1	2	63	0	0	0	4	2	3	0	1	1	0	0	0	0	1	0	0	0	0	4	4	0	0	0	0	0	1	1	6	16	0	0	0	1	0	0	0	26	6	2	39	74	0	12	0	2	18	304	62	113	70	1	15	362	300	0	8	461	1	67	2	12	6	7	1	0	45	0	69	69	6	5	8	3	0	1	5	46	4	0	0	22	21	584	0	0	0	0	0	0	0	7	0	6	3	1	0	0	0	0	0	0	30	1	409	2	138	71	11	2	41	24	19	0	0	0	0	0	151	0	0	0	4	0	107	1	12	12	13	3	20	17	2148	13	3	0	0	6	58	5	59	44	19	50	5	54	1	36	14	3	0	0	0	1	3	11	12	821	159	13	0	18	0	1	0	0	52	1	1	1	5	1	7	1	387	26	0	2	3	875	41	11	5	8	4	201	125	113	1	7	9	0	1	0	6	24	7	5	3	1	0	2	0	5	2	5	0	1	0	0	0	21	3	0	1	0	0	4	0	363	2	0	3	1	305	4	7	0	2	0	23	8	5	1	1	0	60	55	10	29	14	0	30	2	2	1	21	5	1	7	0	0	0	6	3	4	48	30	7	12	68	4	2	148	22	38	32	0	0	0	0	2	0	2	1	11	1	1	0	76	0	0	0	1	0	0	0	53	1	5	2	66	1	8	2	0	36	1	43	0	0	20	3	17	0	0	12	2	22	28	115	169	27	139	2	152	0	2	0	0	0	1	0	0	0	3	8	21	0	1	0	0	0	0	9	0	0	0	53	1	2	20	1	4	1	18	1	0	125	0	321	0	1	147	2	0	5	2	0	0	0	0	6	172	0	0	0	0	3	0	3	11	6	0	28	4	9	0	0	0	6	0	9	17	2	4	0	1	8	2	0	0	88	4	212	66	52	185	15	61	43	40	48	104	69	37	0	76	67	2	1	4	10	0	3	5	3	10	0	68	0	1	0	0	0	5	2	4	0	0	0	0	1	41	1	0	0	0	0	0	1	1	3	0	1	1	3	1	0	0	0	0	1	0	1	0	0	73	1	1	130	0	182	159	6	89	0	8	2	11	7	1	22	1	2	8	25	0	77	23	3	0	0	10	0	13	0	80	44	73	0	1	0	0	7	0	1	2	1	0	2	1	3	0	24	16	28	0	122	2	26	13	8	9	0	1	1	1	1	61	1	3	1	1	73	80	0	49	2	2	3	14	0	0	0	52	4	0	1	3	1	0	0	0	0	49	2	0	0	12	30	3	2	7	6	27	0	5	0	0	0	0	0	1	0	10	8	1	5	9	39	0	2	1	1	0	1	0	0	1	14	0	2	1	2
LakWasMe73_LOW10_2_rpkm	0	0	0	0	0	4	37	3	0	1	0	0	1	0	0	0	0	0	5	0	0	0	0	10	0	0	0	0	0	6	0	0	0	2	1	1	2	0	0	0	0	0	0	3	17	11	33	3	0	0	53	2	0	0	0	1	2	13	21	6	60	0	0	1	0	0	0	0	6	64	0	1	0	0	0	0	0	0	0	0	0	5	0	0	0	0	0	1	0	0	0	0	3	1	5	0	0	0	0	1	0	0	0	0	0	0	0	0	0	0	0	1	50	5	10	0	0	0	0	0	4	0	1	1	0	0	0	0	0	0	0	15	5	0	0	0	0	0	6	0	0	0	0	1	0	0	0	0	2	0	0	5	0	0	7	0	2	17	1	1	10	1	0	1	12	0	0	1	0	2	0	0	0	0	0	0	0	0	0	0	0	0	0	0	0	0	0	0	0	1	1	0	2	1	0	0	0	8	2	27	13	1	0	0	0	0	22	0	9	1	0	0	18	1	11	0	2	0	0	2	0	0	4	0	1	3	0	0	0	0	0	0	0	0	0	0	14	4	6	3	0	0	1	3	10	16	0	0	5	9	2	2	2	0	931	76	0	0	0	0	1	2	0	7	5	0	20	1	0	26	36	0	1	0	0	0	0	0	46	11	0	13	10	13	14	0	0	0	5	0	0	0	0	1	0	0	0	0	1	0	0	492	22	1	7	0	16	5	18	0	10	0	18	0	0	0	0	0	55	0	0	0	0	1	6	21	0	0	0	0	1	0	0	0	0	0	0	0	0	0	0	0	0	6	0	2	13	2	0	0	1	0	1	0	1	0	0	0	0	45	7	0	7	0	0	8	3	14	3	0	0	1	0	0	2	1	0	0	0	1	0	0	0	2	2	0	24	0	0	0	0	0	22	0	0	2	1	0	0	4	0	4	0	0	17	0	0	0	0	0	0	12	4	0	0	14	13	2	1	0	0	0	0	0	0	0	0	0	0	0	2	1	0	1	0	0	0	0	8	0	22	3	0	0	4	50	0	0	0	0	1	71	13	301	0	22	6	2	0	5	0	0	2	3	0	19	3	0	0	0	4	15	3	0	0	0	7	2	23	0	16	0	3	0	0	0	0	28	33	4	0	0	52	22	1	0	0	0	0	0	0	0	0	0	0	0	0	0	0	0	0	0	0	0	0	0	0	0	0	1	0	0	0	0	0	0	0	0	0	2	0	0	0	2	6	0	12	0	0	9	0	6	0	0	18	0	0	0	1	0	0	0	0	0	0	0	0	0	0	0	0	2	0	0	1	0	12	0	7	0	0	0	0	6	14	4	2	40	0	25	12	46	16	10	29	0	4	0	6	0	0	0	956	0	4	2	0	0	2	0	7	0	0	0	2	4	0	24	0	3	0	59	19	90	0	0	24	0	69	1	24	17	7	6	0	1	0	4	0	0	4	9	0	0	0	0	0	0	0	0	0	11	0	0	0	0	0	3	1	0	29	0	0	4	0	0	4	0	0	0	2	65	0	11	0	0	0	0	4	8	0	7	0	0	1	0	1	0	0	0	1	0	9	0	0	0	0	0	0	11	0	0	2	0	0	0	0	2	0	2	0	0	0	0	0	1	2	0	10	0	0	0	0	0	7	2	0	0	0	4	0	0	1	3	0	0	5	0	3	0	0	0	0	0	0	0	0	0	0	0	0	8	4	0	12	9	3	0	1	11	0	0	0	0	0	21	0	0	12	0	0	1	0	13	0	1	0	0	0	0	0	0	0	0	0	5	0	0	0	0	0	0	0	0	0	0	0	0	0	7	2	2	0	0	0	0	5	0	0	3	0	0	0	0	34	0	28	1	0	5	0	0	0	0	0	0	2	0	0	0	0	0	0	6	7	0	0	4	0	0	0	0	0	0	0	0	0	10	18	0	0	0	0	0	0	0	0	5	5	1	0	0	0	0	0	0	1	0	0	11	12	5	0	1	0	1	0	0	1	0	0	0	0	0	0	0	0	0	10	3	0	0	0	0	0	0	2	0	0	0	0	0	0	1	0	0	0	0	0	0	0	0	0	1	0	0	1	0	0	0	0	0	0	0	16	13	16	7	5	0	0	0	0	0	0	0	0	0	0	0	0	0	0	0	1	0	0	0	0	9	0	0	0	6	3	0	4	0	0	0	0	0	0	0	0	0	0	0	0	0	0	0	0	0	0	0	0	0	0	0	0	3	0	14	0	13	10	0	0	0	6	2	10	0	35	0	0	0	0	0	0	0	1	0	0	1	0	0	2	0	0	0	0	0	2	0	0	0	0	0	0	0	0	0	0	0	0	41	0	0	0	25	3	0	0	1	0	0	2	13	0	0	0	0	0	0	0	0	2	0	0	0	0	0	0	0	0	6	0	1	0	0	0	0	0	0	0	0	0	0	1	0	0	1916	0	0	0	0	13	0	26	0	1	0	2	0	5	0	6	3	0	8	0	0	0	0	0	0	0	6	0	0	0	0	0	0	0	0	0	0	0	0	0	0	0	0	6	0	0	3	0	0	0	0	2	0	0	1	0	0	0	9	0	0	0	0	3	9	2	0	1	0	0	0	0	0	0	0	0	0	0	0	0	1	0	0	0	0	0	0	0	0	0	0	3	0	0	0	0	1	0	2	0	0	0	0	0	0	0	0	22	3	0	0	0	0	1	0	1	0	1	0	1	1	0	0	0	1	0	0	0	3	3	2	31	29	1	0	0	4	1	0	0	8	0	1	2	0	0	0	0	0	4	0	0	0	0	1	0	1	0	0	0	0	0	1	0	0	13	0	0	0	0	0	0	0	0	7	0	0	1	0	2	4	0	0	0	0	0	0	4	0	0	66	67	0	0	1	5	0	4	0	0	6	0	0	0	0	2	0	0	0	15	0	1	4	1	5	0	2	1	1	0	1	0	0	0	0	1	0	0	0	0	0	0	3	0	0	0	0	0	0	3	0	0	0	0	1	0	4	1	0	0	0	0	0	0	0	0	1	0	0	11	0	0	0	1	0	4	0	0	1	0	1	3	0	21	11	19	4	0	0	5	0	0	0	0	0	0	4	0	1	2	0	0	0	4	4	0	1	0	0	2	0	6	0	4	0	0	7	0	0	13	5	0	1	3	2	1	0	0	0	1	0	18	0	2	4	1	15	7	4	11	0	0	0	20	6	0	0	0	0	0	6	2	0	1	0	0	0	0	3	6	4	1	0	12	0	0	0	0	0	2	0	3	0	0	0	3	2	10	23	1	1	13	0	1	1	1	0	0	0	0	4	1	0	0	0	0	0	0	0	0	1206	30	3	15	0	2	0	0	0	0	0	0	17	1	1	0	14	1	0	0	1	40	15	43	3	0	0	0	29	0	0	0	0	0	0	0	0	67	8	3	15	19	8	0	5	116	4	0	0	0	0	0	0	50	0	0	0	0	13	0	0	0	0	0	0	0	4	0	1	0	0	0	0	5	0	0	0	0	0	0	0	1	11	0	0	0	0	0	4	0	0	0	0	0	0	2	0	0	0	1	0	0	0	0	0	0	0	0	0	0	0	0	0	0	0	0	0	0	0	0	0	1	0	0	0	0	0	0	0	0	1	0	1	0	29	0	0	13	0	0	0	0	115	0	3	5	0	0	49	0	0	0	2	1	0	0	0	17	0	3	0	0	2	0	0	0	0	0	2	21	0	0	0	1	0	0	0	0	0	0	0	0	0	0	1	0	49	3	5	0	0	2	9	0	0	0	44	0	0	0	2	0	0	0	0	0	0	0	0	3	3	9	0	6	0	0	0	0	7	0	2	1	8	1	0	7	0	0	0	0	1	0	0	2	0	39	2	75	28	128	4	38	3	0	0	0	0	4	16	0	0	3	3	35	0	0	0	1	1	1	0	0	4	24	0	46	4	0	0	0	2	4	0	9	0	5	2	1	0	0	0	0	0	0	29	0	0	51	0	0	0	3	1	1	56	0	4	2	0	4	2	0	2	9	86	14	34	0	2	2	5	5	1	0	0	2	6	0	0	35	0	0	2	0	0	0	0	1	0	6	2	0	0	0	0	0	0	0	0	0	0	0	0	0	0	8	0	0	0	3	0	42	39	0	5	0	0	0	1772	3	0	1	0	0	0	1	0	0	1	0	0	0	1	0	0	0	2	1	0	0	0	0	1	0	0	0	16	0	0	0	0	0	7	1	0	0	1	3	0	2	5	3	0	9	0	0	0	0	0	0	0	10	0	0	3	2	0	1	2	8	99	1	5	0	15	53	0	11	3	8	0	9	6	6	3	11	1	0	2	0	0	0	0	0	0	0	0	0	0	0	0	0	0	0	0	0	3	0	5	150	0	0	0	0	0	0	0	0	0	0	0	1	0	0	0	0	0	1	0	6	0	0	0	2	0	0	0	0	0	0	0	2	0	0	0	0	0	0	0	0	0	1	0	0	0	0	0	0	0	0	0	0	0	0	0	0	0	0	0	22	0	2	1	0	0	0	0	9	0	4	7	28	4	0	0	0	0	0	0	0	0	0	5	0	0	18	0	2	1	0	1	2	0	0	0	0	1	0	0	0	1	4	1	4	2	0	2	2	0	0	0	0	1	0	0	0	0	0	0	0	0	0	0	0	0	0	0	0	0	0	0	0	0	0	3	0	0	0	0	0	0	5	1	0	0	0	3	0	0	3	31	0	0	0	0	0	0	0	0	0	0	0	0	3	0	0	0	2	4	0	0	2	0	0	0	0	1	0	1	0	0	0	33	1	2	0	0	0	0	0	0	0	0	0	28	0	0	0	0	0	1	0	0	0	6	0	33	15	26	1	0	2	0	0	0	4	0	26	4	1	0	0	0	1	5	0	3	0	0	0	0	0	0	0	0	0	0	0	1	0	0	0	0	0	4	0	0	0	0	7	5	0	0	0	0	0	0	0	0	0	0	0	0	0	0	0	0	3	0	1	8	0	2	0	0	0	2	1	0	0	279	0	0	2	11	4	1	2	0	3	3	0	0	0	0	0	2	22	0	0	2	0	0	0	0	0	0	1	0	9	0	0	0	0	7	0	0	15	0	3	0	0	0	0	0	2	8	0	0	0	0	0	1	1	0	0	0	0	0	0	1	7	2	0	4	1	0	0	0	3	2	0	0	5	0	1	0	0	0	1	0	0	1	0	1	66	1	0	0	0	0	0	0	0	4	0	1	0	0	0	0	0	0	0	0	1	1	0	0	0	0	0	0	0	0	0	0	2	0	0	0	0	0	0	1	0	0	23	0	1	0	5	0	0	0	24	0	0	0	0	0	0	0	0	0	0	0	0	0	25	63	42	95	152	40	135	110	3	63	46	35	144	35	30	39	3	103	272	5	19	7	271	243	155	269	375	36	54	24	56	3	79	3	0	0	0	0	0	0	0	0	0	0	12	70	0	0	0	0	0	0	0	0	0	0	0	0	0	0	0	11	0	0	0	0	5	0	0	0	3	0	0	0	0	0	1	0	0	0	0	1	0	0	0	0	0	0	1	0	0	5	0	0	0	0	0	0	0	7	12	0	0	0	0	0	0	3	0	0	0	1	0	0	0	0	113	0	0	1	0	0	0	0	0	0	0	0	0	0	0	2	0	0	0	0	0	0	0	0	0	0	0	0	0	0	0	0	0	1	0	6	0	0	1	3	0	0	0	0	0	0	0	0	0	0	0	0	0	3	1	0	0	0	5	0	0	0	0	0	0	0	0	0	0	0	0	0	0	6	0	1	0	0	0	0	0	0	0	0	3	0	0	5	0	0	0	0	1	2	0	1	0	0	0	0	0	0	0	0	0	0	0	1	0	0	4	0	0	0	0	0	1	0	0	0	0	5	0	2	0	453	1	0	1	0	0	0	0	0	0	0	0	0	0	7	0	0	2	0	1	11	0	0	0	0	3	0	0	57	4	0	1	1	0	14	0	0	4	1	1	0	0	0	0	0	0	4	0	0	0	0	1	0	0	0	2	0	0	0	0	0	0	0	0	0	0	0	0	0	0	0	0	0	0	0	0	1	8	0	0	0	0	7	0	0	27	83	4	0	3	0	0	0	0	0	0	0	0	0	0	0	0	0	0	0	19	1	0	4	0	1	0	0	0	0	0	0	13	13	0	0	0	0	75	0	0	0	0	0	0	0	0	0	0	0	0	0	61	7	0	0	0	0	0	0	0	0	0	0	15	2	1	0	0	0	0	0	2	5	0	5	0	0	0	0	0	0	0	0	0	0	0	0	88	0	0	0	0	1	0	0	0	0	0	0	0	0	0	0	0	0	0	0	0	0	0	0	0	0	0	0	0	1	1	0	0	0	0	0	0	0	1	0	22	0	0	9	0	2	0	0	2	0	0	0	0	9	0	2	2	1	0	0	0	0	0	0	0	4	0	0	0	0	0	0	10	0	1	18	33	1	0	16	19	3	0	7	0	12	0	16	0	9	0	13	1	15	3	0	0	5	0	6	0	11	0	0	0	3	0	1	0	4	3	5	2	2	2	2	1	0	1	1	0	0	84	0	0	0	1	22	0	3	0	0	0	0	4	2	0	0	0	0	0	0	3	0	0	0	0	3	2	0	0	0	0	27	0	0	0	0	0	0	0	0	7	0	0	0	0	1	2	0	0	0	1	1	0	0	0	0	0	0	0	670	1	0	13	9	4	0	9	0	5	0	0	0	84	0	0	0	0	2	19	0	6	0	0	1	0	0	0	0	0	3	0	0	7	5	0	70	0	3	0	0	0	26	6	1	0	0	0	0	0	1	0	0	1	0	0	1	0	0	36	0	0	0	41	13	0	0	0	0	0	0	520	288	241	0	0	0	0	1	0	4	0	2	0	0	0	2	0	0	35	126	9	1	0	0	0	0	0	0	0	0	0	1	0	0	0	0	1	3	0	0	1	0	0	0	0	0	0	0	0	0	13	22	0	0	1	0	0	0	0	4	2	0	0	0	0	0	2	1	0	0	0	0	0	0	0	27	1	0	0	0	0	2	0	1	5	0	0	0	2	1	0	0	0	0	0	0	0	423	1	0	0	4	1	0	0	0	0	0	0	0	0	0	0	0	0	0	0	0	0	0	0	0	0	0	0	0	0	0	0	1	0	0	0	0	0	1	0	0	1	1	0	0	7	0	0	0	0	0	0	0	0	0	0	0	0	0	0	59	0	0	0	0	0	0	12	0	3	0	0	0	0	16	0	0	0	0	0	2	1	28	6	0	3	0	0	2	0	0	28	0	0	6	1	0	0	0	0	0	0	0	1	1	0	3	0	0	0	0	0	0	0	0	0	56	0	0	0	0	0	0	0	0	0	0	3	0	0	0	0	0	3	0	0	0	0	0	0	0	0	7	0	0	0	4	20	0	18	6	0	0	0	0	0	0	0	0	6	0	0	2	0	3	0	0	0	0	0	0	0	1	0	0	0	37	0	3	7	2	0	8	0	1	1	0	0	0	0	0	0	0	0	0	0	1	0	4	5	0	14	0	10	392	1	0	0	0	0	0	0	0	0	3	0	0	0	0	0	0	38	213	0	2	0	0	0	1	0	0	0	0	0	0	0	0	0	0	1	2	22	4	0	0	0	0	0	0	0	0	6	1	2	0	0	0	0	0	0	0	4	1	0	0	0	0	1	1	0	0	0	0	1	0	1420	3	0	2	0	1	0	0	12	0	0	0	14	0	2	0	0	0	0	0	13	0	0	0	2	12	0	0	0	0	0	0	2	0	0	1	1	0	0	37	0	0	0	0	0	0	0	12	0	0	1	0	0	0	0	0	0	0	0	0	0	0	0	0	0	0	2	2	0	1	0	0	0	0	0	0	0	0	0	0	0	0	0	0	4	0	1	0	0	0	0	7	0	1	0	0	0	0	0	0	0	0	0	0	0	1	0	0	1	0	0	0	0	0	1	0	0	0	0	0	0	0	0	0	0	1	0	0	0	0	0	0	2	0	0	0	16	0	0	0	0	0	1	0	0	0	0	0	0	0	0	0	0	0	0	0	0	0	0	0	0	2	0	0	0	2	0	2	3	0	0	0	0	0	9	0	0	0	0	0	1	0	0	3	0	0	0	0	0	0	0	0	0	7	0	0	0	26	2	0	0	0	0	0	0	0	0	0	1	0	4	0	0	14	0	0	0	0	0	0	0	0	3	0	0	2	0	0	0	0	0	0	0	0	0	0	35	0	0	0	0	0	0	0	0	3	0	7	0	1	0	0	0	1	0	1	0	0	0	0	0	0	0	0	0	0	0	0	0	4	0	0	0	0	0	0	0	0	0	0	0	0	0	0	0	0	0	0	0	0	0	0	0	0	0	1	2	3	0	0	0	0	0	0	0	0	0	0	0	0	0	0	0	0	0	0	0	0	0	0	0	0	0	0	0	0	0	0	0	0	0	1	0	0	0	0	1	0	0	3	0	0	0	0	0	0	0	0	0	0	0	0	0	0	0	0	21	0	0	18	0	0	0	1	0	8	0	0	3	0	0	2	0	0	1	0	0	0	0	0	0	0	0	28	12	1	2	0	3	1	0	0	0	0	0	4	1	1	0	0	0	1	3	0	1	0	0	0	0	0	0	1	0	0	0	0	0	1	0	0	0	0	1	0	0	0	0	0	0	0	0	0	0	0	0	0	0	1	0	18	0	41	1	0	0	0	0	0	0	0	0	0	8	0	0	0	1	0	2	0	0	0	0	0	0	1	0	0	0	0	0	0	0	2	0	0	0	7	0	0	0	0	10	1	0	0	0	0	0	0	0	2	0	0	1	0	1	0	0	0	0	0	1	0	0	0	36	0	0	0	0	0	1	0	2	7	0	0	0	0	0	0	0	0	0	0	0	0	0	0	1	0	0	0	0	0	0	0	3	0	0	0	0	1	0	6	0	0	0	0	0	0	0	0	0	1	0	0	0	0	0	0	0	0	0	0	0	0	0	0	0	0	5	0	0	0	0	0	1	0	0	1	0	0	0	0	0	0	0	0	0	1	0	0	2	0	1	0	0	0	0	0	6	0	0	0	0	0	0	0	0	0	0	0	0	3	15	0	9	0	0	0	0	4	0	0	2	0	2	1	0	0	0	0	0	0	4	0	1	0	0	0	1	0	2	0	2	0	0	9	0	0	0	0	0	0	0	0	0	1	0	1	1	0	3	0	0	0	0	11	0	0	9	0	0	0	0	0	0	0	0	0	0	0	0	0	0	1	0	0	0	0	0	0	0	0	84	0	1	0	0	0	5	0	0	0	0	0	5	0	0	0	0	0	0	0	0	0	3	1	2	0	0	0	0	0	0	0	0	0	0	2	1	2	0	10	0	0	32	81	0	0	0	0	262	0	4	48	0	0	0	0	12	123	0	33	0	6	5	0	122	0	3	0	0	2	0	0	6	6	0	14	0	0	5	0	12	11	7	0	0	3	0	1	0	8	1	0	5	1	0	0	0	0	0	1	0	6	1	0	1	0	0	4	2	0	2	0	0	0	0	0	0	0	0	0	0	5	0	0	0	4	0	2	9	6	0	0	0	3	0	5	0	0	0	0	0	0	0	0	0	0	18	15	0	1	0	0	0	0	0	2	0	0	0	0	0	0	0	2	7	0	0	0	0	0	1	4	0	0	0	0	0	0	25	0	0	0	0	1	4	0	0	1	0	2	0	0	0	0	8	2	0	1	11	0	0	0	6	0	0	0	0	6	1	0	0	0	0	0	1	1	0	0	4	0	0	0	0	23	0	0	0	18	63	169	0	12	7	74	159	0	48	38	11	4	72	332	142	0	30	13	96	31	40	1	156	17	83	0	14	0	0	0	4	0	0	0	0	0	0	0	0	0	1	1	2	0	1	0	0	0	8	1	0	3	3	0	0	0	0	0	0	5	1	2	3	0	0	0	0	0	0	12	0	0	0	0	0	0	0	38	1	0	0	0	3	0	0	3	3	2	0	23	0	0	0	0	2	0	0	117	0	24	0	3	0	1	0	0	0	0	1	0	0	0	0	0	0	0	1	4	0	0	0	0	12	0	0	0	0	14	0	0	7	0	0	0	0	0	0	0	0	2	0	0	0	4	1	0	0	0	1	9	0	8	1	0	1	0	0	0	0	0	0	0	0	0	0	2	0	0	55	2	0	0	0	0	0	0	84	0	0	0	0	7	0	0	0	0	6	0	0	29	0	0	0	0	0	0	0	0	0	0	0	0	0	0	1	0	0	0	0	0	0	0	0	0	0	2	0	0	0	3	0	0	0	0	0	0	0	1	37	0	0	0	0	2	2	1	0	10	3	0	0	10	21	0	0	0	2	0	6	1	0	0	0	1	0	0	0	0	0	0	1	0	0	18	0	1	0	10	0	0	0	0	0	0	0	1	3	0	0	5	0	0	0	0	0	0	0	2	0	7	1	0	0	3	53	0	0	0	0	0	0	1	3	0	1	3	0	4	0	0	0	0	5	0	0	21	0	0	0	0	3	0	1	0	0	0	0	0	0	3	0	3	0	0	0	0	0	0	0	0	1	0	0	0	3	0	1	0	0	1	0	0	0	0	42	0	0	0	0	0	0	0	0	0	0	0	0	0	3	0	1	0	0	0	1	0	0	0	0	0	2	0	0	0	0	0	0	0	5	0	1	0	0	0	0	0	2	0	0	0	0	0	0	0	0	0	0	0	0	0	0	0	0	0	1	1	0	1	0	0	0	0	0	0	0	1	0	0	0	0	0	2	1	1	0	0	0	61	25	3	5	0	0	0	0	0	0	0	0	0	0	0	22	9	0	1	0	0	0	9	0	2	3	3	10	5	7	11	3	0	0	0	0	0	4	0	0	0	1	1	0	0	0	0	0	1	0	5	6	0	12	2	0	2	0	0	0	0	13	0	0	0	0	0	0	0	0	0	0	1	0	0	0	0	0	0	0	0	1	0	0	0	1	0	0	15	30	0	0	2	0	0	3	0	1	1	0	2	0	0	18	3	0	0	0	0	1	275	1	41	1	0	0	0	0	0	2	3	0	0	0	0	1	0	0	0	0	0	0	0	1	0	2	0	0	1	1	1	0	0	1	0	0	0	0	0	0	3	0	0	0	0	1	0	0	5	0	0	0	2	0	0	0	0	0	0	1	0	0	0	13	0	0	1	0	1	1	0	1	0	0	16	2	0	0	0	5	0	0	0	0	0	0	1	1	0	1	0	0	1	0	0	1	2	0	1	0	0	0	4	56	0	1	0	7	0	0	0	0	0	0	0	0	5	0	20	0	0	0	0	0	0	18	0	0	0	0	0	0	180	0	0	0	0	0	0	0	107	1	0	0	0	0	0	0	0	0	0	0	0	1	0	0	1	0	6	0	0	0	0	0	0	0	0	0	0	0	4	0	0	0	0	0	0	0	0	0	0	0	0	0	0	0	0	0	0	0	0	1	0	17	0	0	0	0	0	0	0	0	1	0	0	5	0	0	1	0	0	0	0	0	0	3	0	0	0	0	0	0	0	0	0	0	0	0	1	0	0	0	0	0	128	0	0	0	0	0	11	0	4	0	0	0	3	1	0	3	42	0	0	0	0	0	0	0	2	0	1	6	0	1	4	0	0	0	0	0	2	0	0	0	0	4	0	0	0	0	0	2	0	1	0	0	36	0	0	0	0	3	0	0	0	0	0	0	0	0	0	0	0	0	6	12	0	0	0	0	0	1	0	0	0	0	0	0	0	0	0	0	0	0	0	0	0	450	0	0	0	3	0	0	0	0	1	0	0	0	3	1	0	0	0	0	3	1	0	0	0	0	6	0	0	0	0	0	0	0	0	0	0	0	0	1	0	0	0	0	2	4	0	0	0	0	0	2	44	0	0	0	0	0	4	0	6	9	0	0	0	0	2	1	6	0	3	0	0	0	0	0	0	0	0	0	0	3	0	0	0	0	0	0	0	40	5	10	2	0	1	0	0	0	0	1	1	0	0	1	23	2	7	43	0	9	16	0	9	0	0	0	17	1	0	46	0	0	0	0	5	0	0	0	25	3	1	1	50	578	0	0	0	0	1	3	0	0	0	2	0	0	2	0	16	0	0	0	0	0	0	0	3	0	1	2	0	0	0	0	0	4	0	2	0	3	0	14	6	5	5	0	11	0	0	0	1	1	0	0	0	0	1	0	0	1	0	0	0	0	1	0	5	0	1	0	0	0	29	12	4	1	1	12	84	0	0	0	11	2	0	1	0	0	0	0	0	0	0	0	0	1	0	0	0	0	7	1	20	0	0	0	0	0	0	0	0	0	0	0	0	0	0	0	0	0	0	0	0	0	0	0	0	0	0	0	0	0	0	0	0	0	2	2	0	0	2	0	0	0	0	0	0	3	0	0	2	0	5	0	0	0	0	0	0	0	20	12	0	0	1	0	0	0	0	0	0	0	1	113	0	0	0	0	0	4	2	1	0	2	0	3	1	0	0	0	0	0	3	2	0	0	0	0	0	0	2	0	0	0	0	0	0	0	0	3	0	0	0	19	0	0	5	5	0	0	0	0	0	0	12	0	0	0	10	13	0	0	0	0	0	2	0	0	0	0	9	2	29	0	20	0	0	0	5	0	49	0	7	0	14	0	6	0	5	0	0	0	0	1	1	11	0	3	28	0	9	0	0	0	0	11	0	0	4	0	0	6	30	20	3	23	1	0	0	0	8	0	0	4	0	0	3	0	2	0	0	0	0	0	0	0	0	0	0	0	0	0	15	0	0	0	14	0	3	0	0	17	2	1	0	0	25	0	2	1	0	1	14	2	32	17	6	23	5	40	3	0	0	0	0	3	0	0	1	0	0	0	1	0	0	0	0	0	1	0	8	0	1	21	11	10	0	11	2	0	0	0	1	0	0	0	0	0	0	0	0	0	0	0	1	0	0	5	3	0	0	8	0	0	0	0	0	0	4	0	27	0	0	0	0	0	2	0	0	1	0	0	16	0	0	0	0	6	0	60	17	13	0	0	0	51	0	0	0	37	9	0	0	0	0	1	0	0	56	0	0	0	53	0	4	0	0	0	14	0	0	2	0	0	4	0	1	0	1	0	1	1	0	25	34	28	0	0	0	0	0	1	0	0	0	1	0	0	16	9	0	0	0	2	0	12	47	24	0	1	5	15	0	0	0	0	0	0	0	0	0	0	0	0	2	1	4	0	1	0	2	0	5	0	0	0	0	0	19	8	2	3	25	0	3	0	35	1	6	4	12	10	3	1	1	3	68	31	0	1	0	0	0	3	1	3	0	1	0	0	0	0	0	0	1	0	0	0	0	0	0	3	12	8	120	248	5	2	0	0	0	0	2	1	0	0	2	0	0	0	0	0	0	0	0	0	0	0	0	0	0	0	0	1	0	3	0	0	0	0	0	0	1	2	8	0	1	14	1	68	2	1	5	1	5	7	16	0	0	0	0	27	11	3	0	0	0	1	1	0	0	2	2	0	1	0	2	1	0	1	0	0	0	0	18	5	0	1	0	0	0	0	1	0	0	0	0	0	0	0	4	0	1	3	65	1	0	0	0	0	0	3	0	2994	0	1	0	0	6	7	0	0	0	0	0	0	0	0	0	12	5	6	0	0	0	0	0	0	1	1	2	0	0	18	0	0	1	0	0	0	1	0	0	0	4	0	0	0	0	0	0	1	0	0	2	2	0	0	0	0	0	0	0	0	0	0	0	0	0	0	2	13	0	7	4	0	4	0	0	0	0	3	7	0	0	0	0	0	0	0	0	6	0	0	0	0	0	0	1	0	0	0	0	21	1	0	0	125	0	0	0	0	14	0	18	2	33	5	0	0	0	0	0	0	1	57	0	0	0	0	74	0	0	0	0	0	2	0	0	0	0	0	0	0	605	5	8	0	4	528	0	3	22	1	6	0	197	146	149	66	7	5	8	0	1	84	27	19	4	3	0	0	0	723	0	1	43	0	0	28	4	0	0	148	0	0	0	0	0	0	0	2	0	0	0	3	2	12	28	5	3	7	6	2	0	2	0	14	5	1	10	0	0	0	0	0	0	0	0	0	0	2	0	0	5	1	1	0	2	0	0	0	0	0	0	0	0	0	0	3	0	0	1	17	0	0	0	0	0	36	0	0	0	3	0	1	14	0	16	9	0	0	17	6	19	0	0	2	42	19	0	2	3	0	2	0	5	0	0	28	0	0	2	0	1	29	4	0	6	3	9	7	0	0	13	4	0	0	14	2	0	0	1	1	11	0	0	2	2	1	0	0	0	0	0	10	0	0	2	0	0	0	0	0	0	1	0	0	6	0	1	0	2	0	89	5	6	0	0	0	5	0	9	1	1	3	0	0	1	22	1	0	4	6	0	7	3	3	2	5	2	1	4	2	0	0	2	5	2	43	28	9	0	0	0	0	2	0	0	0	0	0	4	1	6	0	0	0	0	0	2	21	7	0	3	0	0	0	0	0	0	3	0	0	0	0	0	0	0	0	1	0	0	0	0	0	0	0	0	0	0	0	0	0	3	0	0	0	17	2	0	1	0	1	0	0	0	1	0	0	0	1	23	0	0	0	0	0	0	0	0	1	0	0	0	2	1	3	0	0	0	0	0	0	0	0	1	106	0	0	56	0	0	0	1	11	4	0	0	2	0	0	1	0	3	4	16	7	0	0	0	0	0	0	0	0	0	0	5	0	3	0	0	1	0	2	2	0	0	3	3	7	1	1	28	3	3	1	2	1	3	1	0	1	0	0	0	0	1	5	2	2	5	1	4	2	2	3	1	5	3	0	1	1	1	2	3	0	0	0	0	2	13	1	0	1	7	3	0	1	37	17	3	50	0	22	0	0	0	0	0	0	7	0	18	0	3	0	119	38	87	1	0	12	0	0	0	0	0	56	6	18	54	49	11	54	1	8	83	0	1	0	39	12	0	0	0	0	0	21	0	2	2	3	4	1	0	1	14	33	5	0	0	0	1	0	2	0	1	0	0	0	0	0	0	0	1	0	0	0	0	0	5	1	0	1	0	0	3	0	0	0	0	0	0	0	0	0	0	0	0	0	0	0	0	0	0	0	0	1	0	1	0	2	1	0	2	6	1	3	9	0	0	1	0	0	0	0	0	0	0	0	0	0	0	0	0	0	0	0	21	0	0	0	0	0	0	0	0	0	0	0	0	0	0	0	0	0	0	0	0	0	0	1	0	0	0	0	7	0	42	2	5	19	0	9	1	22	0	0	0	0	0	0	0	0	0	0	0	1	0	6	3	7	2	1	0	0	0	0	0	0	0	0	5	3	0	22	0	7	0	1	5	15	0	0	0	10	0	0	3	13	11	7	2	0	0	3	0	0	10	1	17	0	0	0	15	7	1	0	2	6	3	8	11	0	0	15	44	7	0	45	82	5	0	1	0	0	8	1	10	8	0	2	0	0	0	0	9	0	0	0	0	0	0	0	2	0	0	8	0	0	0	0	0	0	7	0	0	0	7	0	0	0	0	0	0	0	0	0	3	5	7	0	1	13	0	6	0	0	1	0	2	0	1	2	0	0	0	0	2	0	0	0	1	1	0	5	9	3	1	1	0	0	0	0	1	0	0	0	12	1	0	4	0	0	0	0	0	0	0	0	1	2	9	1	7	3	1	0	0	5	0	0	3	1	0	0	1	0	0	0	0	0	0	0	1	0	4	1	1	0	0	0	11	0	0	0	0	0	1	0	1	0	2	3	1	0	0	0	0	0	0	0	9	1	1	0	0	6	0	0	0	0	11	15	0	0	6	24	3	0	0	12	0	9	1	2	55	0	0	7	0	1	0	0	0	0	0	0	0	18	14	0	9	2	8	1	0	0	0	1	0	0	0	0	0	2	0	0	0	0	0	0	0	0	0	0	0	0	0	0	0	2	0	0	0	5	0	0	1	2	0	0	0	0	16	1	0	0	1	0	40	27	0	2	0	0	2	0	23386	0	0	0	0	0	3	0	2	0	0	0	0	0	0	0	0	0	0	0	0	0	16	10	19	13	0	0	9	3	0	0	0	0	0	0	1	0	27	38	0	45	9	0	0	0	0	0	1	0	1	0	0	1	0	1	4	3	30	113	7	2	7	0	6	1	0	1	2	0	15	0	5	4	0	0	0	0	1	2	0	170	38	12	4	4	0	0	0	0	78	0	0	1	0	17	5	0	22	0	0	0	32	24	0	0	27	16	0	1	0	1	0	0	0	0	0	0	0	19	26	22	7	177	0	33	2	1	1	22	13	35	101	2	2	15	6	65	3	0	13	13	5	0	1	0	0	0	23	6	58	112	3	0	0	0	0	5	16	5	4	2	0	0	0	0	0	0	0	0	0	0	0	1	2	0	1	0	2	2	0	0	3	0	0	0	0	9	8	2	1	0	2	2	4	0	3	2	6	0	1	0	3	3	1	0	8	2	0	1	0	0	0	5	1	0	1	0	3	4	0	0	0	0	0	0	0	0	0	19	0	0	0	6	3	1	0	0	0	0	0	0	0	1	0	8	0	10	0	0	0	25	18	0	1	2	0	10	0	0	2	0	0	10	0	0	0	1	0	0	0	0	0	0	0	0	0	0	0	0	0	0	2	0	2	0	0	0	0	0	0	0	0	0	0	8	0	0	0	0	0	0	0	0	0	0	0	0	0	0	1	0	3	4	0	0	0	0	0	0	4	0	3	0	0	0	4	2	5	0	12	0	0	1	75	3	4	4	2	0	0	0	1	19	0	1	0	0	2	3	1	2	0	0	0	0	0	0	0	0	1	0	12	0	1	1	25	0	0	0	0	14	77	0	0	0	0	0	0	0	0	7	35	9	0	15	0	17	17	1	1031	0	1	0	5	5	9	15	4	12	0	0	3	0	4	0	0	0	0	0	1	0	0	1	1	1	11	1	6	0	0	0	4	2	0	0	0	0	0	0	0	0	0	0	1	0	13	0	5	0	2	0	0	1	0	0	0	0	0	10	13	0	0	0	0	0	0	0	16	114	39	4	4	2	18	1	29	2	1	0	3	4	0	2	3	0	1	0	0	1	0	0	0	0	11	2	0	0	0	0	0	1	0	0	1	0	0	3	0	11	1	1	3	0	16	0	0	0	0	0	0	0	0	39	0	3	0	0	0	0	1	0	0	1	2	0	0	0	0	0	0	0	0	0	0	3	23	0	0	725	0	1	0	2	0	0	1	1	0	3	0	0	0	0	0	0	0	0	0	0	0	0	1	0	0	0	0	12	1	0	14	0	3	4	3	9	0	2	0	0	0	0	0	0	0	0	0	1	0	0	0	0	0	0	0	58	0	0	0	2	0	0	0	0	0	0	0	0	0	0	0	0	6	0	0	0	14	1	10	1	0	3	3	1	0	1	1	0	1	18	4	0	2	9	11	14	114	71	32	179	0	0	16	0	0	1	2	2	0	0	0	0	0	0	0	151	0	0	1	0	27	0	0	0	0	1	137	0	12	1	0	0	5	3	0	0	1	0	0	0	0	2	2	0	0	0	2	150	26	0	0	0	2	0	0	0	0	9	0	0	0	0	0	0	3	16	0	0	0	0	4	0	0	0	36	7	0	22	6	0	0	1	0	0	0	2	3	8	4	0	0	1	0	0	0	0	0	1	0	2	2	0	0	3	35	7	1	483	0	0	0	0	0	2	0	5	6	5	0	0	0	0	2	0	5	0	6	0	0	0	0	9	0	1	0	9	33	1	18	3	0	11	42	0	1	0	0	0	0	0	1	0	0	0	22	0	0	2	1	2	0	1	0	0	3	0	0	5	51	0	0	0	4	0	0	0	0	1	17	4	12	0	0	15	1	0	1	0	0	0	8	5	0	13	3	19	13	0	0	10	0	4	16	18	0	0	0	0	0	0	3	0	0	126	0	0	5	8	11	7	0	7	2	0	1	2	3	4	0	32	5	0	0	1	0	1	0	0	42	133	52	0	0	0	0	0	0	0	0	0	0	1	0	1	0	0	0	0	0	0	0	0	0	2	0	0	0	0	0	0	0	0	0	0	0	0	0	0	0	0	0	0	9	0	0	0	0	0	0	0	0	0	0	0	0	0	0	0	0	3	1	11	2	0	4	0	0	0	0	2	5	1	1	0	0	0	7	224	3	27	4	5	9	0	0	1	0	11	1	0	0	0	0	4	0	2	0	0	1	0	0	4	0	12	8	0	0	1	0	0	29	10	0	5	0	2	0	0	0	0	17	11	6	5	25	3	17	4	1	18	2	0	1	0	0	0	0	3	9	32	7	0	16	11	18	0	0	0	4	0	0	0	0	0	1	1	0	0	0	0	0	25	0	0	0	0	0	0	0	0	0	1	6	4	2	0	1	2	38	15	2	5	0	1	137	29	32	0	0	0	0	0	0	0	2	0	24	1	81	11	0	0	1	0	1	0	0	0	0	0	0	0	0	0	0	0	1	0	10	0	2	4	7	17	17	0	4	0	0	0	0	0	1	0	0	0	0	0	7	0	0	0	0	2	0	0	0	0	0	0	0	4	6	0	7	17	1	0	4	0	0	0	1	0	15	0	0	1844	0	0	0	14	0	11	0	1	0	0	3	0	0	0	0	0	0	8	0	0	0	0	0	7	0	0	0	0	0	0	0	0	0	0	3	1	0	0	0	0	0	0	1	0	4	0	10	45	0	4	0	6	6	16	0	2	0	0	0	13	0	0	0	0	0	0	0	0	0	0	0	3	0	0	0	0	13	0	0	0	0	0	0	6	0	0	0	0	9	1	0	0	0	0	0	0	0	0	6	1	0	0	0	0	0	0	0	0	0	1	0	0	0	4	0	10	8	22	2	15	0	0	0	0	0	0	0	0	13	0	105	0	2	2	20	0	19	23	0	0	1	0	0	0	0	0	0	1	0	0	0	0	0	0	0	0	0	0	0	0	0	0	0	0	0	1	0	0	0	0	0	0	0	0	286	0	0	0	0	0	0	0	0	0	0	0	1	0	0	0	0	0	0	0	0	0	0	1	0	0	1	0	0	0	1	0	0	0	0	31	0	0	2	0	0	0	14	0	0	0	0	0	0	0	0	0	0	0	0	2	0	0	0	0	0	2	0	0	0	0	0	1	0	0	4	0	1	0	0	0	0	0	0	0	0	0	0	0	0	3	0	0	0	0	0	0	1	1	82	0	0	0	0	6	1	0	0	0	0	0	0	0	0	0	0	1	1	0	0	1	0	0	0	1	0	0	0	0	32	0	0	0	1	0	0	0	0	0	0	0	0	2	0	0	0	0	0	0	0	0	0	0	0	0	0	0	0	0	0	0	0	0	0	1	0	1	0	0	19	0	0	0	0	0	0	0	1	0	0	1	1	0	81	0	8	5	0	0	0	9	0	5	0	0	3	16	0	4	0	0	114	2	0	0	0	1	0	0	0	0	0	3	2	0	0	4	2	0	0	1	0	1	0	0	6	0	7	0	7	0	2	0	0	2	3	0	6	3	1	0	0	0	0	0	0	76	2	0	1	1	4	0	0	0	2	0	0	1	0	2	0	0	6	17	0	0	0	0	8	3	29	3	0	0	4	0	2	3	1	0	0	2	2	0	0	29	0	0	0	0	1	0	20	1	4	10	3	0	0	0	0	0	3	16	6	3	0	0	0	6	8	2	0	13	36	21	5	31	49	42	10	0	0	1	50	0	4	0	1	0	1	0	0	0	0	3	0	0	0	0	0	1	0	2	0	28	9	3	0	0	0	0	1	5	0	72	0	33	3	0	0	0	1	1	0	0	0	0	0	0	1	0	0	0	2	0	5	0	0	2	0	0	0	2	0	0	0	0	1	0	10	0	0	0	0	0	0	0	0	0	0	0	0	0	0	0	0	0	0	0	0	2	1	0	2	11	0	0	0	2	0	3	0	0	0	0	0	0	0	0	0	3	0	6	0	0	0	0	0	0	0	9	0	0	0	0	0	0	0	0	0	0	17	0	0	0	0	0	0	0	1	0	0	56	0	2	0	0	0	0	0	0	0	0	0	0	0	0	0	0	0	0	0	0	0	0	24	5	1	16	56	0	0	0	0	0	0	2	0	667	0	1	0	18	0	0	1	0	5	8	3	0	0	0	9	0	0	0	0	0	4	0	3	54	0	3	25	0	0	0	0	0	0	0	0	1	0	0	0	0	0	0	0	0	2	0	6	0	7	2	0	2	2	0	1	0	0	0	0	8	1	7	3	16	23	0	15	14	562	0	16	5	0	11	0	1	6	10	0	0	0	0	0	0	0	5	0	0	0	0	18	7	0	0	0	6	0	0	0	0	0	1	1	0	7	19	8	0	0	31	0	0	0	0	0	0	0	2	3	0	3	5	10	1	1	3	0	0	0	25	0	0	0	1	3	0	9	0	2	0	3	1	0	0	5	0	0	7	0	3	0	37	22	1	0	0	0	0	0	0	0	0	0	0	0	0	0	0	0	4	16	3	0	0	0	1	1	1	23	0	2	0	1	0	30	1	1	0	0	0	0	1	0	2	63	8	0	0	0	0	0	1	0	0	0	0	0	0	25	17	22	0	11	0	0	7	4	1	0	0	0	1	1	0	19	3	9	2	2	3	1	26	0	3	1	0	2	0	7	9	10	16	1	0	1	31	4	1	0	0	0	0	0	0	25	0	0	49	0	0	0	0	0	0	0	53	4	0	0	0	0	0	1	0	0	0	0	2	0	0	0	0	0	15	6	0	44	1	0	0	0	0	0	0	7	3	0	0	5	0	0	0	1	0	0	29	24	0	40	0	1	0	8	13	0	0	0	0	0	3	0	1	0	0	0	0	0	0	12	5	2	5	4	8	1	0	0	0	0	2	1	0	13	0	0	0	2	0	0	12	0	12	5	0	6	2	0	0	0	0	0	16	9	0	0	4	0	0	0	0	0	0	2	1	0	0	22	126	4	2	0	0	0	0	3	0	0	0	0	2	1	1	22	0	47	2	0	63	1	11	218	14	1	18	9	20	0	31	7	10	65	15	24	2	0	0	0	0	0	2	0	1	0	0	1	0	4	0	0	0	0	0	0	3	1	0	0	0	0	7	0	2	3	1	4	0	0	0	0	0	0	0	0	0	0	0	0	0	0	0	0	0	0	0	0	0	0	0	0	0	0	5	2	0	0	0	0	0	3	0	1	0	0	0	0	0	0	0	0	0	0	0	0	0	0	0	0	2	5	0	56	2	1	0	15	0	0	0	10	5	8	2	0	2	10	0	0	3	1	0	0	0	0	0	0	0	0	0	2	13	1	23	3	2	0	0	0	8	2	5	0	0	1	0	0	1	0	0	1	0	0	2	0	0	1	0	0	6	5	9	0	4	0	1	1	5	0	13	13	0	0	0	0	0	0	0	0	12	0	0	0	0	0	0	0	0	0	2	0	0	27	2	0	17	0	22	0	0	0	0	1	0	0	0	117	1	4	1	0	0	116	0	0	0	0	1	0	3	0	0	21	0	0	0	9	0	20	5	1	0	7	4	0	0	0	3	0	0	0	1	0	0	3	0	8	18	0	1	1	0	0	11	0	0	0	4	3	2	25	8	1	0	0	9	0	3	0	0	11	2	0	0	0	10	0	0	3	5	1	0	2	2	0	0	0	0	0	0	0	0	0	0	0	0	0	0	0	0	0	1	0	0	2	10	0	0	0	0	0	0	2	1	2	0	2	1	0	0	0	0	4	10	1	0	15	0	18	0	0	95	2	39	7	6	0	0	223	138	0	10	26	0	0	0	17	7	0	1	0	4	0	15	16	2	0	1	4	0	0	1	1	11	0	0	0	1	17	2	0	0	0	0	0	0	23	0	0	1	0	6	0	0	0	0	0	0	0	111	7	30	9	5	0	19	1	1	0	0	0	0	0	0	0	0	0	0	0	7	0	2	9	1	0	4	2	185	33	2	0	0	34	34	1	13	6	6	3	3	21	0	9	19	274	0	0	0	1	0	0	10	363	105	3	0	2	0	0	0	0	19	0	0	1	4	1	0	0	31	85	0	0	0	26	17	6	24	0	12	1	1	42	1	1	7	0	0	3	3	0	2	0	0	0	0	0	0	8	1	0	1	0	0	0	0	0	0	0	0	0	0	0	0	84	0	0	0	0	16	9	3	0	0	0	1	5	1	0	0	0	11	10	3	0	20	0	20	8	0	0	1	13	1	2	4	0	0	9	7	25	1	25	24	5	1	0	2	47	1	6	10	0	0	0	0	0	0	0	0	1	0	0	0	0	0	0	0	0	0	0	0	3	0	0	1	3	1	5	0	0	6	0	1	0	0	0	0	4	0	0	0	1	0	1	27	6	1	0	0	0	0	0	0	0	0	0	0	0	0	0	0	0	0	0	0	0	0	0	0	0	0	0	2	0	0	3	0	0	1	0	70	0	0	0	2	0	0	2	1	0	4	6	0	0	0	0	2	1	0	0	0	0	2	3	5	6	0	0	1	2	7	0	8	0	38	2	19	65	0	0	0	0	0	1	0	0	3	4	95	6	7	0	3	12	3	2	5	4	0	0	0	1	4	0	0	0	5	0	0	0	0	0	1	13	0	0	0	0	0	0	0	4	0	0	0	0	0	0	0	0	0	0	0	0	0	0	0	0	0	0	0	0	0	0	0	0	0	0	2	1	0	19	5	0	25	0	6	59	11	47	0	0	0	3	0	0	0	0	2	9	0	0	7	4	0	0	0	2	0	14	0	18	2	9	0	0	0	0	0	0	0	0	0	0	0	0	0	2	3	2	0	0	3	5	1	0	4	1	0	0	1	0	0	39	3	4	0	2	0	8	0	24	2	0	1	2	0	26	0	21	2	1	0	0	0	0	0	0	1	1	0	4	0	9	0	0	0	1	1	5	0	1	0	0	0	0	0	0	0	0	4	1	0	8	40	0	0	0	0	0	1	0	0	0	0	4	1	0	0
LakWasMe74_LOW10_2_rpkm	0	0	0	0	0	6	10	0	0	0	0	33	2	0	1	0	0	1	17	0	0	0	0	26	0	0	0	0	0	5	0	0	0	10	2	5	1	0	0	0	0	0	0	0	39	52	55	14	0	1	0	3	0	0	0	5	1	36	33	15	109	0	0	0	0	0	0	0	8	67	1	1	0	0	1	0	0	0	0	0	0	31	0	0	0	0	0	3	0	0	0	0	10	3	9	0	0	0	0	1	0	0	0	0	0	0	0	0	0	0	0	1	61	19	23	0	0	0	0	0	10	0	1	2	0	0	1	0	0	0	0	27	13	0	0	0	0	0	9	0	0	0	0	0	0	0	0	0	7	0	0	14	1	0	60	0	4	16	8	1	8	2	0	0	12	0	0	1	0	4	0	0	0	0	0	0	0	0	0	0	0	0	0	0	0	1	0	1	0	2	0	0	9	1	0	0	0	8	3	39	19	0	2	0	0	0	29	0	26	2	12	8	51	1	10	0	4	0	0	4	0	0	14	0	0	14	0	0	0	0	0	0	13	0	0	0	82	14	12	2	0	0	8	4	17	22	0	0	10	23	9	11	2	0	1352	160	0	1	0	0	0	0	0	22	5	0	0	0	2	49	22	0	8	0	0	0	0	0	48	29	0	31	10	8	22	0	0	0	11	1	1	0	0	1	0	0	2	0	1	0	0	136	35	0	8	0	27	10	13	0	9	0	37	4	0	0	0	2	1	0	0	0	0	0	2	18	2	0	1	0	0	0	0	0	0	0	0	0	0	0	0	0	1	15	2	0	22	8	0	0	1	0	0	0	0	0	0	0	0	50	11	0	7	0	0	8	6	16	12	0	0	4	0	0	2	3	0	0	0	2	0	0	1	2	1	0	99	0	0	0	0	0	49	0	0	26	9	0	0	2	0	14	0	1	37	0	1	0	0	0	0	14	15	0	2	18	35	1	1	0	0	1	0	0	0	0	0	0	0	0	0	0	0	0	0	1	0	0	9	0	61	21	0	0	9	56	0	1	0	0	0	120	17	159	0	33	10	0	0	5	0	0	0	4	1	35	2	0	0	3	6	53	8	1	0	0	8	4	256	0	7	0	0	0	0	0	1	102	21	4	0	2	59	42	2	0	0	0	0	0	0	0	0	0	0	0	0	0	0	0	0	0	0	0	2	0	0	0	0	2	0	0	0	0	0	0	0	0	0	0	1	0	0	1	12	0	28	0	0	20	0	16	1	8	36	1	0	0	0	1	3	0	0	0	1	6	0	0	0	0	0	0	0	0	4	4	22	0	22	0	0	0	0	1	7	2	9	80	0	65	39	106	43	27	81	0	20	0	13	0	0	0	6	0	7	0	0	0	1	0	47	1	0	0	2	8	0	68	0	6	0	161	54	124	0	0	53	0	146	1	107	33	13	6	0	2	2	3	0	1	6	22	0	0	0	0	0	0	0	0	0	15	0	0	0	0	0	4	4	0	52	0	3	10	1	0	0	0	0	0	3	152	0	133	0	0	0	0	20	10	2	15	0	0	2	0	3	1	0	0	1	0	7	0	0	0	0	0	0	17	0	0	6	1	3	0	0	2	0	2	0	0	0	2	0	0	0	0	7	0	0	0	0	0	2	2	0	0	0	2	0	0	3	5	0	0	5	2	11	0	0	1	1	0	0	0	1	0	0	4	0	18	6	2	16	24	5	0	1	26	0	0	0	0	0	11	0	0	15	0	0	2	0	40	0	2	3	0	0	0	0	0	0	0	0	17	0	0	0	0	0	0	1	0	0	0	0	0	0	8	0	3	0	0	0	1	7	0	0	11	0	0	0	0	60	1	13	0	2	0	0	0	0	0	0	0	4	0	0	1	0	0	0	21	12	1	0	4	1	0	2	0	0	0	0	0	0	36	36	0	2	0	0	0	0	0	0	5	17	0	0	0	11	0	0	0	1	0	0	13	29	3	15	0	0	0	0	0	0	1	0	0	0	1	0	0	0	13	106	8	0	0	0	1	0	1	3	0	0	0	0	0	0	4	0	0	0	0	0	0	0	0	0	1	0	0	0	0	0	0	0	0	0	0	24	16	25	11	11	0	0	0	0	0	0	2	0	0	0	0	4	0	0	0	1	0	0	0	0	15	0	0	0	13	9	0	10	2	0	0	0	0	0	0	0	0	0	0	0	0	0	0	1	0	0	0	0	0	0	0	0	6	1	237	0	18	2	0	0	0	6	4	19	0	49	0	0	3	1	0	0	0	3	0	0	0	0	3	3	0	0	0	0	0	0	0	0	0	0	0	0	0	0	0	0	0	0	77	0	0	0	55	24	0	0	3	0	0	2	46	2	0	0	0	1	0	0	0	5	1	0	1	0	0	0	0	0	20	0	0	0	0	0	1	5	128	0	0	0	0	2	1	0	1	0	0	0	0	37	0	25	0	1	0	4	0	7	1	17	2	0	2	0	0	0	0	0	0	0	6	0	0	0	0	0	0	0	0	0	0	0	0	0	0	0	3	19	0	0	16	0	0	0	0	2	0	0	1	0	0	5	2	0	0	0	0	22	36	9	0	0	0	0	0	0	0	0	0	0	0	0	0	0	1	1	0	0	0	0	0	0	0	0	0	10	0	0	0	0	1	0	0	0	0	0	0	0	0	0	0	2	3	0	0	0	0	0	0	0	0	0	0	0	4	0	0	0	0	0	0	2	0	8	11	155	100	1	0	0	5	1	0	0	6	0	4	1	1	0	0	0	0	18	0	0	0	0	1	0	3	0	1	4	0	0	0	0	0	36	1	0	0	0	0	0	0	0	23	1	0	1	0	3	1	0	0	3	0	1	0	2	0	0	86	99	0	0	0	3	0	19	0	0	5	0	0	0	0	1	0	0	0	22	3	3	3	0	178	2	7	1	0	7	7	0	3	0	0	4	0	0	0	0	0	0	7	0	0	0	1	0	0	3	0	0	1	3	1	0	8	0	1	0	0	0	0	0	0	0	0	0	0	22	0	0	0	0	0	1	0	0	0	0	1	6	0	39	19	42	22	0	0	6	2	0	0	0	3	0	4	0	3	1	0	0	0	19	13	0	1	0	0	6	0	17	0	11	3	0	26	0	0	32	11	1	4	16	3	3	0	0	0	2	0	8	1	5	6	2	15	11	4	24	0	0	2	50	17	0	0	0	0	2	15	2	0	2	3	2	1	0	5	17	16	0	0	35	0	0	0	0	0	4	3	10	0	0	0	17	1	14	46	1	1	26	0	4	5	1	2	0	1	0	14	3	1	0	0	0	0	0	0	1	2208	37	2	20	0	0	1	0	0	0	0	3	77	0	1	1	17	0	0	0	1	37	19	19	17	0	0	0	89	0	0	0	0	0	0	0	0	65	13	7	30	33	13	0	4	188	9	0	0	0	0	0	0	63	0	0	0	0	8	0	3	0	1	0	0	0	17	0	3	0	0	0	0	13	0	0	0	0	0	0	2	7	15	0	0	0	0	0	4	0	0	0	0	0	0	4	0	0	0	3	1	0	0	0	0	0	0	0	0	0	2	0	0	0	0	0	0	0	0	0	1	0	0	0	0	0	0	0	0	0	0	1	1	0	120	0	0	48	0	1	0	0	156	0	4	4	0	0	562	0	2	3	2	0	0	0	0	22	0	4	0	0	0	0	0	0	0	0	4	30	0	0	0	4	0	0	2	0	0	1	0	0	0	0	3	0	66	15	28	0	0	6	17	0	0	0	14	0	0	1	0	0	0	0	0	3	0	0	1	9	13	15	0	6	0	0	0	0	13	0	5	2	10	3	0	10	0	0	0	1	1	0	0	4	0	23	4	81	63	223	7	118	1	0	0	0	4	5	32	0	0	1	1	88	0	0	0	5	4	1	0	0	6	33	0	91	8	0	7	0	1	5	2	3	0	10	3	0	0	0	0	0	0	0	57	0	0	45	0	0	0	38	2	1	316	1	3	5	0	15	3	0	3	21	161	11	35	0	8	0	18	3	1	0	0	1	14	0	0	99	0	2	1	0	0	0	0	7	0	0	13	0	0	0	0	0	1	0	1	0	0	0	0	2	0	0	0	0	0	18	0	232	41	0	6	0	0	0	14355	7	0	6	0	1	0	0	0	2	0	1	0	9	0	0	0	0	7	0	0	0	0	0	1	0	0	0	25	0	0	0	1	4	14	1	0	0	1	3	0	2	7	1	0	13	0	0	0	0	0	0	0	14	0	0	6	6	0	0	0	20	148	1	32	0	33	64	0	25	3	27	3	17	10	8	4	25	6	0	9	0	0	0	0	0	0	0	0	0	0	0	0	0	0	0	2	0	16	0	14	450	0	0	0	0	0	0	0	3	0	0	0	1	0	6	0	1	0	0	1	27	0	1	0	1	0	0	0	0	0	0	0	2	0	0	0	1	0	0	0	0	0	0	0	0	0	0	4	0	0	0	0	0	0	0	0	0	0	0	0	32	0	2	2	0	1	0	0	24	0	7	4	113	2	4	0	0	0	1	0	0	0	0	13	0	0	15	0	0	0	0	3	3	0	0	0	0	0	0	0	1	0	9	2	9	8	0	2	3	0	0	0	7	5	0	1	1	0	0	0	0	0	0	0	0	0	0	0	0	0	0	0	1	0	0	0	1	0	0	0	0	0	3	0	0	0	1	0	0	0	2	191	3	0	0	0	0	0	0	0	3	0	0	2	3	0	0	0	1	2	0	0	10	0	0	1	1	2	0	3	1	0	1	16	0	1	0	0	0	0	0	0	0	0	0	15	0	0	0	0	0	3	0	0	3	9	0	18	34	31	2	0	3	0	0	0	10	0	52	7	0	0	0	0	0	7	0	7	1	0	0	0	0	0	0	0	0	0	0	1	1	0	0	0	0	3	0	0	0	0	12	10	0	0	0	0	0	0	0	0	0	0	0	0	0	0	0	0	3	0	0	2	0	11	3	0	0	0	1	0	0	400	0	0	19	109	26	2	14	0	13	5	0	0	0	0	0	1	49	0	0	1	0	0	0	0	0	0	2	0	7	0	0	0	0	25	0	0	19	1	20	0	0	0	0	0	1	13	1	0	0	0	0	2	0	0	0	0	0	0	0	0	31	7	0	5	2	0	0	0	5	17	0	0	0	0	0	0	0	1	2	0	0	0	0	1	83	2	0	0	0	0	0	0	0	0	2	2	0	0	0	0	0	0	0	0	1	0	0	1	0	0	0	0	0	0	0	0	0	0	0	0	0	0	2	5	0	0	0	1	0	0	10	0	3	0	7	0	0	0	0	0	0	3	2	0	0	0	0	0	24	75	57	62	161	75	102	172	11	64	52	52	279	44	18	34	3	112	294	8	30	1	298	298	93	613	536	86	102	19	43	5	63	11	0	1	0	0	0	0	0	0	0	0	53	83	0	0	0	1	0	0	0	0	1	0	0	0	0	0	0	13	0	0	0	0	8	0	6	0	3	1	0	0	0	0	5	0	1	0	5	0	0	2	1	0	0	0	1	0	0	4	0	0	0	0	1	3	0	13	8	0	0	0	0	0	0	8	0	0	0	1	0	0	1	0	166	0	0	6	1	0	0	0	0	0	0	0	0	0	2	3	0	2	0	0	0	0	0	0	0	0	0	0	1	0	0	0	0	0	4	15	0	0	5	3	0	0	0	0	0	1	0	0	0	0	1	0	0	14	8	1	0	0	2	0	0	0	1	0	0	0	0	0	1	0	0	0	0	20	0	0	0	0	0	0	0	0	0	0	11	0	0	18	0	0	0	0	0	2	0	2	0	0	0	0	0	0	0	0	0	0	0	3	0	0	4	0	0	0	0	0	0	0	0	0	0	5	0	2	0	332	0	0	7	4	0	0	0	0	1	1	0	0	0	0	0	0	4	0	2	25	0	0	0	0	11	0	3	93	7	0	1	2	0	25	0	1	1	5	4	0	0	0	0	0	0	6	0	1	0	0	0	0	1	0	1	0	2	0	0	0	1	0	0	0	0	0	0	0	1	0	0	0	0	0	0	0	15	0	0	0	0	11	0	2	33	161	3	0	1	0	0	0	0	0	0	0	0	0	0	0	0	0	0	0	43	2	1	1	0	0	0	0	0	0	1	0	18	26	0	0	0	0	190	0	0	0	0	0	1	0	0	0	0	0	0	0	109	30	0	0	0	0	0	0	0	1	0	0	49	5	4	1	0	0	0	0	11	4	0	1	0	0	0	0	0	0	0	0	1	1	0	0	419	0	0	0	0	0	2	0	1	0	0	0	0	1	0	0	2	0	0	0	0	0	0	0	0	0	0	0	1	2	1	0	0	0	0	0	0	0	0	0	29	0	0	20	0	1	1	0	6	0	0	0	0	22	0	10	5	0	0	0	0	0	0	0	0	8	0	0	0	0	0	0	32	0	3	40	79	0	0	31	42	6	0	35	0	33	0	52	0	19	1	27	0	21	10	14	0	13	0	10	0	21	0	0	0	9	0	1	0	3	7	5	4	11	2	3	2	0	3	2	2	0	169	0	0	0	0	1	0	7	0	1	0	1	8	5	0	0	0	0	0	0	7	0	0	0	0	4	6	0	0	0	0	114	0	0	0	0	0	0	0	0	11	0	0	0	0	1	7	1	0	0	3	1	0	0	0	1	0	1	0	1078	0	1	15	21	12	1	12	1	9	0	0	0	93	0	0	0	1	1	28	0	10	0	0	2	0	0	0	0	0	12	0	0	5	5	0	146	0	17	0	0	0	21	29	0	1	0	3	0	0	0	0	0	3	0	0	15	0	0	41	0	0	0	20	15	0	0	0	0	0	0	443	294	159	1	0	0	0	2	0	7	0	11	0	0	0	1	0	0	15	251	19	0	0	0	0	0	0	0	11	0	1	0	0	0	1	0	0	2	0	0	0	0	0	0	0	0	0	0	0	0	23	36	0	0	1	0	0	0	2	32	4	0	0	0	0	0	8	0	0	0	0	0	0	0	0	125	0	0	0	0	0	2	0	0	8	0	0	1	0	4	0	0	0	0	0	1	0	1127	1	0	0	1	1	0	0	0	0	0	0	0	0	0	0	1	2	0	0	0	0	0	0	0	0	0	0	0	0	0	0	0	0	0	0	0	0	0	0	0	0	0	0	0	13	0	0	0	0	0	0	0	0	0	1	0	0	0	0	37	0	0	0	0	5	0	29	0	0	0	0	0	0	19	1	0	0	0	0	9	2	19	5	0	8	0	0	2	0	0	52	0	0	19	0	0	0	0	0	0	0	0	0	11	0	0	0	0	0	0	0	0	0	0	0	22	0	0	0	0	0	0	0	0	0	0	17	1	0	1	0	0	4	0	0	1	0	0	0	0	0	7	1	0	0	12	35	0	12	11	1	0	0	0	0	0	0	0	6	0	0	0	0	14	0	1	0	0	0	0	0	0	0	1	0	118	0	4	45	4	0	13	0	2	0	0	0	0	4	0	0	0	0	0	0	4	0	11	16	0	10	1	12	873	0	0	1	0	0	0	0	0	0	3	0	0	0	0	0	0	91	628	0	1	0	0	0	6	0	0	0	0	0	0	0	0	0	0	2	4	26	12	0	0	0	1	0	0	0	0	8	0	7	0	0	1	0	7	0	0	19	1	0	0	0	0	11	1	0	0	0	0	6	0	823	9	0	2	0	0	0	1	15	0	0	0	22	0	2	0	0	0	0	0	33	0	0	1	3	16	1	0	0	0	0	0	0	0	0	0	0	0	0	51	0	0	0	0	0	0	0	21	0	0	0	1	0	1	0	0	0	0	0	0	0	0	1	0	7	0	2	1	0	1	0	0	0	0	0	0	5	0	0	0	0	0	0	0	3	0	0	0	1	0	0	3	0	2	0	0	0	0	0	2	0	0	0	0	0	0	0	0	0	0	0	1	0	0	1	0	0	0	0	0	0	3	0	0	0	1	0	0	0	0	1	0	9	0	0	0	37	1	0	0	0	0	0	0	0	0	0	0	0	0	0	0	0	0	0	0	0	0	5	0	0	1	0	1	0	2	0	0	1	0	4	0	0	0	17	0	0	1	0	0	0	0	0	1	0	1	0	0	0	0	0	0	0	12	2	0	0	43	7	0	0	0	0	1	0	0	0	0	0	0	6	0	0	17	1	0	0	0	0	0	0	0	8	0	0	0	0	2	1	0	0	0	0	0	0	0	50	0	3	0	0	0	1	0	0	4	4	34	0	0	0	0	0	1	0	3	0	0	0	0	0	0	0	2	0	0	2	0	0	1	0	0	0	0	0	0	0	0	0	0	0	0	0	0	0	2	7	0	0	0	0	0	0	0	0	0	3	1	0	0	0	0	0	0	0	0	0	0	0	0	0	0	0	0	2	0	0	0	0	0	0	0	0	0	0	0	0	0	0	0	0	0	0	0	0	1	1	0	0	19	0	0	0	0	0	0	0	0	0	1	0	1	0	0	0	0	27	0	0	97	0	3	1	0	0	5	0	0	8	0	0	11	0	0	0	0	0	0	0	0	0	0	0	130	57	2	0	0	34	3	0	0	0	0	0	5	3	4	0	0	0	0	4	0	1	0	0	0	0	0	0	0	0	0	0	2	0	2	0	1	0	0	1	0	0	0	0	0	0	0	0	0	1	0	0	0	0	0	0	31	0	66	3	0	2	0	0	0	0	0	0	0	1	0	0	0	0	0	8	0	0	0	0	0	1	0	0	0	0	0	0	0	0	1	0	0	0	4	0	0	0	0	12	0	0	0	0	2	0	0	0	4	0	0	0	0	0	0	0	0	0	0	0	0	0	0	47	0	0	0	0	0	4	0	1	41	0	2	0	0	0	1	0	0	1	0	0	0	3	0	0	0	5	1	0	0	0	0	0	0	0	0	0	1	0	35	0	0	0	0	0	7	0	0	0	1	0	0	0	0	0	0	0	1	0	0	0	0	0	0	0	0	10	1	0	0	0	0	0	0	0	0	0	0	0	0	0	0	0	0	0	2	0	0	5	0	1	0	0	0	0	0	18	0	0	0	0	0	0	0	0	2	0	0	0	12	83	0	4	0	0	0	0	0	0	0	1	0	14	3	0	0	0	0	0	0	18	0	7	0	0	0	0	0	0	0	0	0	0	21	0	0	0	0	0	0	0	0	0	2	0	13	1	0	6	0	0	0	0	12	0	0	10	0	0	1	0	0	0	0	0	0	0	0	0	0	0	3	0	0	0	0	0	0	1	0	87	1	10	0	0	0	3	0	0	0	0	0	13	0	0	0	0	0	0	0	0	0	0	1	4	0	0	1	0	0	0	0	0	3	0	8	2	3	0	28	0	0	29	101	0	0	4	0	449	0	24	81	1	0	0	0	27	228	0	93	0	5	45	0	564	0	5	0	0	3	0	0	10	23	0	26	0	0	13	0	29	17	10	0	0	1	0	8	0	19	0	0	10	1	0	1	0	0	0	1	0	15	9	1	0	0	0	16	0	0	18	0	0	0	0	0	0	0	0	0	0	6	0	0	1	1	0	0	26	6	0	0	0	4	0	2	1	0	0	0	0	0	1	0	1	0	57	44	0	0	2	0	0	0	0	7	3	0	0	0	0	0	0	7	11	0	0	0	0	0	0	13	1	0	0	0	0	0	2	0	0	0	1	2	7	0	0	0	0	10	0	0	0	1	4	3	0	1	19	0	0	0	10	0	0	3	0	11	7	0	0	0	2	0	4	1	1	0	23	0	0	2	0	35	0	0	0	30	64	209	0	21	4	40	404	0	77	22	13	7	204	274	86	0	150	14	103	39	26	2	103	6	112	0	13	0	12	0	0	0	0	1	0	1	0	0	0	0	0	11	1	0	0	0	0	0	44	0	0	3	4	0	0	0	0	0	0	0	1	2	6	0	0	0	0	1	0	20	0	0	0	1	0	0	0	27	7	0	0	0	12	0	0	2	2	5	0	44	0	0	0	0	3	0	0	165	5	27	0	12	0	0	0	0	0	0	0	0	0	0	0	0	0	0	0	21	0	0	0	0	18	0	0	0	0	27	0	0	7	0	0	0	0	0	0	1	0	6	3	8	0	3	1	0	0	0	2	2	0	12	0	0	2	0	0	0	0	1	0	0	0	1	0	12	0	0	52	2	0	0	0	0	0	0	218	0	0	0	0	9	0	0	0	0	19	0	0	39	0	0	2	1	0	0	0	0	0	0	2	0	0	0	0	0	0	0	0	0	0	0	0	0	0	6	0	0	0	1	0	0	0	0	0	0	0	5	55	0	0	0	0	0	1	0	2	6	9	0	0	136	129	1	0	0	3	0	14	0	0	0	1	3	0	0	0	0	0	1	0	0	0	74	1	3	0	20	0	0	0	0	0	0	0	1	6	0	0	4	1	0	0	0	0	0	0	4	1	5	1	0	0	0	113	0	0	0	0	2	0	2	4	1	7	7	0	3	0	0	2	2	6	0	1	26	0	0	0	0	25	0	4	0	0	0	0	0	0	5	0	3	0	0	0	0	0	0	0	0	1	0	0	1	10	2	0	0	0	18	0	0	0	0	65	0	0	2	0	0	0	2	1	0	0	0	0	0	10	0	0	0	0	0	1	0	0	2	3	0	4	0	2	0	0	0	0	0	21	0	2	0	0	0	0	0	0	0	0	0	0	0	0	0	0	1	0	0	0	0	0	3	2	0	8	0	0	0	0	0	0	0	0	0	0	0	0	0	0	0	0	2	9	1	0	0	0	201	29	21	17	0	0	0	0	0	0	0	0	1	0	0	64	8	0	2	0	0	0	15	0	4	16	3	23	10	22	21	8	0	0	0	0	0	9	0	0	0	1	1	0	0	0	0	0	1	0	18	16	0	7	2	5	0	0	0	0	0	21	0	0	0	0	0	0	3	0	0	0	2	0	0	0	0	0	0	0	0	1	0	0	35	1	0	0	73	35	0	0	2	0	1	4	28	1	29	0	2	0	0	27	1	1	0	0	0	2	412	0	51	0	0	0	0	0	0	7	2	0	0	0	0	0	0	0	0	0	0	0	1	1	0	0	0	0	5	0	2	0	0	0	0	0	1	0	0	1	0	0	2	0	0	6	0	0	8	0	0	0	10	0	0	0	0	0	0	0	0	0	1	16	4	0	0	0	0	0	1	0	1	0	52	5	0	8	0	9	0	0	2	0	0	0	0	0	0	0	1	0	2	0	0	4	4	0	2	0	0	0	0	125	0	2	0	14	0	0	0	0	0	0	0	1	0	0	24	6	0	0	0	0	1	22	0	0	2	0	0	0	411	0	0	0	0	0	0	0	172	0	0	0	0	0	1	0	0	0	0	0	1	0	0	0	0	0	13	0	0	0	0	0	0	0	0	0	0	0	7	0	1	0	0	0	0	0	0	0	0	0	0	0	0	0	0	0	0	0	0	0	0	12	0	0	0	0	0	0	1	0	1	0	0	6	0	0	0	0	0	0	0	0	0	3	0	0	0	0	0	0	2	0	0	0	1	0	1	0	0	0	0	0	205	0	0	3	0	0	22	0	5	0	0	0	1	2	0	1	5	0	0	0	0	0	0	0	4	0	0	28	0	2	18	0	0	0	0	0	10	0	0	0	0	12	0	0	0	0	0	0	0	4	0	0	137	0	0	0	0	3	0	0	0	0	0	0	0	0	0	0	3	0	11	16	0	0	0	0	1	2	0	0	0	0	0	0	0	0	0	0	1	0	0	0	0	885	0	0	0	6	1	0	0	0	0	2	0	0	6	1	0	0	0	0	1	0	0	0	0	0	8	1	0	0	0	0	0	0	0	0	1	0	0	0	0	0	0	0	1	7	0	0	0	0	1	20	10	0	0	0	0	0	6	0	26	18	0	0	0	0	2	0	5	0	3	3	0	0	0	0	0	0	0	0	0	7	0	0	0	0	0	0	1	57	8	34	3	0	1	0	0	0	0	0	1	0	0	0	92	3	19	71	0	17	43	0	12	0	0	0	43	1	0	41	0	0	0	3	9	0	0	0	56	10	0	6	196	1043	0	0	0	9	1	30	0	0	1	2	0	0	5	1	16	0	0	0	0	0	0	0	97	0	1	5	1	0	0	0	0	10	0	12	5	2	3	11	6	7	4	0	29	0	0	0	3	0	0	0	0	0	1	0	0	1	0	0	0	0	0	0	12	0	1	0	2	1	32	27	2	0	1	0	121	0	0	0	12	3	1	3	0	0	0	0	0	0	0	0	0	0	0	0	0	0	12	6	33	3	0	1	0	0	0	0	0	0	0	1	0	0	0	0	1	0	0	0	0	0	0	0	0	0	0	0	0	0	0	0	0	0	3	0	0	0	2	0	0	0	0	0	0	1	0	0	7	0	4	0	0	0	1	0	3	0	40	30	2	0	0	0	0	0	0	0	1	0	3	173	0	0	0	0	0	7	2	4	0	4	1	2	0	0	2	0	0	0	6	3	0	0	0	0	0	0	7	0	0	0	0	0	0	0	0	12	0	0	0	49	0	0	7	9	0	0	0	0	0	0	15	0	0	0	24	27	0	0	0	0	0	2	0	0	0	4	13	3	33	0	33	0	0	0	15	0	139	0	3	0	161	0	6	0	3	0	0	0	0	0	0	38	1	23	9	0	20	0	0	0	0	22	0	0	6	0	0	26	59	24	8	24	1	0	0	0	27	0	4	1	0	0	1	1	6	0	0	0	0	0	3	0	0	0	0	0	0	0	3	0	0	0	33	0	17	3	0	31	4	0	0	0	58	0	5	3	4	7	28	3	0	34	19	44	7	78	10	0	1	0	0	11	0	0	6	9	2	0	1	0	0	0	0	0	3	2	20	0	4	82	22	36	0	32	0	3	0	0	0	0	0	0	0	0	0	0	0	0	0	0	2	0	0	5	10	1	0	3	0	0	0	0	0	0	35	0	135	0	0	0	0	0	6	3	0	2	0	0	18	0	0	1	0	3	0	72	22	48	0	4	0	120	1	0	0	58	27	0	0	1	0	4	0	0	32	0	0	0	107	1	2	2	0	0	12	0	0	2	0	0	9	0	4	1	2	0	1	0	0	47	54	60	0	2	3	0	0	1	2	0	0	3	0	0	15	8	0	0	0	0	0	63	155	58	0	0	15	30	0	0	0	0	0	0	0	0	1	0	0	0	1	1	9	0	2	0	5	3	6	0	0	0	0	0	8	18	2	24	38	0	10	0	43	0	28	34	19	18	15	4	1	26	204	69	0	2	0	0	0	5	0	8	0	6	0	0	0	0	0	0	3	0	0	0	0	0	0	9	43	58	345	602	22	6	0	0	0	3	2	6	0	0	0	0	0	0	0	1	0	0	3	0	0	0	0	0	0	0	0	1	1	10	0	0	1	0	0	0	1	0	17	0	6	29	9	15	4	6	17	4	22	19	32	0	0	0	0	148	24	4	0	0	0	4	5	4	0	3	4	0	0	2	10	1	0	2	0	0	0	0	30	12	0	0	0	0	0	1	0	0	2	0	0	0	0	0	7	0	2	5	87	2	0	0	0	0	1	3	0	6544	0	2	0	7	16	18	1	0	0	0	0	0	0	0	0	24	5	5	0	0	0	0	0	0	7	4	4	0	0	55	0	0	2	0	0	1	0	0	0	0	42	1	0	0	0	0	0	0	0	0	2	4	1	0	0	0	0	0	0	0	0	0	0	0	0	0	5	22	0	19	2	0	25	0	0	1	0	3	24	0	0	0	0	0	0	0	0	30	0	0	0	0	0	2	0	0	0	0	0	154	15	0	2	200	0	1	0	0	23	0	45	6	33	3	0	0	0	0	2	0	5	305	0	0	0	0	44	0	0	0	0	0	2	0	0	0	0	0	1	0	1999	13	27	0	6	1538	1	5	38	20	40	3	219	145	154	26	40	10	39	0	3	58	30	18	19	21	0	0	0	1570	0	1	6	2	1	33	12	0	0	302	0	0	1	0	0	3	1	16	0	5	0	1	15	24	62	12	9	17	6	6	0	3	0	30	9	0	29	1	1	1	0	0	0	0	0	0	0	158	0	0	12	3	12	0	4	6	0	2	0	0	0	4	1	0	0	4	0	0	5	27	0	0	0	0	0	13	0	3	0	3	0	5	26	0	27	13	0	0	16	36	38	0	0	6	27	32	2	12	14	0	5	0	5	3	0	48	0	0	1	5	6	40	8	0	12	25	27	21	0	0	11	6	1	0	18	4	4	1	1	1	26	0	0	12	0	5	0	1	3	0	1	16	0	0	7	0	0	0	0	0	0	1	0	0	11	0	0	2	2	0	189	3	3	0	0	0	9	0	20	4	0	0	0	0	1	53	3	0	20	26	0	45	7	11	6	15	6	4	3	6	2	3	14	7	3	43	46	1	0	0	0	0	3	0	0	0	0	0	0	2	15	0	0	0	0	0	16	44	47	0	1	0	0	1	0	0	0	5	1	1	0	0	0	0	0	0	3	0	0	0	0	0	0	0	1	0	0	2	0	1	5	0	0	0	29	8	0	1	0	1	0	0	0	0	0	0	0	0	8	1	0	0	0	0	0	0	1	0	3	0	0	8	0	4	0	0	0	0	0	0	0	0	2	135	0	0	18	3	0	0	5	15	4	0	0	0	0	0	10	0	13	7	4	8	0	0	0	0	0	0	0	0	1	0	9	13	7	3	2	4	3	4	6	3	0	6	12	32	7	5	21	25	18	15	3	2	3	1	0	4	0	0	1	3	3	10	11	6	21	2	14	16	4	31	4	18	8	1	6	7	7	1	6	0	0	6	0	4	118	0	2	0	15	3	1	7	259	60	2	149	0	82	1	1	0	2	0	0	11	2	39	0	14	0	238	153	92	2	0	25	0	0	0	0	0	137	16	44	83	127	53	119	1	16	760	0	3	20	75	24	0	0	0	6	0	53	2	7	6	9	8	2	2	4	29	66	6	0	0	0	0	0	1	1	0	0	0	1	0	0	0	0	2	0	0	0	0	0	25	2	0	1	0	0	0	0	0	0	7	0	0	0	0	0	0	0	0	0	0	0	0	0	0	0	0	0	0	0	0	1	1	1	13	28	3	31	42	0	0	0	0	0	0	2	0	0	0	0	0	0	0	0	0	0	0	0	35	1	2	0	0	0	1	0	0	0	0	0	0	0	0	0	0	0	0	0	0	0	0	6	0	0	0	0	8	0	53	4	15	49	0	21	1	39	0	0	0	1	0	1	0	0	0	0	0	0	0	5	13	11	13	1	0	1	0	0	0	0	0	2	11	3	0	37	0	6	0	1	10	35	0	0	0	21	0	1	13	41	36	29	8	0	0	14	0	0	13	4	31	0	0	0	36	23	6	3	2	19	10	12	14	0	0	31	63	1	1	56	167	13	9	1	0	0	10	1	9	22	0	5	0	0	0	0	20	0	5	0	0	0	0	0	4	1	0	8	0	0	0	0	0	0	12	2	1	0	21	0	0	0	0	0	0	0	0	0	7	19	6	0	0	23	0	11	0	0	0	9	9	0	0	3	1	0	0	0	3	0	0	0	1	2	0	9	3	10	3	0	0	0	0	0	0	0	0	3	20	6	2	13	0	0	0	0	0	0	0	0	6	10	17	0	13	14	6	0	0	6	0	1	4	2	0	0	2	0	0	0	0	4	0	1	3	0	5	0	0	0	0	0	45	2	0	0	0	0	0	0	9	0	1	5	6	0	0	0	0	0	1	0	8	0	5	0	0	19	0	1	0	0	13	21	0	0	2	50	10	0	1	28	0	13	4	7	213	0	1	18	0	8	0	0	0	0	0	0	0	28	23	0	21	6	17	3	0	0	0	3	0	0	0	0	0	2	0	0	0	0	0	0	0	0	1	0	0	0	0	0	1	3	0	3	0	6	0	1	8	10	0	0	0	0	32	6	0	0	0	0	81	44	0	0	0	0	8	0	23876	0	0	0	0	0	1	0	9	0	0	0	0	0	0	0	0	0	0	0	0	0	31	10	45	25	0	7	13	9	0	0	0	0	0	0	0	0	18	41	0	66	11	0	0	0	0	0	2	0	2	0	0	2	0	40	12	10	69	198	19	9	15	0	8	4	0	1	1	0	20	1	6	7	0	0	0	1	2	4	0	279	79	41	5	4	0	0	0	0	156	0	1	1	0	36	13	0	35	1	0	0	27	31	0	0	49	32	0	3	0	2	0	0	0	0	0	0	0	46	141	33	15	69	0	118	1	0	2	28	50	28	161	0	1	11	2	82	12	0	14	8	16	0	1	2	0	2	20	7	82	120	6	0	3	0	0	16	35	7	2	3	0	0	0	0	0	1	0	0	0	1	0	1	9	0	1	1	2	4	0	1	9	2	0	0	0	33	19	6	3	3	2	2	5	0	4	0	19	0	1	0	7	4	6	7	21	5	0	1	0	0	0	14	3	0	0	0	0	0	0	0	0	0	0	0	0	0	1	23	0	0	0	7	6	6	0	4	0	0	0	0	0	2	1	22	1	16	0	0	0	46	41	0	2	1	0	87	0	0	3	2	0	1	0	0	0	1	0	0	0	0	0	0	0	0	0	0	0	0	0	0	3	0	11	0	1	0	0	0	0	0	0	0	0	7	0	0	0	0	0	0	0	0	0	0	0	0	0	0	0	0	2	13	0	2	2	0	0	1	1	1	13	0	1	0	8	28	7	0	22	0	0	0	122	7	7	4	6	0	1	1	3	14	0	1	2	0	7	4	2	4	0	0	0	0	0	0	0	0	3	0	35	0	3	8	94	0	0	0	0	167	284	0	0	0	2	0	0	2	1	17	77	13	1	45	0	50	35	6	1	2	1	0	3	8	19	33	4	11	0	0	17	0	8	0	0	3	0	0	2	0	0	4	0	3	31	9	8	0	0	0	19	7	0	3	0	0	0	1	0	0	0	0	0	0	20	1	6	0	7	0	1	4	2	0	0	1	1	22	49	0	0	0	0	0	0	0	41	250	69	19	35	7	26	2	37	0	0	3	215	6	1	3	10	0	3	0	2	6	0	0	0	0	20	1	5	0	0	0	0	5	0	0	1	4	0	12	0	16	0	2	3	1	19	0	0	0	0	7	2	0	1	81	0	5	0	0	0	0	4	0	0	0	2	1	0	0	0	3	0	0	0	0	0	5	34	0	2	0	0	0	2	4	0	1	1	6	0	0	0	0	0	0	0	0	0	0	0	0	0	1	0	0	0	0	0	7	2	0	49	0	2	5	36	17	0	16	0	0	0	0	0	0	0	0	0	0	0	0	0	0	0	0	0	53	0	0	0	2	1	0	0	0	1	0	0	0	0	1	0	0	20	0	0	0	18	2	3	3	0	5	9	1	2	1	1	1	5	29	18	1	24	40	61	71	214	144	28	405	0	0	40	0	0	3	7	14	2	0	1	0	0	0	0	308	0	0	3	0	78	0	0	0	0	3	369	0	3	0	0	0	10	6	0	0	1	0	0	0	0	0	0	0	0	0	0	160	16	0	0	0	1	0	0	0	0	13	0	0	0	1	0	0	13	46	0	0	0	0	16	0	0	0	34	1	0	24	5	0	0	0	0	1	0	16	7	12	8	0	0	3	0	0	8	0	0	2	0	5	4	0	0	4	43	5	7	424	0	1	1	0	0	0	0	36	3	8	0	0	0	1	5	0	9	0	5	0	0	0	0	17	0	8	0	83	78	3	52	1	0	19	43	0	3	0	0	0	3	1	1	0	1	0	6	0	0	4	0	1	0	1	0	0	4	0	0	7	0	0	0	0	11	2	1	0	0	2	36	1	17	0	2	38	1	0	0	0	0	1	13	8	0	17	8	67	50	0	1	18	0	6	33	33	0	0	0	0	1	0	8	0	0	341	0	0	9	22	19	11	0	22	2	0	1	2	2	0	0	65	7	1	0	1	0	3	0	0	78	406	59	1	0	0	0	1	0	0	0	0	0	2	0	1	0	0	0	0	0	0	0	0	0	3	0	0	0	0	0	0	0	0	0	1	0	0	0	0	0	0	0	0	7	0	0	0	0	0	0	0	0	0	0	0	0	1	0	0	0	8	2	14	1	0	6	5	0	1	0	3	0	6	0	0	0	0	22	15	6	21	6	5	17	0	2	4	0	13	6	1	0	0	0	4	2	3	0	0	4	0	0	3	0	25	22	0	0	2	0	0	93	20	0	19	0	0	0	0	0	0	33	16	16	10	63	3	21	13	0	31	7	1	2	0	0	0	0	6	25	41	20	0	39	17	20	0	0	0	2	0	0	0	0	0	0	55	0	0	0	0	0	27	0	0	0	0	0	0	1	0	2	10	8	6	4	5	4	2	44	21	4	14	5	1	196	28	60	0	0	0	0	0	0	0	2	0	45	7	46	22	0	0	55	0	0	1	0	0	0	0	0	0	0	0	0	0	4	3	32	1	8	18	21	80	50	0	7	0	0	0	0	0	1	0	2	0	0	0	17	0	0	0	0	0	0	0	0	0	0	0	5	9	13	0	11	16	0	3	2	0	0	0	3	0	21	0	0	2209	0	0	0	24	0	41	0	1	0	0	2	0	0	0	2	0	0	16	0	0	0	0	0	9	0	0	0	0	0	0	0	0	0	1	0	0	0	0	0	0	1	0	0	0	5	2	30	166	0	3	4	10	11	20	2	0	0	4	0	38	0	0	0	0	0	0	0	0	0	0	0	4	0	0	0	0	39	0	0	0	0	1	1	2	0	0	0	0	0	0	0	0	0	1	0	4	0	0	30	2	0	0	0	0	0	0	1	0	0	3	0	1	0	5	0	16	21	29	1	19	0	0	0	0	0	0	0	1	40	0	33	0	1	4	25	0	22	22	0	0	0	0	5	0	0	0	0	2	0	0	0	0	0	0	0	1	0	2	0	0	0	0	0	0	0	4	0	0	1	0	0	0	0	0	706	0	0	0	0	0	0	0	0	0	2	0	1	0	1	0	0	0	1	2	0	0	0	1	0	0	4	0	0	0	0	0	1	2	0	48	0	0	0	0	0	0	7	0	0	0	0	0	0	0	0	0	1	0	0	5	1	0	2	0	0	17	0	0	1	0	0	0	0	0	8	1	1	0	0	0	0	0	0	0	0	0	0	0	0	7	0	0	0	0	0	0	0	0	18	0	0	0	0	11	0	0	0	0	0	0	0	0	0	0	5	1	2	0	0	5	0	0	0	0	0	0	0	0	9	0	0	0	0	0	0	0	0	0	0	0	0	10	0	0	0	0	0	0	0	0	0	0	0	0	0	0	0	0	0	0	0	0	0	1	0	0	0	0	84	0	0	0	0	0	0	0	4	0	1	1	4	0	41	0	44	8	0	0	0	17	0	9	2	0	12	114	0	5	0	0	99	2	5	0	0	2	0	0	3	1	0	5	3	1	0	6	3	0	1	6	0	2	0	0	11	0	10	1	18	0	1	0	0	2	1	2	10	0	5	1	0	1	1	0	2	98	5	6	0	3	5	0	0	3	11	0	1	12	1	5	1	1	14	19	3	0	0	1	17	18	19	5	6	0	25	0	12	0	4	10	0	2	5	0	0	129	0	1	0	0	3	0	67	4	13	33	4	0	2	1	2	1	4	13	43	1	0	1	0	8	10	8	0	19	78	16	4	52	61	106	12	0	0	4	68	0	5	0	1	0	18	0	0	0	0	5	0	2	0	0	0	1	0	5	0	198	18	2	0	0	0	0	3	1	0	59	0	33	7	0	1	0	5	5	0	0	0	0	0	0	7	0	0	0	2	0	11	0	0	8	0	0	0	5	0	0	0	0	0	0	2	0	0	0	0	0	1	0	0	0	0	1	10	1	0	0	0	2	0	0	1	9	0	0	0	25	0	0	0	6	0	4	0	0	0	0	0	0	0	0	0	23	1	12	0	0	0	0	0	0	0	3	0	0	8	0	1	0	0	0	2	0	38	0	3	0	0	0	0	0	0	0	0	67	0	7	3	0	0	0	0	0	0	0	0	1	0	1	0	0	0	0	0	0	0	0	49	8	3	29	50	0	0	0	0	0	3	1	0	1119	0	1	6	92	0	0	1	0	2	58	5	0	0	0	13	0	0	0	1	1	12	0	18	120	0	3	23	1	0	0	0	0	0	0	0	0	0	0	0	0	1	0	0	0	9	1	0	0	19	6	0	1	8	0	1	0	0	0	0	5	13	8	5	23	16	0	40	26	5	0	37	7	0	31	1	19	7	16	0	1	0	0	0	0	14	10	0	0	0	0	38	14	1	0	0	7	0	0	0	0	0	1	0	0	22	50	11	3	0	62	0	0	2	0	0	1	0	9	1	0	2	1	7	1	0	6	0	5	0	47	0	0	0	1	8	0	14	0	5	0	1	1	2	1	27	0	0	7	1	11	1	172	11	1	0	0	0	0	0	0	0	0	1	0	0	0	0	0	0	9	44	7	0	0	0	3	1	2	18	0	2	0	0	0	46	3	4	0	0	0	0	5	6	8	133	22	0	0	0	0	2	11	0	0	0	0	3	0	50	33	41	0	23	0	0	12	5	2	0	0	0	0	1	0	30	2	10	1	1	6	1	48	0	0	1	0	2	0	6	18	8	53	7	1	0	39	46	8	0	0	0	0	0	0	29	0	0	87	0	1	0	0	0	0	0	111	6	1	1	0	0	0	0	0	0	0	0	0	0	0	0	1	0	15	10	0	73	1	2	0	0	0	0	0	3	8	0	0	11	0	2	0	4	0	0	45	21	0	82	0	1	0	7	35	0	0	0	1	0	23	0	0	0	0	0	0	0	0	28	10	1	12	2	19	3	0	0	0	0	6	0	0	42	0	0	1	11	0	0	26	0	1	10	0	5	12	0	0	0	0	0	44	26	1	9	2	1	0	5	0	0	0	0	1	0	0	29	44	8	20	0	0	0	0	9	0	0	0	0	1	0	1	49	0	69	2	1	76	2	14	219	57	5	12	6	12	1	31	3	12	48	3	28	5	0	1	0	1	0	5	0	0	1	0	0	0	12	1	0	0	1	0	0	1	1	0	0	0	0	12	0	2	3	8	0	0	0	0	0	0	0	0	0	0	0	0	0	0	0	0	0	0	0	0	1	0	0	0	0	0	0	15	2	0	0	0	0	0	1	0	0	0	0	0	0	0	0	0	0	0	0	0	0	0	0	1	0	4	12	0	81	3	0	1	33	0	0	0	13	6	21	3	1	5	29	1	0	12	0	1	1	0	0	0	0	0	0	0	6	54	1	52	2	14	0	0	0	17	6	11	2	3	0	0	0	2	0	0	0	0	0	9	4	2	2	0	1	20	7	23	3	5	0	10	10	10	0	19	36	1	0	0	0	0	0	1	29	18	0	0	0	0	0	0	0	1	1	2	0	0	48	6	0	26	0	33	0	0	0	0	4	0	1	0	118	0	3	4	0	0	247	0	0	0	1	2	0	15	0	0	39	0	0	0	13	0	34	5	0	0	37	33	0	0	0	9	0	1	0	5	0	0	4	2	9	35	0	3	0	1	0	6	1	0	1	8	5	2	66	5	4	2	5	23	0	13	0	0	22	4	0	0	0	12	0	0	6	8	4	0	5	4	0	0	0	1	0	0	0	0	0	0	0	0	0	0	0	0	0	0	0	0	0	45	0	0	0	0	0	0	3	0	4	0	4	3	0	0	0	0	3	30	1	0	13	0	27	0	0	280	3	66	9	15	0	1	371	360	3	16	59	0	0	0	32	18	0	1	0	10	0	39	20	3	1	1	2	0	0	3	12	20	0	0	1	6	27	7	0	0	0	0	0	0	76	0	2	2	1	4	0	0	0	0	0	0	0	147	12	47	3	17	0	34	2	3	0	0	0	0	0	1	0	0	0	8	0	36	0	2	21	3	0	15	2	509	23	3	0	1	65	6	6	58	12	9	18	16	72	1	12	53	1	0	0	0	0	0	1	11	319	165	6	0	0	0	0	0	0	41	0	0	3	1	1	0	0	48	153	0	0	0	47	17	8	13	1	31	1	9	82	1	2	90	0	0	12	1	1	1	0	0	0	0	0	1	13	3	0	0	0	0	0	0	0	0	0	0	0	0	1	0	103	0	0	0	0	20	6	13	0	0	0	0	3	1	0	0	0	35	19	9	2	35	0	25	16	0	0	7	25	1	10	6	1	0	28	14	74	3	47	104	26	2	4	7	146	7	32	66	0	0	0	0	0	0	0	0	4	0	0	0	1	0	0	0	0	0	0	0	6	1	0	0	12	0	14	0	0	12	0	7	0	2	1	0	4	0	0	0	1	0	1	13	18	4	13	0	1	0	0	0	0	0	1	0	0	0	0	0	0	0	0	0	0	0	0	2	0	0	0	1	0	0	3	0	1	0	1	1	0	4	0	6	0	0	2	0	1	7	1	0	1	0	0	2	0	0	0	0	0	0	4	13	21	3	0	4	15	24	0	24	0	178	0	84	92	0	1	0	1	1	0	0	0	32	38	593	32	23	0	5	43	6	11	7	10	0	2	0	1	13	0	0	0	12	0	0	0	4	1	0	5	1	0	1	0	0	0	0	12	0	0	0	0	0	0	0	0	0	0	1	0	0	0	1	0	0	0	0	0	0	0	0	0	1	0	2	5	0	16	13	0	43	0	12	67	23	53	0	0	0	5	0	0	3	0	0	28	0	0	14	8	0	0	0	3	0	23	0	7	11	9	0	0	0	0	1	0	3	0	0	0	0	0	0	5	1	1	0	0	3	9	2	1	1	1	0	0	3	0	1	43	13	3	0	3	0	21	0	19	2	2	5	4	0	10	0	43	5	2	0	0	0	0	0	0	0	4	1	6	0	40	0	3	0	1	1	17	0	0	0	0	0	0	0	0	0	0	16	4	0	17	81	0	0	0	0	0	1	0	0	0	1	11	3	1	0
LakWasMe75_LOW10_2_rpkm	0	0	0	0	0	0	0	0	0	0	0	138	0	0	0	0	0	0	0	0	0	0	0	1	0	0	0	0	0	2	0	0	0	1	0	1	0	0	0	0	0	0	0	0	0	1	2	1	0	0	0	3	0	0	0	0	0	2	2	0	5	0	0	0	0	0	0	0	0	2	0	0	0	0	4	0	0	0	0	0	0	0	0	0	0	0	0	0	0	0	0	0	2	0	0	0	0	0	0	0	0	0	0	0	0	0	0	0	0	0	0	0	3	0	3	0	0	0	0	0	0	0	0	2	0	0	1	0	0	0	0	1	0	0	0	0	0	0	1	0	0	0	0	3	0	0	0	0	2	0	1	2	1	1	8	0	0	1	0	0	0	0	0	0	1	0	0	0	0	1	0	0	0	0	0	0	0	0	0	0	0	0	0	0	0	0	0	0	0	0	2	0	1	0	0	0	0	4	0	2	0	0	0	0	0	0	2	0	0	1	0	9	0	0	1	0	0	0	0	0	0	0	0	0	0	0	0	0	0	0	0	0	0	0	0	0	3	1	0	0	0	0	1	0	1	0	0	0	0	2	0	2	1	0	121	19	0	0	0	0	0	0	0	4	0	0	0	0	6	4	2	0	0	0	0	0	0	0	1	2	0	2	1	1	9	0	0	0	6	2	0	0	0	1	0	0	0	1	0	0	0	1	5	0	0	0	3	18	0	0	1	0	3	0	0	0	0	0	35	0	0	0	0	1	0	2	0	0	0	0	0	0	0	0	0	0	1	0	0	0	0	0	0	0	1	0	0	0	0	0	0	0	0	0	2	0	0	0	0	2	1	0	0	0	0	3	1	0	0	2	0	0	0	0	0	0	0	0	0	1	0	0	0	0	1	0	1	0	0	0	0	0	10	0	0	1	4	0	0	0	0	0	0	0	11	0	3	0	0	0	0	5	16	0	0	0	2	1	0	0	0	0	0	0	0	0	0	0	0	0	0	0	0	0	0	0	0	0	0	0	19	0	0	0	0	8	0	0	0	0	0	5	0	153	0	1	0	1	0	1	0	0	0	0	0	1	0	0	0	0	0	3	3	2	0	0	0	0	1	0	0	0	0	0	0	0	0	1	1	1	0	0	2	7	0	0	0	0	0	0	0	0	0	0	0	0	0	0	0	0	0	0	0	0	0	0	0	0	0	0	1	0	0	0	0	0	0	0	0	0	0	0	0	0	0	0	1	0	0	3	0	0	0	0	1	0	0	1	0	0	0	0	0	0	0	0	0	0	0	0	0	1	0	0	0	0	2	0	3	0	0	0	0	0	2	1	17	9	0	3	0	17	9	2	3	0	0	0	0	0	0	0	614	0	1	0	0	0	0	0	1	0	0	0	0	0	0	2	0	0	0	7	4	5	0	0	3	0	9	0	11	1	0	0	0	0	0	0	0	0	1	1	0	0	0	0	0	0	0	0	0	2	0	0	0	0	0	1	1	1	0	0	0	0	0	0	0	0	0	0	0	4	0	0	1	0	0	0	1	1	0	1	0	0	0	0	0	0	0	0	0	0	11	0	0	0	0	0	0	18	0	0	4	0	0	0	0	0	0	0	0	0	0	0	1	0	0	0	2	0	0	0	0	1	1	1	0	0	0	0	0	0	0	0	0	0	1	7	2	0	0	0	0	0	0	0	0	0	0	0	0	3	2	0	1	4	0	0	0	1	0	0	1	0	0	0	0	0	9	0	0	0	0	4	0	1	0	0	0	0	0	0	0	0	0	2	0	0	0	0	0	0	0	0	0	0	0	0	0	1	1	12	0	0	0	0	0	0	0	1	0	0	0	0	2	0	3	0	0	0	0	0	0	0	0	0	0	0	0	0	0	0	0	0	0	0	0	1	0	0	0	0	0	0	0	0	0	6	7	0	0	0	0	0	0	0	0	0	1	0	0	0	0	0	0	0	0	0	0	0	1	0	1	0	0	0	0	0	0	0	0	0	0	0	0	0	1	0	1	0	0	0	0	0	0	0	0	0	0	0	0	0	0	0	0	0	0	0	0	0	0	0	0	0	0	0	0	0	0	0	0	0	0	1	2	2	1	5	0	1	0	0	0	0	0	0	0	0	0	0	0	0	0	0	0	0	0	0	0	1	0	0	0	0	0	0	1	2	0	0	0	0	0	0	0	0	0	0	0	0	0	0	0	0	2	0	0	0	0	0	0	0	0	7	0	2	0	0	0	0	0	0	1	0	2	0	0	0	0	0	0	0	5	0	0	0	0	0	0	0	0	0	0	0	0	0	0	0	0	0	0	0	0	0	0	0	0	4	0	0	0	2	0	0	0	12	0	0	4	1	0	0	0	0	0	0	0	0	0	3	0	0	0	0	0	0	0	0	0	0	6	0	1	0	0	0	0	0	0	0	0	0	0	1744	0	0	0	0	2	0	1	0	0	0	0	0	1	0	0	0	0	0	0	0	0	0	0	0	0	2	0	0	0	0	0	0	0	0	0	1	0	0	0	0	0	1	1	0	0	2	0	0	0	0	0	0	0	0	0	0	1	1	0	0	0	0	1	5	3	0	0	0	0	0	0	0	0	0	0	0	0	0	0	0	0	0	0	0	0	0	0	0	0	0	0	0	0	0	0	5	0	0	0	0	0	0	0	0	0	0	0	0	0	0	0	0	0	0	0	0	0	0	0	1	0	0	0	0	0	0	0	0	0	4	4	4	1	0	0	0	0	0	0	0	1	6	0	0	0	0	0	0	0	0	0	0	0	0	0	0	0	0	0	0	0	0	0	0	1	0	0	0	0	0	0	0	0	1	1	0	0	0	3	0	0	0	0	0	1	0	4	0	0	6	5	0	0	0	0	0	0	0	0	0	0	1	0	0	0	0	0	2	0	0	0	7	0	470	0	0	0	0	0	1	0	2	0	0	0	0	0	0	0	0	1	0	0	0	0	0	0	0	0	0	0	6	0	1	0	4	0	5	0	0	0	0	0	0	0	0	0	0	5	0	0	0	1	0	0	0	0	0	0	0	0	0	2	1	1	0	0	0	0	0	0	0	0	0	0	0	0	0	0	0	0	0	0	0	0	0	0	0	0	0	0	0	0	0	0	1	0	0	2	1	0	0	0	0	0	0	0	0	0	0	0	1	0	0	0	0	1	0	2	0	0	0	2	3	0	0	0	1	0	0	0	0	0	0	0	0	0	0	1	1	0	0	0	0	0	0	0	0	0	2	0	0	0	0	1	0	0	2	1	0	1	0	0	5	0	0	0	0	0	2	0	0	0	0	0	0	0	0	0	223	6	0	3	0	0	0	0	0	0	0	0	0	0	2	0	0	0	0	0	0	19	29	2	1	0	0	0	4	0	0	0	0	0	0	0	0	11	3	0	3	3	0	0	0	3	1	0	0	0	0	0	0	2	0	0	0	0	0	0	0	0	6	0	0	0	0	0	5	0	0	0	1	0	0	0	0	0	0	0	0	0	2	0	0	0	0	0	0	0	0	0	0	0	0	0	0	0	0	0	0	0	0	0	0	0	1	0	0	0	3	0	0	0	0	0	0	0	0	0	0	0	0	0	0	0	0	0	0	0	0	0	0	0	2	0	0	0	0	0	0	1	12	0	0	0	0	0	3	0	1	0	3	0	0	0	0	12	0	0	0	0	0	0	0	0	0	0	0	69	0	0	0	3	0	0	0	0	0	0	0	0	0	0	0	0	2	0	0	0	0	18	0	0	0	0	0	0	0	0	0	2	0	0	0	3	0	0	0	0	1	6	0	1	0	0	0	0	1	0	0	0	2	2	0	0	0	0	0	0	0	0	0	0	0	3	5	3	5	11	2	26	2	0	0	0	0	1	1	0	0	0	0	1	0	0	0	0	0	3	0	0	1	4	0	3	0	0	0	0	2	0	1	1	0	0	0	0	0	0	0	0	0	0	1	0	1	1	0	0	0	0	0	0	5	0	0	1	0	1	0	0	0	9	3	2	9	0	0	0	1	0	1	0	0	0	0	0	0	14	0	0	0	0	0	0	0	0	0	0	0	0	0	0	1	0	1	0	0	0	0	0	0	3	0	4	0	0	0	0	0	0	7	0	1	0	2	0	19	0	0	2	0	2	0	0	0	0	0	5	0	0	0	0	0	0	2	0	0	0	0	0	0	0	0	0	3	0	1	0	0	0	0	0	0	0	0	1	0	0	0	0	0	0	0	0	0	0	0	0	0	2	0	0	0	0	0	0	0	0	2	1	26	0	1	22	0	2	0	27	13	5	0	0	0	1	0	0	0	0	0	0	0	0	0	0	0	0	0	0	0	0	0	0	0	0	8	0	0	7	1	0	0	0	0	0	0	0	0	0	0	0	0	0	0	0	0	0	2	2	1	0	0	0	0	0	0	0	0	0	1	0	0	0	0	4	0	0	0	0	0	0	0	0	0	0	0	0	0	0	0	0	0	0	0	0	0	0	0	17	0	0	0	0	0	0	0	1	0	1	2	12	0	0	0	0	0	0	0	0	0	0	1	0	0	0	0	0	0	0	0	0	0	0	0	0	0	0	0	0	0	0	0	1	0	0	1	0	0	0	0	1	14	0	0	0	0	0	0	0	0	0	0	0	0	0	0	0	0	0	0	0	0	0	0	0	0	0	0	0	0	0	0	0	0	1	0	0	0	0	1	0	0	0	0	0	0	0	1	0	0	0	0	0	0	0	0	0	1	0	0	49	0	0	0	0	0	4	1	1	0	0	21	0	0	0	0	0	0	0	0	1	0	0	1	0	0	0	0	0	1	0	0	0	0	0	4	0	1	0	0	0	0	0	0	1	0	1	0	0	0	0	0	1	0	0	0	0	0	0	0	0	0	0	0	0	0	0	0	0	0	0	0	0	2	0	0	1	0	0	3	0	0	0	0	0	0	0	0	0	0	0	0	0	0	0	0	0	0	0	0	0	0	15	1	0	1	0	0	0	14	0	0	0	0	0	2	0	0	0	1	0	0	0	0	0	0	3	0	0	5	0	0	0	1	1	0	0	0	0	0	0	0	0	1	0	0	9	0	0	0	0	0	0	0	0	2	0	0	0	0	0	0	0	0	0	0	0	0	0	0	1	0	0	1	0	0	0	0	1	3	0	0	0	0	0	0	0	0	0	0	1	0	0	0	6	0	0	0	0	0	0	0	0	0	10	8	0	0	0	0	0	0	0	0	3	0	0	0	0	0	0	0	0	0	0	0	1	0	0	0	0	0	0	0	0	0	0	0	0	0	1	0	0	0	1	0	1	0	0	0	0	0	0	0	0	0	0	0	2	16	11	7	17	8	9	10	3	11	16	6	9	9	1	9	1	8	13	2	2	0	24	39	5	23	24	28	6	2	5	5	11	10	0	0	0	0	0	0	0	0	0	0	2	2	0	0	0	0	0	0	0	0	0	0	0	0	0	0	0	0	0	0	0	0	0	0	5	0	14	0	0	0	0	0	0	0	0	0	10	0	0	0	0	0	0	0	0	0	0	1	0	0	0	0	0	0	0	2	0	0	0	0	0	0	0	0	0	0	1	0	0	0	0	0	2	0	0	1	7	0	0	0	0	2	0	0	0	0	2	0	0	0	0	0	0	0	0	0	0	1	0	0	0	0	0	0	0	0	12	13	0	0	6	0	0	0	0	0	0	0	0	0	0	0	0	0	0	1	0	0	0	0	0	0	0	0	0	0	0	0	0	0	0	0	0	0	0	1	0	0	2	1	0	0	0	0	0	0	0	0	0	1	0	0	0	0	0	2	0	0	0	0	0	0	0	0	1	0	0	0	0	0	0	0	0	0	0	0	0	0	0	1	0	0	0	1	0	0	0	4	0	0	0	0	0	0	0	0	0	0	0	0	0	2	0	0	0	0	0	0	0	0	0	0	11	0	0	12	1	0	1	0	0	27	0	0	0	0	0	0	0	0	0	0	0	0	0	0	0	0	0	0	0	0	0	0	10	0	0	0	0	0	0	0	0	0	0	0	1	0	0	0	0	0	0	1	2	0	0	0	0	3	0	1	8	3	0	0	1	0	0	1	0	0	0	0	0	0	0	0	0	0	0	0	8	0	0	6	0	0	0	0	0	0	0	0	4	1	1	0	0	0	0	0	0	0	0	0	0	0	0	0	0	0	0	0	5	0	0	0	0	0	0	0	1	0	0	0	1	0	0	0	0	0	0	0	8	0	0	0	0	0	0	0	0	0	2	0	0	0	0	0	0	0	1	0	0	0	0	0	0	0	0	0	0	0	1	0	0	0	0	0	0	0	0	0	0	0	0	0	0	0	0	0	0	0	0	0	0	0	0	0	19	0	0	2	0	1	0	0	7	0	0	0	0	4	0	2	0	0	0	0	0	0	0	0	0	1	0	0	0	0	0	0	1	0	0	1	8	0	0	2	1	2	0	1	0	2	0	4	0	1	0	2	0	0	3	0	0	2	0	1	0	1	0	0	0	4	0	0	0	1	2	1	2	0	0	1	0	0	0	0	4	0	1	0	0	0	1	0	0	0	0	0	0	0	1	0	0	0	0	0	0	0	1	0	0	0	0	0	0	0	0	0	0	2	0	0	0	0	0	0	0	0	0	0	0	0	0	0	0	0	0	0	0	0	0	0	0	0	0	0	0	14	0	0	10	32	17	0	0	2	1	0	0	0	3	0	0	0	0	0	0	0	0	0	0	0	0	0	0	0	0	0	0	0	0	0	0	8	0	0	0	0	0	1	1	0	0	0	10	0	0	0	0	0	0	0	1	0	0	0	1	0	0	0	1	1	0	0	0	0	0	2	75	10	4	0	0	0	0	0	0	0	0	8	0	0	0	1	0	0	18	7	3	0	0	0	0	0	0	0	9	0	0	0	0	0	0	0	0	0	0	0	0	0	0	0	0	0	0	0	0	0	8	6	0	1	0	0	0	1	1	1	1	0	0	0	0	0	1	1	0	0	0	0	0	0	0	18	0	0	0	0	0	0	0	0	17	1	0	0	0	0	0	0	0	0	0	0	0	64	0	0	0	0	2	0	0	0	0	0	0	0	0	0	0	1	0	2	0	0	0	0	0	0	0	0	0	0	0	0	0	0	0	0	0	0	0	0	0	0	0	1	0	0	0	0	0	0	0	0	0	0	0	0	0	0	0	0	0	25	0	0	0	0	0	0	2	0	0	0	0	0	0	4	0	0	0	0	0	0	2	22	3	0	0	0	0	2	0	0	1	0	0	0	0	0	0	0	0	0	0	0	0	0	0	0	0	0	0	0	0	0	0	0	0	11	0	0	0	0	0	0	0	0	0	0	0	0	0	0	0	0	2	0	0	0	0	0	0	0	0	1	0	0	0	0	0	0	0	1	0	0	0	0	0	1	0	0	1	0	0	0	0	0	0	0	0	0	0	0	0	0	0	0	0	4	0	0	1	0	0	0	0	1	0	0	0	0	0	0	0	0	0	0	0	0	0	1	0	0	3	0	10	1	0	0	0	0	0	0	0	0	0	0	0	0	0	0	0	0	1	15	0	3	0	0	0	0	0	0	0	0	0	0	0	0	0	0	1	0	0	0	0	0	0	0	0	0	0	0	0	2	1	0	0	4	0	0	0	0	0	0	0	0	0	0	0	2	0	0	0	0	1	0	285	0	0	0	0	0	0	7	5	0	0	0	2	0	5	0	0	0	0	0	1	0	0	0	2	1	0	0	0	0	0	0	0	0	0	0	0	0	0	7	0	0	0	0	0	0	0	15	0	0	0	4	0	0	0	0	0	0	0	0	0	0	0	0	0	0	0	0	0	0	0	0	3	0	0	0	0	0	0	0	0	0	0	0	4	3	0	0	0	0	0	1	0	0	0	0	0	0	0	0	0	0	0	0	0	0	0	0	0	0	0	0	0	0	2	0	0	0	0	0	0	0	0	0	0	0	0	0	0	0	0	0	0	0	0	0	11	0	0	1	0	0	0	0	0	0	0	0	0	0	0	0	0	0	0	0	0	0	27	0	1	0	0	0	0	0	0	1	0	0	1	0	0	0	0	0	0	3	0	0	0	0	0	0	0	0	0	0	0	0	0	0	0	0	1	0	0	0	1	0	0	0	0	0	0	0	0	0	0	0	1	0	0	1	0	0	0	0	0	0	0	0	18	0	0	0	0	6	0	1	0	0	0	0	0	0	7	0	0	1	0	0	0	0	0	1	16	1	0	0	0	0	0	0	0	1	0	0	0	0	0	0	0	0	0	0	0	0	0	0	0	0	0	0	0	0	0	0	0	0	0	0	0	0	0	0	37	0	0	0	0	0	0	0	0	0	0	0	0	0	1	0	0	0	0	0	0	0	0	0	0	0	0	0	1	0	0	0	0	0	0	0	0	0	0	0	0	0	0	0	0	0	0	0	0	0	0	0	0	0	0	0	0	0	0	2	0	0	0	0	0	0	0	0	0	0	3	0	0	3	0	7	0	0	0	0	0	0	13	0	0	1	0	0	1	0	0	0	0	0	0	0	0	9	12	0	0	0	0	0	0	0	0	0	0	1	2	0	0	0	0	0	0	0	0	0	0	0	0	0	0	0	0	0	0	0	0	7	1	0	0	0	0	0	0	0	0	0	0	0	0	0	2	0	0	0	0	0	0	1	0	3	1	0	0	0	0	0	0	0	0	0	2	0	0	0	0	0	1	0	0	0	0	0	0	0	0	0	0	0	1	0	0	1	0	0	0	1	0	0	0	0	1	1	0	0	0	0	0	0	0	0	0	0	0	0	1	0	0	0	0	0	0	0	0	0	1	0	0	0	0	0	13	0	0	3	0	11	0	0	0	0	0	0	2	0	0	0	17	0	1	2	0	0	0	0	0	0	0	0	0	0	0	0	0	1	0	0	0	0	0	0	0	0	0	0	0	0	0	0	0	0	0	0	0	0	0	0	0	0	0	0	1	0	0	0	0	0	1	0	0	0	1	0	0	0	0	0	0	0	0	0	0	0	1	0	0	0	1	0	0	0	1	0	0	0	0	0	0	0	0	0	0	0	0	0	2	0	3	0	0	0	0	0	0	0	1	0	32	6	0	0	0	0	0	0	4	0	0	0	0	0	0	0	1	0	0	0	0	0	0	0	0	0	0	0	0	0	0	0	0	0	0	0	9	0	0	0	0	0	0	0	1	0	0	1	0	0	0	0	1	0	0	0	0	0	0	0	0	0	0	0	0	0	1	0	1	0	0	0	0	3	0	0	0	0	0	0	3	0	0	0	0	0	0	0	0	0	4	0	0	0	0	0	0	0	0	0	0	0	0	1	0	0	0	0	0	0	2	8	0	0	1	0	7	0	13	4	0	0	0	0	1	2	0	6	0	0	2	0	24	0	1	0	0	1	0	0	4	0	0	2	0	0	0	1	1	3	3	1	0	0	0	6	0	0	0	0	0	0	0	0	0	0	0	0	0	1	0	0	0	0	0	0	0	0	0	0	0	0	0	0	0	0	0	0	0	0	0	0	0	1	2	0	1	3	0	0	0	0	1	0	0	0	0	0	0	0	0	0	0	0	3	1	0	0	0	0	0	0	0	0	0	0	0	0	0	0	0	3	0	0	0	0	0	0	0	0	0	1	0	2	0	0	3	0	0	0	0	0	4	0	0	0	0	0	0	0	0	0	0	1	0	0	0	0	0	0	1	0	0	0	0	0	0	0	0	0	0	0	0	1	0	0	0	0	0	0	0	2	0	0	0	21	6	14	1	2	3	3	17	0	10	4	4	1	10	26	5	0	4	3	13	7	9	0	7	0	4	1	1	0	63	0	0	0	0	3	0	4	0	0	0	0	0	0	0	1	0	0	0	0	4	0	0	0	1	0	3	0	0	0	0	0	0	0	0	0	0	0	0	0	0	4	0	2	0	0	0	0	0	1	0	0	0	0	0	0	0	0	0	0	0	1	0	0	0	0	0	0	0	4	0	0	0	4	0	0	0	0	0	0	0	0	0	0	0	0	0	0	2	0	0	0	0	0	0	0	0	0	0	1	0	0	0	0	0	0	0	0	0	0	0	0	0	16	0	1	0	0	0	0	0	0	0	0	0	0	1	0	0	0	0	3	0	0	0	0	0	0	0	0	3	1	0	0	0	0	0	0	0	0	0	0	0	0	0	0	0	0	0	0	0	3	0	0	0	1	0	0	0	0	0	0	0	0	0	0	0	0	0	0	0	0	0	0	0	0	0	1	0	0	0	0	0	0	0	0	0	0	0	0	1	0	0	0	0	0	0	0	0	1	0	0	0	1	1	0	0	0	8	0	4	0	0	0	0	1	0	0	0	1	0	0	0	0	0	1	0	0	0	1	0	0	0	0	0	0	0	0	0	0	1	0	0	0	0	0	1	0	0	0	0	0	0	0	0	0	0	0	0	0	0	0	0	0	0	0	0	24	0	0	0	0	0	0	0	0	3	1	0	0	1	0	0	0	1	0	0	0	0	0	0	0	0	0	0	0	0	0	0	0	0	0	0	0	1	0	2	0	0	0	0	0	0	0	0	0	1	0	0	0	0	0	0	1	0	0	0	0	0	0	1	0	0	0	0	0	0	0	0	0	9	0	0	0	0	0	0	0	0	0	0	0	0	0	0	0	0	0	0	1	0	0	0	0	0	0	0	2	0	0	0	0	0	0	0	0	0	0	0	2	0	0	0	0	0	0	0	0	0	0	0	0	0	0	0	0	0	0	0	23	0	1	1	0	0	0	0	0	0	0	0	0	0	0	1	1	0	0	0	0	0	0	0	0	2	0	3	3	1	1	0	0	0	0	0	0	1	0	0	0	1	0	0	0	0	0	0	0	0	1	0	0	2	0	1	0	0	0	0	0	3	0	0	0	0	0	0	0	0	0	0	0	0	0	0	0	0	0	0	0	2	0	0	0	0	0	0	1	90	0	0	0	0	0	0	102	1	1	0	0	0	0	0	0	0	0	0	0	0	0	0	0	0	0	0	1	0	0	0	0	0	0	0	0	1	0	0	0	0	0	0	0	0	0	1	0	0	0	0	0	0	0	0	0	0	0	0	0	0	3	0	0	0	0	0	0	0	29	0	0	0	0	0	0	0	0	0	0	0	0	0	0	2	0	0	0	0	0	0	0	2	0	0	3	1	0	0	0	0	0	0	3	0	0	0	0	0	0	0	0	0	0	0	0	0	0	0	7	0	0	0	1	25	0	0	0	1	0	1	0	0	0	0	0	0	0	0	2	18	0	0	0	0	0	0	0	0	3	0	0	0	4	0	2	0	0	0	0	0	7	2	0	0	0	0	0	0	1	0	0	0	0	0	0	0	0	0	0	0	0	0	0	0	0	0	0	0	0	0	1	0	0	0	0	0	0	0	0	0	0	0	0	0	0	0	0	0	0	0	0	0	0	23	0	0	0	0	0	0	5	0	0	0	0	0	0	0	0	0	0	0	0	0	0	0	0	0	0	0	0	0	0	0	0	0	5	0	0	0	0	0	2	0	0	0	0	0	0	0	1	0	0	0	0	0	1	0	0	0	40	0	0	0	0	0	0	0	0	0	0	0	0	0	0	0	0	0	0	0	0	0	0	0	0	1	0	0	0	0	0	0	0	0	0	0	4	0	0	0	0	0	0	0	0	0	0	0	0	0	0	0	0	0	1	1	0	0	0	0	1	0	0	0	0	0	0	0	0	0	0	0	0	0	0	0	0	3	0	0	0	1	0	0	0	0	0	7	0	0	0	0	0	0	0	0	0	0	0	0	0	0	1	0	0	0	0	0	0	0	0	0	0	0	0	0	0	0	0	0	0	1	0	0	0	0	0	81	0	0	0	0	0	0	1	0	2	1	0	0	0	0	0	0	2	0	0	0	1	0	0	0	0	0	0	0	0	0	0	0	0	0	0	0	0	12	2	3	0	0	0	0	0	0	0	0	0	1	0	0	280	0	0	3	0	0	2	0	5	0	0	0	5	0	0	2	2	0	0	0	3	0	0	0	8	2	0	3	377	72	0	0	0	31	0	0	0	0	0	0	0	0	0	0	2	0	0	0	0	0	0	0	2	0	0	0	0	0	0	0	0	0	0	21	0	1	0	0	0	0	0	0	0	0	0	0	0	0	0	0	0	0	0	0	0	0	0	0	0	0	0	0	0	0	0	0	0	0	2	4	0	0	0	0	52	0	0	0	0	0	0	0	0	0	0	0	0	0	0	0	0	0	0	0	0	0	2	0	1	0	0	0	0	0	0	0	0	0	0	0	0	1	0	0	2	0	0	0	0	0	0	0	0	0	0	0	0	0	0	0	0	0	0	0	0	0	0	0	0	0	0	0	0	0	0	0	0	0	1	0	0	0	2	0	0	0	2	1	0	0	0	0	0	0	0	0	0	0	0	32	0	0	0	0	0	21	0	0	0	1	0	2	0	0	1	0	0	0	1	2	0	0	0	0	0	0	0	0	0	0	0	0	0	0	0	0	0	0	0	0	0	0	0	0	0	0	0	0	1	0	1	0	0	0	3	5	0	0	0	0	0	1	0	0	0	1	1	0	2	1	1	0	0	0	0	0	2	0	0	0	4	0	0	0	6	0	0	0	0	0	0	0	0	1	1	0	0	0	0	0	0	1	0	0	1	1	0	0	2	1	0	1	0	0	0	0	0	0	0	0	0	0	1	0	0	0	0	0	0	0	0	0	0	0	0	0	0	0	0	0	0	0	1	0	2	0	0	4	1	0	0	1	3	0	0	1	0	15	3	0	0	0	1	2	2	2	2	0	0	0	0	0	0	0	1	0	0	0	1	0	0	0	0	0	12	1	1	0	0	7	14	16	0	51	0	0	0	0	0	0	0	0	0	0	0	0	0	0	0	0	0	0	0	1	0	2	0	0	0	0	0	0	0	0	0	0	0	0	0	0	0	0	0	0	0	0	0	0	0	0	0	2	0	0	0	9	2	1	0	0	0	3	0	0	0	1	0	0	0	1	0	0	0	0	15	0	0	0	7	0	0	3	0	0	0	0	0	1	0	0	1	0	5	0	0	0	0	0	0	2	2	3	0	0	1	0	0	0	0	0	0	0	0	0	0	0	0	0	0	3	0	5	4	0	0	0	1	2	0	0	0	0	0	0	0	0	0	0	0	0	0	0	0	0	0	0	0	0	1	0	0	0	0	0	2	1	1	0	0	0	0	0	4	0	1	1	0	1	13	1	0	0	23	3	0	0	0	0	0	1	0	1	0	0	0	0	0	0	0	0	0	0	0	0	0	0	0	0	1	2	18	15	3	1	0	0	0	0	2	0	0	0	1	0	0	0	0	0	0	0	0	0	0	0	0	0	0	0	0	0	0	0	0	0	0	0	0	0	0	0	2	0	0	0	0	0	0	0	0	1	0	1	1	0	0	0	0	21	2	0	0	0	0	0	0	1	0	0	0	0	0	0	9	0	0	1	0	0	0	0	1	1	0	0	0	0	0	0	0	0	0	0	0	0	0	0	0	0	0	0	10	1	0	0	0	0	0	5	0	634	0	0	0	0	2	9	0	0	0	0	0	0	0	0	0	0	0	0	0	0	0	0	0	0	29	9	0	0	0	12	0	0	1	0	0	0	0	0	0	0	9	0	0	0	0	0	0	0	0	0	0	1	0	0	0	0	0	0	1	0	0	0	0	0	0	0	20	1	0	1	1	0	0	0	0	0	0	0	3	0	0	0	0	0	0	0	0	5	0	0	1	0	0	0	0	0	0	0	0	167	0	0	0	6	0	0	0	1	1	0	2	1	1	0	0	0	0	0	0	0	0	0	0	0	0	0	7	0	0	0	0	0	0	0	0	0	0	0	0	1	71	0	0	0	0	28	0	0	3	1	3	0	21	21	17	5	4	2	4	0	0	5	2	1	1	1	0	0	0	71	0	0	0	0	0	2	0	0	0	0	0	0	0	0	0	12	0	0	0	0	0	0	1	1	1	1	1	0	0	0	0	0	0	1	0	0	1	0	0	0	0	0	0	0	0	0	0	1	0	0	0	0	0	0	0	0	0	0	0	0	0	0	0	0	0	0	0	0	1	2	0	0	0	0	0	2	0	1	0	1	0	1	0	0	1	1	0	0	0	1	10	1	0	0	4	32	0	11	0	0	0	0	0	0	0	3	0	0	0	1	0	21	0	0	0	1	5	1	0	0	0	0	0	0	5	0	0	0	0	1	2	0	0	0	0	0	0	0	0	0	0	0	0	0	0	0	0	0	1	0	0	0	0	0	0	0	0	7	2	0	6	0	1	0	0	0	0	0	1	0	0	0	0	0	0	1	0	0	2	10	0	2	1	0	1	4	0	0	0	0	0	0	39	0	0	5	7	1	1	0	0	0	0	0	0	0	0	0	0	0	0	0	0	0	0	0	57	1	2	0	1	0	0	0	0	0	0	1	1	0	1	0	0	0	0	0	0	0	0	0	0	0	0	0	1	0	0	0	0	0	0	0	0	0	10	0	0	0	1	0	0	0	0	0	0	0	0	0	0	0	0	0	0	0	0	0	1	0	0	1	0	0	0	0	0	0	0	0	0	0	0	0	0	20	0	0	0	0	0	0	0	0	2	0	0	0	0	0	1	0	1	0	1	0	0	0	0	0	0	0	0	0	0	0	1	2	1	0	0	1	0	1	1	1	0	0	0	0	2	1	21	7	1	6	0	1	0	0	0	0	1	0	1	1	0	1	1	0	0	5	0	0	0	0	6	3	0	0	4	1	1	0	0	0	0	0	0	0	1	0	0	1	1	0	1	0	2	2	1	6	0	2	0	0	0	0	0	1	0	0	72	0	0	0	6	6	8	1	0	12	0	0	0	0	0	4	1	0	4	2	1	6	1	1	8	0	0	0	2	0	0	0	0	0	0	15	0	0	0	1	6	0	1	0	1	1	0	0	0	0	0	0	1	0	0	0	0	0	0	0	0	0	4	0	0	0	0	0	2	0	0	0	0	0	1	0	0	0	1	0	0	0	0	0	0	0	0	0	1	0	1	0	0	0	0	0	0	1	0	0	0	0	0	0	0	0	2	2	0	1	0	0	0	1	0	0	0	0	1	0	0	0	0	0	0	0	0	0	0	0	0	0	0	0	0	0	0	0	0	0	0	0	0	0	0	0	0	0	0	0	0	0	0	0	0	0	2	0	1	1	0	2	1	1	0	0	0	0	0	0	0	0	0	0	0	0	0	1	1	2	0	0	0	0	1	0	0	0	0	0	0	0	0	4	0	0	0	0	1	3	0	0	0	0	0	1	5	1	1	19	0	0	0	0	0	0	0	0	1	0	0	0	1	1	0	0	0	1	0	0	27	0	0	2	1	0	0	6	4	1	0	4	1	0	0	0	2	4	0	0	2	0	0	0	0	0	0	0	0	0	0	0	0	0	0	2	0	0	0	0	0	0	1	4	0	0	0	0	0	0	0	0	0	0	0	0	0	1	1	0	0	1	0	0	0	0	0	0	1	0	0	1	0	0	0	0	0	0	0	0	0	0	0	3	1	0	0	0	0	0	0	0	0	0	0	0	2	0	0	0	0	0	1	0	0	0	0	0	1	52	0	1	1	0	3	0	0	0	0	0	0	1	0	0	0	0	0	2	0	0	0	0	0	0	0	0	2	0	0	0	4	8	0	0	0	0	0	0	6	1	0	0	0	0	0	0	0	0	5	0	1	0	1	0	0	0	0	0	0	0	0	1	0	0	0	1	0	0	0	3	0	2	0	0	13	0	0	2	0	0	0	0	0	0	0	0	0	0	0	0	0	1	2	0	0	1	0	0	0	0	0	0	0	3	0	0	0	0	0	0	0	0	0	0	0	0	0	0	0	0	0	0	0	0	0	1	1	0	0	0	0	0	4	0	0	0	0	0	9	2	0	0	0	0	10	0	9420	0	0	0	0	0	0	0	0	0	0	0	0	0	0	0	0	0	0	0	0	0	2	1	8	2	0	0	1	1	0	0	0	0	0	0	1	0	1	5	0	4	1	0	0	0	0	0	0	0	0	0	0	0	0	1	0	0	6	14	0	0	1	0	1	0	0	0	0	0	1	0	11	1	0	0	0	0	1	0	0	2	6	2	1	3	0	0	0	0	1	0	0	0	0	4	0	0	31	5	0	0	4	1	0	0	7	0	0	0	0	0	0	0	0	0	0	0	0	2	7	8	8	23	0	2	3	0	2	7	6	9	24	1	5	1	4	7	0	0	1	2	2	0	0	1	0	0	2	3	9	67	3	0	0	0	0	7	0	0	0	0	0	0	0	0	0	0	0	0	0	0	0	0	0	0	0	0	0	0	0	0	0	0	0	0	0	2	1	2	0	0	0	1	0	0	6	0	0	0	0	0	0	0	0	0	4	0	0	0	0	1	0	1	0	0	0	0	0	0	0	0	0	0	0	0	0	0	0	1	0	1	0	1	0	6	0	0	0	1	0	0	0	0	1	1	0	1	0	0	0	1	3	0	5	5	0	14	1	0	0	5	0	1	1	1	0	0	0	0	0	0	1	0	0	0	0	0	0	0	0	0	0	0	0	0	0	0	0	1	0	0	0	0	0	1	0	1	0	0	0	0	0	0	0	0	0	0	0	0	0	0	5	0	0	0	4	0	0	0	0	1	0	0	0	0	5	0	0	0	3	0	0	0	6	0	0	0	0	0	0	0	0	1	0	0	1	0	2	1	4	0	0	0	0	0	0	0	0	0	0	0	127	0	0	3	2	0	0	0	0	2	13	1	0	1	0	0	0	0	0	1	2	0	0	3	0	0	2	0	808	0	0	0	0	1	0	0	0	0	0	0	3	0	1	0	0	0	0	0	0	0	0	0	0	1	0	0	0	0	0	0	2	1	0	0	0	0	0	0	0	0	0	0	0	0	1	0	0	0	0	0	0	0	7	0	0	0	3	0	1	0	0	0	0	0	1	0	1	3	2	0	0	2	0	1	2	0	0	0	0	7	0	0	2	0	1	0	0	0	3	0	2	1	1	0	0	0	0	0	0	1	0	1	0	0	0	1	0	0	1	0	0	0	0	0	0	0	0	0	0	0	0	6	0	0	0	0	0	0	0	0	0	0	0	0	0	0	0	7	0	1	0	0	0	0	9	0	0	505	0	0	0	1	0	0	0	0	0	1	0	0	0	0	0	0	0	0	0	0	0	1	0	0	0	0	0	0	0	0	7	0	1	2	1	2	0	1	0	0	0	0	0	0	0	0	0	0	0	0	0	0	0	0	0	2	0	0	0	0	0	0	0	0	0	0	0	0	0	0	0	0	2	0	0	0	0	0	0	0	0	0	0	0	0	5	1	0	0	1	54	0	1	5	5	13	55	16	1	28	0	0	1	0	0	1	0	7	1	0	0	0	0	0	0	8	0	0	0	0	12	0	2	0	0	0	1	2	8	0	0	0	2	0	0	0	0	0	0	0	0	0	0	0	0	0	0	10	4	0	0	0	0	0	0	0	0	1	0	0	0	1	0	0	0	3	0	0	0	0	3	1	0	0	2	0	0	1	2	0	0	0	0	0	0	1	0	0	0	0	0	0	0	0	3	0	1	0	0	0	0	0	0	0	5	1	0	4	0	0	0	0	0	0	0	25	0	0	0	0	1	0	0	0	0	0	0	0	0	0	0	0	0	19	1	0	0	0	1	0	0	1	4	0	0	0	0	0	0	0	0	0	0	0	16	0	0	0	0	0	0	0	0	0	0	0	0	0	0	0	0	0	1	0	0	0	0	0	0	0	0	0	0	1	0	0	0	0	0	0	0	0	0	1	0	2	2	0	0	1	3	0	18	27	0	0	0	0	0	0	0	0	0	11	0	0	0	3	27	2	0	0	0	1	0	0	3	0	1	1	0	0	0	1	0	0	0	0	7	11	3	0	0	0	0	1	0	0	0	0	0	3	0	0	0	0	0	0	0	0	0	0	0	0	0	0	0	0	0	0	0	2	0	0	0	0	0	0	0	0	0	0	0	0	0	0	0	0	0	0	0	0	0	0	0	0	0	0	0	1	0	2	0	0	0	0	0	0	0	0	0	0	0	0	0	0	0	180	2	2	0	0	0	0	1	0	0	0	0	0	0	0	0	0	0	0	0	0	0	0	0	0	0	3	4	0	0	3	0	0	2	2	0	1	0	0	0	0	0	0	1	0	1	0	3	0	0	0	0	3	0	4	0	0	0	0	0	1	0	4	2	0	2	1	2	0	0	0	0	1	0	0	0	0	0	0	0	0	0	0	0	0	0	0	0	1	0	0	0	0	0	1	0	3	0	0	0	0	1	0	0	1	0	0	2	0	1	0	0	0	0	0	0	0	0	0	3	1	12	3	0	0	0	0	0	0	0	0	0	0	0	0	0	0	0	0	0	2	2	0	5	5	1	100	1	0	1	0	0	0	0	0	4	1	4	0	0	1	0	0	0	0	0	0	0	0	0	0	0	0	18	3	0	0	0	2	0	0	0	0	0	0	0	0	11	0	0	133	0	0	0	2	0	1	0	0	0	0	0	0	0	0	0	0	0	1	0	0	0	0	0	2	0	0	0	0	0	0	0	0	0	2	1	0	0	0	0	0	0	0	0	0	0	6	1	3	0	0	0	0	2	0	0	0	0	5	0	1	0	0	0	0	0	0	0	0	0	0	0	0	0	0	0	0	70	0	0	0	0	0	0	2	0	0	0	0	0	0	0	0	0	0	0	1	0	0	0	0	0	0	0	0	0	0	0	0	0	0	0	0	0	1	0	1	5	2	0	1	0	0	0	0	0	0	0	4	2	0	5	0	0	0	1	0	1	88	0	0	0	0	1	0	0	0	0	0	0	0	0	0	1	0	0	0	0	6	0	0	0	0	0	0	0	1	0	0	0	0	0	0	0	0	24	0	0	0	0	0	3	0	0	0	2	0	0	0	0	0	0	0	0	0	0	0	0	0	0	0	0	0	0	0	0	0	1	0	0	2	0	0	0	0	0	0	0	0	0	1	0	0	0	0	0	0	2	0	0	2	0	0	6	0	0	0	0	0	0	0	0	0	0	0	0	0	0	0	0	0	0	0	0	0	0	0	0	0	0	18	0	0	0	0	0	0	0	0	0	0	0	0	0	0	0	0	0	0	0	0	0	0	0	0	0	0	0	0	0	0	0	0	0	1	0	0	0	0	0	0	0	0	0	0	0	0	0	0	0	0	0	2	0	0	0	0	0	0	0	0	0	0	0	0	0	0	0	0	0	0	0	0	0	0	0	0	1	0	1	0	0	0	0	0	0	0	1	0	0	0	0	0	1	0	0	0	0	0	0	0	0	0	0	0	0	2	0	1	0	0	3	0	3	0	0	0	0	0	0	0	0	0	0	0	0	0	0	0	0	0	0	0	0	0	1	0	0	0	0	0	0	0	0	0	0	0	0	0	0	0	0	0	0	0	0	43	0	2	0	0	0	0	0	0	0	0	0	0	0	0	0	0	0	0	0	0	0	0	1	0	1	0	1	0	68	0	0	0	0	1	0	0	1	0	0	0	0	1	0	0	0	0	1	0	2	0	0	0	0	0	0	0	1	0	0	0	0	0	0	0	0	0	0	1	3	1	1	9	9	4	0	0	0	0	2	0	0	0	0	0	17	0	0	0	0	0	0	9	0	0	0	1	0	0	0	18	1	0	0	0	0	0	0	0	0	4	0	29	0	0	0	0	7	0	0	0	0	0	0	0	0	0	0	0	0	2	1	0	0	6	1	0	0	0	0	0	0	0	0	0	1	0	0	0	0	0	0	0	0	0	0	0	0	0	0	0	0	3	0	0	0	0	0	0	0	1	0	0	0	1	0	1	0	0	0	0	0	0	0	0	0	1	8	5	0	1	0	0	0	0	0	0	0	0	0	0	0	0	0	0	1	0	7	0	0	0	0	0	0	0	0	0	0	1	0	0	0	1	0	0	0	0	0	0	0	0	0	0	0	0	0	0	0	0	0	0	7	1	0	3	3	0	1	0	0	0	14	4	0	42	0	0	1	3	0	0	0	1	3	1	1	0	0	0	0	0	1	1	0	0	0	0	1	7	0	11	5	0	0	0	0	0	0	0	0	0	0	0	0	0	3	0	0	0	2	0	0	0	2	0	0	0	0	0	0	0	0	0	0	1	1	1	1	1	1	1	0	3	413	0	3	0	0	3	0	1	0	0	1	0	0	0	0	0	20	0	0	0	0	0	0	0	0	0	0	1	0	0	0	0	0	0	1	0	1	0	2	9	0	2	0	0	0	0	0	0	0	1	0	0	0	0	0	0	0	0	0	0	0	7	0	0	0	0	0	0	1	0	0	0	0	4	3	3	5	0	1	0	0	22	1	9	4	0	0	0	0	0	0	0	0	0	0	0	0	0	0	0	0	0	1	0	0	0	0	0	0	0	1	0	0	0	0	0	0	1	2	0	0	0	0	0	2	2	2	1	0	0	0	0	0	0	0	0	0	0	0	0	2	0	1	0	1	0	0	0	0	0	0	0	0	0	0	1	1	3	0	0	0	1	0	2	0	0	0	0	1	0	1	6	1	5	0	0	0	4	0	0	0	0	2	0	0	0	0	1	0	2	0	0	0	0	0	0	0	6	0	2	0	0	0	0	0	0	0	0	0	0	0	0	0	0	0	1	2	0	3	0	0	0	0	0	0	0	0	1	0	0	0	0	0	0	1	0	1	1	2	0	2	0	1	0	0	2	0	0	0	0	0	3	0	0	1	0	0	0	0	0	1	0	0	0	1	0	0	0	0	0	0	0	0	0	5	0	0	0	1	0	0	1	0	0	0	0	2	0	0	0	0	0	0	1	1	0	0	1	0	0	0	0	0	0	1	2	0	0	2	2	1	0	0	0	0	0	4	0	0	0	0	0	0	0	0	0	11	1	0	10	3	1	12	10	1	2	5	4	0	10	3	2	5	2	2	2	0	0	0	2	0	0	0	0	1	0	0	0	0	0	0	0	1	0	0	0	0	0	0	0	0	0	0	0	1	1	2	0	0	0	0	0	0	0	0	0	0	0	0	0	0	0	0	0	0	0	0	0	0	0	0	0	0	2	0	0	0	0	0	0	0	0	0	0	0	0	0	0	0	0	0	0	0	0	0	0	0	2	0	0	1	0	0	0	0	0	3	0	0	0	3	11	4	1	0	0	4	1	0	0	0	0	0	0	1	0	0	0	0	0	4	3	0	2	0	1	0	0	0	0	11	0	0	0	0	0	0	0	0	0	0	0	1	17	0	0	0	0	0	3	0	5	1	0	0	12	2	1	0	1	2	0	0	0	1	0	0	0	114	2	0	0	0	0	0	0	0	0	1	0	0	0	9	16	0	1	0	3	0	0	0	0	1	1	0	0	3	1	1	0	0	0	19	0	0	0	0	0	0	0	0	0	3	0	0	0	0	0	1	0	0	0	1	4	0	0	0	1	0	1	0	1	0	0	1	2	2	2	0	0	0	0	0	1	0	0	0	0	0	0	1	0	0	0	0	20	0	1	0	0	0	0	0	0	0	1	0	0	1	4	0	0	0	0	0	0	0	0	0	0	0	0	0	0	0	0	0	0	0	0	0	0	0	0	0	0	0	0	0	0	0	0	1	0	0	0	0	0	0	0	0	0	0	4	0	1	1	0	2	0	0	13	0	3	1	0	0	0	23	4	0	2	1	0	0	0	21	0	0	0	0	8	0	1	3	0	4	0	0	0	0	0	22	2	0	0	0	1	0	0	0	0	0	0	0	0	2	0	0	0	0	0	0	0	0	0	0	0	0	11	1	4	1	4	0	2	0	1	0	0	0	0	0	0	0	0	0	23	0	0	0	0	0	6	0	10	1	12	2	0	0	0	1	0	0	16	0	1	2	2	1	0	6	2	0	0	0	0	0	0	0	0	52	5	4	0	0	0	0	0	0	2	0	0	0	1	0	0	0	5	9	0	0	0	12	2	1	3	0	3	0	4	6	0	0	0	0	0	0	2	0	0	0	0	0	0	0	3	0	1	0	2	0	0	0	0	0	0	0	0	0	0	0	0	6	0	0	0	0	2	1	21	0	0	0	0	0	1	0	1	0	0	3	0	0	6	0	3	0	0	0	0	0	0	0	0	0	0	0	0	5	0	17	7	3	0	0	0	12	0	1	1	0	0	0	0	0	0	0	0	0	0	1	0	0	0	0	0	0	0	0	0	0	1	0	0	0	0	0	0	0	0	0	0	0	0	0	0	0	0	0	0	4	1	0	2	1	0	10	0	0	0	0	0	0	0	0	0	0	0	0	0	0	0	0	0	0	0	0	0	0	0	0	0	0	0	0	0	0	0	0	1	0	3	0	4	0	0	4	0	0	0	2	0	0	0	0	0	1	0	0	0	0	0	0	1	1	2	0	13	0	0	0	1	0	0	0	1	31	0	0	1	0	1	0	0	0	0	1	100	2	1	1	0	2	2	1	1	2	0	0	0	1	0	0	0	0	0	0	0	0	1	0	0	4	2	0	0	0	0	0	0	0	0	0	0	0	0	0	0	0	0	0	0	0	0	0	0	0	0	0	0	0	0	0	0	0	5	0	0	0	0	2	0	0	3	0	5	2	0	2	0	0	0	0	0	0	1	0	0	86	0	0	1	0	0	0	0	4	0	1	0	3	0	8	0	0	0	0	1	0	0	0	0	0	0	0	0	0	0	0	0	0	1	0	0	1	0	0	0	0	0	0	0	2	0	1	0	1	0	1	0	1	0	0	0	0	0	0	0	1	0	0	0	0	0	0	0	0	1	0	0	0	0	0	1	0	0	0	1	0	0	0	0	0	0	0	0	0	0	0	2	0	0	1	2	0	0	0	0	0	0	0	0	1	0	0	2	2	0
LakWasMe76_LOW10_2_rpkm	0	0	0	0	0	5	7	1	1	0	0	295	0	0	0	0	0	1	1	0	0	0	0	9	2	0	0	0	0	8	0	4	0	9	1	6	0	0	0	0	0	0	0	2	6	12	23	10	0	4	0	4	0	0	0	0	0	0	30	4	71	0	0	2	2	0	0	0	3	18	0	0	1	0	3	0	0	0	0	0	1	5	1	0	0	0	0	1	0	0	0	0	6	0	2	0	0	0	3	0	0	0	0	0	0	0	0	0	0	0	0	0	45	1	16	0	0	0	0	0	0	0	1	12	0	0	1	0	0	0	0	17	4	0	0	1	0	0	0	0	0	0	0	4	1	0	0	0	11	0	3	21	1	1	13	0	1	1	6	0	2	0	0	0	4	0	0	0	0	5	0	0	0	0	0	0	0	0	0	0	0	0	0	0	0	3	0	0	0	2	5	1	5	10	0	0	0	9	11	14	3	0	0	0	0	0	2	0	2	1	4	6	14	6	5	1	3	0	0	1	10	6	2	0	0	1	0	1	6	0	0	0	2	0	1	0	18	1	14	1	0	0	5	0	19	1	0	0	4	4	2	3	6	1	938	73	0	0	0	0	0	0	0	15	0	1	1	0	7	25	5	0	2	0	0	0	0	0	7	3	0	24	4	15	12	0	1	0	10	3	1	0	0	0	2	0	0	0	10	0	0	1	22	1	1	0	3	38	4	1	2	0	9	3	0	0	0	0	1	0	0	0	0	0	3	8	0	2	1	0	0	0	0	0	0	0	0	0	0	0	0	0	10	1	6	2	7	0	0	0	0	0	0	0	1	0	0	0	0	32	1	0	2	0	0	8	2	6	1	38	0	22	0	0	0	0	0	0	0	2	0	0	4	0	1	0	6	0	0	0	0	0	62	0	0	2	10	0	0	4	0	13	0	0	22	0	17	1	0	2	0	9	6	0	0	11	16	2	2	0	0	0	1	0	0	0	0	0	0	0	0	1	0	1	3	0	0	0	2	0	35	7	0	1	2	42	0	0	0	0	0	30	3	38	0	11	9	1	0	1	1	0	1	7	0	12	10	0	0	1	9	1	11	1	0	0	4	0	6	0	2	0	4	1	0	0	0	12	0	2	0	0	33	18	1	0	0	0	0	1	0	1	3	0	0	0	0	2	0	0	0	0	0	1	0	0	1	0	2	4	1	0	0	0	0	0	0	0	0	0	0	0	0	0	8	0	5	0	0	12	0	1	0	12	2	0	0	0	1	0	0	0	1	0	0	3	1	0	0	0	0	0	0	0	12	0	2	0	15	0	0	0	0	1	4	14	2	81	0	4	14	98	6	8	55	0	5	5	3	0	0	0	5	0	1	1	0	0	1	0	8	0	0	0	6	7	0	14	0	2	0	52	24	33	0	0	20	0	49	1	18	5	40	3	0	2	0	4	0	1	0	5	0	0	0	0	0	0	0	1	5	23	0	0	0	0	0	1	5	1	34	0	2	4	0	0	1	0	1	0	1	19	0	5	0	0	1	0	1	5	0	10	1	0	0	0	2	0	0	0	0	0	5	0	0	0	0	0	0	13	0	0	3	0	0	0	0	1	0	1	0	2	0	3	1	1	4	0	10	0	0	0	0	0	3	1	1	0	0	0	1	0	3	4	0	0	2	11	3	0	0	0	0	0	0	0	0	0	0	7	0	18	13	0	4	19	2	0	1	4	0	0	0	0	0	5	0	0	16	0	0	1	0	39	0	2	0	0	0	1	0	0	0	0	0	17	0	0	0	0	0	0	0	0	0	0	3	0	0	2	0	8	1	0	0	0	2	0	0	4	0	0	0	0	27	1	2	0	0	0	0	0	0	0	0	0	2	0	0	0	0	0	0	7	12	1	0	0	0	0	0	0	0	0	0	0	0	16	22	0	0	0	0	0	0	0	0	2	11	6	0	0	5	0	0	0	0	0	0	5	10	0	0	1	0	0	0	0	1	0	0	0	0	0	0	0	1	4	0	13	0	0	0	0	0	1	1	0	0	0	0	0	0	0	1	0	0	0	0	0	0	0	0	0	0	0	1	1	0	0	0	0	0	0	20	18	16	6	14	0	0	0	0	0	0	0	0	0	0	0	1	0	0	0	0	0	0	0	0	3	0	0	0	1	2	0	0	7	0	0	0	1	0	1	0	0	0	0	4	0	0	0	0	0	2	1	0	0	0	1	0	1	3	8	9	8	0	0	0	0	18	6	1	1	5	0	0	0	1	0	0	1	30	0	0	0	0	0	1	0	0	0	0	0	0	1	0	0	0	0	0	0	0	0	0	0	0	22	0	0	0	22	3	0	3	11	0	0	2	2	1	0	0	0	0	0	0	0	8	3	0	0	0	0	0	0	1	1	0	0	1	0	1	3	1	0	0	0	0	0	4	2	0	4	1	0	0	0	0	1	6	0	0	0	1	0	2	1	1	12	0	0	0	0	0	0	0	0	0	9	0	1	0	0	0	0	1	0	0	0	0	0	0	0	0	2	19	0	1	7	0	0	0	0	2	0	0	2	2	1	6	4	1	0	0	0	5	4	9	0	0	0	0	0	0	6	0	0	0	0	0	0	0	0	0	0	0	0	0	0	0	0	0	0	6	0	0	0	0	40	0	0	0	0	0	0	0	0	0	0	10	0	0	0	0	0	0	0	0	0	0	0	3	0	0	0	0	0	0	0	0	1	11	2	17	19	11	5	0	4	1	0	0	0	0	5	2	0	0	1	0	0	1	0	0	0	0	2	0	0	0	0	5	0	0	0	0	1	5	9	0	0	0	0	0	0	0	10	11	0	2	0	1	3	0	0	0	45	0	0	5	0	0	40	51	0	0	0	0	0	2	0	0	12	0	1	0	0	0	0	0	1	2	2	0	4	5	717	0	26	0	0	1	5	0	5	0	0	4	0	0	0	0	0	0	5	0	0	0	3	0	0	1	0	0	1	0	1	0	12	0	1	0	0	0	0	0	0	0	0	0	0	18	0	1	0	0	0	1	0	0	1	4	5	2	0	15	4	13	3	0	0	3	0	0	0	0	1	3	11	0	0	0	0	0	0	3	4	0	0	0	0	2	0	49	0	3	0	0	1	0	0	3	3	0	1	3	1	1	0	0	0	0	0	9	1	3	13	7	8	4	2	16	0	0	2	1	8	0	1	0	4	0	6	2	0	7	0	0	0	0	1	8	5	2	0	6	0	0	0	0	0	0	2	1	0	0	0	1	0	5	16	1	1	2	0	2	2	0	0	0	0	0	1	2	3	0	1	0	0	0	0	2	470	21	0	8	2	1	0	0	0	0	0	0	22	0	6	0	11	0	0	0	2	46	21	7	101	1	0	0	70	0	0	0	0	0	0	0	0	101	2	24	8	30	6	0	12	4	3	0	0	0	0	0	0	7	1	0	0	0	8	0	5	0	1	0	0	0	3	0	7	0	0	0	1	2	0	0	0	0	0	0	0	2	4	0	0	0	0	0	3	0	0	0	0	0	0	4	3	0	0	3	0	0	0	0	0	0	1	0	0	0	1	0	0	0	0	0	0	0	0	0	0	0	0	0	0	0	0	0	0	0	0	0	0	0	32	0	0	4	0	0	0	1	51	0	7	8	0	0	17	0	2	0	4	1	0	0	0	11	0	16	0	0	0	0	0	1	1	0	2	44	0	0	0	5	0	0	0	0	0	0	0	0	0	0	0	0	22	1	2	0	0	11	4	1	0	0	11	0	0	0	2	1	0	0	0	0	2	1	0	0	7	7	0	8	6	0	0	0	4	0	1	2	8	1	0	1	0	0	0	0	1	0	0	1	0	42	11	66	74	127	47	104	2	0	0	0	1	1	7	0	0	0	4	30	0	0	0	1	3	4	0	0	5	15	0	15	5	0	5	0	1	0	2	3	0	36	14	18	0	0	0	0	0	0	33	0	14	8	0	0	0	0	0	2	34	1	7	2	0	0	7	0	1	10	33	4	39	0	4	1	5	3	1	0	0	1	0	6	0	15	5	0	0	0	0	0	1	2	1	3	6	0	0	0	0	0	0	0	18	0	0	0	0	1	21	3	0	0	0	7	0	6	10	0	1	7	8	0	112	1	0	2	0	1	0	0	0	2	0	5	0	0	1	0	0	0	43	0	0	1	0	0	0	0	0	0	22	2	1	0	0	0	3	0	0	0	0	1	0	1	1	0	0	9	0	0	0	0	0	0	0	12	1	0	7	2	0	0	1	42	15	0	18	0	12	65	0	9	0	40	27	8	2	3	2	5	1	0	3	0	0	0	0	3	0	0	0	0	0	0	4	0	1	5	0	0	13	0	1	26	0	0	0	0	0	0	0	1	0	0	0	0	0	0	0	0	0	1	4	5	0	0	0	0	0	0	0	3	0	0	1	0	0	0	0	2	0	0	0	0	0	1	0	0	0	0	0	0	0	0	0	0	0	5	1	0	0	0	0	47	0	0	1	3	1	4	0	4	0	6	8	50	2	0	0	0	0	0	0	0	0	0	2	0	0	19	0	0	1	0	1	0	0	0	0	0	0	0	0	1	0	3	0	11	2	0	5	0	0	0	0	18	55	23	0	0	0	0	0	0	0	0	0	0	0	0	0	3	0	0	2	2	0	0	0	0	0	0	0	0	0	0	0	0	0	1	0	0	0	1	34	21	0	0	0	0	0	0	0	4	0	0	3	2	0	0	0	0	9	0	0	36	0	0	3	4	0	1	0	1	0	1	18	0	1	0	0	1	0	0	0	0	0	0	14	0	0	0	0	0	10	0	0	1	10	0	11	14	5	1	0	0	0	0	0	4	0	12	0	0	0	0	0	3	2	0	5	0	0	0	0	0	0	0	0	1	0	0	2	0	0	0	0	0	4	1	0	0	0	1	25	0	0	0	0	0	0	0	0	0	0	0	0	1	0	0	0	7	0	0	0	0	1	0	1	0	3	0	1	1	146	2	1	5	14	2	7	5	0	7	2	1	0	0	0	0	1	25	0	0	1	2	0	0	2	1	0	6	0	5	0	0	0	0	2	0	0	5	0	2	1	0	1	0	0	0	0	0	0	0	1	2	1	1	0	2	1	0	2	1	0	9	0	0	4	0	0	0	0	1	4	0	0	4	0	1	0	0	0	4	0	0	1	0	1	14	2	0	0	0	0	0	0	0	1	9	5	0	0	0	0	0	0	0	0	1	0	0	0	0	1	0	0	0	0	1	0	1	0	0	0	1	0	0	1	0	0	3	0	1	0	4	0	5	0	8	0	0	0	0	0	0	3	5	0	0	0	0	0	101	79	89	65	129	30	44	45	6	50	24	35	19	35	6	20	9	111	14	4	8	0	226	138	25	103	75	63	53	11	35	12	23	8	0	2	0	0	0	0	0	0	0	0	21	34	0	0	0	0	0	0	0	0	0	0	0	0	0	0	0	0	0	0	0	0	3	2	7	0	2	2	0	0	0	0	16	1	5	0	5	1	0	1	1	1	0	0	0	0	0	12	0	0	0	0	1	7	2	2	1	0	1	14	0	0	0	2	0	0	2	1	0	0	0	0	17	0	0	2	14	2	0	0	1	0	0	0	0	0	13	1	0	1	0	0	0	0	0	0	0	0	0	0	0	0	0	0	0	0	8	168	0	0	5	7	0	0	0	0	0	0	0	0	0	0	1	0	0	2	2	1	0	0	0	0	0	0	7	2	7	2	1	4	3	2	0	5	1	33	4	1	0	0	0	0	0	0	0	0	10	0	1	1	1	0	0	0	0	2	0	0	0	0	0	1	0	1	1	0	0	0	1	0	0	0	3	0	0	0	0	0	0	0	0	2	0	2	0	1	0	49	0	0	0	0	0	0	0	1	0	0	0	0	0	0	0	0	3	0	59	1	0	2	0	0	9	0	1	54	3	0	2	0	0	33	0	0	0	1	0	0	0	0	0	0	0	2	0	0	0	0	0	0	0	0	0	0	8	0	7	0	0	0	0	0	0	0	0	0	1	0	1	0	0	0	0	1	2	1	0	0	0	2	0	0	95	32	1	0	0	0	0	1	0	0	0	0	0	0	0	0	0	0	0	0	12	0	2	6	0	0	0	0	0	0	0	0	21	7	0	0	0	0	27	0	0	0	0	0	0	0	0	0	0	0	0	0	32	3	0	0	0	0	1	0	0	0	1	0	6	5	3	1	0	0	1	0	20	1	0	2	0	0	0	0	0	0	1	0	0	1	0	0	4	0	0	0	1	0	0	0	0	0	0	0	0	0	1	0	0	0	0	0	2	0	0	1	0	0	0	0	0	6	0	0	0	0	0	0	0	2	2	0	24	0	0	5	0	2	0	0	4	1	1	0	0	27	0	11	0	0	0	0	0	0	0	0	0	4	0	0	1	0	1	0	17	0	1	0	14	6	0	6	4	2	0	1	0	2	0	4	1	1	1	13	14	2	5	2	0	2	1	1	0	3	0	0	0	11	0	8	1	26	32	18	24	26	17	15	1	0	17	16	21	0	9	0	0	0	4	6	0	9	0	1	0	0	10	7	0	0	0	0	1	0	3	0	0	0	0	15	0	0	0	0	1	15	0	0	0	0	0	0	0	0	3	0	0	6	0	1	1	1	0	0	0	0	0	0	0	1	1	0	0	57	0	2	45	26	19	1	5	1	1	0	1	0	16	0	0	1	0	0	4	0	2	0	0	1	0	0	0	0	0	0	0	0	4	6	0	17	0	0	2	0	0	17	5	1	0	0	8	1	2	1	0	0	3	0	4	0	0	0	11	0	0	0	10	3	0	0	0	0	0	0	201	101	8	2	0	0	0	0	0	1	0	21	0	1	0	5	0	1	22	40	6	0	0	0	0	0	0	0	90	0	0	0	0	0	1	0	0	0	0	0	0	0	0	0	0	0	0	0	0	0	48	108	2	1	0	0	0	0	10	3	3	1	0	0	0	1	4	0	0	1	0	0	0	0	0	13	0	1	0	0	0	1	0	0	9	0	0	0	0	0	0	0	0	0	0	0	0	187	0	1	1	0	2	0	0	0	0	0	0	0	0	0	0	1	0	4	0	0	0	0	0	0	0	0	0	0	0	0	0	0	0	0	0	0	0	0	0	0	0	0	0	0	1	0	0	0	0	0	0	0	0	0	0	0	0	0	0	33	0	0	0	0	0	0	10	0	0	0	0	0	0	40	0	0	0	0	0	3	6	12	6	0	3	0	0	4	0	0	26	0	0	2	1	0	0	0	0	0	0	1	9	0	0	0	1	0	0	0	0	0	0	0	0	5	0	0	0	0	0	1	0	0	4	0	6	0	1	1	0	0	6	0	0	0	0	0	0	0	0	8	1	1	0	3	6	5	1	7	0	0	0	0	0	0	0	0	3	0	0	0	0	3	0	8	0	0	0	0	0	0	0	0	0	2	1	3	9	1	0	1	0	1	0	0	0	0	2	0	0	0	0	0	0	5	0	3	2	0	4	1	7	3	0	0	0	0	0	0	0	1	0	13	0	0	0	0	0	0	7	68	0	3	0	0	0	1	0	0	0	0	0	0	0	1	0	0	3	3	6	1	0	0	0	0	0	0	0	2	21	0	7	1	0	1	0	0	0	0	17	0	0	0	0	0	8	4	0	0	0	0	0	1	4	0	1	21	3	2	0	7	20	0	0	0	8	0	4	10	0	0	0	0	89	0	0	2	2	5	1	0	0	0	0	0	0	0	0	0	0	0	0	46	0	0	0	0	0	0	0	26	0	0	1	0	0	0	0	0	0	0	0	0	0	0	0	0	0	0	0	1	0	2	0	0	7	0	10	0	0	0	0	0	0	0	0	0	6	27	11	0	0	0	1	8	0	3	0	0	1	0	0	0	0	0	1	0	0	1	0	1	0	0	0	0	2	0	2	0	0	0	0	0	0	2	0	0	0	0	0	0	0	0	1	0	4	0	0	0	41	0	0	1	5	0	1	2	0	0	0	0	0	0	0	0	0	0	0	3	0	0	24	0	0	0	0	0	0	16	0	0	0	0	18	0	0	0	9	0	0	2	0	0	1	0	0	5	0	0	0	0	16	0	0	0	0	20	0	0	1	1	1	0	0	0	0	0	0	0	0	0	0	0	0	0	0	10	0	0	0	0	0	0	0	0	495	0	0	0	0	3	0	0	0	0	0	0	0	0	2	0	3	0	0	0	0	0	0	0	8	10	0	0	0	0	0	2	0	2	0	0	0	0	0	0	0	6	0	0	0	0	0	1	0	0	0	0	0	0	0	0	0	0	0	0	1	2	0	1	32	0	0	0	0	0	0	0	0	0	2	0	0	0	0	2	0	0	3	1	0	0	1	0	1	0	0	0	0	0	0	0	0	0	1	0	0	0	0	0	0	0	0	0	0	0	0	0	0	0	0	0	0	5	0	0	0	0	0	0	0	0	0	0	0	0	0	0	1	0	27	0	0	4	0	11	1	0	0	83	0	0	11	0	0	1	0	1	0	4	0	0	3	0	0	1	0	19	36	2	0	0	0	1	0	0	0	0	0	1	1	3	0	2	0	0	3	0	0	0	0	0	0	1	0	0	0	0	0	5	0	0	0	0	0	1	0	0	0	0	0	0	0	0	0	0	1	0	0	0	0	0	0	12	0	16	1	0	0	2	0	0	0	0	0	0	13	0	0	0	0	0	3	0	0	0	0	0	0	1	0	7	0	0	0	2	0	1	0	0	0	0	0	0	0	0	3	0	0	0	0	0	1	0	0	1	0	0	2	0	0	0	0	0	1	0	0	0	1	0	4	2	0	0	0	0	8	0	1	13	0	5	0	0	0	0	0	0	2	0	0	0	7	0	1	1	0	0	0	0	0	0	0	0	0	0	0	0	0	5	0	0	0	0	0	1	0	0	0	1	0	0	0	2	0	0	0	0	0	0	0	0	0	0	0	0	11	0	0	0	0	0	0	0	0	0	0	0	0	0	0	1	0	0	0	1	0	0	1	1	0	0	0	0	1	0	1	0	0	0	0	0	1	0	0	0	0	0	0	8	0	0	2	0	1	0	0	0	0	0	2	0	37	14	0	0	0	1	0	0	10	0	1	4	1	0	0	0	2	0	0	0	0	16	0	0	0	0	0	0	0	0	0	0	0	10	1	0	4	2	0	0	0	8	1	0	12	0	0	5	0	0	0	0	0	0	0	0	0	0	0	0	0	0	0	0	0	0	2	0	33	0	0	0	0	1	3	0	0	0	0	0	4	0	0	0	0	3	0	0	0	0	2	5	1	1	0	0	0	0	0	0	0	0	2	6	1	0	0	21	8	2	22	61	0	0	0	0	56	0	21	10	0	0	0	0	6	38	0	35	0	3	27	0	67	0	5	0	1	0	0	0	6	1	0	1	0	0	0	1	3	12	7	0	0	7	0	17	0	1	0	0	2	1	1	0	0	0	0	1	0	2	2	0	0	0	0	11	0	0	7	0	0	0	0	0	0	0	0	0	0	2	0	0	2	8	0	1	1	18	2	0	0	5	0	2	0	0	0	0	0	0	0	0	0	0	11	43	0	1	8	0	0	0	0	2	0	0	0	0	0	0	0	3	8	0	0	0	0	0	0	5	2	1	0	0	0	0	0	0	0	0	0	5	3	0	3	0	1	1	0	0	0	2	0	1	1	1	0	0	0	0	6	0	0	7	0	4	3	1	0	0	1	0	1	0	0	3	2	0	0	0	0	1	0	0	0	61	68	98	0	1	7	12	28	0	22	21	16	7	17	65	29	4	43	20	21	12	15	1	58	14	82	0	8	0	6	0	0	0	0	2	0	0	0	0	0	0	0	2	1	0	0	0	0	0	12	8	0	8	1	0	1	0	0	3	0	0	0	3	4	6	1	0	0	0	0	16	0	1	1	2	0	0	0	48	4	0	1	0	4	0	0	2	0	3	1	17	0	0	0	0	4	0	6	13	1	12	0	42	0	0	0	0	0	0	0	0	0	0	0	0	0	1	6	2	0	0	0	0	0	0	0	0	0	12	1	0	4	0	1	0	1	0	0	0	0	1	0	1	0	0	1	0	0	0	4	1	1	8	0	1	9	0	0	0	0	3	0	0	0	0	0	13	0	0	19	0	0	0	0	0	0	0	9	0	0	0	0	2	0	0	0	0	9	0	0	13	1	5	1	1	2	0	9	0	0	0	6	0	0	0	3	0	0	0	0	0	0	0	0	0	0	3	0	0	0	2	0	0	1	1	1	0	0	0	13	0	0	0	0	3	5	1	0	15	1	0	0	15	2	0	0	0	13	0	20	0	0	0	0	2	0	0	0	1	0	0	0	0	2	6	0	2	0	8	0	0	2	0	0	0	0	1	0	0	0	0	0	0	0	0	1	0	3	18	0	1	0	0	0	0	12	0	0	0	0	0	0	1	1	0	7	27	0	9	0	0	0	3	3	0	5	10	1	0	0	0	12	0	7	0	1	0	0	0	0	3	0	5	0	0	0	0	0	1	0	0	1	0	0	2	5	1	0	1	0	0	1	0	0	0	3	0	0	0	0	0	0	3	0	0	0	0	0	0	0	1	0	0	0	0	1	0	0	3	17	0	3	0	0	0	0	0	0	0	8	0	2	0	1	0	0	0	5	0	0	0	0	0	0	0	0	4	0	0	0	1	0	0	1	0	8	1	0	0	2	0	0	0	0	0	0	1	0	0	0	0	0	2	3	0	1	1	0	35	8	11	3	0	1	2	0	0	0	0	2	1	0	0	26	2	0	3	0	0	0	2	0	2	2	1	6	1	10	3	0	1	0	0	0	0	6	0	1	0	0	3	0	0	0	0	0	1	0	6	9	0	5	3	3	3	0	0	0	0	38	0	0	0	2	0	0	5	0	0	0	0	0	0	0	0	2	0	0	0	0	0	0	0	3	0	0	28	81	1	0	0	0	58	6	69	1	3	0	0	0	0	5	1	0	0	0	0	1	3	0	11	0	0	0	7	0	0	4	0	1	0	0	0	1	0	0	0	1	0	23	3	0	0	0	0	0	4	1	0	0	0	0	1	0	1	3	0	1	4	0	0	0	3	0	0	0	143	1	0	5	7	0	0	0	0	2	0	0	4	0	0	13	0	0	0	1	0	0	0	4	1	0	9	13	0	16	0	16	0	0	7	0	0	0	2	0	0	0	0	0	0	0	0	7	7	0	4	0	0	0	2	66	0	2	0	4	0	1	0	1	4	0	0	1	2	2	8	27	0	0	0	0	0	25	0	0	2	0	1	0	20	0	1	0	0	0	0	0	54	5	0	0	0	0	2	0	10	0	0	0	0	0	0	0	0	0	2	0	0	0	0	1	0	0	0	0	0	0	1	0	0	4	0	0	0	0	0	0	0	0	0	0	0	0	0	0	0	0	0	0	0	46	0	0	2	0	2	0	0	0	4	0	0	5	0	0	0	0	0	1	0	0	0	4	0	0	0	0	0	0	0	0	0	1	18	0	4	0	0	0	0	0	7	0	0	0	0	0	0	0	1	0	0	0	0	0	0	0	6	0	0	0	0	0	0	1	1	0	3	3	0	0	3	0	0	0	0	0	0	0	0	3	0	5	0	1	0	2	0	1	0	0	0	0	10	0	0	1	0	0	0	0	0	0	0	0	0	0	0	0	7	0	5	7	0	0	0	0	0	0	0	0	0	0	0	0	1	0	0	0	0	0	2	0	0	5	0	0	0	2	1	0	0	0	0	7	0	0	14	1	0	0	0	0	0	0	0	0	0	0	10	0	0	0	0	0	0	0	0	0	0	0	0	0	0	0	0	2	1	0	0	0	0	0	0	165	4	0	0	0	0	0	1	0	1	0	0	0	0	0	0	0	5	0	1	1	0	4	0	0	0	0	0	1	4	0	0	0	2	0	0	0	0	47	4	26	0	0	0	0	1	0	1	5	5	2	0	0	276	17	18	7	0	3	18	0	54	0	0	1	8	16	0	4	0	0	0	0	2	0	0	0	26	2	0	21	286	309	0	0	0	61	4	1	1	0	0	4	0	0	2	0	1	0	0	0	0	0	0	0	9	0	1	4	0	0	1	0	0	9	0	6	0	3	0	7	1	19	1	0	7	0	3	0	0	12	3	0	0	0	0	0	1	1	1	0	0	0	2	4	10	1	2	0	0	0	17	14	1	0	33	1	195	0	0	0	2	0	0	0	0	0	0	0	0	0	0	1	0	0	0	0	2	0	7	1	30	0	1	1	0	0	5	0	0	0	0	1	0	0	0	0	3	0	0	1	0	0	0	0	0	0	1	1	0	0	0	0	0	0	0	1	0	0	1	0	0	0	0	0	0	0	0	0	1	0	2	0	0	0	2	0	2	0	21	4	0	1	0	0	0	0	0	1	0	0	2	18	0	1	1	0	0	23	6	2	0	11	5	3	0	0	2	1	0	0	2	3	0	0	0	0	1	1	1	0	0	0	0	0	0	0	0	2	1	0	0	5	0	0	4	2	0	0	0	0	0	0	2	1	0	0	10	26	0	0	0	0	0	3	0	0	0	6	3	16	16	1	2	0	0	0	2	0	20	0	0	0	100	1	0	0	6	0	2	0	0	0	0	7	1	11	8	0	15	0	1	0	0	15	1	0	2	0	0	15	6	10	1	7	1	0	0	1	5	0	0	0	0	0	0	0	2	0	0	0	0	0	5	0	0	0	0	0	3	0	3	0	0	0	21	0	4	0	0	22	3	0	0	0	5	0	14	1	3	12	15	1	2	11	4	17	4	24	3	0	0	0	0	4	0	0	1	0	0	0	2	0	0	0	0	0	6	2	1	1	0	19	16	35	0	121	0	1	0	1	1	0	0	0	0	0	0	0	0	0	0	0	0	0	0	6	16	2	0	1	0	0	0	0	0	0	3	0	9	0	0	0	2	0	1	1	0	2	0	0	10	0	0	0	0	7	0	40	22	7	3	0	0	8	0	0	0	14	3	0	0	0	0	1	0	0	10	0	0	0	27	5	14	4	0	0	8	0	0	17	1	0	14	0	4	1	0	0	2	0	0	24	26	16	3	0	7	0	0	2	3	1	0	0	0	0	6	3	0	1	0	1	0	50	32	13	1	0	0	34	0	0	0	0	0	0	0	0	2	0	0	0	5	14	6	0	0	0	2	2	0	0	0	0	0	0	32	8	1	1	3	0	3	0	28	0	7	7	8	4	12	6	0	1	65	13	0	6	0	0	1	7	3	1	0	0	0	0	0	0	0	0	0	0	2	0	0	0	0	4	22	44	134	184	11	6	0	5	0	11	26	14	0	0	14	0	0	0	0	0	0	0	0	0	0	0	0	0	0	0	0	1	0	4	1	0	0	0	0	0	1	0	7	0	0	27	2	16	0	6	4	5	10	0	1	0	0	0	0	66	27	3	0	0	1	1	1	8	0	1	4	0	0	1	10	1	1	13	0	0	0	0	12	7	0	0	0	0	0	1	0	0	3	0	0	0	0	0	12	2	1	0	92	0	0	0	0	0	0	15	0	2946	0	5	0	4	12	356	0	0	0	0	0	0	0	0	0	7	5	6	0	0	0	0	0	0	27	11	3	0	0	23	0	0	1	0	0	0	0	0	0	1	14	8	0	0	0	0	1	0	0	0	3	3	0	1	0	0	0	0	1	0	0	0	0	0	0	0	23	0	0	14	1	0	4	0	0	1	0	3	49	0	0	0	0	0	0	0	1	8	0	0	0	0	0	0	0	0	0	0	0	180	1	0	2	16	0	0	0	0	8	0	19	4	7	0	0	0	1	0	4	0	1	7	0	0	0	0	26	0	0	0	0	0	0	0	0	0	0	0	0	0	247	2	5	1	0	102	0	2	15	0	4	6	92	62	66	16	12	8	13	1	0	7	8	5	2	7	0	0	1	319	0	2	9	5	0	15	0	0	0	77	1	0	0	0	0	5	0	0	0	0	0	7	12	19	7	14	19	10	4	9	0	3	0	8	2	9	12	1	0	0	0	0	0	0	0	0	0	7	0	0	4	0	7	0	1	4	0	0	0	2	0	3	1	1	0	6	0	0	4	3	0	0	0	0	0	8	0	0	0	3	3	5	3	0	6	0	0	0	6	19	69	5	0	0	7	58	0	7	5	0	2	0	11	2	0	8	0	0	7	2	11	40	1	1	11	3	60	2	0	0	12	1	2	0	15	2	4	0	0	2	9	0	0	0	0	0	0	3	7	0	0	3	0	0	4	1	0	0	0	0	0	1	0	1	4	0	0	6	1	0	78	3	3	0	0	3	4	0	1	3	0	3	0	1	0	35	12	0	53	137	0	8	3	6	3	6	3	1	1	1	0	2	29	1	8	41	28	25	0	0	0	0	1	0	0	0	0	1	14	9	1	0	0	0	0	0	33	24	4	0	11	0	0	0	0	2	0	4	2	0	1	0	0	0	0	0	2	0	0	0	0	0	0	0	1	0	0	3	0	0	1	0	0	0	13	3	0	0	1	4	11	0	0	0	0	0	0	0	4	0	0	0	0	0	0	0	0	0	0	1	5	3	0	1	0	0	0	0	0	0	0	0	2	50	0	0	25	0	1	0	12	2	50	0	0	1	0	0	3	0	8	2	2	4	0	0	1	0	0	0	0	0	0	0	3	45	27	11	31	1	29	24	1	40	0	30	4	3	1	47	83	48	69	101	8	20	29	23	0	19	0	0	14	22	9	1	7	41	3	20	50	2	22	4	57	8	0	60	4	21	37	4	27	0	0	0	0	29	30	0	20	11	18	19	0	1	28	105	179	112	0	42	21	1	0	0	0	0	7	2	78	0	10	0	244	256	61	0	0	16	0	0	0	0	0	36	1	29	3	4	0	53	4	6	398	0	16	4	15	3	0	1	0	0	0	26	11	2	6	3	18	0	5	1	11	10	2	0	0	0	1	0	0	0	4	0	0	1	0	0	0	0	9	1	0	0	0	0	5	0	2	1	0	0	0	0	0	2	8	0	0	0	0	0	0	0	0	3	0	0	0	0	0	0	1	0	0	4	0	1	1	2	8	4	0	4	8	1	0	1	0	0	0	1	0	0	0	0	0	0	0	0	0	0	0	0	5	0	1	0	0	0	6	0	0	0	0	0	0	0	0	0	0	0	0	0	0	1	0	7	1	0	0	0	1	0	13	1	4	15	0	18	1	22	0	1	0	0	0	1	0	0	0	0	0	2	0	8	2	6	1	0	0	0	0	0	0	0	1	5	3	0	0	12	0	4	0	0	22	27	0	0	0	7	0	0	17	3	12	23	13	0	0	3	0	1	12	0	48	0	0	0	3	4	0	0	1	4	0	10	58	0	0	19	1	0	0	20	28	6	1	3	0	0	2	2	16	2	0	4	1	0	0	1	1	0	3	0	0	0	0	0	6	0	0	10	0	0	0	0	0	0	2	4	2	0	19	0	0	0	0	0	1	0	0	0	19	6	1	0	3	3	0	1	1	0	2	1	2	0	0	1	0	0	0	0	0	0	0	0	0	0	0	6	2	6	0	1	0	0	0	0	0	0	1	2	9	1	1	0	2	0	0	0	0	1	0	0	1	31	5	0	18	6	4	0	0	6	0	1	0	2	0	0	0	0	0	2	2	1	0	0	0	0	0	1	1	1	0	10	23	8	0	1	0	0	0	0	5	0	3	4	4	1	0	0	0	0	5	0	1	2	2	0	0	6	0	0	0	0	3	6	0	0	22	4	1	0	1	13	1	11	1	1	75	0	0	9	0	0	0	0	0	0	0	0	0	12	6	0	11	0	7	2	0	0	0	18	0	0	0	0	0	0	0	0	0	0	1	0	0	0	0	0	0	0	0	0	0	0	0	0	0	0	0	0	13	2	0	1	1	0	6	1	0	0	0	0	26	21	0	0	1	0	6	0	10372	0	0	0	1	0	0	0	0	0	0	0	0	0	0	0	0	9	0	0	0	0	3	0	20	9	0	7	2	2	0	0	0	0	0	0	0	0	15	58	0	9	4	0	1	0	0	1	1	0	5	0	0	1	0	12	4	7	21	47	5	11	13	0	8	0	0	1	0	0	13	5	21	23	0	0	0	2	2	3	0	13	56	12	1	10	0	0	0	0	2	0	2	1	8	23	4	0	44	0	0	0	23	13	0	0	45	6	1	1	0	0	0	0	0	0	0	0	0	15	57	4	61	103	0	5	33	1	82	25	120	71	238	68	11	17	23	72	11	0	5	27	13	0	2	0	0	0	30	33	82	116	46	0	6	0	0	19	12	1	9	0	0	0	0	0	0	0	0	0	0	0	0	0	1	1	4	0	3	0	0	0	6	0	0	0	0	9	10	7	2	2	2	1	1	0	13	0	2	0	2	0	0	1	36	0	8	6	0	3	0	0	0	8	5	0	0	0	3	0	0	0	0	1	0	0	0	0	0	4	1	1	0	11	3	2	0	0	2	0	0	0	0	0	0	7	0	4	0	0	0	24	9	0	3	8	0	24	1	0	5	4	0	4	0	0	0	0	0	0	1	0	1	1	1	0	0	0	0	0	0	0	2	0	4	1	0	0	0	1	0	0	0	1	0	6	0	7	0	0	0	1	1	0	1	0	0	0	0	0	0	0	5	13	0	0	3	0	1	0	0	1	5	0	0	0	2	6	4	0	25	0	0	2	24	11	19	2	1	0	1	0	1	10	0	0	9	0	4	2	4	3	0	0	0	0	0	0	0	0	1	0	91	0	2	4	6	0	0	0	0	973	5319	0	0	0	0	0	0	1	17	4	18	3	8	2	0	13	10	1	6	1	1	0	11	9	2	9	0	25	0	0	10	0	19	10	1	0	0	0	0	0	0	10	0	0	19	10	2	0	0	0	20	0	0	0	0	1	0	3	0	0	0	1	0	0	4	5	0	0	1	0	1	1	6	0	0	0	3	2	1	0	0	0	0	0	0	0	9	38	4	8	6	6	8	5	17	2	3	2	2	11	0	0	2	0	1	0	4	2	3	0	0	0	2	0	0	0	0	0	0	0	0	5	1	4	0	0	0	4	1	3	1	0	4	0	0	0	0	4	0	0	1	65	0	7	0	0	0	0	0	0	2	0	3	0	1	0	0	6	0	9	0	0	0	0	21	0	1	0	0	0	0	2	0	0	1	14	3	3	0	1	0	2	0	3	0	0	0	0	0	0	0	0	0	0	1	0	0	0	10	0	3	19	114	134	15	17	0	0	0	0	0	0	0	0	0	0	0	0	0	0	0	0	0	14	0	0	0	1	0	4	2	0	0	0	0	0	0	0	0	0	16	1	0	9	1	0	9	0	1	4	2	1	0	56	3	2	1	10	40	0	10	18	14	29	208	181	2	12	0	0	13	0	0	0	2	18	3	0	0	0	0	0	3	65	0	0	1	0	105	0	0	0	0	1	8	16	137	1	0	0	0	2	0	0	1	0	0	0	1	0	1	0	0	1	0	76	3	0	0	0	2	0	0	0	0	10	0	0	0	1	0	0	16	4	0	0	0	0	2	0	0	0	23	9	0	10	3	1	0	0	0	0	1	8	5	6	0	0	0	0	0	0	1	1	1	1	0	2	14	0	0	3	37	10	2	103	0	0	0	0	0	0	0	25	5	9	0	0	1	0	11	1	7	0	4	0	0	0	0	4	0	38	0	16	18	0	6	3	0	3	37	0	0	0	0	0	0	1	0	0	1	0	1	0	0	3	0	0	0	0	0	0	1	0	0	10	0	1	0	0	1	1	0	0	0	0	0	1	2	0	0	13	3	0	0	0	0	0	2	1	5	11	6	29	4	0	4	9	1	11	41	103	0	0	0	0	1	0	1	0	0	90	0	0	7	16	24	20	0	5	2	0	0	1	5	0	1	20	6	0	0	1	0	2	0	0	13	131	11	2	0	0	0	1	0	1	0	0	0	0	1	1	9	0	0	0	0	0	0	0	0	0	0	0	1	0	0	0	0	0	0	0	0	0	0	0	0	0	0	1	1	0	0	0	0	0	0	0	0	0	0	1	0	2	0	0	0	7	1	12	0	0	1	1	1	0	0	0	0	3	0	0	0	0	11	5	6	12	5	0	3	0	6	1	0	9	11	0	0	0	0	10	4	1	0	0	1	0	0	12	0	7	3	0	0	8	0	0	26	3	0	1	0	1	1	0	0	0	10	1	10	1	7	0	4	3	3	17	0	10	0	0	0	1	0	4	8	21	19	0	20	8	18	0	0	0	1	0	0	2	2	0	1	1	1	0	0	0	0	13	0	0	0	0	0	0	2	0	4	9	0	9	1	0	7	0	7	5	10	5	0	2	33	12	12	0	0	0	0	0	0	0	1	3	11	1	27	5	0	0	6	0	0	0	0	0	0	0	0	0	0	0	0	0	0	0	2	0	2	1	25	121	5	0	4	0	0	0	0	0	7	0	2	0	0	2	6	0	0	0	1	2	0	0	0	0	0	0	42	6	11	0	3	21	0	0	0	0	1	0	2	0	14	0	0	47	0	0	0	10	1	9	0	0	0	0	2	0	0	0	0	0	0	2	0	0	0	0	0	0	0	0	0	0	0	0	0	0	0	1	0	0	1	0	0	0	0	0	0	0	8	3	4	120	0	15	30	13	23	15	36	29	0	0	0	4	0	1	0	0	0	0	0	0	0	0	0	10	0	0	0	1	62	3	1	0	0	2	0	7	0	0	0	0	4	0	0	0	0	1	0	2	0	0	8	0	0	0	0	0	1	0	0	0	0	0	1	1	0	6	0	3	5	6	7	7	1	0	0	0	0	0	0	2	10	0	20	0	1	2	10	0	27	190	0	0	0	0	0	0	1	1	0	3	0	0	0	0	0	0	0	0	5	6	0	0	0	0	0	0	0	1	0	0	0	0	0	0	0	0	107	0	0	0	0	0	1	0	0	0	1	0	0	0	0	0	0	3	0	0	0	0	0	1	0	0	0	0	0	0	0	0	1	0	0	20	0	0	0	0	0	0	12	0	0	1	0	0	0	0	0	0	0	1	0	3	0	0	2	0	0	1	0	0	0	0	0	3	2	0	3	0	0	0	0	0	0	1	0	0	0	0	0	0	0	79	0	0	0	0	0	0	0	0	35	0	0	0	0	9	1	0	0	0	0	0	0	0	0	0	0	0	0	0	0	0	0	0	0	1	0	0	0	0	3	0	0	0	0	0	0	0	0	0	0	0	0	8	0	0	0	0	0	0	0	0	0	0	0	0	0	0	0	0	0	0	0	0	0	0	7	1	0	0	9	0	0	0	0	1	0	1	3	0	0	0	0	0	16	0	7	1	0	0	0	1	0	2	0	0	5	27	0	2	0	0	8	0	2	0	0	2	0	0	1	1	0	1	1	0	0	1	1	0	1	2	0	0	0	0	1	1	1	0	3	0	0	0	0	0	2	0	3	1	4	0	0	0	0	1	1	54	0	0	0	0	3	0	0	1	3	2	0	6	0	0	1	1	2	0	0	0	0	0	6	2	4	0	1	0	33	0	0	0	1	4	0	0	12	0	0	31	0	2	0	0	0	0	21	0	5	2	1	0	0	1	0	3	1	0	3	2	0	0	0	8	2	2	4	5	5	6	11	8	53	7	2	0	2	1	18	0	2	0	0	0	0	0	0	0	0	5	0	22	0	0	0	3	0	0	0	14	3	3	0	1	1	0	0	23	0	39	0	113	6	0	0	0	12	1	0	0	0	0	0	0	4	0	0	0	24	1	6	0	2	3	1	0	0	0	0	0	0	0	0	1	0	0	0	0	0	0	0	0	0	0	0	1	3	20	0	0	0	3	0	0	0	1	0	0	3	16	0	0	0	0	0	3	0	0	0	2	1	0	0	0	0	3	7	8	0	0	1	0	0	0	0	5	0	0	0	0	0	0	0	1	2	0	32	0	1	0	0	0	0	0	1	0	0	66	0	6	2	0	0	0	0	0	0	0	0	1	0	0	0	1	0	0	0	0	0	0	45	22	0	9	8	0	0	0	2	0	14	3	0	101	0	1	0	5	0	0	0	0	6	5	5	0	0	0	0	0	0	0	0	0	17	2	12	49	0	12	9	11	0	2	0	0	0	0	0	2	0	0	0	0	45	0	0	0	3	0	0	0	0	10	0	0	2	0	0	0	0	0	0	19	1	10	7	7	10	0	16	25	2	0	24	4	2	28	1	1	6	6	0	1	0	0	0	0	9	3	0	0	0	0	9	2	1	0	0	7	0	0	0	0	0	1	0	0	9	14	1	8	0	32	0	0	0	0	0	0	5	2	2	0	3	1	15	2	0	1	0	2	0	20	0	0	0	3	4	0	16	0	5	0	12	48	31	55	2	0	1	1	1	12	0	20	19	0	1	0	0	0	0	0	0	0	0	0	0	0	1	0	0	10	13	1	0	2	0	0	7	13	6	0	1	0	1	11	7	7	9	1	3	0	1	8	16	12	28	4	0	0	0	0	0	3	0	0	0	0	3	0	25	5	26	0	6	0	0	2	3	8	2	0	0	1	0	3	9	0	11	2	6	4	1	28	0	5	0	0	9	0	3	9	11	13	2	0	5	17	32	0	0	0	3	0	0	0	8	0	1	29	0	2	0	0	0	1	2	27	9	5	0	0	0	0	1	0	0	1	0	0	0	0	0	0	0	6	9	3	29	2	3	0	1	0	1	0	5	4	0	0	7	0	1	0	7	0	0	9	4	2	11	0	1	0	3	10	0	0	1	0	0	3	0	1	0	0	0	0	0	3	13	3	0	5	0	5	1	0	0	0	0	3	0	0	24	0	0	0	3	0	0	9	1	5	3	0	11	2	0	0	0	0	0	14	3	0	0	0	0	0	1	0	0	0	3	4	0	0	22	10	5	0	0	0	0	0	4	0	0	0	0	0	1	4	2	0	56	3	0	81	34	91	85	60	14	21	82	136	74	49	77	47	74	10	47	6	0	0	0	1	1	2	0	0	0	0	1	0	5	0	0	1	0	1	0	0	1	0	0	0	0	3	0	0	1	1	0	0	0	0	0	0	0	0	4	0	0	0	0	0	1	0	1	0	0	0	0	0	0	1	0	0	0	7	4	0	0	0	0	0	1	0	0	0	0	0	0	0	0	0	0	0	0	0	0	0	0	1	0	5	5	1	16	3	0	0	4	0	0	0	30	10	26	0	0	4	16	1	0	2	0	0	2	0	1	0	0	0	0	0	9	7	1	4	11	11	0	0	0	7	1	3	0	0	0	0	0	0	0	0	0	0	1	23	0	1	0	1	0	11	2	14	2	4	0	15	5	5	0	9	0	1	0	0	0	0	0	0	112	21	0	1	0	0	0	0	0	0	1	2	0	0	20	29	0	30	0	3	0	0	0	0	1	1	0	1	42	5	3	1	0	0	85	0	0	0	0	2	0	3	0	0	6	0	0	0	4	0	4	21	14	1	8	2	0	0	4	6	0	0	0	0	3	0	6	5	1	22	1	1	0	1	0	9	1	0	0	5	2	5	8	0	21	0	5	30	0	5	0	0	2	1	0	0	1	17	0	0	1	4	4	0	2	1	0	0	0	0	0	9	0	0	1	0	0	0	0	0	0	0	0	0	0	0	0	1	0	0	0	0	0	0	0	0	3	0	3	0	0	0	0	0	4	2	3	4	0	0	14	0	0	8	82	23	12	1	0	5	133	31	0	6	19	0	0	0	17	1	4	0	0	12	0	18	11	6	2	1	3	0	0	1	48	3	0	0	15	0	13	1	0	0	0	0	0	0	13	0	5	5	2	0	0	0	0	0	0	2	0	67	3	31	9	3	0	15	0	3	0	0	0	0	0	0	0	1	0	65	0	17	0	0	5	1	1	16	3	82	4	4	0	0	3	10	0	22	6	4	3	2	28	0	22	30	0	0	0	0	0	1	3	2	132	65	1	0	4	0	0	0	0	12	0	0	0	2	0	0	0	71	40	0	0	0	42	20	8	5	1	8	5	16	25	0	0	9	0	0	2	1	0	2	0	0	0	0	0	3	5	0	0	2	1	0	0	0	1	1	0	0	0	0	0	0	38	0	0	1	0	15	2	33	0	0	1	3	3	0	0	1	0	22	19	1	0	4	4	12	1	0	1	1	16	0	2	4	0	0	1	4	11	13	26	24	21	2	2	0	47	3	9	10	0	0	0	0	0	0	0	0	1	0	0	0	0	0	0	0	0	0	0	0	12	0	1	1	1	1	4	0	0	6	2	7	0	0	2	0	2	0	0	0	5	0	3	10	3	3	15	0	2	0	0	0	0	0	0	0	0	0	0	0	2	0	0	0	0	0	0	0	0	0	0	1	0	0	2	1	4	0	4	4	0	19	0	49	0	0	7	0	1	3	0	0	0	0	0	2	0	0	0	0	0	0	2	6	7	2	0	15	1	4	0	1	0	9	0	9	5	0	0	1	0	7	0	0	0	11	11	139	23	14	29	6	24	8	11	20	17	11	8	0	11	8	0	0	1	18	0	0	0	0	0	0	18	1	0	1	0	0	0	1	2	0	0	1	0	0	0	0	0	0	1	0	0	0	0	0	0	0	0	0	0	0	0	0	0	4	0	0	0	0	5	1	0	34	0	16	37	9	10	0	0	0	1	0	0	2	0	1	3	0	0	27	44	0	0	0	14	0	9	0	6	10	11	0	0	0	0	0	0	0	1	0	0	0	0	0	0	3	3	3	0	5	4	0	0	1	0	0	0	0	0	0	13	1	2	0	4	1	8	0	8	0	0	2	2	0	3	0	7	1	1	1	0	0	1	0	0	0	6	0	0	0	29	0	2	0	1	1	6	1	1	0	0	0	0	0	0	0	0	0	4	1	8	12	0	0	0	0	0	0	1	0	4	0	1	2	0	0
LakWasMe79_HOW10_2_rpkm	0	0	1	0	0	29	8	3	2	1	1	21	4	2	2	0	1	4	5	0	2	0	1	59	0	9	1	0	1	37	1	1	0	60	1	26	2	3	3	1	0	0	1	33	101	234	102	11	2	55	2	46	0	0	0	1	0	4	325	37	50	3	3	3	0	0	0	3	3	116	5	1	5	1	2	2	2	0	0	1	1	30	5	1	2	0	3	0	2	0	0	5	21	3	95	2	2	0	8	0	1	0	1	0	0	1	0	0	0	24	4	1	12	4	79	2	1	14	0	1	0	1	2	49	0	0	24	1	0	1	43	269	9	0	0	1	9	0	7	0	0	2	0	16	2	0	0	0	103	0	19	176	1	0	295	0	4	8	98	19	21	1	8	79	5	4	1	21	6	225	2	2	1	0	0	0	10	3	3	2	5	0	0	0	12	33	0	0	0	1	24	6	36	16	10	10	4	45	22	339	2	1	5	0	1	2	5	0	5	2	42	11	62	73	98	1	5	2	0	3	0	2	2	9	1	2	4	0	14	0	2	10	0	0	0	0	66	7	58	1	0	0	44	7	57	2	0	1	1	1	2	15	74	0	2736	172	0	0	2	0	20	1	7	29	8	1	27	2	9	217	55	1	70	0	0	6	0	3	9	6	15	130	6	140	83	1	8	0	45	1	3	0	1	4	20	2	0	27	26	1	3	147	118	31	7	2	8	112	47	1	48	0	159	32	1	0	1	7	92	0	6	1	1	13	7	11	15	0	5	0	1	0	1	1	0	0	2	4	1	0	0	31	36	4	21	1	25	17	9	1	13	21	2	1	14	0	2	17	1	36	10	1	7	2	0	92	2	177	4	16	1	141	0	2	22	0	1	20	2	15	0	5	51	23	8	0	70	0	0	0	1	6	231	4	2	15	23	0	0	22	1	94	1	18	55	0	0	0	1	4	1	3	1	1919	0	118	22	6	14	4	0	0	2	1	0	0	0	3	53	0	11	8	2	5	1	8	0	6	15	0	152	11	0	0	0	953	1	2	0	1	0	240	1	1254	0	14	149	6	0	2	5	0	1	36	2	40	94	0	1	1	23	21	30	2	0	0	66	0	19	0	4	2	80	214	1	1	6	32	41	1	3	2	167	115	5	0	4	3	0	23	4	2	67	1	0	11	0	3	1	5	1	21	0	2	8	0	7	0	3	50	0	0	0	1	1	0	0	0	0	0	2	0	789	42	3	0	9	8	3	77	0	4	3	109	27	3	0	0	3	9	0	1	7	8	0	3	0	18	2	1	0	2	2	3	17	1	2	1	33	1	0	5	0	3	4	30	11	474	5	10	27	33	25	21	74	0	2	18	118	0	0	0	1517	7	28	35	1	1	8	0	79	1	13	2	27	18	0	66	0	8	0	891	38	258	6	2	248	5	337	15	21	9	31	24	1	29	2	31	0	11	1	3	3	0	5	0	0	2	4	16	10	407	1	1	3	7	2	33	22	3	10	0	10	20	4	0	3	0	6	0	0	33	1	4	0	2	4	2	6	9	0	40	6	0	0	0	6	1	2	1	1	0	9	0	1	0	6	11	0	34	4	1	35	2	6	0	1	15	1	2	0	7	2	30	12	2	15	1	4	0	9	30	0	1	26	10	1	0	47	2	0	6	12	16	4	0	0	1	38	1	0	10	5	0	0	0	1	1	0	5	0	44	8	2	16	82	5	0	2	49	9	0	5	7	0	19	21	0	25	19	0	3	0	11	1	0	5	0	0	1	0	0	0	2	4	116	0	1	0	7	1	0	117	2	0	0	1	0	0	0	1	25	0	0	0	4	22	0	0	8	0	0	1	0	22	30	985	0	1	0	1	0	3	0	15	0	2	0	0	0	1	0	0	3	101	0	45	3	20	167	30	0	1	2	0	0	15	95	54	0	0	1	0	7	0	0	0	1	80	101	0	0	1	1	0	1	4	6	3	6	85	0	0	4	0	3	0	0	20	2	0	0	0	2	0	1	12	1	13	1	0	0	0	1	5	1	4	0	1	0	0	0	0	0	7	0	2	0	1	0	0	1	13	12	0	0	7	6	0	0	0	0	0	1	9	4	4	20	7	4	1	2	0	1	0	0	0	0	0	1	0	0	1	1	1	0	0	0	0	5	1	1	0	40	37	0	1	3	1	0	0	0	0	0	2	0	0	0	9	0	0	0	17	10	1	41	0	0	1	4	0	2	29	793	1	28	1	29	1	2	116	73	10	0	17	0	0	5	0	0	0	1	0	0	7	0	0	0	1	0	3	5	1	0	1	1	0	1	1	5	0	1	0	0	0	1	5	258	2	0	0	77	2	3	6	47	0	0	11	29	37	0	0	0	0	3	0	2	12	2	0	0	0	0	1	0	0	0	0	0	1	0	0	17	5	0	1	0	0	2	1	4	0	3099	0	0	0	0	0	2	3	0	2	15	3	7	4	127	6	4	1	1	3	0	0	1	0	0	8	167	2	0	3	0	0	0	4	6	0	5	1	0	0	0	4	13	24	0	2	14	1	13	0	0	5	0	0	118	1	0	7	14	1	0	0	0	9	1	42	0	0	1	2	1	0	6	0	0	0	0	0	0	2	0	0	1	0	0	0	0	6	0	0	0	2	0	0	9	8	3	0	0	3	0	1	0	0	0	0	0	105	6	0	0	44	1	15	4	7	0	1	0	4	3	0	0	0	22	1	0	0	1	23	52	1	71	1	0	0	99	25	0	0	1	1	16	15	0	0	0	1	0	4	0	1	0	3	54	4	1	1	2	38	2	1	0	2	0	4	3	0	0	0	2	1	0	0	0	19	0	24	1	23	6	0	16	7	21	21	0	18	0	3	100	267	0	0	5	2	8	24	0	0	52	0	7	0	0	0	0	0	1	8	219	2	21	70	29	4	28	0	105	3	1	0	35	7	4	68	2	2	3	0	0	1	18	0	0	1	4	8	0	1	2	3	0	12	10	2	7	1	7	0	0	0	0	3	4	0	19	0	0	14	1	0	5	5	0	10	1	0	0	0	7	12	1	66	16	425	5	0	2	28	1	2	1	6	0	5	33	7	1	13	0	0	0	57	37	0	2	0	0	1	3	39	0	23	9	6	4	0	1	25	157	1	0	28	2	1	0	1	1	2	0	6	0	34	127	39	49	18	26	65	0	0	29	0	7	0	0	4	14	1	18	11	0	77	0	6	4	11	8	18	26	7	0	70	0	0	0	1	0	0	142	12	0	0	5	3	8	1	228	4	5	7	0	20	24	1	1	111	3	3	29	0	5	1	0	1	0	0	0	22	138	85	227	172	12	2	7	0	1	0	1	0	47	81	8	11	96	2	9	1	24	464	982	307	44	1	1	13	165	0	1	1	1	6	1	3	0	210	21	176	17	546	13	0	14	7	55	0	0	0	0	0	0	14	303	0	0	0	40	0	54	0	3	2	0	0	8	0	0	0	1	0	21	64	2	1	1	2	0	4	14	5	8	0	0	0	0	0	0	0	0	0	4	0	0	3	7	0	0	29	0	7	0	0	0	0	60	0	2	2	38	1	0	0	0	0	0	0	0	1	1	0	0	1	0	0	1	0	0	0	0	0	1	0	26	4	0	12	0	4	1	0	81	0	110	273	0	7	24	0	18	22	3	1	0	2	3	50	25	135	0	1	0	0	1	6	1	0	2	42	0	3	0	5	5	10	2	1	1	0	0	0	2	0	50	1	144	5	2	0	0	67	14	1	2	1	6	4	0	0	4	2	7	0	6	1	5	173	2	13	25	23	0	2	69	0	41	6	13	0	24	3	5	3	0	7	0	0	1	0	2	0	0	2	0	181	43	36	77	502	99	13	163	0	0	1	12	0	5	0	0	3	3	105	0	0	3	13	1	1	0	0	57	84	0	131	9	1	161	0	27	0	16	5	4	10	11	0	1	1	48	0	7	0	182	1	8	2	16	0	0	19	0	6	6	17	0	0	7	1	0	0	5	42	244	5	246	1	1	4	51	2	16	0	0	2	0	0	0	20	3	8	4	0	6	0	4	3	23	18	62	4	0	0	0	0	7	0	0	1	0	2	0	5	6	56	0	0	0	5	0	19	0	1	15	95	8	2	804	3	0	0	0	0	0	1	1	12	88	0	2	0	10	5	0	3	68	2	0	1	11	1	1	0	11	0	105	3	2	0	0	6	3	4	0	1	23	2	0	9	65	4	6	142	0	8	0	0	0	1	0	62	6	0	64	6	1	2	6	579	14	88	1	0	53	160	1	56	1	118	3	54	8	4	2	7	69	1	65	9	0	0	0	9	0	0	0	0	0	1	13	0	0	6	15	4	17	0	3	127	0	0	0	0	0	0	0	2	0	0	0	0	0	164	0	0	2	11	16	7	42	6	0	5	0	3	2	149	0	25	702	16	1	6	1	5	0	0	1	3	0	0	1	0	0	0	52	1	0	1	26	0	0	0	0	1	2	0	0	329	0	8	82	43	25	14	0	19	6	13	101	504	18	2	0	2	0	0	0	0	0	0	9	0	1	7	0	5	0	5	4	3	0	0	1	1	5	6	3	1	5	1	2	55	2	0	128	21	0	23	2	65	21	105	0	6	0	0	0	12	1	0	0	1	0	9	1	148	1	0	0	10	0	1	0	0	0	6	0	2	10	0	0	4	0	1	0	1	1	2	13	0	0	0	0	17	0	0	0	4	1	0	108	0	0	32	0	0	7	1	0	0	2	20	1	50	0	0	92	6	0	5	82	0	0	1	0	0	0	1	4	3	0	0	74	0	0	0	0	1	53	0	0	1	26	2	77	69	72	0	0	0	2	0	0	1	0	34	2	1	2	0	1	5	3	0	11	3	1	1	3	2	1	1	0	2	0	1	0	0	1	1	0	0	18	0	0	3	2	7	257	0	0	1	116	0	1	7	0	0	0	0	0	5	0	0	0	13	1	10	0	1	0	10	8	6	3631	20	0	1	12	0	44	10	24	3	11	0	7	58	1	0	0	1	0	0	1	569	0	12	13	10	0	0	0	1	0	26	180	87	1	3	1	1	17	0	6	14	1	5	1	4	7	1	0	0	45	4	0	0	2	10	0	7	0	7	8	0	2	41	0	19	2	0	41	1	0	0	0	0	4	3	1	3	0	2	1	2	0	26	14	8	3	3	29	20	5	0	0	1	0	1	4	0	18	3	2	10	0	0	4	0	0	0	3	2	2	13	1	14	1	0	4	0	0	2	1	15	0	0	7	12	54	7	4	9	0	12	0	1	2	4	0	37	0	15	7	6	2	0	0	1	3	8	1	1	0	0	4	81	74	166	60	78	141	131	84	16	297	34	321	32	55	10	46	34	43	33	7	70	5	148	78	49	517	38	290	44	16	66	21	43	92	1	6	0	0	0	1	6	0	1	0	11	168	1	0	0	0	0	0	2	0	1	3	0	1	6	3	1	2	2	4	0	0	27	0	104	0	38	24	0	1	27	1	0	1	0	0	7	18	0	0	6	0	1	0	0	2	4	33	1	0	0	0	2	47	6	55	8	0	9	8	1	9	1	7	1	0	17	15	1	1	1	1	37	1	0	4	0	1	0	0	0	43	9	1	2	2	48	61	0	23	1	0	0	0	1	1	0	9	0	0	15	4	0	2	2	48	1	193	4	0	9	206	0	1	1	0	0	61	0	1	2	3	114	0	1	5	44	1	0	0	1	12	0	0	45	29	149	0	1	17	24	25	41	53	2	6	0	27	0	5	0	3	0	0	0	21	185	0	0	2	2	0	0	0	0	5	0	2	1	2	1	0	5	0	1	1	0	2	0	148	2	0	17	0	1	2	0	1	32	2	3	0	0	18	0	13	2	586	37	0	3	114	2	0	0	0	0	90	1	0	0	1	0	1	17	0	5	0	3	0	3	0	14	0	3	37	30	0	1	7	0	1229	25	1	27	1	0	0	1	0	1	1	0	19	1	6	0	6	3	1	6	0	1	1	1	5	15	2	0	1	0	1	0	2	7	1	87	0	6	1	18	0	0	0	44	1	2	0	0	32	1	9	317	166	4	0	0	0	0	0	1	1	0	1	1	4	1	0	0	0	1	0	126	9	221	41	0	2	1	21	1	0	1	0	151	111	5	0	0	0	24	0	3	0	1	7	0	0	0	1	0	0	1	0	256	7	1	2	0	1	1	0	4	21	0	117	24	3	7	1	18	1	0	7	206	1	0	2	0	0	0	17	0	1	1	1	85	14	1	3	101	0	0	0	2	1	2	0	6	0	5	4	0	1	11	0	15	0	15	1	18	0	1	5	0	1	6	1	0	29	36	1	0	4	0	0	0	20	27	0	400	1	2	139	2	36	1	11	4	0	6	0	4	95	8	19	2	0	0	0	0	0	14	12	1	2	1	0	6	2	0	0	505	0	1	7	150	16	0	3	9	21	2	16	1	11	1	15	3	37	10	12	0	6	24	36	4	11	6	3	3	11	7	1	0	39	0	3	2	93	68	35	70	59	66	74	31	0	64	24	40	0	3	0	0	0	39	7	1	176	0	10	5	20	80	14	1	0	0	1	0	6	10	1	0	0	0	29	30	0	1	0	8	62	0	0	0	0	0	0	0	0	1	1	0	31	1	14	13	2	9	0	0	1	0	0	1	0	1	5	0	94	6	5	171	82	67	1	174	3	5	0	1	1	66	0	2	0	1	4	1	6	0	0	0	0	1	0	1	2	1	622	0	0	192	3	0	212	0	8	3	0	0	97	131	0	1	5	8	41	6	3	1	0	6	2	16	48	0	0	13	3	0	1	56	5	1	0	0	0	0	1	3034	435	18	21	0	1	2	1	0	1	1	260	0	0	0	18	2	0	788	631	124	7	0	0	11	1	6	0	107	19	5	9	0	0	7	0	0	1	0	0	3	0	0	0	0	0	0	0	20	0	192	1077	0	7	0	0	0	0	3	5	1	3	0	0	0	0	26	7	1	9	0	1	27	2	3	32288	104	334	0	0	15	1	0	0	0	4	0	39	1	0	1	5	0	3	0	3	2	13133	2	2	9	4	4	2	36	1	0	0	0	8	0	0	0	1	0	1	0	0	0	0	0	1	0	0	0	0	0	0	7	2	0	0	1	0	0	2	0	1	5	5	1	0	0	1	50	1	0	0	2	2	0	0	3	10	0	2	0	18	1	0	0	1	2	0	295	0	0	2	1	0	11	1268	10	1	11	0	9	2	7	196	31	1	7	2	0	75	4	0	125	1	1	2	1	1	3	0	0	0	1	0	12	0	0	2	0	0	0	0	0	2	0	1	0	2	21	0	0	0	1	2	1	0	1	0	3	1	1	2	1	0	0	0	0	14	0	2	0	0	0	65	2	0	38	6	93	6	2	29	0	0	0	2	0	0	0	1	18	1	1	11	1	62	2	67	0	0	0	2	0	0	0	8	3	0	0	4	103	1	32	4	0	18	0	0	4	0	0	0	0	4	14	0	0	5	0	1	2	1	12	2	129	3	0	0	2	0	0	1	0	27	74	73	0	2	0	3	3	0	220	49	5	28	0	0	1	10	0	0	0	1	0	0	11	10	10	0	15	2	9	16	0	0	1	0	3	0	0	3	101	0	18	24	0	0	1	3	25	3	1	25	0	0	0	0	26	1	1	4	6	0	38	1	17	0	0	99	0	6	0	0	112	6	8	0	4	4	4	0	1	0	0	1	1614	0	0	39	1	0	3	1	1	1	1	4	19	0	0	3	2	2	0	209	2	0	0	1	0	0	4	158	1	0	0	20	0	4	4	0	0	0	1	0	2	1	0	2	3	4	0	11	0	13	0	0	0	0	0	0	6	0	0	2	1	0	5	0	15	8	7	0	13	1	0	19	0	1	0	0	3	0	0	1	0	0	0	0	0	1	2	0	0	0	0	2	5	0	0	1	0	0	1	0	1	2	0	1	4	1	1	0	0	0	0	2	3	0	0	0	170	2	2	5	1	0	0	1	0	0	0	0	1	0	0	0	1	0	1	1	2	0	0	1	20	0	0	4	1	3	0	3	6	1	12	9	1	0	17	2	1	0	0	1	0	6	0	24	0	0	0	90	11	1	0	0	0	49	12	0	3	7	5	0	0	0	0	8	1	2	0	2	0	2	8	0	0	10	0	0	1	3	6	0	8	2	8	2	0	0	0	1	0	6	2	2	2	1	0	1	3	0	13	0	0	0	9	0	1	13	6	5	0	1	0	20	0	4	0	0	0	0	0	0	5	0	0	1177	7	0	0	0	0	1	0	0	2	3	10	0	1	1	0	1	0	1	0	0	1	4	0	0	0	0	0	2	2	0	5	0	21	21	1	0	0	5	0	18	6	0	0	14	1	0	4	2	0	0	9	2	9	0	0	0	0	0	0	0	0	1	0	0	0	0	2	0	1	0	0	7	2	2	0	1	0	0	0	0	0	7	0	3	0	0	0	0	0	0	4	4	206	0	0	27	0	0	11	0	2	61	0	1	36	96	0	1387	2	0	54	13	4	1	31	2	5	15	2	20	165	31	0	5	0	280	0	15	1	0	2	294	0	10	0	0	0	1	1	0	7	2	0	0	1	2	0	4	1	2	1	19	0	0	2	0	0	3	5	2	0	4	2	2	0	0	0	22	2	1	0	1	2	3	0	62	0	40	0	0	4	0	0	1	0	0	0	0	2	5	0	0	1	3	7	5	1	2	0	0	0	0	0	1	10	0	3	0	1	42	2	1	2	73	0	0	0	0	3	47	0	1	15	2	2	1	0	16	11	0	0	8	0	1	0	1	1	0	5	1	8	2	13	0	0	1	4	2	6	1	0	596	0	0	1	0	1	0	0	24	11	0	0	2	0	0	3	0	0	0	0	1	0	0	1	0	0	0	0	0	1	207	2	0	1	0	0	4	1	1	2	4	3	1	0	0	0	0	0	0	1	0	0	5	0	0	17	0	5	0	0	0	0	0	43	598	5	1	0	0	0	0	0	0	0	0	1	0	1	0	2	0	13	1	5	0	0	0	137	0	0	0	0	0	0	1	2	0	0	2	2	7	81	0	29	0	4	0	1	0	1	4	1	4	4	1	0	0	1	0	2	0	115	0	8	1	2	2	0	4	3	1	2	6	4	105	0	8	0	0	0	2	0	0	2	14	5	12	18	0	11	0	0	0	2	3	6	0	241	0	2	3	1	2	0	11	1	7	0	1	18	1	3	1	0	0	2	0	0	0	0	0	37	0	2	0	5	0	83	0	2	2	1	0	2	0	0	10	0	0	1	2	1	3	4	3	1	8	0	17	0	0	2	0	0	8	0	8	3	0	2	235	73	161	399	2910	0	1	4	0	27	3	11	23	7	0	0	0	15	17	0	54	0	4	125	0	97	0	1	0	53	2	2	0	6	0	1	4	0	3	6	0	5	17	407	21	0	7	0	2	9	10	2	0	2	1	3	0	0	4	1	0	5	8	1	2	0	0	0	85	0	0	2	0	13	1	0	1	8	0	0	0	0	1	0	0	5	43	4	0	3	26	0	2	0	97	4	13	2	1	0	20	0	0	4	0	0	1	20	152	0	1	1	0	0	5	4	0	2	0	0	0	0	0	1	78	38	0	4	0	0	0	1	2	1	4	0	0	0	0	2	0	0	0	3	64	128	0	10	0	3	4	2	2	0	1	2	20	1	4	9	0	0	0	44	1	1	6	0	51	1	3	1	1	21	1	5	566	0	0	1	0	0	1	1	25	3	2	1	963	609	135	11	2	50	10	103	7	27	70	113	32	57	974	66	1	54	41	34	28	57	7	85	8	66	0	129	0	592	2	0	0	0	0	0	166	3	0	0	7	1	1	2	0	14	0	1	0	8	3	2	5	54	0	3	4	4	0	1	1	1	2	60	0	1	0	0	3	0	369	2	5	0	0	0	0	0	282	8	0	4	0	56	1	0	86	1	23	8	33	0	0	0	1	4	0	41	62	0	297	418	42	0	2	0	4	1	0	2	3	0	0	0	0	0	0	2	6	0	0	0	0	24	2	0	0	1	27	0	0	2	4	19	9	4	0	0	0	87	3	1	2	2	0	6	0	1	2	18	11	6	60	33	0	5	0	0	1	2	0	0	0	0	6	0	10	1	0	332	4	0	1	1	2	0	0	25	1	92	2	11	10	830	370	2	0	25	0	1	76	1	2	19	11	9	2	7	0	0	0	0	0	3	1	0	0	2	0	2	1	0	2	2	0	0	0	94	1	0	6	34	0	0	1	0	0	0	2	93	0	0	29	2	47	24	37	14	133	1	0	0	38	4	81	0	0	13	1	79	0	0	0	0	25	0	0	0	0	0	4	0	0	1	14	0	2	0	178	0	0	0	0	40	0	0	5	56	1	3	0	2	0	0	0	1	1	42	107	1	3	5	0	0	0	17	0	7	5	2	0	0	12	0	26	36	20	0	102	0	0	3	0	3	0	5	151	1	59	3	1	8	7	12	0	1	1	0	0	3	1	2	27	0	0	1	0	0	1	0	5	16	8	0	13	50	39	21	4	0	76	10	0	12	2	5	2	1	1	2	6	7	22	11	12	0	0	4	32	31	12	0	1	0	1	0	0	0	14	122	0	0	2	1	22	0	0	0	4	68	1	6	0	6	2	0	0	33	4	0	0	15	0	0	0	201	2	0	2	1	10	0	5	6	2	2	0	17	1	1	0	0	1	1	0	0	0	6	1	3	6	0	48	75	12	7	0	0	424	6	36	3	0	0	0	0	0	0	0	0	6	0	0	198	7	1	6	0	2	1	10	0	5	159	21	294	8	56	176	2	1	3	12	0	0	112	8	7	2	22	10	2	1	0	0	12	76	0	36	34	19	10	49	86	77	0	0	1	0	66	8	40	0	22	1	11	0	0	0	3	1	0	0	0	1	9	0	2	4	3	0	0	2	0	0	0	207	0	0	1	3	1	22	14	161	0	4	0	5	0	0	102	1	6	0	0	0	5	13	4	364	6	2	311	8	0	1	40	3	5	6	0	0	5	0	8	9	2	0	4	82	0	2	5	7	1	239	0	4	1	0	1	0	0	12	15	1	11	4	0	6	18	1	7	8	3	0	4	0	5	14	0	4	0	5	0	0	2	12	3	4	100	1	20	4	6	2	1	3	1	98	0	2	66	0	129	0	8	7	9	9	0	4	0	3	1	8	3	3	0	1	6	0	0	3	44	47	8	42	0	4	1008	0	7	8	0	1	35	0	9	30	2	1	29	13	2	23	13	0	0	0	1	4	3	0	0	4	0	21	0	146	3	20	4	7	0	3	0	3	23	1	0	72	0	8	0	2	0	0	30	7	1	0	1	0	2	2	0	3	0	0	2	1	0	0	0	2	0	5	0	3	0	0	0	0	0	0	0	0	0	1	0	0	0	0	0	0	0	0	0	3	84	0	0	0	0	19	9	26	0	14	0	0	10	0	0	5	3	5	8	1	0	5	27	1	0	0	0	1	0	22	0	0	3	2	0	9	6	0	0	2	4	34	0	0	0	2	3	5	1	5	0	2	42	6	3	1	1	92	0	0	2	0	0	0	0	4	1	139	2	0	0	5	0	1	0	0	1	11	0	0	44	4	26	3	0	0	2	0	3	3	0	0	0	8	5	1	1	0	9	1	0	78	77	0	7	0	0	0	0	1	0	43	62	0	0	0	0	6	0	0	0	2	0	0	0	0	0	2	0	0	0	2	0	0	6	1	0	12	0	5	0	0	0	5	71	0	1	24	2	1	0	0	0	1	0	0	0	0	0	8	0	0	0	2	0	0	0	0	1	0	25	0	82	0	0	0	0	2	265	0	0	7	0	3	60	6	0	0	0	6	1	4	2	3	6	4	15	1	1	3	0	88	1	2	0	2	0	0	0	0	0	0	0	2	0	1	0	2	0	0	1	6	114	5	46	2	16	4	1	1	0	7	73	19	4	1	15	182	56	105	30	1	9	111	0	112	1	4	3	16	75	0	16	16	1	0	11	6	2	0	0	435	9	24	7	1	210	0	0	0	27	0	214	0	2	2	21	4	0	20	0	1	0	0	4	0	1	8	0	5	0	0	57	1	0	3	4	9	58	1	40	0	14	3	27	6	181	10	2	32	0	31	4	3	48	6	0	0	0	7	0	9	4	3	2	5	0	19	2	61	2	2	0	0	2	97	79	8	36	55	26	1378	37	4	0	1	2	2	2	7	0	0	1	1	1	1	43	0	2	1	0	76	0	25	2	14	27	3	23	0	1	5	1	0	1	0	1	0	5	1	1	0	0	4	1	0	5	0	1	2	2	3	10	3	4	1	5	0	1	4	23	1	1	10	0	1	8	2	1	5	11	5	0	13	146	0	1	5	3	14	0	3	3	90	6	1	27	5	2	3	7	7	3	1	1	48	179	1	2	36	8	0	104	30	35	12	57	15	35	8	15	30	20	1	3	72	23	0	1	1	0	1	0	4	1	2	0	2	0	0	0	0	0	17	0	5	9	1	0	28	2	0	0	0	0	0	2	8	1	0	2	9	46	12	0	0	1	0	18	0	0	2	23	5	42	14	1	5	2	0	0	6	17	13	3	19	0	60	0	0	0	12	3	2	1	0	14	0	186	10	79	11	3	69	0	2	0	2	46	7	0	65	14	0	55	13	118	1	142	2	1	0	2	31	0	0	0	4	0	8	1	1	2	0	0	0	1	23	1	0	0	0	1	85	0	16	1	1	0	94	27	33	1	2	103	4	3	0	1	14	1	9	30	16	48	70	5	5	57	1	36	2	150	5	5	1	0	0	30	1	0	0	0	3	8	16	1	0	2	0	0	1	69	6	7	11	101	40	122	0	6622	2	1	0	53	13	4	0	0	0	0	0	3	0	0	3	0	2	0	0	47	29	15	8	3	6	18	0	26	0	0	2	0	15	0	0	0	1	0	1	0	2	15	0	0	90	11	1	6	1	7	0	347	257	15	15	0	0	8	3	5	1	32	4	5	0	4	7	5	0	13	67	0	7	0	288	64	70	106	4	0	0	1	0	1	0	1	20	0	2	22	8	3	1	13	2	138	68	58	7	6	287	16	42	13	39	84	0	0	0	0	34	4	0	39	13	43	0	128	132	11	19	26	4	30	0	1	0	12	1	9	16	2	3	0	0	0	421	166	7	3	15	0	60	24	1	12	0	8	0	1	46	29	25	6	3	0	3	0	941	0	60	57	248	214	72	107	2	2	1555	8	0	191	9	7	1	42	40	1	1	1	0	0	0	1	0	1	1	296	22	4	1	1	0	1	22	14	533	402	8	2	0	97	1	607	73	136	1	0	238	1	0	0	0	0	0	0	0	13	6	1	5	1	0	1	5	4	3	23	4	0	15	4	0	0	20	1	73	0	1	67	2	16	4	54	9	259	52	7	6	2	1	4	0	318	125	3	1	5	5	55	0	141	4	1	9	1	11	1	31	0	7	0	0	1	1	0	40	77	0	0	0	2	0	1	3	9	4	2	0	0	0	1	33	4	1	2	70	0	2	1	0	0	1	892	3	9734	0	32	0	13	102	7	21	0	0	0	0	0	0	0	2	141	0	55	1	0	2	0	0	1	0	2	1	15	0	124	0	0	11	2	0	9	1	14	0	1933	11	5	4	0	0	0	0	2	2	1	17	17	3	6	0	1	4	1	7	0	2	1	0	0	3	1	9	9	0	11	2	2	8	0	1	5	1	26	79	4	0	1	6	1	3	0	0	515	0	0	20	2	0	6	1	0	1	2	1	507	2	11	198	5	0	2	1	0	8	1	175	68	13	5	0	0	0	6	19	2	0	8	1	1	3	0	687	1	0	1	13	19	2	2	3	1	1	6	1	1	4612	1	43	12	6	254	3	10	117	14	405	100	832	626	243	8	750	166	647	2	0	84	22	14	40	10	10	2	3	6637	0	18	23	15	1	471	3	1	0	96	77	25	1	1	3	1	0	1	0	3	0	41	1	255	19	21	59	45	26	69	0	2	13	90	5	9	73	1	6	0	0	3	1	3	0	6	3	99	7	0	1	5	78	2	1	6	0	5	1	4	1	4	0	1	1	22	2	1	32	6	0	2	0	0	0	3	0	30	0	1	4	83	263	0	187	1	1	0	8	230	1582	0	5	2	15	21	2	6	25	3	13	1	95	1	0	20	1	3	45	1	42	240	5	0	4	1	103	1	0	0	45	1	3	0	42	2	43	4	2	5	204	1	1	4	0	5	0	29	33	0	5	42	1	2	11	0	0	1	0	5	0	5	2	1	31	0	9	10	42	0	17	13	17	0	1	4	22	1	4	3	7	74	1	0	3	23	346	11	145	51	2	0	46	1	3	0	1	1	1	2	0	2	0	1	32	439	243	111	2	0	3	0	2	0	33	0	0	3	4	12	3	5	0	0	1	1	3	126	24	0	24	0	1	2	2	0	0	56	5	4	1	0	0	0	3	4	3	3	0	2	0	0	0	0	14	4	0	51	1	0	2	2	0	0	56	8	1	1	3	28	138	1	0	0	0	0	0	0	22	3	0	46	1	0	0	0	5	0	35	1	5	18	0	10	0	0	0	3	0	0	0	0	32	176	1	1	20	2	1	2	50	5	203	0	0	6	0	0	11	0	20	0	12	16	1	0	3	0	2	474	2	0	1	0	8	70	293	43	96	2	15	173	0	222	0	136	21	3	2	646	168	331	39	43	52	35	35	49	5	105	0	0	64	10	41	5	3	338	4	6	676	0	224	3	248	16	1	102	8	156	124	4	185	0	0	0	2	313	16	5	179	89	467	210	1	3	18	332	945	8904	0	51	111	2	0	0	0	3	1	1	3	2	2	0	71	45	450	1	2	5	6	4	0	5	0	17	12	9	10	3	7	5	19	361	657	3	3	288	26	2	6	7	2	4	29	83	4	1	283	2	6	3	163	5	2	38	4	0	0	131	67	0	3	3	189	1	7	18	1	0	0	0	186	3	2	0	5	3	32	0	19	10	1	0	5	0	3	6	50	0	6	0	0	0	2	0	0	7	2	1	0	8	1	2	6	9	1	3	6	89	6	3	46	95	52	120	9	1	26	7	1	1	1	1	0	0	0	0	0	6	16	2	0	0	0	0	3	1	15	2	0	0	75	1	3	0	3	7	0	0	1	1	0	1	5	0	42	1	3	54	2	6	0	0	3	0	221	18	93	153	1	233	9	20	2	1	0	0	3	3	1	0	2	2	2	1	1	92	16	89	1	8	1	8	3	1	11	0	0	18	50	0	3	10	1	20	1	1	177	254	1	0	0	59	0	0	87	5	66	3	44	1	0	3	0	2	83	2	37	0	0	2	15	43	2	57	22	7	2	52	5	0	5	17	4	0	12	199	57	14	3	7	0	0	17	110	31	49	0	1	12	1	1	3	1	0	11	8	0	2	0	0	26	52	10	34	5	0	12	0	1	3	9	51	12	0	166	6	1	2	8	1	0	1	0	0	206	37	5	0	23	5	1	3	15	7	10	3	2	0	0	2	2	0	0	3	19	0	3	0	1	5	1	33	6	60	2	2	6	9	7	8	1	4	5	4	41	5	4	0	67	1	8	0	0	7	1	1	21	5	1	2	162	56	59	0	1	6	2	8	4	0	0	0	0	13	0	43	359	12	0	5	1	0	4	11	2	0	1	2	157	4	0	3	3	0	1	6	20	57	6	18	40	0	0	3	0	1	1	8	3	25	9	1	1	21	0	0	3	0	20	12	0	0	119	5	2	0	3	94	0	43	3	2	230	0	0	66	0	1	2	3	3	1	14	1	2	13	4	0	54	2	25	0	3	2	0	304	3	1	11	2	0	24	5	2	0	0	1	2	6	4	7	1	0	4	3	0	2	4	12	8	1	2	0	27	31	59	0	0	0	1	42	3	49	1	1	0	22	157	0	12	4	0	600	7	128203	0	0	7	0	7	88	0	11	0	0	0	0	10	0	6	2	104	0	4	1	1	4	4	6	11	6	7	42	2	1	7	0	0	0	0	2	7	101	172	4	15	5	1	3	0	3	4	2	0	22	2	0	8	1	8	126	54	73	16	4	22	58	0	7	3	0	1	5	0	1863	78	43	53	0	5	0	26	19	32	0	21	287	10	0	38	1	0	0	0	3	2	2	34	12	98	6	1	33	2	0	0	82	136	7	0	52	8	2	9	2	3	0	4	0	2	0	6	0	74	72	10	63	39	19	68	188	5	608	9	24	928	41	8	7	160	27	505	495	3	3	49	7	4	46	3	35	0	228	247	335	273	199	15	52	3	0	210	99	4	11	0	1	1	0	0	0	1	0	0	1	0	1	0	98	8	47	2	16	1	0	0	95	1	19	1	0	17	16	22	9	1	39	13	1	5	1	1	3	0	7	1	0	0	1	18	98	24	0	51	2	0	0	52	39	2	0	4	14	0	0	0	0	1	2	0	0	0	8	2	4	3	2	10	71	73	0	0	4	37	0	0	8	10	1	71	2	30	1	1	5	137	14	0	2	18	3	122	13	0	30	10	1	2	19	5	1	1	0	0	9	0	2	5	0	4	1	3	3	1	0	1	41	14	18	5	7	1	2	0	27	2	1	0	4	1	0	4	0	0	0	1	6	2	5	0	0	0	3	1	1	4	2	69	4	14	9	4	0	0	5	1	3	0	5	5	18	60	40	4	211	3	8	12	83	69	98	73	24	0	8	0	2	89	0	2	4	0	24	4	30	1	1	0	0	0	0	1	0	4	137	2	2	2	28	6	13	0	0	0	0	109	88	2	0	1	0	3	2	1	96	4	235	2	11	10	0	64	41	2	2102	3	1	0	54	58	21	95	1	1314	0	2	58	1	1290	0	0	4	2	1	8	0	0	351	0	7	29	30	94	0	2	0	66	2	2	4	1	6	0	0	16	0	1	3	8	0	5	28	14	0	5	0	2	11	8	4	4	15	8	2	5	0	0	0	0	0	0	4	103	271	22	35	63	107	64	402	0	0	22	21	152	80	0	1	1	1	78	1	0	0	7	0	0	26	45	5	0	1	0	2	1	5	1	25	4	16	4	20	4	6	19	52	2	5	21	0	1	11	5	2	0	12	16	215	2	118	0	0	0	1	1	1	4	4	15	416	3	1	0	1	1	0	1	61	0	17	127	0	1	1611	0	0	0	19	1	0	9	73	15	45	1	2	0	0	0	1	0	0	2	0	0	1	1	1	0	1	0	6	5	4	12	0	100	22	10	25	80	65	2	0	0	0	1	0	0	0	0	2	1	0	3	2	0	8	4	102	0	0	0	3	0	7	0	0	0	0	0	1	6	30	1	1	218	2	1	6	11	6	53	0	0	34	5	2	1	11	43	1	17	14	12	0	217	5	2	11	37	0	3	45	0	0	21	1	4	4	1	17	21	3	0	0	1	0	0	89	1	0	1	0	540	10	1	2	2	21	17	0	0	4	5	1	1	6	1	0	17	2	0	0	0	5	9	0	0	5	10	466	15	0	0	0	11	3	0	0	3	39	3	0	0	0	0	2	100	4	3	0	0	0	76	6	6	0	83	2	1	192	4	17	4	2	0	0	2	12	2	34	80	17	5	6	0	0	412	6	2	5	2	7	21	5	0	18	15	4	3	816	1	93	194	42	4	74	0	443	52	308	0	0	1	0	20	22	15	1	78	3	5	3	2	6	1	2	4	4	30	3	6	1	2	5	243	238	8	0	2	0	49	9	8	1	6	0	18	0	2	27	0	1	1	13	19	1	2	0	0	75	6	16	0	0	3	2	4	0	0	5	3	1	7	0	0	9	1	2	0	0	1	0	3	2	34	54	51	158	9	2	28	131	25	117	139	226	0	0	0	1	4	1	2	0	0	36	3	0	5	501	250	55	38	8	480	1	5	64	37	1	8	11	12	0	2	0	0	2	0	0	35	73	60	4	0	0	0	3	2	1	1	0	1	16	3	9	9	0	0	0	3	0	1	0	0	8	12	0	0	8	3	0	0	0	3	2	0	0	0	0	0	4	0	5	4	14	1	0	0	0	0	0	0	0	0	0	2	14	0	2	2	44	3	18	5	0	15	58	4	9	2	8	7	2	1	3	0	1	21	490	41	81	30	3	11	2	2	2	2	107	45	1	0	0	2	25	1	5	0	1	59	0	36	29	1	6	80	2	8	37	1	24	153	8	2	5	0	0	1	0	0	0	89	5	55	2	64	7	92	8	2	240	11	10	45	8	3	3	0	62	728	195	10	0	90	10	189	1	50	0	54	0	0	2	1	0	27	6	3	0	1	0	0	36	0	2	37	0	0	0	28	1	12	48	1	35	2	1	26	5	15	3	44	171	3	11	174	3	68	0	0	1	1	1	8	0	0	5	140	8	68	3	2	1	44	6	0	9	1	0	1	0	1	0	0	2	8	0	1	344	135	1	165	81	129	441	60	0	5	1	0	0	0	0	87	18	43	0	1	4	64	0	4	0	18	5	70	2	1	68	1	0	0	78	59	0	18	214	2	4	1	0	2	1	440	0	20	0	56	95	0	7	7	63	2	5	0	1	1	0	1	0	0	1	0	2	3	5	0	0	0	0	0	6	1	4	1	1	0	32	0	1	0	7	2	3	6	0	0	0	0	4	2	1	20	4	2206	29	1	102	28	10	75	65	8	23	0	5	3	8	2	0	1	0	0	0	0	0	1	0	0	55	5	2	2	1	1	0	2	0	1	103	1	89	0	0	3	0	25	4	0	1	0	0	0	1	1	77	133	3	20	117	1	6	0	0	1	0	17	1	14	14	8	10	2	4	11	7	1	160	3	0	0	0	0	0	2	1	244	0	160	2	11	8	80	1	63	235	0	0	0	0	1	1	2	1	0	10	0	0	0	0	1	0	0	1	0	2	0	0	0	0	2	0	0	26	7	1	0	0	0	21	3	0	294	0	0	0	19	0	2	2	0	2	3	0	0	0	6	12	0	3	0	13	1	0	1	0	0	0	0	0	0	0	0	1	0	0	3	103	0	4	8175	1	2	0	18	5	0	21	1	1	1	6	0	3	5	0	0	72	0	1	0	0	1	1	0	1	2	1	1	2	4	0	0	0	1	0	0	1	0	0	0	0	0	4	0	0	1	0	14	12	0	0	0	0	0	0	30	0	0	2	0	35	8	0	4	0	1	0	0	2	0	1	1	2	2	0	0	52	0	0	10	2	0	0	0	0	2	0	1	0	0	4	1	0	0	0	0	0	0	64	0	0	2	1	0	0	1	0	0	11	0	0	1	0	0	2	0	0	2	0	34	4	0	0	4	0	130	1	0	2	0	0	0	1	3	1	0	1	4	2	7	1	7	0	0	0	0	2	0	2	10	0	1	7	1	16	1	2	64	1	77	0	0	1	0	0	2	5	1	1	0	0	2	0	1	0	2	6	0	2	1	0	3	9	1	49	0	0	0	1	24	0	1	6	2	1	0	2	0	0	6	0	0	3	1	1	0	0	5	1	0	0	1	1	1	6	1	4	0	1	7	0	0	0	0	1	4	68	17	0	2	0	2	0	1	2	2	2	0	3	20	1	2	13	0	2	7	1	3	1	14	1	3	1	0	0	2	2	3	2	1	0	3	1	0	0	2	125	6	4	0	7	7	1	12	17	116	17	5	0	1	1	135	0	4	0	4	0	4	0	1	1	0	52	0	10	0	0	0	4	0	1	0	2176	12	5	0	3	3	0	0	324	11	279	1	187	67	1	14	4	40	5	0	1	1	0	0	1	0	0	0	10	4	2	26	0	2	2	0	1	0	1	0	1	2	0	8	60	1	0	16	0	0	0	0	1	1	1	0	0	2	0	0	1	3	53	3	3	2	1	11	1	4	23	1	1	0	2	0	2	5	0	3	19	11	0	2	6	6	77	1	14	1	1	2	3	1	0	0	17	1	7	2	2	0	0	0	4	1	0	109	0	2	0	1	0	0	10	13	2	1	660	0	6	1	0	0	3	3	0	0	0	7	1	0	1	0	1	3	4	4	0	0	1	108	27	8	6	53	6	1	1	0	1	3	83	0	4	1	1	3	65	0	0	0	1	16	124	55	0	1	0	2	4	2	0	0	1	28	19	3	42	0	13	47	204	1	1	1	3	0	0	6	7	3	0	0	3	1	2	4	0	3	2	8	1	11	224	36	0	30	0	0	5	0	0	0	17	4	58	11	220	99	5	238	113	1173	0	102	99	16	83	1	1	9	6	1	1	0	0	0	7	112	18	0	1	0	0	390	7	2	2	0	365	1	0	0	0	1	6	6	0	32	3	5	271	0	87	2	0	1	6	0	0	0	0	5	1	14	2	37	8	6	2	0	72	0	4	11	0	4	1	28	0	34	0	27	0	96	102	1	0	7	6	1	4	5	3	1	242	16	0	5	0	2	2	1	0	3	0	12	1	0	0	11	1	0	20	244	3	2	27	2	14	46	61	133	0	1	0	13	78	3	28	40	0	4	0	2	61	12	40	185	23	15	4	0	3	6	0	0	4	5	10	24	10	135	12	82	0	13	0	0	9	0	53	28	0	0	0	0	16	28	17	14	19	24	25	1	58	0	3	13	4	12	0	22	23	48	63	1	1	16	120	7	2	0	3	1	1	0	2	19	2	0	121	1	8	0	3	3	5	25	204	23	15	1	0	0	0	15	0	0	1	22	2	7	5	1	0	0	79	35	20	186	0	56	2	5	1	12	0	6	0	17	0	42	0	6	1	20	7	21	61	7	9	8	1	0	1	40	387	2	0	7	0	0	15	0	4	25	0	0	0	2	13	93	3	1	36	9	82	2	0	5	0	0	0	7	0	36	1	11	2	67	0	4	316	0	64	3	0	27	42	1	3	4	10	0	119	6	0	3	1	0	0	10	0	0	15	22	43	121	0	190	29	55	0	1	1	1	1	1	0	0	0	0	29	92	5	3	7	316	30	2	813	15	36	31	418	73	11	846	26	1	515	23	341	321	27	55	108	0	7	3	14	0	4	0	3	14	1	1	1	31	6	1	0	1	1	1	2	5	16	1	16	1	14	3	11	11	35	11	0	0	0	0	0	0	0	0	0	0	0	0	1	5	0	0	0	0	4	0	0	0	77	0	0	3	16	82	1	0	0	0	0	1	0	0	0	0	0	0	0	0	0	0	0	0	1	0	0	0	21	0	163	38	0	106	25	8	0	29	0	1	0	57	5	91	0	31	1	88	0	0	3	6	5	20	0	3	0	0	1	0	3	44	13	13	16	71	107	0	7	4	46	13	41	2	10	53	1	6	0	3	2	1	2	4	1	3	1	4	3	3	11	5	90	2	46	1	10	29	75	0	106	3	197	2	0	38	0	0	0	11	67	8	2	0	0	0	0	0	37	19	17	0	0	85	59	11	11	2	23	0	1	0	0	10	9	8	6	18	5	1	1	0	28	443	1	0	0	2	80	7	4	0	0	10	1	0	3	18	0	2	45	318	2	33	6	0	15	0	95	0	4	0	3	1	1	36	19	12	68	1	1	1	1	3	10	9	0	0	18	22	42	142	28	49	0	46	39	1	17	5	5	6	3	30	0	4	164	0	4	3	14	18	0	6	0	7	5	0	0	0	0	4	3	0	0	0	0	6	3	3	7	1	3	0	0	1	3	2	0	0	0	0	2	1	1080	6	0	6	0	0	1	0	0	35	5	3	50	91	0	12	0	53	37	807	27	129	78	0	41	159	35	1	3	127	2	317	1	1	4	31	0	2	48	0	30	41	4	2	2	7	0	0	4	37	33	1	0	80	72	166	2	0	0	2	1	0	0	11	0	4	1	5	0	0	0	1	0	0	13	14	440	2	93	31	50	0	88	7	24	0	0	0	0	0	5	0	5	0	15	0	123	2	5	99	7	0	34	17	441	8	13	0	1	4	30	1	158	69	60	51	5	302	2	28	59	12	0	0	0	8	3	22	51	1214	61	9	0	51	0	0	0	0	63	1	0	0	2	0	29	0	22	28	0	1	0	1302	51	20	58	6	2	86	116	267	13	10	9	0	0	6	1	36	9	4	10	1	0	1	0	14	17	0	3	1	4	2	1	4	0	0	1	5	0	3	2	457	1	0	42	7	501	4	18	0	2	0	38	12	9	2	6	2	11	79	1	51	8	0	51	2	0	2	29	9	1	11	1	1	0	17	2	11	107	97	18	123	31	0	1	80	77	77	20	2	0	0	2	3	0	0	0	13	3	9	2	190	0	0	0	3	0	0	0	20	19	4	3	32	6	31	2	0	32	2	59	0	2	26	6	42	0	1	5	13	0	22	52	146	35	135	2	173	0	1	0	5	0	2	1	0	5	1	1	10	0	6	1	0	1	1	21	1	0	0	117	0	2	2	8	23	8	5	3	0	305	5	959	3	1	341	0	0	1	3	0	0	0	2	24	94	0	1	11	6	2	4	10	10	7	0	23	4	11	1	0	0	14	0	18	104	0	12	15	0	42	1	2	0	53	6	1418	110	239	86	14	161	90	73	178	117	4	51	0	59	25	2	0	1	7	1	7	8	4	1	2	1	7	4	13	0	1	4	9	11	0	0	0	0	4	1	1	2	2	1	5	3	0	1	4	1	14	3	2	4	0	0	0	0	1	0	2	1	0	10	3	0	112	4	266	387	5	235	3	0	0	20	0	0	26	1	5	14626	0	0	79	71	1	0	1	2	0	38	1	53	62	46	1	0	1	0	20	0	2	2	29	1	1	0	1	1	27	33	21	5	151	0	16	39	10	9	7	5	4	4	13	63	11	13	0	6	54	39	0	140	2	5	1	38	0	3	0	58	5	0	3	14	0	0	1	0	2	40	5	2	0	9	40	1	6	3	16	107	3	25	2	1	0	0	0	1	0	2	3	5	8	37	56	0	0	3	1	1	3	1	0	4	1	2	2	2	89
LakWasMe80_HOW10_2_rpkm	0	0	0	0	0	5	0	0	0	0	1	4	2	5	0	0	0	1	0	0	0	0	0	11	0	0	0	0	0	4	0	1	0	6	0	3	0	1	0	0	0	0	0	1	27	12	4	7	0	7	0	6	0	0	0	0	0	0	21	20	2	3	0	0	0	0	0	0	0	9	0	0	0	0	0	0	2	0	0	0	0	15	1	0	0	0	0	0	0	0	0	1	0	0	19	0	0	0	0	0	0	0	0	0	0	1	0	0	0	0	1	0	4	0	3	0	0	0	0	0	0	0	0	1	0	0	2	0	0	0	4	53	10	0	0	0	0	0	0	0	0	0	0	1	0	0	0	0	9	0	0	16	0	0	66	0	0	0	28	0	3	0	0	1	0	0	0	2	0	9	1	0	0	0	0	0	0	0	0	0	0	0	0	0	0	32	0	0	0	0	1	2	1	1	0	0	2	11	7	73	0	0	0	0	0	0	0	0	2	0	9	1	3	9	4	0	0	0	0	10	1	0	0	2	0	0	6	0	12	0	0	3	0	0	0	0	2	0	2	0	0	0	4	0	11	0	0	0	0	0	0	2	21	0	327	10	0	0	0	0	0	0	0	3	0	0	168	0	0	25	42	0	11	0	0	1	0	0	0	1	0	20	0	19	15	0	0	0	2	0	0	0	0	0	0	0	0	12	1	0	0	4	3	0	0	0	1	10	12	0	0	0	24	2	0	0	0	0	0	0	0	0	0	0	2	0	0	0	0	0	0	1	0	0	0	0	0	3	0	0	0	2	8	1	0	0	2	1	16	0	0	0	0	0	0	0	0	0	0	10	0	0	0	0	0	9	0	30	0	0	0	20	0	17	22	0	0	3	0	5	1	0	1	0	3	0	5	0	0	0	0	0	60	0	0	3	3	0	0	1	2	5	0	2	7	0	0	0	0	0	0	0	0	115	0	9	1	1	1	7	0	0	3	0	0	0	0	0	0	0	0	0	0	0	0	5	0	1	4	0	13	1	0	0	0	89	0	0	0	0	0	46	0	139	0	0	38	0	0	0	0	0	0	2	0	7	19	0	0	1	2	12	3	1	0	0	16	2	2	0	7	2	16	733	1	0	0	17	8	0	0	0	12	21	1	0	5	0	0	0	0	0	18	0	0	1	0	0	0	0	0	0	0	0	0	0	0	0	0	9	0	0	0	0	0	0	0	0	0	0	0	0	149	5	1	0	0	2	0	6	0	0	0	7	0	0	0	0	0	10	0	0	1	1	0	0	0	7	0	0	0	0	0	0	0	0	0	0	2	0	0	0	0	0	0	1	2	38	5	1	1	8	4	1	11	0	0	3	39	0	0	0	5	1	43	6	1	0	4	0	9	0	0	0	2	2	0	7	0	35	1	169	57	134	0	0	18	0	48	1	1	1	0	5	0	5	0	1	0	1	0	0	0	0	2	0	0	0	4	3	3	67	0	0	0	4	2	8	5	3	0	0	2	16	2	0	1	0	2	0	0	6	0	0	0	0	0	0	0	1	0	4	4	0	0	0	0	1	0	0	0	0	2	0	0	0	0	0	0	5	0	0	1	0	0	0	0	0	0	0	0	14	0	8	0	0	3	0	0	0	0	3	0	0	4	4	0	0	5	4	0	1	0	4	0	0	0	0	4	0	0	0	0	0	0	0	0	0	0	0	0	3	1	0	1	14	0	0	0	3	0	0	3	0	0	0	0	0	3	8	0	0	0	4	0	0	0	0	0	0	0	0	0	0	6	73	0	0	0	0	0	0	6	1	0	0	0	0	0	0	0	2	0	0	0	0	3	5	0	4	0	0	0	0	4	1	85	0	0	0	0	0	0	0	3	0	0	0	0	0	0	0	0	0	5	0	0	0	25	16	4	0	0	0	0	0	0	9	10	0	0	0	0	0	0	0	0	0	10	10	0	0	0	0	0	1	0	0	0	0	13	0	0	3	0	0	0	0	7	0	0	0	0	0	0	0	0	0	4	0	0	0	0	0	0	0	3	0	0	1	0	0	0	0	0	0	0	0	0	0	0	3	3	17	0	0	0	0	0	0	0	0	0	1	0	1	1	0	0	0	0	2	0	1	0	0	0	0	0	0	0	0	0	0	0	0	0	0	0	0	0	0	0	6	4	0	0	0	0	0	0	0	0	0	0	0	0	0	0	0	0	0	0	0	0	0	0	0	0	2	0	0	2	33	0	11	0	0	0	0	13	7	1	0	44	0	0	0	0	0	0	0	0	0	0	0	0	0	0	0	0	0	0	0	0	0	0	0	0	2	0	0	0	0	0	0	0	21	0	0	0	7	0	0	0	2	0	0	13	0	6	0	0	0	0	0	1	0	0	0	0	0	0	0	0	0	0	0	0	0	0	0	0	1	1	0	0	0	0	0	0	0	0	4	0	0	0	0	0	0	1	0	0	0	0	0	1	0	2	0	0	0	0	0	0	0	0	0	0	5	0	0	2	0	0	0	0	0	0	0	0	0	0	0	0	1	20	0	0	79	0	102	0	0	0	0	0	24	0	0	8	0	0	0	0	0	0	1	21	0	0	1	0	0	0	0	0	0	0	0	0	0	0	0	0	0	0	0	0	0	0	3	0	0	0	0	0	0	0	0	0	0	0	0	0	0	0	0	0	0	13	0	0	0	55	0	1	0	0	0	0	0	0	0	0	0	0	3	0	0	0	0	21	2	0	11	0	0	0	53	1	0	0	0	0	0	1	0	0	0	0	0	0	0	0	0	0	1	0	0	0	0	0	0	0	0	0	0	1	0	0	0	0	0	1	0	0	0	0	0	10	0	3	0	0	0	32	0	1	0	2	0	0	6	30	0	0	0	1	0	2	0	0	11	0	5	0	0	0	0	0	0	2	37	0	13	12	4	0	5	0	0	0	0	0	28	5	5	13	0	0	0	0	0	0	4	0	0	1	0	0	0	0	0	0	0	0	0	0	3	0	0	0	0	0	0	0	0	0	1	0	0	0	0	0	1	0	0	0	0	0	0	0	0	10	0	9	8	7	0	0	0	7	8	0	0	3	0	0	2	0	0	1	0	0	0	15	3	0	0	0	0	0	0	8	0	1	0	3	1	0	0	0	24	0	0	2	0	0	0	0	0	3	0	0	0	6	6	6	15	0	1	15	0	0	2	0	1	0	0	0	0	0	1	2	0	7	0	0	8	2	1	9	5	2	0	18	0	0	0	0	0	0	0	0	0	0	5	0	0	0	14	7	0	9	0	1	1	0	0	0	0	1	5	0	0	0	0	1	0	0	0	2	0	3	35	56	0	0	0	0	0	0	0	0	15	12	0	1	8	0	0	0	0	88	80	1	13	0	0	2	16	0	0	2	0	0	0	0	0	12	0	9	2	50	1	0	0	0	10	0	0	0	0	0	0	2	20	0	0	0	3	0	15	0	0	0	0	0	7	0	0	0	0	0	0	4	0	0	0	0	0	0	3	0	4	0	0	0	0	0	0	0	0	0	0	0	0	0	18	0	0	4	0	0	0	0	0	0	0	0	0	0	3	1	0	0	0	0	0	0	0	0	0	0	0	0	0	0	0	0	0	0	0	0	0	0	1	0	0	0	0	1	0	0	13	0	5	67	0	0	0	0	1	1	0	1	0	1	0	7	1	3	0	0	0	0	0	5	0	0	0	0	0	0	0	8	0	0	1	0	0	0	0	0	0	0	15	0	12	2	0	0	0	5	0	0	0	0	0	0	0	0	0	0	0	0	1	0	0	4	0	6	10	2	0	0	7	0	0	0	4	0	2	1	0	0	0	0	0	0	0	0	0	0	0	0	0	18	1	223	4	42	10	0	6	0	0	0	0	0	0	0	0	0	0	12	0	0	0	0	1	0	0	0	18	9	0	21	0	0	39	0	0	0	3	4	0	0	0	0	0	0	0	0	0	0	22	0	1	0	2	0	0	1	0	0	1	0	0	0	0	0	0	0	0	14	126	2	16	0	0	1	6	0	2	0	0	0	0	0	0	1	0	1	0	0	6	0	0	0	2	2	2	0	0	0	0	0	0	0	0	0	0	0	0	0	4	11	0	0	0	0	1	0	0	0	0	3	0	7	5	1	0	0	0	0	0	0	0	0	19	0	0	0	0	0	0	0	0	0	0	0	0	0	11	0	76	0	14	0	0	0	0	0	0	0	0	0	0	4	0	0	16	4	16	34	0	1	0	0	0	0	0	11	0	0	6	0	0	0	0	66	2	19	0	1	6	15	0	1	0	41	0	3	1	0	0	2	0	0	5	0	0	0	0	0	0	0	0	0	0	0	0	0	0	1	3	0	13	0	0	53	0	0	0	0	0	0	0	0	0	0	0	0	0	39	0	0	0	0	2	1	2	0	0	0	0	0	1	7	0	5	63	4	0	0	0	0	0	0	0	0	0	0	0	0	0	0	4	0	0	3	116	1	0	0	0	0	0	0	0	36	0	14	8	17	4	0	0	18	0	0	25	127	2	0	0	0	0	0	0	0	0	0	0	0	0	0	0	0	0	0	1	0	0	0	0	0	0	0	0	0	29	0	0	12	0	0	13	20	0	4	0	108	2	8	0	0	0	0	0	0	0	0	0	0	0	1	0	5	0	0	0	7	0	2	0	0	0	0	5	0	0	0	0	0	0	0	0	0	0	0	1	0	0	0	0	0	0	0	1	2	3	0	8	0	0	10	0	0	0	0	0	0	0	4	1	81	0	0	5	2	0	5	116	0	0	0	0	0	0	2	0	0	0	0	275	0	0	0	0	0	10	0	0	0	4	0	5	66	7	0	1	0	0	0	0	1	0	3	0	0	0	0	0	0	0	0	0	0	0	1	0	0	0	0	0	1	0	1	0	0	0	0	0	0	0	0	0	0	0	0	68	0	0	0	11	0	17	3	0	0	0	0	0	43	0	0	0	0	0	0	0	0	0	4	1	12	21	0	0	0	0	0	4	3	5	0	2	0	2	9	0	0	0	1	0	0	0	53	0	0	0	0	0	0	0	0	0	23	96	8	0	0	0	0	2	0	6	0	0	2	0	44	0	0	0	0	13	0	0	0	0	0	0	1	0	0	2	0	0	0	0	2	1	0	2	0	0	0	0	0	4	0	0	5	0	0	0	0	0	2	0	0	0	0	0	0	0	0	0	0	0	0	0	0	0	0	0	18	0	0	0	0	1	0	0	0	1	2	0	0	0	0	0	0	0	0	0	0	0	0	0	8	0	0	4	0	0	0	3	0	1	0	0	3	1	0	0	2	0	0	0	0	1	0	0	0	0	0	0	0	4	170	2	0	0	0	0	0	19	1	6	0	1	0	1	2	1	5	0	0	0	0	3	0	59	1	7	5	0	12	2	1	14	0	0	0	0	0	0	0	0	0	0	1	33	0	0	0	0	0	0	0	0	0	0	0	0	0	0	0	0	0	0	0	1	2	0	16	0	20	3	0	0	11	0	0	1	0	0	13	1	0	0	1	0	0	0	0	0	0	1	0	0	0	0	0	18	0	6	1	0	0	1	0	0	0	0	0	0	0	3	0	0	1	0	17	0	0	0	0	0	0	0	0	2	1	0	0	0	5	3	0	7	0	0	0	2	0	5	0	0	0	0	1	0	0	1	0	2	0	49	4	0	2	47	0	0	0	0	0	0	0	0	0	0	0	0	0	1	2	0	0	0	0	1	0	0	22	3	6	0	0	2	3	4	5	6	0	2	0	4	1	8	0	0	0	0	0	0	1	0	0	0	0	0	0	0	0	0	0	0	0	0	2	0	0	0	0	0	0	0	0	16	0	0	7	0	0	0	0	0	1	0	0	0	0	0	0	8	0	178	3	0	0	14	0	0	1	0	0	7	0	0	0	0	0	0	0	0	1	1	0	0	0	0	5	0	0	15	1	0	0	0	0	25	2	1	5	1	0	0	0	0	0	2	0	10	0	0	0	0	0	0	0	0	0	5	0	0	0	0	0	0	0	0	0	10	0	0	0	0	0	0	3	0	0	0	4	0	0	0	0	4	44	11	16	11	0	2	0	0	0	0	0	0	0	0	3	0	0	0	0	0	0	0	13	6	9	12	0	0	0	2	0	0	2	0	3	28	0	0	0	1	0	0	0	0	0	4	0	0	0	0	0	0	4	0	15	0	0	0	0	0	0	0	9	0	0	10	2	0	0	0	0	0	0	0	22	0	0	0	0	0	0	0	0	0	0	0	5	3	0	0	8	0	0	0	1	0	0	0	0	0	0	0	0	0	0	0	0	0	8	0	0	0	0	6	0	0	0	0	0	1	0	0	0	0	0	0	0	0	0	0	47	0	0	20	0	30	0	9	4	0	0	0	0	6	0	4	0	0	0	0	0	0	0	0	0	0	0	0	3	0	0	0	70	0	15	0	13	0	0	0	0	0	0	0	0	0	0	81	0	0	3	0	0	0	1	0	1	5	0	0	0	0	0	0	0	3	0	0	0	13	5	0	10	7	14	3	5	0	14	3	6	0	0	0	0	0	4	0	0	9	0	1	0	2	21	5	0	0	0	0	0	5	22	0	0	0	0	16	1	0	0	0	0	0	0	0	0	0	0	0	0	0	0	0	0	14	0	1	4	3	6	0	0	0	0	0	0	0	0	0	0	10	0	0	50	16	5	0	29	0	5	0	0	0	4	0	2	0	0	0	1	2	0	0	0	0	0	0	0	4	0	76	0	0	19	0	1	5	0	0	0	0	0	21	19	0	0	0	2	2	0	0	0	0	2	0	0	2	0	6	6	0	0	0	45	0	0	0	0	0	0	0	659	2	2	1	0	0	0	0	0	1	0	29	0	0	0	1	0	0	52	136	27	0	0	0	1	0	1	0	42	0	0	0	0	0	15	0	0	0	0	0	0	0	0	0	0	0	0	0	0	0	144	191	0	2	0	0	0	0	4	0	0	0	0	0	0	0	2	1	0	7	0	0	2	1	0	5696	21	26	0	0	0	0	0	0	0	0	0	1	0	0	0	0	0	0	0	0	0	719	0	0	0	1	1	0	0	0	0	0	0	2	0	0	0	0	0	0	0	0	0	0	0	0	0	0	0	0	0	0	0	0	0	0	0	0	0	0	0	1	1	7	0	0	0	0	5	0	0	0	0	0	0	0	0	3	0	0	0	0	0	0	0	0	0	0	485	0	0	0	0	0	1	82	1	0	0	0	0	0	1	139	4	0	0	0	0	6	33	0	16	1	0	0	0	2	0	0	0	0	0	0	8	0	1	0	0	0	0	0	0	0	0	0	0	0	0	0	0	0	0	0	0	0	0	0	5	0	14	0	0	0	0	0	0	0	0	0	0	0	0	7	1	1	4	0	15	0	0	3	0	0	0	3	0	0	0	0	0	0	0	2	0	16	0	11	0	0	0	0	0	0	0	0	0	0	0	0	10	0	45	5	3	12	0	0	0	0	0	0	0	0	1	0	0	1	0	1	0	0	0	0	249	5	0	0	0	0	0	0	0	239	5	19	0	0	0	0	0	0	14	4	0	1	0	0	0	0	0	0	0	0	0	0	7	9	38	0	2	0	0	3	0	0	0	0	0	0	0	0	12	35	4	8	0	0	0	0	0	0	0	36	0	0	0	0	4	0	0	0	0	0	4	0	3	0	0	9	0	0	0	0	26	0	9	0	0	0	9	0	0	0	0	0	25	0	0	0	0	0	0	0	0	0	1	0	2	0	0	0	1	0	0	41	0	0	0	0	0	0	0	22	0	0	0	0	0	2	0	0	0	0	0	0	0	0	0	0	0	1	0	0	0	1	0	0	0	0	0	0	0	0	0	0	0	0	0	0	0	1	1	0	14	0	0	1	0	0	0	0	0	0	0	0	0	0	0	0	0	0	0	0	0	0	0	2	0	0	0	0	0	0	0	0	0	2	0	0	0	0	2	0	0	0	0	0	0	0	0	0	11	0	0	0	0	0	0	0	0	0	0	0	0	0	0	0	0	0	1	0	0	0	0	0	0	0	2	4	3	0	0	0	1	0	1	0	0	0	7	0	0	0	0	0	0	14	0	7	0	0	0	0	1	0	0	0	0	30	0	0	0	0	0	0	0	0	0	0	0	0	0	0	0	0	0	0	0	1	0	0	0	0	0	0	0	0	3	0	0	0	0	0	0	0	0	0	0	0	0	0	0	0	5	0	0	0	4	0	0	2	1	0	0	0	0	0	0	0	0	3	0	0	0	0	0	0	0	156	0	0	0	1	0	0	0	0	0	0	0	0	0	0	0	0	0	0	0	0	0	1	0	0	0	0	0	0	0	0	1	0	0	2	0	0	0	0	0	1	0	0	0	2	0	0	0	0	0	0	0	0	3	0	1	0	0	0	0	0	0	0	0	0	0	0	0	0	0	0	0	0	0	0	0	4	0	0	4	0	0	4	0	0	0	0	0	0	0	0	0	0	23	0	0	11	0	5	0	0	0	4	0	0	1	0	0	148	0	2	0	1	0	0	0	0	0	2	0	0	9	1	0	0	0	30	0	0	0	0	1	27	0	0	0	0	0	0	0	0	2	0	0	0	0	0	0	0	5	0	0	1	0	0	0	0	0	1	0	0	0	3	0	0	0	0	0	0	1	0	0	0	0	0	0	22	0	4	0	0	0	0	0	0	0	0	0	0	0	0	0	0	0	0	0	0	0	0	0	0	0	0	0	0	0	0	0	0	0	0	6	0	0	26	0	0	0	0	1	7	0	0	0	1	0	0	0	5	5	0	0	3	0	0	0	0	0	0	0	0	0	0	0	2	0	0	1	0	0	0	0	144	0	0	0	0	0	0	0	0	0	0	0	3	0	0	0	0	0	0	0	0	0	0	0	0	0	0	0	0	0	31	1	0	0	0	0	0	1	0	0	1	0	0	0	0	0	0	0	0	0	0	0	2	0	0	40	0	0	0	0	0	0	0	3	27	0	1	0	0	0	0	0	0	0	0	0	0	1	1	0	0	1	1	2	0	0	0	8	0	0	0	0	0	0	0	0	0	0	0	1	0	1	0	0	0	0	0	1	0	0	0	0	0	0	0	0	0	0	0	5	0	8	0	1	1	0	0	0	0	1	1	3	1	0	28	0	12	0	0	0	0	0	0	0	1	0	0	30	0	2	0	0	0	0	0	0	0	11	0	0	1	0	0	0	1	0	0	0	0	2	0	0	0	0	0	0	0	0	0	0	0	2	0	1	0	0	0	17	0	0	0	0	0	0	0	0	0	0	0	1	0	0	0	0	0	0	0	0	2	0	0	2	0	0	0	0	0	0	1	0	33	6	12	91	267	0	0	0	0	2	0	0	0	0	0	0	0	2	1	0	5	0	0	24	0	48	0	0	0	676	0	0	0	0	1	0	0	0	0	0	0	2	12	42	0	0	0	0	0	0	1	0	0	0	0	0	0	0	0	0	0	0	0	0	0	0	0	0	12	0	0	0	0	0	1	0	0	0	0	0	0	0	1	0	0	0	34	0	0	0	0	0	0	0	65	1	0	0	0	0	0	0	0	5	0	0	0	6	137	0	0	0	0	0	0	0	0	1	0	0	0	0	0	0	1	1	0	0	0	0	0	1	0	2	0	0	0	0	0	0	0	0	0	0	0	1	0	1	0	3	0	0	0	0	0	0	8	0	0	0	0	0	0	22	0	0	0	0	14	0	1	0	0	2	0	0	71	0	0	0	0	0	0	0	32	0	0	0	38	41	5	0	1	0	0	3	0	0	1	5	1	2	55	2	0	5	2	0	0	1	1	6	0	1	0	17	0	16	0	0	0	0	0	0	1	0	0	0	50	0	4	0	0	0	0	0	0	0	0	0	0	1	0	0	3	20	0	0	0	0	1	8	0	0	0	0	0	0	151	19	0	0	0	0	0	0	48	2	0	0	1	1	0	0	17	1	5	0	3	0	1	0	0	0	0	18	23	0	46	69	2	0	0	0	0	0	0	0	0	0	0	0	0	0	0	0	1	0	0	0	0	4	1	0	0	0	4	0	0	0	9	1	0	0	0	0	4	23	0	3	0	1	0	0	0	0	0	0	10	0	1	5	0	2	0	0	0	0	0	0	0	0	0	0	0	0	0	58	0	0	1	3	0	0	0	1	0	6	0	1	7	127	68	13	0	1	0	0	5	0	0	3	0	0	0	0	0	0	0	0	0	0	0	0	0	0	0	0	0	1	0	0	0	0	0	17	0	0	0	5	0	0	0	0	0	0	0	14	0	0	3	0	11	6	4	0	1	0	0	0	2	0	23	0	0	0	0	15	0	0	0	0	0	0	0	0	1	0	0	0	0	0	0	0	0	0	16	0	0	0	0	3	0	0	4	5	0	0	0	0	0	0	0	0	0	0	18	0	1	1	0	0	0	0	0	1	0	0	0	0	0	0	0	6	1	0	9	0	0	3	0	0	0	2	37	0	7	5	1	0	0	3	0	0	0	0	0	0	0	0	5	0	0	0	0	0	0	0	0	12	0	0	12	15	0	1	0	0	3	5	0	1	0	0	0	15	0	0	2	0	28	1	0	0	0	5	0	30	5	0	0	0	0	0	0	0	0	2	0	0	0	0	1	1	0	0	0	18	0	0	0	0	5	0	0	9	0	0	0	3	0	0	0	5	0	0	1	0	1	0	0	0	0	0	0	1	0	0	0	0	0	0	0	0	0	0	1	6	0	0	0	7	0	6	0	0	50	2	3	0	0	0	0	0	0	0	0	0	0	0	0	44	1	0	0	0	0	0	0	0	0	19	6	35	0	4	23	0	0	0	0	0	0	9	0	0	4	1	0	0	6	0	0	0	7	0	5	1	0	0	4	7	19	0	0	0	0	10	0	4	0	2	0	0	0	0	0	0	0	0	0	0	0	0	0	0	0	0	0	0	0	0	0	0	21	0	0	0	0	0	10	0	17	0	0	0	0	0	0	14	0	0	0	0	0	0	1	0	68	0	0	58	1	0	0	9	0	0	6	0	0	0	0	0	0	0	0	0	5	0	0	1	0	0	68	0	0	0	0	0	0	0	13	0	0	0	0	0	0	8	0	0	0	0	1	0	0	0	0	0	2	0	0	0	0	0	1	0	17	6	0	2	0	3	0	0	0	0	45	0	0	4	0	9	0	0	0	1	7	0	0	0	0	0	0	1	0	0	0	0	0	0	0	7	46	1	0	0	1	89	0	1	0	0	0	2	0	1	4	10	0	4	2	0	1	0	0	0	0	0	0	1	0	0	0	0	0	0	3	0	0	0	0	0	0	0	0	1	0	0	3	0	0	0	0	0	0	17	34	0	0	0	0	0	0	0	0	0	0	0	0	0	0	0	0	0	0	0	10	0	0	0	0	0	0	0	0	0	0	0	0	0	1	0	0	0	0	0	0	34	0	0	0	0	0	0	0	0	0	0	0	1	0	2	0	0	0	0	0	0	0	3	0	0	0	0	0	0	0	0	0	0	0	0	0	0	0	0	0	0	3	0	0	1	0	0	1	0	0	0	0	4	0	0	0	0	6	0	0	0	0	0	0	0	1	0	0	2	0	0	0	0	0	0	0	0	0	0	0	0	0	1	0	0	0	0	0	0	0	0	0	0	5	0	0	0	0	1	0	0	5	0	0	0	0	0	0	0	0	0	6	16	0	0	0	0	0	0	0	1	9	0	0	0	0	0	0	0	0	0	0	0	0	0	8	0	0	0	1	0	0	0	0	8	0	0	1	0	1	0	0	0	0	0	0	0	0	0	0	0	0	0	0	0	0	0	0	0	0	4	0	0	0	0	0	0	0	47	0	0	0	0	0	6	0	0	0	0	0	0	1	0	0	0	0	39	0	0	0	0	4	0	0	1	15	0	0	0	0	0	0	0	0	0	0	0	0	0	0	0	0	77	0	8	1	22	0	0	0	0	0	21	0	0	0	0	4	5	9	0	0	0	5	0	7	0	0	0	8	9	0	7	11	0	0	0	0	0	0	0	70	7	0	4	0	6	0	0	0	0	0	8	0	0	0	0	1	0	8	0	0	0	0	0	0	0	0	0	0	0	0	11	0	0	0	0	3	3	0	0	0	0	1	17	0	15	7	0	4	0	6	0	0	218	0	0	0	0	0	0	2	0	2	0	0	0	0	4	8	0	0	0	0	0	11	21	5	18	2	0	99	9	0	0	0	0	0	0	0	0	0	0	0	0	0	5	0	1	0	0	6	0	3	0	1	11	2	2	0	0	0	0	0	0	0	0	0	0	0	0	0	0	0	0	0	0	0	0	0	0	0	5	1	0	0	2	0	0	0	1	2	0	27	0	0	0	0	0	0	0	2	0	2	3	0	0	0	0	0	0	0	0	13	0	0	61	1	0	0	0	0	0	0	0	1	2	0	0	246	0	0	79	9	4	6	2	8	0	3	0	1	4	0	18	16	4	0	0	0	0	2	0	0	0	0	0	0	0	0	0	0	0	8	0	0	2	0	0	2	0	0	0	0	0	0	0	2	0	0	0	4	5	2	0	0	0	0	1	0	0	0	5	0	10	0	0	2	0	0	0	0	11	1	0	3	0	2	0	0	0	1	0	2	0	0	0	0	24	1	2	0	0	3	0	0	0	0	2	0	0	5	0	0	6	17	17	0	4	0	0	0	0	7	0	0	1	0	0	3	0	0	0	0	0	0	0	2	0	0	0	0	0	5	44	0	0	0	0	8	1	3	0	0	11	0	0	0	0	0	0	0	0	3	7	12	0	0	7	0	5	0	11	2	6	0	0	0	14	0	0	1	0	1	0	0	0	0	3	1	0	1	2	0	0	0	1	153	4	0	146	3	0	0	8	23	0	0	0	0	0	0	0	0	0	0	0	0	0	0	3	2	1	0	0	7	14	0	2	0	0	0	0	1	0	0	0	0	0	0	0	3	0	0	0	17	2	0	0	0	0	0	48	50	4	1	0	0	0	0	0	0	1	0	0	0	0	6	0	0	0	33	0	0	0	20	2	43	10	0	0	0	0	0	0	0	0	0	0	0	0	0	0	0	14	0	21	9	4	0	0	24	21	4	0	2	2	0	0	0	0	10	0	0	0	0	0	0	4	15	1	5	0	0	3	0	0	0	0	0	15	1	0	0	1	0	0	63	18	5	91	10	0	51	13	0	1	0	0	0	0	2	2	0	6	0	0	0	0	198	0	170	8	24	12	5	12	0	0	173	1	0	12	3	0	0	6	7	0	0	0	0	0	0	0	0	0	0	29	0	2	0	0	0	0	1	0	69	36	19	0	0	3	0	27	4	11	0	0	10	0	0	0	0	0	0	0	0	0	0	0	0	0	0	0	0	0	0	24	0	0	0	0	2	0	1	0	8	0	0	12	0	2	1	2	2	34	6	0	1	1	0	6	0	93	27	1	0	0	0	0	0	18	0	0	0	0	0	0	12	0	0	0	0	0	0	0	4	14	0	0	0	0	0	0	0	0	0	0	0	0	0	0	0	0	0	0	14	0	0	0	0	0	0	154	0	662	0	2	0	1	38	1	5	0	0	0	0	0	0	0	0	15	0	8	0	0	0	0	0	0	0	0	1	0	2	28	0	0	2	0	0	0	0	1	0	0	0	0	0	0	0	0	0	2	4	0	1	1	0	0	0	0	0	0	0	0	0	2	0	0	0	0	1	1	0	1	0	0	0	0	0	0	0	4	3	2	0	0	7	0	0	0	0	94	0	0	0	0	0	0	0	0	0	0	0	256	0	0	36	1	0	0	0	0	2	0	0	9	0	0	0	0	0	0	2	0	0	0	0	0	0	0	56	0	0	1	3	0	0	0	0	0	0	0	0	0	463	0	8	0	5	21	0	0	61	0	24	25	293	268	91	0	34	19	26	0	0	6	1	1	2	0	1	3	0	1392	0	5	0	1	0	49	0	0	0	0	12	8	0	0	0	0	0	1	0	1	0	6	1	25	6	0	2	10	22	3	0	0	0	10	0	1	3	0	0	0	0	1	0	2	0	0	0	11	10	0	1	3	8	0	0	0	0	0	0	0	0	1	0	0	0	0	0	0	6	0	0	0	0	0	0	0	0	4	0	0	0	4	1	0	58	0	0	0	0	17	397	0	0	0	0	5	1	3	14	0	2	0	11	0	0	1	1	0	6	0	4	102	0	0	0	0	42	0	0	0	4	0	0	0	6	6	9	0	0	0	56	1	0	0	0	10	0	1	3	0	0	2	0	0	14	0	2	0	0	0	0	0	0	5	7	0	0	0	0	0	0	0	2	0	0	3	25	1	1	0	7	15	0	0	0	0	15	0	32	6	0	0	10	4	0	0	1	0	0	0	0	0	0	0	6	30	24	13	1	0	0	0	0	0	18	0	0	1	0	0	0	0	0	0	0	0	2	10	1	0	1	0	0	0	0	0	0	21	4	1	0	0	0	0	0	0	0	0	0	0	0	0	0	0	4	0	0	10	0	0	0	0	0	0	1	1	0	0	0	2	12	0	1	0	0	0	0	0	3	2	0	2	0	0	0	0	2	0	6	1	0	19	0	1	0	0	0	8	0	0	0	0	5	16	0	0	1	0	1	0	10	0	54	0	0	6	0	0	0	0	2	0	1	3	0	0	0	0	1	61	0	0	0	0	4	2	16	0	21	0	1	14	0	6	0	8	0	0	2	26	8	19	1	4	6	6	1	1	0	10	0	0	7	0	3	0	0	8	0	1	46	1	80	0	16	0	0	3	0	10	2	0	4	0	1	0	0	17	1	7	8	6	55	13	0	23	0	8	25	648	0	1	6	7	0	0	0	0	0	0	2	0	0	0	0	5	67	0	0	20	0	0	0	0	0	8	9	2	20	0	0	0	1	27	100	0	0	23	6	4	0	2	0	0	4	14	3	1	60	0	1	0	22	0	0	1	0	0	0	0	13	0	0	0	31	0	0	2	0	0	0	0	28	0	1	0	0	0	8	0	0	0	0	0	1	0	0	0	28	0	0	0	0	0	0	0	0	0	0	4	0	0	0	0	0	0	0	20	0	5	3	0	6	7	6	11	4	0	0	7	0	0	5	2	0	0	0	0	0	0	22	0	0	0	0	0	0	0	1	0	0	0	12	0	0	0	0	2	0	0	0	0	0	0	0	0	0	0	0	25	0	2	0	0	0	0	131	13	11	23	0	55	0	5	0	0	0	0	0	1	0	0	0	0	0	0	0	4	10	3	0	0	0	0	0	0	3	0	0	13	3	0	0	2	0	1	1	0	237	21	0	0	0	3	0	0	8	0	14	0	10	0	0	0	0	1	8	0	7	0	0	0	7	5	0	0	3	3	0	12	0	0	0	8	0	0	0	57	2	1	0	0	0	0	1	4	0	0	0	0	7	0	2	1	0	0	0	2	0	0	0	0	2	1	0	5	0	0	0	0	0	0	2	0	10	0	14	0	0	0	2	0	0	0	0	0	23	2	3	0	0	1	0	0	7	0	0	0	0	0	0	0	6	0	0	0	0	0	0	0	0	0	0	3	0	9	0	1	0	0	0	0	0	0	0	0	5	0	0	0	14	0	0	0	0	0	0	0	17	0	0	0	32	6	12	0	0	11	0	1	0	0	0	0	0	16	0	0	1	0	0	0	0	0	0	0	0	0	0	0	12	1	0	4	2	0	0	2	0	14	7	3	4	0	0	0	0	0	0	0	0	1	0	1	0	14	0	1	0	0	1	0	0	0	19	0	2	0	0	23	0	22	0	0	12	0	0	9	0	0	0	0	0	0	0	0	0	3	1	0	6	0	2	0	0	0	0	21	0	0	0	0	0	2	5	0	0	0	0	0	0	0	0	1	0	3	3	0	0	0	31	0	0	0	0	19	5	0	0	0	0	0	3	0	0	0	0	0	3	17	0	0	0	0	106	0	21772	0	0	0	0	0	9	0	0	0	0	0	0	0	0	0	0	17	0	1	0	0	1	0	0	0	2	0	5	0	0	0	0	0	0	0	4	0	8	14	0	1	0	0	0	0	3	7	0	0	0	0	0	0	0	4	64	11	0	0	0	1	17	0	0	0	0	0	0	0	155	5	34	14	0	0	1	75	2	9	0	0	106	0	0	0	0	0	0	0	1	0	2	0	0	6	0	0	1	0	0	0	0	8	0	0	3	0	0	0	0	0	0	0	0	0	0	0	0	18	0	1	3	1	0	5	15	0	53	0	0	62	0	0	2	16	0	59	76	0	0	1	1	0	6	0	0	0	61	67	22	0	20	0	1	0	0	32	25	0	0	0	3	0	0	0	0	0	0	0	0	0	4	9	9	3	3	0	11	0	0	0	16	0	0	0	0	5	3	19	0	0	8	6	1	2	1	0	0	0	1	0	0	0	0	9	23	3	0	27	0	0	0	1	8	0	0	0	0	0	0	0	0	0	0	0	0	0	0	6	0	0	0	5	7	14	0	0	1	7	0	0	1	0	0	3	0	1	0	0	0	14	32	0	0	0	1	19	20	0	2	3	0	0	0	0	0	0	0	0	0	0	0	0	0	0	0	1	0	0	0	0	0	21	2	0	0	0	0	0	6	0	0	0	0	1	0	0	0	0	0	0	0	0	0	0	0	0	0	0	0	0	0	8	0	6	0	0	0	0	6	0	6	0	0	1	0	7	9	0	39	0	0	0	1	15	9	12	7	0	0	0	0	7	0	0	0	0	7	0	19	0	0	0	0	0	0	0	0	0	731	0	0	0	3	1	0	0	0	0	0	121	229	0	0	1	1	0	0	0	4	0	18	0	0	0	0	42	6	0	15	11	0	0	4	33	11	9	0	175	0	0	22	5	366	0	1	0	0	0	1	0	0	50	0	0	5	9	29	0	0	0	7	0	0	0	0	0	0	0	3	0	0	0	3	0	0	2	0	0	1	0	1	52	0	0	0	0	0	0	2	0	0	0	0	0	1	1	11	41	3	13	45	21	15	134	0	0	28	6	11	72	0	0	0	1	9	0	0	0	0	0	0	0	8	0	0	1	0	0	0	0	0	1	0	2	1	6	0	0	34	6	0	1	3	0	0	2	0	0	0	0	0	45	0	8	0	0	0	0	0	3	0	0	0	0	0	0	0	0	0	0	0	1	0	5	13	0	0	0	0	0	0	2	0	0	0	39	0	39	2	0	0	0	0	0	0	0	0	0	0	0	0	0	0	0	0	0	0	0	0	0	2	0	3	8	6	8	0	0	0	0	0	0	0	0	0	0	0	0	0	0	0	1	0	15	0	0	0	0	0	1	0	0	0	0	0	0	15	4	0	0	72	0	0	0	0	0	67	0	0	3	1	1	0	0	1	0	0	4	1	0	28	1	2	0	1	1	0	0	0	0	1	0	0	0	0	3	1	0	0	0	0	0	0	28	0	0	0	0	124	0	0	0	0	0	1	0	0	1	0	0	0	0	0	0	3	0	0	0	0	0	0	0	0	0	0	42	2	0	0	0	0	1	0	0	0	7	0	0	0	0	0	3	20	0	0	0	0	0	1	0	3	0	0	0	0	2	0	0	0	0	0	0	0	2	0	1	139	0	0	8	0	0	115	1	0	1	0	3	3	11	0	1	22	0	1	1698	0	13	80	3	0	7	0	33	9	36	0	0	0	0	1	0	0	0	1	0	0	0	0	0	0	0	3	0	23	0	0	0	0	0	76	0	1	0	0	0	3	0	0	4	0	0	0	0	0	9	0	0	0	1	4	0	0	0	0	41	2	1	0	0	0	0	0	0	0	1	0	0	5	0	0	0	0	6	0	0	0	0	0	0	1	7	556	10	1	0	3	21	3	18	21	51	0	0	0	0	0	0	2	0	0	6	0	0	0	44	26	5	2	0	58	0	0	6	10	2	0	0	1	0	1	0	0	0	0	0	6	4	3	0	0	0	0	14	0	1	2	0	0	0	0	0	0	0	0	0	0	0	0	0	0	0	0	0	0	0	0	0	0	0	0	0	0	0	0	0	0	7	0	0	0	0	0	0	0	0	0	1	0	0	0	0	0	0	0	0	0	5	0	6	2	0	0	568	0	0	0	2	0	0	0	0	0	0	5	2	9	6	1	0	3	1	0	0	0	4	3	0	0	0	0	1	0	1	0	2	13	0	3	2	0	0	2	0	0	2	0	0	19	1	0	0	0	0	0	0	0	0	31	5	15	4	3	0	33	0	0	24	0	0	2	0	0	0	0	5	72	26	0	0	6	0	15	1	4	0	8	0	2	0	1	0	0	0	0	0	0	0	0	22	0	1	1	0	0	0	2	0	0	4	0	4	1	0	20	0	3	0	2	16	0	1	45	0	9	0	0	0	0	0	0	0	0	4	510	8	8	0	0	0	3	0	0	0	0	0	0	0	0	0	0	0	0	0	0	48	3	0	4	4	9	2	0	0	0	4	0	0	0	0	1	0	38	0	0	8	16	0	0	0	0	0	13	0	0	0	0	0	0	8	1	0	6	9	0	0	0	0	0	1	44	0	9	0	3	4	0	1	0	6	0	0	0	0	0	0	0	0	0	0	0	0	0	0	0	0	0	0	0	0	0	0	0	0	0	0	0	0	0	0	0	0	0	0	0	0	0	0	0	0	2	1	205	2	0	9	1	3	6	24	10	2	0	1	0	0	0	0	0	2	0	0	0	0	0	0	0	23	0	0	0	0	0	0	0	0	1	2	0	151	0	0	0	0	4	0	0	0	0	0	0	0	0	0	10	0	0	0	0	0	0	0	0	0	1	0	0	2	0	0	0	1	5	0	0	22	0	0	0	3	0	0	0	0	0	0	14	0	0	9	22	0	9	49	0	0	0	0	0	0	0	0	0	1	0	1	0	0	0	0	0	2	0	0	0	0	0	0	0	0	0	2	7	0	0	0	0	1	0	0	129	0	0	0	0	0	0	0	0	0	5	0	0	0	0	4	0	0	0	0	0	0	0	0	0	0	0	0	0	0	0	0	0	0	0	6	0	5	4	0	0	0	3	0	0	0	0	0	0	0	0	1	0	0	0	45	0	0	3	0	0	0	0	0	0	0	0	0	0	0	0	0	0	0	0	0	0	0	0	0	0	23	0	0	0	0	0	0	0	0	0	0	0	0	0	0	0	0	0	5	0	0	14	0	0	0	0	0	0	0	0	0	0	0	0	10	0	0	2	0	0	0	0	0	0	0	0	0	0	0	0	0	0	0	0	0	0	12	0	0	0	0	0	0	0	0	0	0	0	0	0	0	0	0	0	0	0	0	8	7	0	0	0	0	77	0	0	0	0	0	0	0	0	0	0	0	0	0	1	0	1	0	0	0	1	1	1	0	6	0	1	0	0	9	0	0	7	0	6	0	0	0	0	0	0	0	0	0	0	0	0	0	0	0	0	0	0	2	0	0	0	0	0	10	0	0	0	0	5	0	1	0	0	5	0	0	0	0	7	0	1	0	0	0	0	0	8	0	0	0	0	0	0	1	0	0	0	0	1	3	0	0	0	0	0	0	0	0	0	0	0	0	0	0	0	0	0	0	1	0	0	3	0	0	0	0	0	0	1	0	2	2	0	0	0	0	0	0	0	0	0	0	0	0	0	46	0	8	0	0	1	0	0	0	9	0	1	0	0	0	12	0	14	0	2	0	0	0	2	0	0	10	0	1	0	0	0	0	0	0	0	247	2	0	0	0	0	0	0	7	0	112	0	31	15	0	7	0	3	6	0	0	0	0	0	0	0	0	0	0	0	0	4	0	0	0	0	0	0	0	0	0	0	0	6	0	0	1	0	0	0	0	0	0	0	0	0	0	1	0	0	0	0	23	0	0	0	0	0	0	0	0	0	0	0	0	0	1	0	0	4	4	0	0	0	39	0	19	0	15	0	0	0	0	0	0	0	0	1	1	0	0	0	0	0	0	0	0	15	0	0	0	0	0	0	0	0	0	0	99	0	0	0	0	0	0	0	0	0	0	0	0	0	0	0	0	0	0	0	0	0	0	16	1	0	0	1	12	0	0	0	0	0	1	0	3	0	0	0	2	0	0	0	0	0	0	13	0	0	0	0	5	0	0	0	0	3	2	0	5	0	3	2	21	0	0	0	0	0	2	1	0	0	0	0	0	0	0	0	0	0	0	1	0	0	44	1	0	2	0	0	0	0	0	0	1	0	8	3	26	24	3	24	28	52	0	8	0	0	16	0	0	6	2	2	2	0	0	0	0	9	7	0	0	0	0	60	1	0	0	0	23	0	0	0	0	1	0	1	0	1	0	0	17	0	4	1	0	0	0	0	0	0	0	0	0	1	0	3	0	3	1	0	19	0	1	0	0	0	1	6	0	5	0	0	0	3	1	0	0	1	6	0	0	1	11	0	47	1	0	0	2	0	0	0	0	0	0	0	0	0	0	2	0	0	0	34	0	10	3	2	4	3	7	14	0	0	0	6	26	0	2	10	0	0	0	0	15	1	11	4	4	3	0	0	6	0	1	0	46	5	0	10	5	12	1	10	0	10	0	0	3	0	3	4	0	0	0	0	0	1	4	0	0	4	1	0	2	0	0	15	2	6	0	2	3	4	2	0	0	1	14	0	2	0	11	1	0	0	0	1	0	0	9	0	0	0	0	0	0	2	19	1	3	0	0	0	0	5	0	0	1	0	0	0	0	0	0	0	4	0	0	27	0	9	0	4	0	0	0	1	0	0	0	5	0	10	0	3	5	0	1	1	0	4	0	0	0	7	1114	0	0	0	0	0	6	0	0	6	0	0	0	0	1	14	0	0	2	2	6	0	0	0	0	0	0	0	0	11	0	0	0	6	1	0	24	0	5	0	0	1	6	0	0	0	1	0	17	0	0	0	0	0	0	0	0	0	0	1	0	0	0	33	0	5	0	0	0	0	0	0	0	0	0	0	2	75	1	0	0	17	0	0	54	1	5	0	41	2	2	81	1	0	28	150	12	42	1	0	0	0	0	0	0	0	0	0	5	1	1	0	0	3	0	0	0	0	0	0	0	0	0	0	5	0	4	0	5	0	29	0	0	0	0	0	0	0	0	0	0	0	0	0	0	0	0	0	0	0	0	0	0	0	1	0	0	0	3	15	0	0	0	0	0	0	0	0	0	0	0	0	0	0	0	0	0	0	0	0	0	0	1	0	20	6	0	31	2	4	0	4	0	0	0	4	0	6	0	0	0	15	0	0	0	0	0	5	0	0	0	0	0	0	0	1	0	1	4	12	16	0	6	3	9	24	4	0	1	3	0	0	0	0	0	0	0	0	0	0	0	3	0	6	0	3	6	0	5	0	3	4	15	0	11	2	32	0	0	2	0	0	0	3	8	0	0	0	0	0	0	0	0	0	1	0	0	10	10	2	2	0	1	0	0	0	0	1	0	0	0	1	0	0	0	0	28	46	0	0	0	0	6	0	0	0	0	0	0	0	0	6	0	0	18	20	4	2	1	0	1	0	17	0	0	1	0	0	0	1	1	7	5	0	0	0	0	0	0	0	0	0	3	6	3	10	0	5	0	4	0	17	0	0	0	0	0	2	0	1	8	0	0	0	3	2	0	1	0	0	26	0	0	0	0	0	0	0	0	0	1	16	0	0	1	0	0	0	0	0	1	0	0	0	0	0	0	0	6	3	0	0	0	0	0	0	1	7	0	0	23	8	0	0	0	5	1	48	3	31	8	0	5	2	1	0	0	19	0	46	0	3	0	41	0	0	3	0	2	6	0	0	0	0	0	0	2	6	0	0	0	9	5	36	0	0	0	0	0	0	0	0	0	1	0	0	0	0	0	0	0	0	11	7	87	0	8	0	2	0	4	0	2	0	0	0	0	0	1	0	0	0	0	0	5	0	1	585	0	0	6	0	37	0	2	0	0	0	16	0	37	17	4	20	0	29	0	2	0	0	0	0	0	0	0	8	8	174	7	0	0	4	0	0	0	0	1	0	0	0	0	0	2	0	0	15	0	0	0	165	6	0	1	0	0	6	7	10	0	1	0	0	0	0	0	10	0	0	0	0	0	0	0	0	1	0	0	0	0	0	0	0	0	0	0	0	0	0	0	63	0	0	0	0	90	0	0	0	2	0	1	0	0	0	0	0	0	2	0	2	0	0	5	0	0	0	4	0	0	0	0	0	0	0	0	0	3	2	0	17	5	0	0	4	4	12	8	3	0	0	0	0	0	0	0	1	0	0	0	13	0	0	0	3	0	0	0	2	0	0	0	1	0	3	1	0	5	0	56	0	0	2	0	15	0	0	1	0	0	2	10	47	2	3	0	11	0	0	0	0	0	0	0	0	0	0	0	0	0	21	0	0	0	0	0	0	0	0	9	0	0	0	0	0	2	1	4	0	24	0	147	24	0	125	0	0	0	0	0	0	0	4	0	21	0	0	0	1	0	4	12	1	0	0	1	0	1	3	0	0	0	0	1	2	0	0	0	0	4	0	0	0	0	0	25	6	11	3	1	10	4	3	2	8	0	3	0	6	1	0	0	0	0	1	0	0	1	0	0	0	0	0	2	0	0	0	1	6	0	0	0	1	1	0	0	0	0	0	0	0	0	0	1	0	0	0	0	0	0	0	0	0	0	0	2	0	0	4	0	0	5	0	90	53	1	16	0	0	0	0	0	0	0	0	0	14	0	0	26	5	0	0	0	0	0	3	0	16	8	9	0	1	0	0	0	0	0	0	5	0	0	0	0	0	0	1	39	0	18	0	24	21	0	5	0	4	1	0	0	540	0	0	0	2	51	12	0	18	0	0	0	5	0	0	0	7	1	0	4	2	0	0	0	0	0	3	0	1	0	1	3	0	0	1	2	4	0	6	0	1	0	0	0	0	0	0	1	1	0	5	4	0	0	0	0	0	0	0	0	0	0	0	1	0	12
LakWasMe81_HOW10_2_rpkm	0	0	0	0	1	11	3	0	3	0	4	1	0	0	0	0	0	0	2	0	0	0	0	28	0	0	0	0	1	8	0	0	1	17	0	6	0	0	0	0	0	0	0	5	17	29	26	6	0	32	1	30	0	0	0	1	0	2	79	16	13	0	0	2	0	0	0	0	1	35	2	2	1	0	0	0	0	0	0	0	1	4	0	0	0	0	0	0	0	0	0	0	9	0	26	0	0	0	0	0	0	0	1	0	0	0	0	0	0	1	0	4	90	1	11	0	0	19	0	0	0	0	0	10	0	0	3	0	0	0	30	253	4	0	0	1	0	1	1	0	0	1	0	0	4	0	0	0	19	1	3	31	0	1	94	0	0	0	33	0	18	0	0	2	22	0	0	4	0	9	1	0	0	0	0	0	0	0	1	0	0	0	1	0	0	4	0	0	0	2	3	5	3	10	0	0	0	10	13	13	3	0	1	0	0	0	3	0	0	0	11	3	8	15	10	0	7	3	0	0	0	0	0	1	3	1	0	0	20	0	1	0	1	0	0	0	16	6	21	1	0	0	25	1	20	4	0	1	2	0	1	3	7	0	495	110	0	0	0	0	1	0	0	17	0	0	7	0	1	61	2	0	2	0	0	0	0	0	4	3	1	73	3	231	41	0	0	0	8	1	1	0	0	0	3	1	0	2	4	0	0	15	11	2	3	0	10	50	3	0	4	0	77	14	1	0	0	1	1	0	1	0	0	0	0	243	0	1	4	0	0	0	0	0	0	1	1	0	0	0	0	0	10	1	7	3	9	3	1	0	1	0	2	1	2	0	0	2	0	2	4	0	1	0	0	28	3	49	1	3	1	43	0	0	6	0	1	13	0	1	0	0	3	0	5	0	25	0	0	0	0	0	95	0	0	2	6	0	0	32	0	8	0	1	15	0	0	0	0	0	0	0	1	288	1	19	11	1	1	0	0	1	0	0	0	0	0	0	1	1	24	7	0	0	0	0	0	0	5	0	25	4	0	0	0	107	0	0	0	0	0	60	3	210	0	8	25	4	0	2	0	0	0	7	2	11	24	0	0	1	13	4	2	0	0	0	21	0	3	0	3	1	6	0	0	0	0	4	18	1	0	0	84	44	0	0	0	0	0	0	0	1	7	0	1	0	0	0	0	0	0	0	0	0	2	0	5	0	0	7	0	0	0	0	0	0	0	0	0	0	0	0	58	20	2	0	9	2	0	12	0	1	0	35	9	0	0	0	53	0	0	0	0	1	0	2	3	1	0	0	0	0	0	2	17	1	3	0	45	0	0	0	0	2	5	6	5	51	1	7	4	28	5	10	17	0	2	1	22	0	0	0	8	3	7	7	0	0	17	0	21	0	0	0	2	16	0	15	0	0	0	368	9	316	0	0	150	1	193	2	2	3	56	12	0	11	0	4	0	6	0	2	0	0	0	0	0	0	0	3	0	278	0	0	0	1	1	9	4	0	9	0	2	4	0	0	0	1	0	0	0	6	1	0	0	0	0	0	2	5	1	10	0	0	2	0	0	0	0	0	1	0	2	1	0	0	10	0	0	6	0	0	5	2	0	0	0	7	0	0	0	1	0	0	2	0	1	1	22	0	2	0	0	0	7	4	0	1	9	0	0	0	2	0	0	0	58	0	12	0	0	0	5	0	0	0	0	0	0	1	0	16	4	0	4	32	4	0	0	3	0	0	2	1	0	1	0	0	8	1	0	4	0	31	0	0	9	0	0	0	0	0	0	0	0	73	0	0	0	0	0	0	6	0	0	0	0	0	0	3	5	0	0	0	0	1	11	0	0	11	0	0	0	0	2	6	122	0	0	47	0	0	5	0	1	2	1	0	0	0	0	0	0	1	15	1	0	0	0	14	8	0	0	0	0	0	0	28	12	0	0	0	0	2	0	0	0	0	31	36	0	0	2	0	0	0	0	1	0	3	24	1	0	1	0	1	0	0	5	1	0	0	0	1	0	0	0	2	13	0	0	0	0	0	0	3	23	0	0	0	0	0	0	0	1	0	0	0	0	0	0	0	0	0	0	0	0	3	0	0	0	1	0	1	2	2	3	2	1	0	0	0	0	0	0	0	0	0	0	0	0	0	0	0	0	0	0	0	1	0	0	0	0	31	6	0	0	4	0	0	0	0	0	0	1	0	0	0	2	0	0	0	0	1	0	0	0	0	0	0	0	5	8	74	0	16	0	13	1	0	24	18	2	0	2	0	0	0	0	0	0	0	0	0	0	0	0	0	1	0	0	0	0	0	3	0	0	0	0	0	0	0	0	0	0	1	0	111	0	0	0	17	2	0	0	1	0	1	1	1	8	0	0	0	0	0	0	0	0	14	0	1	0	0	0	0	0	1	0	0	1	0	1	1	2	0	0	0	0	1	0	1	0	73	0	0	0	0	0	1	3	0	2	0	1	1	1	1	2	15	1	2	0	0	0	0	0	0	0	19	1	0	0	0	0	0	0	0	0	0	0	0	0	0	2	1	4	0	0	2	0	1	0	0	3	0	0	8	0	0	0	80	0	0	1	0	2	0	28	0	1	1	5	0	0	3	2	0	0	0	0	0	0	0	0	0	0	0	0	0	0	0	0	0	2	0	0	0	0	0	0	9	0	0	0	0	0	0	1	0	20	1	0	0	1	0	17	0	2	0	1	0	2	0	0	0	0	0	0	0	0	0	26	6	54	44	0	0	0	58	4	0	0	0	0	6	1	0	0	0	0	0	0	0	0	0	1	2	0	0	0	2	3	0	0	0	0	0	3	1	0	0	0	0	0	0	0	1	1	0	46	0	74	4	0	0	2	0	3	0	4	0	3	36	72	0	0	1	2	0	2	0	0	18	0	1	0	0	0	0	0	0	0	32	1	17	35	9	1	38	0	2	1	1	0	12	1	0	9	0	0	3	0	0	0	6	0	0	0	0	2	0	28	0	1	0	3	10	0	2	0	3	0	0	0	0	0	1	0	0	0	0	5	0	0	1	1	0	1	0	0	1	0	0	0	0	35	5	26	5	0	0	19	0	0	0	2	0	0	9	0	0	9	0	0	0	13	8	0	2	0	0	0	0	35	0	6	0	0	1	1	1	6	33	0	1	6	1	0	0	0	0	1	0	65	0	14	27	10	27	14	2	14	0	0	7	0	7	0	0	0	3	0	14	6	0	7	0	1	2	0	2	10	10	10	0	16	0	0	0	0	0	1	8	3	0	0	0	2	0	1	31	1	0	1	0	13	7	0	1	0	1	2	10	0	0	0	0	0	0	0	0	7	38	13	133	40	0	4	0	0	0	0	0	0	128	3	421	0	12	0	0	0	2	307	289	7	31	1	1	10	42	0	0	0	1	2	0	0	0	70	3	39	2	86	3	0	7	3	9	0	0	0	0	0	0	7	47	0	0	0	5	0	14	0	1	0	0	0	3	0	2	0	1	0	0	7	0	0	0	0	1	0	5	2	3	0	0	0	0	0	0	0	0	0	0	0	0	1	0	0	0	11	0	0	0	0	0	0	1	0	0	0	7	0	0	0	0	0	0	0	0	1	0	0	0	0	0	0	0	0	0	0	0	0	1	1	23	1	1	3	0	0	6	0	29	0	15	90	0	0	10	0	10	2	0	9	0	0	0	52	4	22	0	0	0	0	0	0	0	0	2	4	0	0	0	9	0	0	1	0	0	0	0	0	0	0	2	0	22	1	0	0	0	18	1	0	0	0	24	0	0	0	0	1	0	0	1	1	0	2	0	0	27	7	0	0	17	0	0	0	5467	1	3	3	3	1	0	2	0	0	0	0	0	0	0	1	0	3	5	19	35	92	29	30	43	0	0	1	3	2	4	0	0	0	1	41	0	1	0	2	0	0	0	0	32	25	0	42	1	0	5	0	30	0	7	4	0	11	2	1	0	0	0	0	1	0	66	0	1	3	1	0	0	2	0	1	48	2	0	3	0	0	0	0	2	15	147	8	111	0	0	0	2	0	7	0	1	0	0	0	0	11	1	0	0	0	3	0	3	1	5	2	0	0	0	0	1	0	0	0	0	0	0	0	0	2	1	0	0	0	0	3	0	1	0	0	3	8	0	0	6	1	0	1	0	0	0	0	0	2	18	0	0	0	3	1	0	0	13	0	1	0	0	0	0	1	0	0	17	1	0	0	1	0	3	3	0	0	0	1	0	7	17	0	0	4	0	0	3	0	0	0	0	12	1	0	16	0	0	0	0	114	13	71	1	1	27	65	0	12	0	132	0	17	7	1	1	15	1	0	56	2	0	0	0	3	1	0	0	0	0	0	0	0	0	11	9	0	1	0	3	20	0	0	0	0	0	0	0	0	0	0	0	0	0	16	0	0	0	1	11	6	8	0	0	1	0	0	0	5	0	0	16	1	0	0	0	1	0	0	0	0	0	2	0	0	0	0	6	0	0	5	14	0	0	1	0	0	0	0	0	70	0	9	11	0	4	4	0	38	0	2	50	207	11	0	0	0	0	0	0	0	1	0	7	0	1	6	0	0	0	1	1	1	0	0	0	0	20	1	0	0	0	2	4	17	1	0	27	4	0	16	0	17	15	32	0	0	1	0	1	0	0	0	0	0	0	0	0	11	0	0	0	1	0	0	0	2	0	2	0	0	0	0	7	0	1	0	0	0	0	1	1	0	0	0	0	0	0	0	0	1	0	0	30	0	0	3	0	1	0	0	0	6	0	0	0	171	0	0	75	1	0	0	69	0	0	0	0	0	0	0	0	6	0	0	225	0	0	0	0	0	17	0	0	1	4	0	231	18	13	2	0	1	0	0	0	1	0	29	2	0	0	0	0	0	1	0	1	0	0	0	0	0	1	0	0	2	0	0	0	0	0	0	2	0	0	0	0	0	0	3	43	0	0	0	59	0	0	1	0	0	0	0	0	2	0	0	0	1	0	0	0	0	0	3	0	1	1	16	0	0	19	0	9	0	1	0	8	0	5	12	1	0	0	0	0	0	0	70	0	1	0	2	0	0	0	1	6	6	65	22	0	0	0	1	2	0	0	4	0	1	0	1	5	0	0	0	3	0	0	0	0	2	0	2	0	3	0	0	0	0	0	2	1	0	96	1	0	0	0	0	1	1	0	2	0	0	0	0	0	6	0	0	8	0	4	5	1	0	0	1	0	0	0	0	19	0	1	1	0	0	0	0	0	0	0	0	0	0	0	1	0	0	0	0	0	0	0	0	0	0	0	1	0	0	0	0	1	3	0	1	0	1	0	5	0	164	0	19	0	0	0	0	17	13	0	0	0	0	0	6	31	8	13	59	8	24	11	4	62	9	22	14	8	5	4	5	29	18	2	11	0	18	30	81	97	83	61	11	6	7	6	10	8	0	0	0	0	0	0	0	0	1	0	5	388	1	0	0	0	0	0	0	0	0	0	0	0	0	0	0	4	0	0	0	0	4	0	25	0	17	4	0	0	0	2	2	1	5	0	0	7	0	23	0	0	0	0	0	2	0	11	0	0	1	0	2	12	3	21	11	0	2	6	0	0	0	1	0	1	6	0	0	0	0	0	7	0	0	1	0	20	0	0	0	0	0	0	0	1	11	7	0	18	0	1	0	0	0	0	0	5	0	0	4	0	0	0	0	2	0	48	0	1	3	17	0	0	0	0	1	1	0	1	0	0	0	0	0	1	11	1	0	0	0	2	0	0	40	7	23	0	0	14	14	16	2	2	0	21	1	2	0	2	0	0	0	0	0	0	7	0	1	1	0	0	0	0	0	1	0	0	0	0	0	0	0	0	0	1	0	0	0	7	0	0	1	0	0	0	0	1	1	0	0	0	0	23	0	1	0	129	6	0	0	3	0	0	0	0	0	18	0	0	0	0	7	0	4	0	2	1	0	1	0	0	9	0	0	2	15	0	2	1	0	75	1	0	0	0	0	0	0	0	0	2	0	4	0	0	0	0	0	0	0	0	0	0	0	0	0	0	0	0	0	0	0	0	0	0	0	0	13	0	6	5	0	0	13	0	2	0	0	0	0	0	73	30	1	0	9	0	0	0	0	1	0	5	0	1	0	0	0	0	0	0	68	3	6	15	0	0	1	8	0	0	0	0	26	54	2	0	1	0	1	0	0	0	0	0	0	0	0	0	7	0	0	0	46	0	1	0	0	0	0	0	0	1	0	17	3	3	4	1	1	2	0	0	27	2	0	20	0	0	1	1	0	0	0	0	12	2	0	0	19	0	0	1	0	0	1	0	0	0	1	0	0	0	10	0	1	1	0	1	0	0	0	0	0	0	1	0	0	10	0	0	0	0	0	0	0	1	22	0	173	0	0	10	3	3149	0	1	0	0	2	0	3	9	3	6	0	0	12	0	0	0	0	0	3	0	0	0	0	1	0	0	106	0	0	3	34	3	0	3	1	7	1	0	0	5	0	3	1	3	1	3	0	7	8	0	0	1	1	0	0	0	1	0	0	9	0	3	0	14	27	7	29	33	19	14	18	0	24	17	14	0	1	0	0	0	8	5	0	5	0	8	0	5	50	11	0	0	0	1	0	0	1	0	1	0	0	1	8	0	0	0	0	5	0	0	0	0	0	0	1	0	0	0	0	5	0	1	4	0	1	0	0	2	1	0	0	1	0	0	0	597	1	1	6	9	5	0	14	0	1	0	0	2	41	1	0	0	0	0	0	8	3	0	0	1	0	0	0	0	3	58	0	0	37	0	0	17	0	3	0	0	0	74	15	2	0	0	0	3	0	2	0	0	0	0	6	4	1	1	1	0	0	0	52	2	1	0	0	0	0	0	978	19	7	0	0	0	0	2	0	3	2	56	0	8	0	1	0	0	2097	103	112	1	0	0	33	0	2	0	46	1	19	0	0	0	1	0	0	0	0	0	0	0	0	0	0	0	0	0	0	0	39	10767	0	0	0	0	0	0	0	1	0	0	0	1	0	0	5	5	0	1	1	0	7	0	0	4856	87	29	0	0	2	0	0	0	0	0	0	19	0	0	0	0	0	0	0	0	0	332	2	1	2	0	1	0	0	0	0	0	0	0	0	0	0	2	0	6	0	0	0	0	0	0	0	0	0	0	0	0	1	0	0	0	0	0	0	0	0	0	0	0	0	2	0	0	10	0	0	0	0	0	0	0	0	3	0	0	0	25	0	0	1	1	0	0	38	0	0	0	0	0	0	194	0	0	4	0	0	0	5	25	4	0	1	0	0	38	0	0	31	0	0	2	2	0	1	0	0	0	0	0	3	0	0	0	0	0	0	0	0	0	0	0	0	1058	1	0	0	0	0	0	0	0	1	0	0	0	0	0	1	0	0	0	0	1	0	0	0	0	0	8	0	0	4	2	18	7	171	10	0	0	0	0	0	1	0	3	11	1	0	1	0	12	0	15	0	1	1	0	0	0	0	4	0	0	0	2	5	1	0	1	0	4	0	0	5	1	0	0	0	0	0	0	0	4	0	9	2	1	3	0	71	0	0	0	1	0	0	0	0	2	11	11	0	0	0	0	0	0	52	114	0	50	0	0	0	1	0	0	0	0	0	0	0	0	0	0	1	0	3	1	0	0	0	0	2	0	0	0	34	0	12	1	0	2	1	0	1	1	0	0	0	0	0	0	14	0	0	0	4	0	3	0	248	0	0	22	0	0	0	0	81	0	0	0	22	0	0	0	0	0	0	0	173	0	0	0	0	0	0	1	0	0	0	0	8	0	0	0	0	0	0	72	0	0	0	0	1	0	0	183	0	0	0	14	0	2	0	0	0	0	0	1	2	0	0	0	0	0	0	0	0	2	0	0	0	0	1	0	0	0	0	1	0	1	0	0	3	0	7	0	1	0	0	159	0	0	0	0	1	0	0	0	0	1	1	0	0	0	1	0	0	0	0	0	0	0	0	0	0	0	1	0	0	37	1	0	0	0	1	0	0	0	0	10	4	0	0	0	17	0	0	12	0	0	0	0	0	0	0	0	0	0	0	0	0	0	0	0	0	0	0	0	0	1	0	0	0	2	0	0	0	0	3	0	0	0	30	0	0	0	0	0	0	1	1	0	0	0	0	0	2	0	0	0	0	17	1	0	2	0	1	0	0	0	0	1	0	0	0	1	0	0	1	0	0	0	0	0	0	0	0	0	0	0	12	0	0	0	0	0	0	0	0	0	0	2	2	0	0	0	1	0	0	0	0	0	0	5	1	2	0	0	0	4	0	0	0	0	0	0	0	0	0	0	0	35	0	0	0	0	0	0	0	0	0	0	0	0	0	0	0	0	0	0	0	0	0	5	0	0	0	0	0	0	0	0	1	0	1	13	0	0	0	0	0	0	1	0	0	6	2	0	0	0	0	0	0	0	6	1	0	0	0	0	0	0	0	0	0	0	0	0	1	0	0	0	0	3	0	0	0	0	0	0	0	0	9	3	0	0	0	0	0	0	0	0	0	0	74	0	0	2	2	1	0	0	0	8	0	0	7	1	0	79	0	0	1	1	7	0	1	0	9	3	0	0	30	10	2	0	0	13	0	0	0	0	1	13	1	174	0	0	0	2	0	0	0	0	0	0	0	1	0	0	0	0	0	8	0	0	0	0	0	0	0	0	0	1	0	0	0	0	0	0	0	0	0	1	0	0	0	5	0	25	0	0	0	0	0	0	0	0	0	0	58	0	0	0	0	0	0	0	0	0	0	0	0	0	0	0	0	0	0	0	0	0	1	1	0	9	0	0	0	0	0	18	0	0	0	0	0	0	0	0	4	0	1	2	0	0	0	0	0	0	0	0	0	0	53	0	0	0	0	0	3	0	7	166	0	0	0	0	0	0	0	0	1	0	0	0	0	0	1	0	0	0	1	0	0	0	0	0	0	0	0	0	0	41	1	0	0	0	0	0	0	1	0	0	0	0	0	0	0	0	0	0	0	0	0	0	0	0	3	0	3	0	0	0	0	0	0	25	2	0	0	2	0	0	0	1	0	0	0	0	0	0	1	0	5	0	0	0	0	0	10	0	0	0	0	0	0	0	1	0	0	1	0	3	2	0	1	0	3	0	0	0	0	2	0	0	0	1	0	0	0	8	0	0	6	0	32	0	0	0	1	0	60	0	0	1	0	31	0	0	0	0	0	1	0	0	0	2	1	623	2	1	9	2	0	0	0	15	0	0	32	0	0	0	0	0	0	1	0	0	0	0	7	5	0	0	0	0	0	0	0	0	0	0	1	0	2	0	0	0	21	0	0	0	0	0	1	0	0	0	0	0	2	0	1	0	1	3	0	0	0	4	0	0	0	0	2	0	0	7	1	1	0	88	9	17	264	401	0	0	0	0	6	0	14	5	0	0	0	0	2	3	0	32	0	1	12	0	13	0	0	0	0	2	0	0	1	0	2	0	0	1	2	0	1	3	41	0	0	10	0	5	0	3	13	0	2	1	0	0	0	0	0	5	0	4	1	1	0	0	0	23	29	0	0	0	2	0	0	0	0	0	0	0	0	0	0	0	1	1	0	0	2	26	0	0	0	16	1	3	0	0	0	0	9	0	0	0	0	0	2	67	1	0	0	1	0	19	1	0	4	0	0	0	0	0	0	3	6	0	2	2	0	0	1	0	0	0	0	0	0	0	0	0	0	0	0	6	4	0	0	1	0	2	1	2	0	0	0	8	2	4	0	0	0	0	25	0	0	6	0	20	1	5	0	0	7	0	2	31	0	0	1	0	0	0	1	2	0	0	0	53	180	59	0	2	8	3	19	0	12	22	3	1	26	47	14	0	39	5	9	7	6	1	53	89	24	0	35	0	206	0	2	0	0	0	0	6	0	0	0	1	1	1	14	0	0	0	0	0	0	1	0	4	5	0	0	0	17	0	0	0	1	3	18	0	0	0	1	0	0	92	0	1	0	1	0	0	0	181	7	0	0	0	0	2	0	4	0	8	1	8	0	0	0	0	1	0	8	28	0	48	31	11	0	0	0	0	0	0	0	0	0	0	0	0	0	0	0	5	0	0	0	0	1	0	0	0	0	7	0	0	2	0	5	0	0	0	0	2	22	6	0	0	0	1	0	0	0	0	1	7	0	1	4	3	3	0	0	0	0	0	0	0	0	1	0	0	0	0	54	0	0	1	2	0	0	0	7	0	8	2	0	15	183	146	0	0	8	0	1	23	0	14	4	0	2	0	1	0	1	0	0	0	0	1	0	0	0	0	0	0	0	0	1	1	1	0	28	0	0	49	9	0	0	0	0	0	0	1	30	0	0	8	0	5	1	0	2	12	1	0	0	15	0	12	0	0	0	1	10	0	0	0	1	2	0	0	0	2	0	0	1	0	0	3	0	0	0	21	0	0	0	0	8	0	0	1	11	0	0	0	1	0	0	0	0	0	0	27	0	0	4	0	1	7	0	0	1	0	0	0	0	2	0	0	6	47	2	40	0	0	2	0	1	0	1	43	0	5	1	1	3	0	2	0	0	0	0	0	0	2	0	9	0	0	0	0	0	0	0	0	2	0	0	0	79	0	9	0	0	28	3	0	10	1	1	0	0	1	0	1	2	30	0	0	0	1	0	0	0	0	0	0	0	0	0	0	0	3	6	0	0	0	0	5	0	0	0	0	36	1	8	0	1	0	0	0	16	1	2	0	1	0	0	0	5	2	0	1	0	3	0	3	0	0	0	0	1	0	0	0	0	0	0	0	0	6	1	1	0	1	0	1	18	2	0	0	0	46	0	25	1	0	0	0	0	0	0	0	0	1	0	0	38	18	0	0	0	0	0	3	0	1	23	0	26	0	9	24	1	1	0	0	0	0	39	0	1	5	5	0	0	0	0	0	0	11	0	8	6	1	75	19	15	47	0	0	0	0	14	0	2	0	5	0	0	0	0	0	0	0	0	0	0	0	0	0	0	0	4	0	1	0	0	0	0	34	0	0	0	3	0	10	4	9	0	2	0	0	1	0	17	2	0	1	0	0	0	10	2	32	0	0	21	0	0	1	11	0	0	1	0	0	0	0	3	1	0	0	3	3	0	0	1	0	0	20	0	8	3	0	0	0	0	15	3	0	1	1	0	1	8	0	2	0	0	7	0	0	2	0	0	0	0	1	0	0	2	0	0	0	42	0	1	0	0	0	0	3	1	71	0	1	3	0	7	0	1	0	0	0	0	0	0	1	3	0	0	0	0	0	1	0	0	0	0	45	0	5	0	1	185	1	1	0	0	0	7	0	0	4	0	0	1	34	1	4	5	0	0	0	0	0	0	0	0	1	0	0	0	19	0	2	0	0	0	0	0	2	3	0	0	6	0	0	0	0	0	0	1	0	2	0	0	0	0	2	0	0	0	0	0	0	0	0	0	0	0	7	0	1	1	0	0	0	0	0	0	0	0	0	0	0	0	0	0	0	0	0	0	0	75	0	0	0	0	0	98	20	3	1	0	0	1	0	0	3	1	0	2	0	0	0	7	0	0	0	0	0	0	2	0	0	0	0	0	18	0	0	0	0	0	20	0	6	0	0	0	1	0	2	0	0	0	3	0	0	0	10	0	0	0	1	0	0	0	6	1	0	3	0	0	3	0	0	0	0	0	0	0	0	166	0	3	0	0	0	0	0	0	0	0	0	0	22	1	0	0	0	7	0	0	0	4	0	0	0	30	0	0	0	0	8	21	0	1	0	0	0	0	0	0	1	0	1	15	7	0	0	2	2	0	0	0	0	1	13	0	0	0	0	0	0	0	0	17	0	0	8	1	1	0	0	0	0	0	0	0	0	0	1	0	1	0	0	0	0	0	0	0	0	2	0	2	0	0	0	0	1	50	0	0	0	0	0	5	95	0	0	0	0	0	2	0	1	0	0	0	0	0	7	1	23	0	1	0	2	0	0	0	0	0	0	0	1	0	0	0	0	0	0	0	0	43	3	16	1	2	0	0	0	0	0	8	0	1	0	2	7	16	14	3	0	5	21	0	18	0	0	0	4	35	0	7	1	0	0	6	0	0	0	0	55	2	21	3	0	225	0	0	0	5	1	312	0	1	3	5	0	0	20	4	0	0	0	0	0	6	0	0	0	0	1	31	1	0	0	0	0	19	1	7	0	1	0	12	0	54	2	0	13	0	2	0	0	12	1	0	0	0	0	0	1	1	0	0	0	0	7	1	11	1	1	0	0	1	40	17	3	4	5	0	114	5	1	0	0	1	0	0	0	0	0	0	0	0	5	5	0	2	0	0	8	0	24	0	3	4	0	1	0	0	0	0	0	0	0	0	0	1	0	0	0	0	0	0	0	0	0	0	0	0	0	0	0	0	0	0	0	0	1	5	0	0	8	0	0	1	0	0	0	0	4	0	19	9	73	1	1	0	0	0	2	0	51	2	1	0	1	1	0	0	0	0	0	0	4	27	0	0	3	0	0	12	6	1	1	48	4	3	0	0	1	1	0	0	2	7	0	0	0	0	0	0	0	0	1	0	0	0	0	0	0	2	2	0	0	2	0	0	17	6	0	0	0	0	0	0	3	0	1	2	1	45	3	0	0	0	0	13	0	0	0	9	1	23	19	0	3	0	0	0	4	0	1	1	4	0	92	0	0	0	11	0	0	0	1	0	0	13	2	51	77	0	12	0	0	0	0	6	0	0	10	0	0	23	5	46	2	18	2	0	0	1	13	0	0	0	0	0	4	0	0	0	0	0	0	0	22	0	0	0	0	0	1	1	5	0	0	0	17	3	5	2	0	39	2	0	0	0	3	0	96	0	6	45	48	2	3	20	1	25	4	28	3	1	1	0	0	9	0	0	2	0	1	0	0	1	0	0	0	0	0	0	1	1	2	18	3	67	0	149	46	0	0	12	1	1	0	0	0	0	0	4	0	0	1	0	0	0	0	12	4	6	0	2	0	2	0	20	0	0	0	0	3	2	0	0	0	0	1	0	1	2	0	0	24	0	0	1	3	1	0	87	69	14	10	0	0	2	1	0	0	17	5	0	3	0	0	2	0	0	42	1	2	0	43	12	22	21	0	0	0	0	0	1	0	0	9	0	0	0	0	0	0	4	0	43	51	9	1	1	0	1	5	0	6	1	0	1	0	0	9	2	0	1	3	8	0	27	70	3	2	2	1	9	0	0	4	2	0	0	3	0	0	0	4	0	194	24	0	0	0	0	100	2	17	1	3	0	0	0	1	15	3	1	3	0	1	0	249	0	18	18	90	6	7	10	1	0	113	5	0	22	1	1	0	6	9	0	0	0	0	0	0	0	0	0	0	25	2	2	0	0	0	1	6	0	373	271	1	2	0	22	0	71	14	17	0	0	44	0	0	0	0	0	0	0	0	1	1	2	0	0	0	5	0	4	0	1	0	0	1	1	0	0	12	1	14	0	3	36	1	19	0	4	4	37	12	1	2	0	0	0	0	207	32	4	0	2	0	0	2	70	0	0	4	0	0	1	13	0	2	0	0	1	0	0	13	27	0	0	0	0	0	0	4	0	6	2	0	0	0	0	25	3	7	4	111	1	1	0	0	0	0	439	0	778	0	10	0	4	8	9	4	0	0	0	0	0	0	0	0	20	1	10	0	0	0	0	0	0	0	178	3	1	1	116	0	0	2	0	0	0	0	0	0	3	1172	0	0	0	0	1	0	3	1	0	2	0	1	0	0	0	0	0	0	0	0	0	0	0	0	0	3	3	0	5	0	0	0	0	2	1	1	1	33	0	0	0	0	0	2	0	0	52	0	0	5	0	0	1	3	0	0	0	0	379	0	0	11	12	0	0	2	0	1	0	4	7	15	2	0	0	0	0	5	0	0	5	1	0	0	2	59	0	0	0	0	0	1	0	0	0	0	1	0	0	666	0	8	2	1	175	0	4	70	4	63	26	321	246	222	2	136	41	45	0	1	30	13	22	8	1	1	75	0	413	1	0	35	1	0	39	2	0	0	8	11	10	0	0	0	0	1	37	0	0	0	8	6	10	5	24	12	16	1	15	0	1	0	15	6	7	15	0	1	0	0	0	0	0	0	0	0	24	3	0	1	1	9	0	1	10	0	2	0	0	2	9	2	1	0	4	0	0	13	2	0	0	0	0	0	168	0	15	0	0	0	10	1	0	30	1	0	0	8	38	358	0	3	0	3	6	0	0	17	1	2	0	40	1	0	4	1	1	15	1	10	142	0	0	5	1	36	2	0	0	14	0	1	0	22	0	19	1	0	4	59	0	0	6	16	1	0	2	4	0	0	6	0	0	0	0	0	0	1	0	0	0	0	0	24	0	0	0	1	0	4	28	7	0	0	2	2	0	3	0	0	19	0	0	0	20	23	1	18	28	0	1	8	0	0	4	2	1	1	1	0	1	0	8	19	77	47	29	0	0	0	1	0	0	1	0	0	0	1	0	1	0	0	0	0	0	0	32	1	0	0	0	0	0	0	0	0	7	0	2	0	0	0	0	0	0	2	0	0	0	0	0	0	0	6	0	0	16	0	0	0	0	0	0	12	3	0	2	1	10	12	0	0	0	0	0	0	0	7	0	0	6	0	0	0	0	4	1	1	0	2	5	0	1	0	0	0	0	0	0	0	0	1	54	0	0	6	0	0	0	12	3	25	0	0	1	0	0	7	1	13	1	7	7	0	0	0	0	1	91	1	0	0	0	8	53	88	0	21	1	6	24	0	21	0	14	0	0	2	51	42	31	8	19	12	15	18	8	0	14	0	0	217	0	29	0	1	40	0	93	152	0	52	0	79	1	0	10	0	22	6	0	16	0	0	0	0	48	2	0	12	15	64	42	1	0	0	33	95	1993	0	1	13	3	0	0	0	9	5	0	1	1	1	0	84	4	102	1	0	4	0	0	0	0	0	1	7	1	3	0	1	6	3	34	69	0	0	40	23	2	0	1	0	1	10	13	0	2	31	3	78	2	27	2	0	10	4	0	0	0	26	0	1	0	35	0	0	1	0	0	0	1	39	0	0	0	0	4	12	1	2	2	0	0	0	0	0	3	21	0	0	0	0	0	1	0	0	4	0	0	0	0	0	0	0	0	0	0	0	2	0	0	12	29	28	58	4	0	0	0	2	0	0	0	0	10	0	0	0	0	0	0	0	0	0	0	3	0	0	0	0	0	17	0	0	0	0	1	0	0	0	0	0	0	0	1	1	1	1	16	0	0	0	0	2	0	95	0	14	40	0	62	29	37	0	0	0	0	0	0	0	0	0	0	0	0	0	67	1	8	1	0	0	0	0	0	0	0	0	0	3	0	0	4	0	6	0	0	47	37	0	0	0	9	0	0	13	3	37	3	11	0	0	2	0	1	15	1	14	0	0	0	0	12	0	1	7	9	2	18	2	0	0	36	1	0	0	111	60	7	1	0	0	0	4	34	9	7	0	0	0	0	0	0	2	0	12	0	0	0	0	0	9	1	0	33	0	1	0	0	0	0	0	2	0	0	62	1	0	0	0	0	0	0	0	0	60	24	1	0	4	2	0	1	1	1	3	2	2	0	1	0	0	0	0	1	0	1	0	0	0	0	1	13	3	18	1	2	1	5	0	0	0	1	0	0	5	4	2	0	13	0	4	0	0	0	1	0	1	0	0	0	140	38	42	0	0	5	0	0	1	0	0	0	0	2	0	0	3	0	1	0	0	0	0	2	0	0	1	0	27	10	0	0	0	0	0	0	2	14	2	7	816	0	1	0	0	0	0	0	0	7	1	0	0	2	0	0	0	0	1	1	0	0	30	3	4	0	1	25	0	6	1	1	142	0	0	10	0	0	0	0	0	0	0	0	3	26	2	0	14	3	8	1	0	0	0	49	0	0	0	0	0	681	0	0	0	0	0	0	0	1	1	0	0	2	0	1	0	0	0	1	0	1	0	0	12	6	0	0	0	0	16	1	0	0	1	0	28	19	0	2	0	0	95	1	17410	0	0	0	0	0	11	0	3	0	0	0	0	0	0	1	0	19	0	1	0	0	2	2	34	4	1	1	11	0	0	0	0	0	0	0	0	2	14	29	0	6	1	0	0	0	0	0	1	3	2	0	0	3	0	2	21	14	9	12	1	4	12	0	8	1	0	5	0	1	81	281	21	52	0	0	0	1	1	2	0	7	121	6	0	410	0	0	0	0	1	0	0	6	1	47	3	0	9	2	0	0	19	23	0	0	20	3	0	0	0	2	0	0	0	1	0	0	0	23	41	8	68	73	0	4	48	1	205	1	3	197	6	104	12	32	20	132	74	0	0	19	0	0	60	0	0	0	34	16	57	127	36	2	6	0	0	81	33	1	8	0	0	0	0	0	0	0	0	0	0	0	0	9	143	0	5	0	12	0	0	0	14	0	0	0	0	6	11	11	6	0	0	0	1	0	0	0	0	0	5	0	1	1	0	0	16	8	0	21	0	0	0	4	37	0	1	0	1	0	0	2	0	1	1	0	0	0	0	0	0	9	0	0	10	19	0	0	1	4	0	0	1	3	1	11	0	6	0	0	0	33	6	0	0	0	1	56	0	0	2	5	0	58	0	0	0	0	0	0	0	0	1	1	0	0	0	1	0	0	0	0	0	0	3	0	0	0	0	0	2	0	0	2	0	0	0	0	0	0	0	0	0	0	0	0	0	0	0	0	0	0	0	14	0	1	1	0	0	0	1	0	0	0	1	9	13	11	27	2	152	1	0	2	8	37	74	12	17	0	1	3	3	2	0	7	2	0	10	1	7	3	0	0	0	0	0	0	0	0	85	0	0	0	5	2	2	0	0	0	0	1705	6386	0	0	0	0	1	0	0	8	1	31	1	2	2	0	24	7	0	50	1	2	0	6	10	0	19	2	162	0	0	4	0	328	0	0	1	0	0	1	0	0	45	1	4	34	26	34	0	5	0	18	0	1	0	0	0	0	14	1	0	0	0	0	0	4	7	1	0	3	0	8	0	0	0	1	0	0	1	2	2	0	0	0	0	0	1	99	638	167	26	48	40	105	603	0	0	6	4	39	41	0	1	1	2	7	0	0	0	0	0	0	0	13	0	0	2	1	0	0	2	0	4	1	4	1	3	0	0	24	5	1	0	27	0	0	0	0	0	0	0	1	27	0	31	0	0	0	2	0	1	0	1	1	1	0	0	0	0	0	0	0	0	0	3	36	0	0	1	0	0	1	4	0	0	0	10	1	4	0	0	0	1	0	1	0	0	0	0	0	0	0	0	2	0	1	1	0	1	4	0	12	14	34	218	29	28	0	0	0	0	0	0	0	0	0	0	0	0	0	0	0	4	0	18	0	0	0	27	1	5	2	0	0	0	0	0	0	8	0	0	95	1	0	0	5	0	5	1	0	14	0	2	0	1	5	1	9	19	28	0	425	0	3	103	14	1	2	12	0	0	23	0	0	2	0	30	19	2	0	0	1	0	0	65	0	0	0	1	216	0	1	0	0	0	4	0	0	1	0	0	1	3	0	0	0	0	0	0	0	4	3	0	0	0	19	127	8	0	0	0	2	1	0	0	1	19	0	0	1	1	0	0	99	1	0	0	0	0	4	1	0	0	20	4	0	29	3	0	0	0	0	0	0	10	2	10	1	0	0	0	0	0	72	0	1	1	3	48	9	0	0	3	109	11	2	1214	0	13	48	4	0	28	0	119	41	54	0	0	2	0	1	1	0	0	3	0	33	0	0	2	0	10	0	6	42	1	0	0	0	14	105	0	2	0	0	0	28	12	0	0	0	0	2	0	0	7	0	0	0	6	7	0	0	0	0	17	0	6	0	0	3	0	0	0	0	1	0	0	1	0	0	6	0	0	0	0	0	0	1	7	4	24	6	23	2	0	31	51	13	18	13	49	0	0	0	0	1	0	0	0	0	247	0	0	3	37	31	23	5	2	122	0	0	19	15	3	0	8	0	0	0	4	0	0	0	0	4	649	26	0	0	0	0	0	0	0	0	0	0	2	1	6	1	0	0	0	0	0	0	0	0	0	0	0	0	2	1	0	0	0	6	1	1	0	0	0	0	0	0	2	1	0	0	0	0	0	0	0	0	0	0	1	0	4	0	0	0	8	1	10	0	0	1	2	0	0	0	0	26	0	0	10	0	1	15	3	6	39	32	0	1	2	0	0	0	17	10	0	0	0	0	7	0	3	0	0	8	0	5	9	0	5	2	0	1	3	2	12	69	4	0	2	1	0	0	0	0	0	26	1	21	2	20	3	47	2	0	58	1	1	8	3	0	0	0	8	55	75	6	0	10	5	32	0	13	0	17	0	0	0	0	0	1	0	30	0	0	0	0	10	0	2	12	0	0	0	6	0	1	1	1	21	0	0	9	3	29	0	9	24	2	7	51	2	59	0	0	0	1	0	1	0	3	0	38	3	1291	8	0	0	6	0	0	0	0	0	0	0	0	0	0	0	0	0	0	20	13	0	18	16	26	304	4	0	2	0	0	0	0	0	4	1	1	0	0	4	28	0	0	0	0	1	10	0	0	1	0	0	0	20	11	0	10	37	3	0	0	0	1	0	36	1	30	0	16	132	0	0	0	9	0	0	0	0	0	2	2	0	0	0	0	0	8	3	0	0	0	0	0	1	0	0	0	0	0	0	0	0	0	0	0	1	1	0	0	0	0	1	13	1	5	0	51	6	1	24	62	10	22	10	29	10	0	2	0	2	0	0	0	0	0	0	0	0	1	0	0	22	0	0	0	0	0	0	0	0	0	3	0	11	0	0	0	0	9	1	0	0	0	0	0	3	0	0	17	0	0	0	0	0	0	0	0	0	0	0	2	2	1	2	0	5	4	3	2	36	0	0	0	0	0	0	0	0	17	0	39	0	1	0	2	0	15	86	0	0	0	0	211	0	0	0	0	4	0	0	0	0	0	0	0	3	0	111	0	0	0	0	0	0	0	5	0	0	0	0	0	5	0	0	297	0	0	0	0	0	0	2	0	0	1	0	0	0	37	2	2	0	0	0	0	0	0	1	0	0	0	0	0	0	0	1	0	0	0	13	1	0	0	0	1	0	22	0	0	7	0	0	0	0	0	2	2	0	0	43787	0	0	0	0	1	2	0	0	0	0	0	0	0	2	0	0	0	0	0	0	0	0	0	0	0	1	0	0	0	2	0	0	0	0	0	0	0	1	43	0	0	0	0	14	0	1	0	0	0	0	0	1	0	0	0	0	0	0	0	6	0	0	0	0	0	0	0	0	18	0	0	3	0	2	0	0	0	0	0	0	0	13	0	0	0	0	0	0	0	0	0	0	0	0	0	0	0	6	0	0	1	0	2	0	0	2	0	0	4	0	0	0	0	0	0	0	1	0	0	0	0	2	8	0	1	2	0	0	0	1	0	4	1	0	1	5	0	2	2	0	36	1	73	0	0	3	0	0	2	1	1	2	0	0	0	0	0	4	0	0	0	2	0	0	2	1	0	4	2	0	0	0	24	0	1	0	0	0	2	6	0	0	1	0	1	1	0	1	4	0	0	0	0	0	2	3	4	3	1	1	0	0	1	1	1	0	0	0	2	2	9	2	0	0	1	4	2	1	0	4	0	1	7	0	0	1	0	1	4	0	3	0	3	0	0	4	1	0	1	0	1	0	3	1	0	0	0	0	0	50	0	5	0	3	6	3	3	7	27	2	0	0	1	2	74	0	2	0	0	0	1	0	0	0	0	7	0	11	0	0	0	7	0	0	0	114	4	3	0	1	50	0	0	34	0	38	0	306	12	0	0	0	8	0	1	0	0	0	0	0	0	0	0	1	1	1	4	0	0	1	0	0	0	2	0	1	0	0	0	0	0	0	0	0	0	0	1	0	0	0	0	0	0	0	0	2	0	24	0	3	0	2	1	0	4	12	0	0	0	0	0	1	0	0	0	0	0	0	0	55	0	4	0	5	0	0	0	0	0	0	0	2	0	1	2	0	0	0	0	0	0	0	159	0	0	1	0	0	0	1	0	0	0	99	0	17	0	1	0	0	0	0	0	0	0	1	0	0	0	0	1	0	0	0	0	0	26	99	7	75	6	0	0	0	1	0	0	7	0	733	0	3	0	10	0	0	0	0	5	3	1	0	0	0	0	0	0	0	0	0	14	5	1	18	0	0	10	38	0	0	0	1	0	0	1	2	4	0	0	4	0	0	0	0	0	3	1	0	2	24	0	1	5	0	0	0	1	0	0	6	1	14	20	21	56	0	29	43	5	0	49	0	5	50	1	0	3	3	0	1	0	0	0	3	17	5	0	0	0	0	58	4	1	0	0	28	0	0	0	0	0	2	1	0	9	0	2	28	0	46	0	0	0	1	3	0	0	0	10	0	2	0	2	0	6	1	0	32	0	20	0	0	0	12	8	0	8	0	2	0	10	13	0	1	1	2	0	6	0	8	3	17	6	0	0	0	0	1	0	0	0	0	0	0	0	0	4	0	0	2	49	4	0	15	0	5	15	20	14	0	1	0	5	42	1	23	48	1	1	1	0	9	5	12	25	11	57	7	0	0	0	10	0	1	0	0	18	1	38	9	36	0	2	0	0	0	1	7	6	0	0	0	0	5	8	5	1	17	8	1	0	11	0	1	0	2	10	1	7	13	34	26	0	1	17	41	14	0	0	0	0	0	1	0	8	1	0	60	0	2	0	0	1	0	14	42	10	5	0	0	0	0	3	0	0	1	1	7	0	1	0	2	0	5	10	6	44	0	10	0	0	0	1	0	1	0	6	0	3	0	0	0	16	0	1	11	1	3	2	0	0	0	8	131	0	0	0	0	0	1	0	0	3	0	0	0	0	4	11	2	0	14	0	18	0	0	1	0	0	0	0	0	65	0	0	0	20	0	0	166	0	39	0	0	6	0	0	2	0	0	0	23	1	0	1	0	0	0	0	0	0	5	3	1	0	0	87	8	8	1	0	0	0	0	0	0	0	0	0	6	17	6	0	0	59	5	0	190	2	11	67	54	5	5	308	107	0	91	258	4	63	113	2	6	0	0	0	4	0	0	0	0	2	1	0	0	11	0	0	0	0	0	0	10	1	0	0	0	0	7	1	1	2	1	0	0	0	0	0	0	0	0	0	0	0	0	0	0	1	0	0	0	0	0	0	0	0	0	0	1	0	8	11	0	0	0	0	0	1	0	0	0	0	0	0	0	0	0	0	0	0	0	0	0	0	2	0	31	12	0	88	3	0	0	6	0	0	0	29	14	27	3	4	0	18	1	0	0	0	1	2	0	0	0	0	0	0	5	10	3	3	5	33	39	0	0	1	7	2	9	1	6	0	0	3	1	0	0	0	0	1	0	0	0	1	0	0	9	1	17	1	10	0	3	4	19	0	17	0	13	0	4	2	0	0	0	5	20	0	0	0	1	0	0	0	1	4	1	0	0	14	6	3	9	0	2	0	0	0	0	7	1	0	2	44	1	0	1	0	2	88	0	0	0	1	23	0	2	9	0	1	0	0	0	8	0	0	11	25	0	3	8	0	2	0	18	0	0	0	0	0	0	3	8	2	15	0	0	0	0	0	15	3	0	15	13	6	7	11	2	11	0	8	0	0	9	0	0	4	2	1	0	0	16	0	0	0	1	7	0	8	0	0	2	0	0	0	0	0	0	0	0	1	0	6	0	0	5	0	1	0	0	0	0	10	0	1	0	0	1	0	4	1	0	2	0	1	0	0	1	12	3	2	12	25	0	3	0	7	6	99	19	43	13	7	8	143	96	0	3	268	0	31	0	2	0	1	0	0	9	0	22	22	12	0	7	19	0	0	1	19	1	0	0	14	9	120	0	0	0	0	0	0	0	4	0	1	0	1	0	0	0	0	0	0	4	0	92	0	43	21	5	0	11	1	4	0	0	0	0	0	3	0	0	0	0	0	44	0	0	32	10	1	17	9	720	2	3	0	0	1	29	0	20	44	10	7	6	14	1	19	8	4	0	0	0	0	0	3	1	936	368	2	0	8	0	0	0	0	7	1	0	1	2	0	6	0	88	11	0	0	0	203	11	3	1	2	0	97	36	36	1	4	3	0	0	2	21	6	0	3	1	1	0	0	0	1	2	0	0	0	0	0	0	0	0	0	0	0	0	1	0	112	0	0	0	0	132	3	0	0	0	0	7	3	3	0	0	0	9	10	2	12	4	0	9	1	0	0	54	1	0	0	0	0	0	6	0	0	19	9	5	7	19	2	1	101	3	15	14	1	0	0	1	0	0	0	0	6	1	1	0	9	0	0	0	0	0	0	0	11	0	29	0	22	0	7	1	0	9	1	11	0	0	7	14	10	0	0	2	1	7	12	85	50	6	63	1	44	0	0	0	1	0	0	0	0	0	0	1	0	0	3	0	0	0	0	6	0	0	0	33	1	1	41	0	1	0	0	1	0	62	0	149	0	0	39	0	0	4	1	0	0	0	0	0	39	0	0	0	0	2	0	1	2	1	0	8	0	5	0	1	0	1	1	20	12	2	0	2	0	2	1	0	0	20	2	123	25	21	20	27	13	20	19	21	28	6	7	0	11	8	0	1	0	6	0	3	0	1	0	0	422	0	0	0	0	0	2	1	2	0	0	0	0	1	8	1	0	0	0	0	0	0	0	0	0	0	0	0	0	0	0	0	0	0	0	0	0	0	19	1	0	30	0	30	62	5	34	0	0	0	7	0	0	9	0	4	5	1	0	50	10	0	0	0	3	0	3	0	169	17	24	0	0	0	0	1	0	0	0	0	0	0	0	0	0	3	7	6	0	48	2	9	9	12	4	0	2	2	0	0	28	3	1	0	3	18	25	0	16	0	0	2	4	0	1	1	13	3	0	0	1	0	0	0	0	1	40	0	0	0	15	6	2	0	7	3	7	0	6	0	0	4	0	0	0	0	1	0	1	0	9	15	0	0	0	0	0	0	0	0	1	2	0	0	0	0
LakWasMe82_HOW10_2_rpkm	0	0	0	0	0	12	18	0	0	0	4	6	7	1	0	0	0	0	24	0	2	0	1	36	3	0	0	0	0	10	0	2	0	3	12	9	10	0	1	0	0	0	0	9	17	29	34	4	0	7	2	11	0	0	0	7	0	16	88	5	237	0	0	13	0	3	0	0	15	53	2	4	0	0	1	1	0	0	0	0	2	13	2	0	0	0	2	0	0	0	0	4	14	15	13	0	0	1	3	9	0	0	0	0	0	0	0	0	1	0	2	2	71	11	76	0	1	3	0	1	0	0	3	12	0	0	1	0	0	0	1	37	51	0	1	2	0	0	35	1	0	0	0	10	0	1	0	0	13	10	5	18	11	5	10	0	14	19	15	0	16	7	0	38	48	0	0	8	1	22	0	0	0	0	0	0	0	0	0	0	1	0	1	0	3	10	0	0	0	20	6	5	4	7	1	0	0	7	7	13	24	1	21	0	0	5	44	0	18	7	7	2	15	6	15	0	29	1	0	9	1	0	8	1	15	19	0	2	6	0	1	4	0	3	0	0	9	59	24	13	0	0	16	20	19	39	0	0	13	12	12	2	10	0	1248	1979	0	0	0	0	1	1	1	8	39	0	24	0	3	36	31	1	8	0	0	1	0	5	53	50	8	20	47	28	26	0	0	0	1	0	2	0	1	2	2	1	0	11	14	0	3	27	76	6	35	1	44	27	56	1	30	0	33	4	0	0	0	0	275	0	3	0	0	2	17	93	8	4	32	0	1	0	0	1	0	0	1	0	1	0	0	3	17	32	7	7	5	7	0	2	8	2	18	0	3	0	1	0	0	32	56	1	3	0	0	49	15	22	29	20	0	19	0	0	10	9	0	4	0	24	0	1	3	10	10	0	74	0	1	0	1	1	42	3	0	1	217	0	0	32	0	11	0	4	18	0	5	0	1	1	0	8	14	8	0	38	33	5	4	0	0	1	4	0	0	0	0	0	15	3	61	6	0	1	1	1	0	1	3	0	15	67	0	0	67	37	0	1	0	0	2	74	35	1049	0	99	19	9	0	23	1	0	0	2	0	39	4	0	0	8	16	73	13	4	0	0	10	4	33	2	4	0	15	0	0	0	0	125	113	21	1	6	44	49	10	2	0	0	0	1	1	2	2	0	0	0	0	0	0	3	0	0	0	0	2	0	0	0	1	9	1	0	0	0	1	0	0	0	0	0	0	0	2	12	11	0	15	1	0	8	0	25	0	9	9	0	0	0	10	0	0	0	3	0	2	22	0	0	0	0	2	10	0	3	19	0	34	6	14	0	0	1	0	5	74	185	292	237	1	104	293	240	204	103	17	2	30	6	13	0	0	0	3644	0	6	10	3	0	9	0	7	0	0	1	8	10	0	47	0	20	0	75	110	47	3	0	42	2	80	4	113	77	32	4	0	4	5	19	1	5	6	10	1	0	0	0	0	2	0	7	1	45	0	0	0	6	2	12	3	3	31	0	3	16	1	1	3	0	1	0	5	101	0	24	0	0	0	1	18	52	75	14	11	0	8	0	9	0	2	1	16	2	7	0	0	0	2	0	0	16	1	0	17	3	1	1	0	14	0	1	0	2	1	4	1	1	6	0	7	0	6	0	1	0	21	7	0	0	19	2	0	1	8	9	8	0	34	0	12	2	0	1	1	0	0	0	0	1	0	14	0	47	25	1	33	37	33	1	0	10	0	0	3	1	0	11	3	0	167	1	0	26	0	14	0	2	4	0	0	0	0	0	0	0	0	15	0	0	0	0	0	0	3	0	0	0	4	0	0	10	8	3	2	0	0	1	1	2	0	36	0	0	0	0	161	0	10	1	0	0	0	0	0	0	0	0	14	0	2	1	0	2	1	23	8	1	0	4	2	0	7	0	0	0	0	0	0	30	82	0	0	0	0	0	0	0	0	14	11	32	0	0	5	0	0	0	3	1	0	22	15	0	0	1	0	1	0	0	10	10	0	0	0	1	0	0	0	10	1	8	0	3	1	5	1	5	9	0	0	0	0	0	1	1	8	0	0	1	1	0	0	0	9	0	0	0	0	0	2	0	0	0	0	2	45	41	58	32	17	0	0	1	0	0	0	0	0	0	0	0	1	0	0	0	0	0	0	0	0	39	0	0	0	15	2	0	14	6	0	0	0	0	2	0	3	0	0	0	2	0	0	0	2	0	0	3	1	1	1	0	3	13	5	24	3	12	1	0	4	0	25	13	16	1	32	0	0	7	3	0	0	2	0	0	0	1	0	35	9	0	0	5	0	0	28	0	1	0	0	1	0	0	1	0	0	3	1	60	1	0	0	42	22	0	2	4	0	1	0	2	2	2	0	0	0	0	0	0	67	9	0	1	0	0	0	0	0	11	0	0	0	0	1	19	13	0	0	0	1	0	2	20	0	9660	0	0	0	0	72	5	13	0	2	4	8	2	25	2	14	14	0	2	1	0	0	0	0	1	1	20	1	3	0	0	1	0	10	1	0	0	0	0	0	0	3	100	69	0	9	90	0	3	0	0	7	0	0	6	9	1	1	20	0	0	0	0	24	27	12	0	3	0	2	0	0	5	18	0	0	0	0	0	0	0	0	0	0	0	0	0	0	0	0	0	22	0	0	2	0	5	0	5	0	0	0	0	0	0	0	0	31	36	0	0	1	0	5	0	0	0	3	0	3	2	2	0	0	12	0	0	2	3	20	8	16	34	2	0	1	13	5	0	2	8	0	8	15	0	0	0	0	1	2	1	0	0	2	9	0	1	0	2	6	0	1	0	0	0	37	1	0	0	0	0	1	0	0	17	9	2	12	0	2	33	0	0	0	3	0	0	9	0	0	42	37	0	1	6	0	0	53	0	0	11	0	1	0	0	0	0	0	0	11	13	8	19	3	11	0	8	0	11	8	12	0	22	0	0	3	2	0	8	0	1	0	8	0	1	3	5	3	0	25	0	1	0	1	2	1	7	0	1	0	0	0	0	1	0	1	1	0	1	59	1	1	0	2	2	4	1	0	0	0	2	10	0	25	50	100	36	0	0	13	0	0	1	1	4	4	11	0	11	1	0	0	0	15	8	0	8	0	0	11	7	17	0	23	6	3	19	0	2	49	1	9	13	5	14	8	0	0	0	10	0	31	0	7	14	5	33	10	6	33	1	0	11	11	10	0	0	0	3	11	11	13	0	5	1	2	12	1	17	15	30	4	0	8	0	0	0	0	0	3	11	22	0	0	0	12	2	6	52	5	6	22	0	1	5	6	10	2	10	7	27	1	8	0	0	0	0	0	3	6	154	39	39	24	1	1	1	0	0	0	1	4	51	2	58	3	26	0	4	0	5	119	72	75	21	1	2	0	64	0	2	0	0	5	0	2	0	143	110	31	68	51	40	2	1	60	9	0	0	0	0	0	0	130	6	0	0	0	19	0	5	0	3	0	0	0	5	0	1	0	0	0	1	5	0	0	1	1	0	0	5	29	14	0	0	0	1	0	1	0	2	0	0	0	0	11	4	0	0	3	5	0	0	0	0	1	4	0	0	0	4	0	0	0	0	0	0	0	0	0	0	0	0	0	0	0	0	0	0	0	0	7	0	14	554	13	0	140	0	4	2	0	42	0	17	30	0	0	29	5	50	4	18	3	0	0	0	16	0	32	0	0	1	0	0	2	0	0	11	18	1	1	0	13	3	1	9	1	0	0	0	0	0	1	17	7	67	48	43	0	0	2	28	1	0	0	76	2	0	0	2	14	1	0	9	0	1	38	5	11	23	15	0	0	15	1	1	1	50	1	12	8	4	12	0	30	0	0	1	1	0	1	0	9	0	46	15	30	118	77	35	8	6	0	0	0	10	0	62	0	1	13	14	37	0	0	0	20	0	2	0	2	19	13	0	39	13	3	5	0	22	6	7	6	0	24	4	6	0	0	2	0	2	0	120	1	5	48	6	0	0	2	2	7	9	5	1	23	3	0	3	0	24	30	80	65	95	0	16	41	7	17	9	0	2	1	0	1	1	301	2	2	0	0	1	1	19	25	1	11	7	0	3	0	1	0	3	0	10	1	0	1	0	0	0	32	0	0	0	31	0	59	0	0	4	37	0	0	1337	14	0	9	0	1	2	0	0	3	3	0	1	0	3	3	0	4	40	0	0	0	0	0	0	2	0	0	34	0	3	2	3	2	17	5	1	3	1	18	0	27	5	1	2	22	0	1	0	3	4	0	0	19	4	0	13	20	0	1	1	33	170	5	18	1	19	84	1	45	10	50	0	38	26	50	16	60	49	1	36	1	0	0	0	1	1	1	0	0	0	0	2	0	1	8	0	2	13	0	31	34	0	1	0	0	1	2	2	4	0	0	0	4	0	1	0	0	0	12	10	80	8	0	1	7	0	0	0	4	0	0	4	10	0	0	0	0	0	0	0	0	0	2	0	0	0	0	12	1	0	1	5	0	0	1	0	1	0	0	0	85	0	5	2	4	3	8	0	7	0	36	38	32	11	0	3	0	0	1	0	0	1	0	32	0	0	53	0	2	0	0	7	0	0	0	0	0	10	1	1	5	0	17	13	28	23	0	12	2	1	0	0	15	21	24	2	0	0	0	1	0	2	0	0	0	0	3	1	0	0	0	0	0	0	0	0	5	1	0	0	0	0	2	4	0	0	0	1	0	0	23	49	21	0	0	0	1	0	0	1	24	0	0	11	0	0	0	0	4	4	0	0	7	0	0	2	10	0	0	5	4	0	1	72	1	3	2	0	1	0	0	0	1	0	0	117	0	0	0	0	0	16	0	0	24	13	1	31	19	22	5	0	13	0	0	0	36	0	28	7	4	0	0	0	4	11	0	18	0	6	0	0	0	1	0	0	5	1	0	5	0	0	0	2	0	4	0	3	0	1	34	28	0	0	0	2	0	0	3	0	0	5	0	0	4	0	1	0	42	1	1	0	0	8	6	4	0	58	22	2	1	174	0	4	16	29	8	4	0	0	13	14	1	0	2	0	0	7	49	1	3	8	6	6	0	1	0	0	23	0	29	0	0	3	1	32	0	1	12	0	24	0	1	1	0	0	6	6	0	0	0	3	2	2	2	0	2	3	0	0	3	1	15	21	0	19	3	0	0	1	6	14	0	0	12	0	5	0	0	0	2	5	1	5	3	7	191	1	0	0	0	0	0	0	0	13	1	0	2	0	0	0	1	0	0	0	0	1	1	0	1	0	0	0	0	0	1	0	4	1	0	0	5	0	0	5	0	0	5	0	0	2	20	0	6	0	46	0	2	1	0	0	1	1	5	2	0	0	0	0	267	238	200	302	359	195	444	252	52	234	205	321	349	134	49	141	124	247	304	77	97	14	389	433	124	203	236	194	272	147	221	11	179	0	0	11	0	0	0	0	2	0	4	0	84	47	0	0	3	0	0	0	0	0	1	0	0	0	3	0	1	6	0	0	1	0	4	0	6	0	1060	4	0	0	0	1	4	0	3	3	2	2	4	4	0	0	0	1	0	1	0	6	0	0	0	0	3	7	5	26	16	0	1	5	0	1	0	16	1	1	15	2	0	0	0	2	92	1	0	30	0	1	0	0	0	1	2	7	0	1	6	19	0	12	0	1	0	0	0	0	0	14	1	0	0	2	1	4	2	5	0	70	6	1	5	6	1	0	1	0	0	1	0	1	0	0	1	0	0	43	12	6	0	0	0	0	14	0	12	7	6	1	3	1	2	3	3	0	1	46	4	12	0	6	0	0	2	0	0	0	32	0	8	20	0	0	0	1	3	24	0	0	0	0	0	0	1	0	1	2	0	0	3	2	0	0	1	1	2	0	0	0	6	0	6	0	0	32	0	2	0	104	2	0	1	0	0	0	0	0	0	1	0	0	1	0	0	1	7	0	8	19	0	0	0	0	55	0	0	13	16	0	16	12	0	56	34	12	10	1	0	0	0	0	1	18	0	4	0	1	2	0	0	0	14	0	12	0	0	0	1	0	0	3	1	1	0	0	1	0	0	0	2	0	0	0	0	0	15	0	4	0	0	54	0	9	45	70	8	0	3	0	0	0	0	0	0	0	0	0	1	0	0	0	1	1	24	3	8	6	0	5	3	12	0	0	2	0	20	6	2	0	0	1	265	0	0	2	0	1	0	0	0	0	0	0	0	0	46	30	1	0	1	0	0	0	7	4	0	1	16	25	5	6	0	6	0	2	28	13	2	18	0	0	0	5	0	0	0	1	0	3	0	0	17	4	0	0	0	5	0	1	0	0	0	2	0	2	6	2	2	2	2	2	4	0	0	3	0	0	1	0	1	5	2	0	0	0	0	0	1	8	14	0	120	0	0	13	0	16	0	1	0	3	4	1	1	9	13	9	16	0	12	0	0	0	0	4	0	35	0	0	0	0	0	0	39	0	25	8	58	32	0	48	43	24	0	49	1	51	1	65	3	15	2	37	2	20	13	9	1	31	2	20	0	34	5	0	0	18	0	8	1	16	14	8	19	20	12	22	5	0	11	6	7	0	33	3	0	0	22	10	0	7	0	1	0	6	19	5	0	0	0	4	0	1	34	2	0	0	0	11	4	0	0	0	1	107	0	0	0	0	0	0	2	0	1	0	0	7	0	2	5	4	0	0	0	0	0	0	1	1	1	3	0	458	2	1	38	41	56	0	23	0	29	0	3	1	18	0	1	1	0	3	1	4	167	0	0	8	0	0	0	0	0	2	0	0	27	6	0	1011	0	18	0	0	0	85	57	10	0	17	2	8	3	2	1	0	6	0	8	4	0	0	16	1	0	0	42	15	1	0	0	0	0	0	162	867	1070	2	0	0	0	12	0	26	4	55	0	4	0	3	0	0	141	49	19	3	0	0	2	1	0	0	54	0	126	40	0	0	3	0	0	16	0	0	2	0	0	0	0	0	0	0	0	0	72	828	1	1	0	0	0	0	0	28	3	0	0	0	0	0	10	30	0	0	2	0	0	0	0	76	5	0	2	1	0	12	0	0	0	0	0	4	1	10	0	2	0	0	0	1	1	5485	10	1	8	0	6	0	2	1	0	0	0	2	0	1	0	14	1	6	0	0	0	0	0	0	0	0	0	0	0	0	1	2	0	0	1	0	0	1	0	0	0	0	15	2	0	0	0	0	0	0	0	0	1	0	2	0	0	1	0	252	0	0	0	6	0	0	25	0	0	0	1	0	0	163	1	2	0	0	1	37	45	135	18	4	27	0	0	23	2	0	21	0	0	20	6	0	0	0	0	0	0	0	18	1	2	2	0	0	0	0	4	1	0	0	0	456	0	0	0	0	0	0	0	1	1	0	0	0	0	0	0	0	8	0	0	10	0	1	0	0	0	12	0	0	0	48	13	5	60	5	0	2	0	0	0	0	1	0	31	0	0	5	0	9	1	5	0	1	0	0	0	2	0	0	0	0	2	20	5	21	0	14	0	3	0	0	1	0	7	0	0	1	0	0	0	4	1	58	54	1	8	0	59	21	0	0	1	1	0	1	0	2	8	13	0	0	1	0	0	0	4	75	0	259	0	0	0	8	0	0	0	2	0	0	0	4	2	0	8	15	122	11	0	0	0	0	2	0	3	0	15	0	9	4	0	0	0	1	0	0	7	1	0	2	0	0	6	1	1	0	2	0	4	2	11	0	5	7	4	2	4	1	32	0	0	0	16	1	0	2	0	0	0	0	808	0	0	6	1	1	1	0	1	1	0	0	5	0	2	0	2	0	0	105	1	0	0	0	0	0	2	17	0	0	0	0	0	1	1	0	0	0	1	1	1	0	1	1	1	2	1	4	0	4	0	0	0	0	3	1	3	0	0	0	0	0	0	0	8	1	8	0	1	0	1	20	0	5	0	0	2	0	0	0	0	0	2	0	0	0	0	0	2	2	0	0	0	0	0	0	0	0	0	0	0	13	2	1	2	0	63	0	0	0	0	2	4	0	0	0	21	0	1	5	2	0	0	0	1	0	0	0	0	2	0	0	0	0	0	1	1	0	0	0	2	1	0	0	2	8	1	27	1	0	28	3	0	0	12	0	1	0	0	0	0	0	0	10	0	2	2	2	3	1	0	0	0	37	5	0	4	10	8	0	0	1	0	1	0	0	0	0	3	1	17	0	0	400	0	0	3	2	2	0	0	0	10	0	0	0	0	0	0	0	1	0	1	0	0	0	4	0	8	0	0	0	0	0	0	4	2	2	0	3	0	1	0	2	0	0	1	0	0	0	0	0	0	1	0	1	0	0	0	0	0	0	0	1	0	0	0	0	0	0	0	3	0	0	0	2	0	0	0	0	0	1	16	0	2	0	4	0	0	0	0	5	0	0	1	0	0	4	1	0	2	0	0	0	0	0	0	1	0	0	0	0	0	0	0	0	0	0	0	0	1	1	0	0	0	0	0	0	0	0	0	0	0	0	0	0	0	0	0	0	0	0	0	0	0	0	24	0	0	4	0	0	3	0	0	22	0	0	7	3	0	4	0	1	10	0	1	0	0	0	6	1	0	28	10	6	1	0	0	108	0	0	0	0	0	1	3	104	0	0	0	2	2	0	0	0	0	0	0	0	0	0	1	0	2	5	0	0	0	0	0	0	0	1	0	2	0	0	0	0	0	0	0	0	0	0	0	1	0	37	0	26	2	0	2	0	0	0	0	0	0	0	24	0	0	0	0	1	3	2	0	1	1	0	3	0	0	6	1	0	0	0	0	2	0	1	1	6	0	0	0	0	9	0	0	0	1	0	0	0	0	8	1720	0	4	2	0	0	0	1	0	0	0	0	0	0	3	0	0	2	0	0	9	0	2	12	0	0	0	0	0	0	0	0	1	0	0	0	0	0	9	1	0	0	2	1	0	0	2	0	1	0	0	0	0	7	0	0	0	0	0	0	0	1	0	10	0	0	0	0	2	0	0	0	0	0	1	7	0	0	0	0	4	3	1	0	0	0	84	6	3	0	0	0	0	0	3	3	2	1	0	0	3	2	9	12	22	4	20	2	0	2	6	1	0	0	0	3	0	0	0	0	0	0	2	42	6	0	27	0	5	0	0	0	0	10	0	0	1	0	0	0	1	1	0	0	6	0	3	0	20	0	0	0	45	0	0	5	3	25	0	0	0	0	0	0	0	0	1	1	5	110	6	0	1	0	0	0	0	14	3	0	23	0	0	1	0	2	0	0	2	2	0	0	2	9	0	0	0	0	0	0	0	0	0	0	8	1	19	3	0	0	0	0	2	0	0	0	34	0	0	0	0	7	0	0	0	0	4	10	2	1	0	3	0	0	0	1	7	0	0	4	5	12	2	19	5	2	219	387	0	0	6	0	125	1	28	67	4	0	2	1	39	109	0	84	1	13	21	0	197	1	0	0	0	18	0	0	24	23	0	18	0	0	26	1	21	60	26	0	0	9	3	24	0	33	5	0	11	16	4	1	1	0	0	5	1	12	22	1	0	1	6	21	0	0	7	0	4	1	0	0	2	0	0	0	0	9	0	2	0	21	0	2	0	46	1	1	0	9	1	11	2	1	0	409	0	1	0	0	0	0	104	52	3	0	4	0	2	2	2	5	7	0	0	0	0	0	0	26	2	1	2	0	0	0	0	29	5	3	0	0	0	1	5	0	0	0	0	19	14	0	2	2	2	16	0	0	0	1	11	12	2	0	7	0	0	0	11	0	0	5	0	9	14	2	1	0	1	8	25	4	4	3	5	0	0	0	0	42	1	0	0	148	31	266	2	28	118	90	502	0	264	123	63	8	444	467	285	0	664	150	248	100	239	9	324	68	358	0	15	0	330	2	5	0	0	1	0	10	7	0	2	3	4	12	23	0	2	1	1	0	14	2	1	11	6	0	6	3	6	0	0	1	4	2	9	0	0	0	6	5	0	41	1	23	0	5	1	0	0	91	4	0	0	0	148	0	0	13	1	4	2	20	1	5	0	0	1	0	11	23	6	12	2	30	0	3	0	3	0	0	2	1	0	0	0	0	0	0	0	46	0	0	3	0	7	0	3	0	1	27	0	0	20	0	13	2	1	1	0	0	37	47	8	2	1	12	0	0	0	2	7	9	10	6	13	4	7	0	0	0	0	2	0	0	0	13	0	61	1	0	38	15	0	0	1	0	0	0	133	1	1	1	0	4	1	0	0	0	7	0	0	32	1	5	3	0	2	1	2	6	0	0	0	0	0	0	0	0	0	0	0	0	0	2	1	2	1	7	1	0	0	3	2	0	0	0	0	0	0	1	93	0	0	0	1	11	2	5	1	44	1	0	0	37	16	18	0	0	5	1	19	0	0	0	2	15	0	0	0	0	0	0	2	0	0	89	4	9	0	44	0	0	1	0	1	0	0	2	4	8	0	0	0	0	0	0	0	0	2	15	0	26	20	0	6	3	42	0	1	11	0	0	0	5	6	7	7	12	1	16	1	2	6	2	32	0	1	11	0	1	7	1	191	1	97	2	0	0	0	0	0	22	0	7	0	0	0	1	0	1	0	0	12	0	0	2	42	10	11	4	1	29	5	0	1	1	2	3	0	1	0	3	8	9	1	0	0	0	0	1	2	1	1	1	0	0	0	0	0	5	22	0	2	1	7	1	1	0	0	3	17	3	5	0	6	0	0	0	9	1	0	0	3	0	1	0	0	2	0	0	2	1	0	12	2	0	3	0	2	0	0	2	0	0	0	0	0	4	2	1	1	0	0	18	7	5	2	1	0	28	42	9	27	0	0	1	0	0	0	0	0	4	0	1	46	19	1	9	0	1	0	25	0	13	7	10	22	23	21	14	7	1	2	1	0	0	23	0	2	30	0	1	1	0	0	0	9	9	2	7	6	3	7	1	17	3	1	0	0	0	132	0	3	0	1	0	0	2	0	0	0	31	0	0	1	0	0	0	2	1	10	0	2	0	1	6	0	54	0	0	0	0	0	15	34	12	0	15	0	0	1	0	6	5	3	0	0	0	2	4	1	40	0	0	0	2	0	0	15	0	8	7	0	0	0	0	0	1	0	0	3	4	0	19	3	1	0	36	1	9	4	0	24	0	0	6	1	0	0	1	0	1	1	4	3	0	0	52	5	0	1	15	0	0	0	3	2	0	6	7	0	0	43	3	0	2	0	2	5	0	0	18	0	3	5	0	10	0	3	0	4	4	0	0	0	5	0	1	4	6	0	1	5	0	3	1	1	16	0	2	0	7	109	0	3	0	0	1	12	2	1	9	0	0	4	52	2	9	7	0	0	1	0	2	1	0	0	2	0	1	0	34	0	4	1	4	0	0	1	30	1	0	0	2	0	3	0	20	1	0	2	1	6	0	2	0	0	1	4	0	0	0	1	1	0	0	0	0	1	3	0	2	0	0	0	0	0	0	0	0	0	0	0	0	0	0	0	0	0	0	0	0	36	0	0	0	0	0	0	72	1	2	0	0	1	0	0	0	1	1	0	0	0	0	2	0	0	0	0	2	0	1	0	0	0	12	0	2	1	0	0	0	0	4	0	0	4	0	0	32	1	9	0	1	10	1	0	0	10	170	4	3	3	2	0	0	0	19	3	1	14	0	2	45	0	0	2	0	0	1	0	0	37	0	86	1	0	0	2	0	0	0	1	0	0	206	1	0	0	0	4	0	0	0	0	0	2	0	0	0	1	12	0	15	14	0	0	0	0	0	3	0	4	1	0	1	5	5	2	0	1	12	0	1	0	0	44	1	0	2	16	0	2	0	0	34	4	0	0	12	0	5	2	0	0	0	0	0	0	0	0	19	1	6	0	1	0	0	2	2	0	0	5	10	13	0	4	1	0	17	8	1	0	0	0	2	6	43	0	0	0	0	1	27	0	20	13	1	1	0	0	5	0	35	0	6	1	1	0	0	0	0	0	0	0	13	7	4	2	0	0	0	0	0	31	52	39	17	8	0	0	1	0	1	20	5	1	1	5	14	14	16	88	0	44	41	0	36	0	4	3	58	2	0	42	7	0	0	6	0	0	0	0	53	34	6	12	0	982	0	0	0	4	2	5	0	2	2	6	1	1	8	1	14	0	0	1	0	5	2	0	11	0	0	9	2	0	2	1	0	13	0	12	1	9	5	15	4	33	13	0	13	0	12	1	10	8	5	0	0	0	0	0	2	1	4	1	0	0	4	2	17	6	7	0	0	3	33	21	14	5	47	4	205	8	2	1	9	2	1	6	1	0	0	0	0	0	3	5	0	0	1	0	8	0	19	8	195	1	1	1	0	8	5	0	0	1	0	2	0	2	0	0	2	0	1	0	0	0	0	1	1	2	1	0	2	1	0	0	0	1	2	1	0	0	2	0	0	2	1	1	0	44	5	0	24	4	29	5	4	0	3	0	14	3	44	52	1	6	2	1	2	2	0	2	1	0	7	146	0	0	5	0	0	34	12	15	5	34	16	18	5	1	7	2	0	0	9	55	2	2	0	0	1	0	17	0	0	0	2	3	0	0	1	23	5	0	0	32	1	0	27	14	0	1	0	0	0	1	55	1	8	4	57	64	2	1	1	1	0	13	0	0	0	7	21	12	13	1	26	1	0	0	29	1	52	0	24	0	142	0	0	0	7	0	0	3	0	0	7	26	3	20	61	0	10	0	0	0	4	21	0	0	7	1	0	11	33	28	27	43	10	2	1	2	36	0	9	2	0	0	3	1	3	1	3	0	1	1	19	2	0	1	0	0	4	0	9	0	1	0	38	5	10	7	1	36	44	0	0	0	61	0	24	12	7	7	48	17	2	14	18	32	29	14	43	0	1	2	0	12	0	0	25	0	1	4	3	0	0	0	1	0	1	3	23	14	11	184	67	162	0	78	13	12	0	6	2	1	0	0	1	0	0	0	0	0	1	0	0	0	0	24	7	16	0	27	0	5	0	0	0	1	1	0	92	0	1	0	3	0	5	6	1	35	1	1	14	0	2	0	2	41	0	82	39	8	2	18	1	69	2	0	0	28	61	4	3	0	1	5	1	0	209	0	0	0	23	26	18	36	0	0	0	0	0	10	1	1	33	0	2	6	0	0	1	3	0	57	86	29	8	4	7	6	12	2	10	6	0	4	0	0	4	12	0	10	5	17	0	81	43	76	1	1	31	46	0	0	0	4	0	2	7	0	0	0	2	0	15	19	4	1	0	0	8	11	0	1	2	1	0	0	40	11	0	13	11	0	25	0	46	0	29	21	49	16	15	8	0	9	110	70	0	22	5	2	0	7	3	9	4	5	0	0	0	0	0	0	0	6	45	0	1	0	0	22	104	14	211	192	9	29	0	3	0	7	25	28	0	0	23	3	0	0	0	0	0	0	0	1	1	2	0	0	0	2	1	7	2	4	0	0	2	0	0	0	26	7	18	0	24	37	15	26	9	13	24	34	13	12	22	0	0	0	0	30	37	35	0	0	2	22	17	15	1	18	11	0	0	17	16	7	0	0	0	1	0	0	14	19	0	7	0	1	0	4	2	0	7	5	1	1	0	2	100	12	32	33	61	12	0	1	0	0	0	114	0	7960	0	0	0	6	87	87	2	0	0	0	0	0	0	0	0	11	6	11	0	0	0	0	0	0	0	46	0	4	0	92	1	1	1	0	0	4	5	0	0	197	12	4	0	0	0	0	0	0	0	0	10	14	1	1	0	2	1	0	1	0	0	0	0	0	0	4	1	13	0	25	25	0	31	0	0	2	1	7	39	0	0	0	2	0	0	0	0	36	1	0	5	2	0	1	0	0	0	0	0	77	4	1	10	109	0	3	1	1	17	0	46	3	20	13	0	0	0	1	21	0	3	73	3	0	0	0	23	1	0	1	11	6	1	0	1	0	2	0	0	0	743	16	5	4	10	2539	1	96	38	50	38	5	182	150	79	12	23	15	16	0	94	705	419	548	68	59	4	4	2	286	5	0	11	4	1	26	70	1	0	836	5	3	0	0	2	0	7	17	0	2	0	3	0	25	49	12	24	20	10	3	0	12	0	20	32	8	18	0	0	0	0	3	1	0	0	1	1	17	1	0	13	12	11	0	9	13	0	2	0	8	7	2	4	9	0	7	0	0	12	44	1	1	0	0	0	52	0	3	0	9	1	6	26	0	8	10	0	0	71	93	180	1	0	23	57	98	6	27	81	3	26	0	26	7	1	55	2	2	19	15	16	69	15	2	24	9	20	20	0	0	10	13	2	0	8	8	12	2	1	5	27	1	0	10	4	12	0	2	5	0	2	37	0	0	6	0	0	0	0	0	0	6	0	0	11	0	1	2	8	0	294	8	3	0	0	5	15	2	41	1	7	23	0	0	1	94	21	1	69	99	0	1	7	3	1	3	3	16	11	4	5	17	7	37	12	107	18	21	0	0	0	3	0	1	0	1	0	2	0	0	24	0	0	0	0	0	6	15	78	0	5	0	0	0	0	0	0	8	3	2	1	0	0	1	0	1	1	2	3	1	0	0	0	0	1	1	0	6	1	0	17	0	2	0	19	4	0	3	0	7	10	0	1	0	0	0	0	0	5	4	0	1	0	0	0	0	20	2	9	1	1	7	5	14	0	0	0	0	1	6	0	0	6	19	4	2	52	2	1	0	12	46	15	1	0	0	0	0	51	2	8	16	13	8	3	0	2	1	4	7	0	0	0	0	99	23	17	14	10	22	11	21	10	11	0	33	35	37	29	6	165	72	67	77	8	7	11	14	2	17	1	2	90	13	12	26	38	32	35	12	26	17	15	22	24	31	25	8	25	25	26	19	26	0	0	1	0	48	102	0	3	0	36	16	4	7	239	113	18	448	0	239	10	1	0	3	0	8	22	8	14	0	17	0	151	416	217	1	0	1	2	0	0	0	0	65	42	51	26	58	31	84	43	13	15	0	22	3	21	33	0	11	0	0	2	8	11	19	5	27	40	14	6	16	11	16	36	0	0	0	9	0	7	1	10	1	2	1	9	0	3	0	32	6	0	0	0	12	12	7	8	3	0	1	10	1	2	5	13	0	0	0	0	0	0	0	0	8	2	1	1	5	0	0	1	3	1	0	4	9	2	0	11	13	6	81	83	0	0	2	1	0	0	8	0	0	0	1	0	1	0	0	1	1	0	0	44	0	3	1	1	0	14	2	0	0	0	3	0	0	0	0	0	0	2	2	3	1	1	17	1	2	0	0	25	0	44	1	14	46	1	28	11	37	0	0	0	0	0	2	0	0	0	0	1	1	0	42	17	20	12	0	0	0	0	0	1	1	0	2	7	11	1	84	2	31	1	0	24	59	0	0	0	8	0	0	4	31	23	38	8	0	0	21	0	1	16	12	106	0	0	1	18	8	15	14	1	5	13	13	31	0	11	43	28	0	9	67	92	5	7	3	0	0	0	12	8	26	0	40	1	2	0	2	9	0	1	2	0	0	0	0	8	0	5	38	1	0	1	1	0	0	1	7	2	1	99	5	0	0	1	1	0	0	0	0	14	15	19	0	13	26	2	17	6	1	6	11	34	0	1	22	5	2	0	9	19	4	0	0	0	0	0	18	14	22	8	0	15	7	2	2	0	4	2	1	6	20	3	2	7	0	9	0	1	5	3	0	11	5	6	0	29	20	30	0	0	37	0	3	6	5	0	1	10	0	0	6	10	2	5	5	4	0	0	3	3	0	2	42	14	2	0	1	0	5	0	9	20	6	4	7	8	1	0	0	0	3	0	4	0	9	2	4	6	50	1	2	1	0	8	27	0	0	12	58	24	0	1	33	0	8	20	24	1973	0	0	39	0	0	0	0	0	0	2	0	1	18	11	0	31	13	22	14	1	2	0	7	0	0	0	1	0	20	0	0	0	2	0	0	1	4	1	1	0	4	1	0	0	0	0	7	0	11	0	3	12	20	0	0	2	0	8	17	2	0	0	1	147	11	0	3	2	0	15	1	62499	0	0	0	0	0	0	0	0	0	0	0	0	0	0	2	0	4	0	2	1	0	42	17	18	87	0	38	8	21	1	1	0	1	0	0	1	5	19	66	1	102	39	0	0	0	0	2	9	4	23	0	2	34	1	9	11	12	21	12	75	107	16	0	9	20	0	25	1	0	128	45	18	13	0	1	0	5	4	7	0	150	40	50	8	41	0	0	1	0	38	0	0	13	1	45	29	2	57	6	0	0	33	18	1	0	67	99	0	23	0	4	0	0	0	1	0	2	1	84	95	161	120	76	0	1	22	4	20	45	35	129	35	39	10	21	18	62	41	2	2	40	24	4	0	0	0	0	38	48	136	79	34	0	6	0	0	16	7	13	5	7	0	1	0	0	0	0	0	0	0	0	5	18	55	1	2	2	9	6	0	6	18	0	0	0	0	15	25	15	8	2	5	15	25	0	0	0	12	0	0	0	11	7	19	3	8	9	0	13	0	0	0	18	13	0	1	0	3	2	0	0	0	2	0	0	0	0	16	2	4	1	1	13	26	9	0	1	0	0	0	0	1	17	4	7	2	16	0	0	0	56	86	0	3	2	1	21	8	0	17	6	1	30	0	4	0	7	0	0	2	0	0	4	0	0	0	0	1	0	0	0	4	0	2	0	2	0	0	0	0	0	0	0	2	0	0	1	0	0	0	0	0	0	1	0	0	0	3	0	1	1	11	34	1	0	2	0	0	0	6	0	35	1	2	3	1	6	16	0	101	1	1	4	101	20	19	38	6	0	1	10	15	8	0	2	11	5	6	2	5	3	2	0	0	0	0	0	1	1	10	0	0	4	4	30	3	0	1	0	0	219	1452	2	0	0	1	0	0	10	6	42	29	27	8	61	0	38	24	11	4021	3	17	0	7	19	10	19	8	63	0	1	113	3	85	3	3	0	1	0	0	1	0	8	3	9	87	5	12	0	2	0	6	15	5	1	0	3	0	0	6	0	0	2	1	0	15	10	11	0	13	1	12	17	2	7	1	3	2	18	16	1	0	0	0	0	0	2	46	103	31	5	0	5	20	19	0	3	2	9	18	11	0	6	6	0	3	0	6	5	1	0	0	7	11	5	8	11	0	0	0	18	0	8	7	2	3	23	3	12	0	4	0	0	114	4	1	3	1	0	0	0	1	89	0	11	0	1	0	7	15	2	2	0	4	1	0	4	1	0	0	0	0	0	0	5	42	0	0	3125	0	1	6	6	0	0	4	8	2	13	1	1	0	7	3	0	0	0	1	0	0	0	0	0	1	0	0	0	1	0	94	0	8	7	27	48	8	9	0	0	0	0	0	0	0	0	2	0	0	0	0	0	1	0	0	11	1	0	0	9	1	2	1	0	0	0	0	1	1	4	0	1	26	0	0	0	5	16	3	12	0	10	14	3	3	22	15	5	39	4	5	1	36	59	37	107	421	19	227	1028	0	0	13	6	0	23	14	10	12	0	0	0	1	0	0	92	6	1	2	1	254	0	1	0	0	2	63	0	22	2	7	0	17	3	0	0	0	0	0	1	1	9	5	0	0	3	6	86	147	0	0	0	6	2	0	0	0	33	0	0	3	0	0	1	16	20	0	0	0	0	12	1	2	0	46	10	0	20	45	5	3	2	0	4	3	10	40	22	14	3	14	1	0	0	12	1	2	7	12	33	16	0	0	10	31	5	20	253	1	0	2	0	0	4	1	17	7	16	0	0	0	10	132	0	74	1	52	4	2	0	0	48	0	1	1	129	26	18	21	4	1	237	658	3	0	1	1	1	14	6	3	0	5	0	89	0	0	2	1	8	1	8	2	0	0	0	0	11	4	2	0	0	19	11	0	1	0	35	4	18	34	0	10	69	6	3	0	0	4	3	25	48	7	24	9	68	28	9	10	26	3	27	23	93	0	0	0	1	6	0	7	0	0	283	1	0	9	41	27	24	3	75	19	1	9	10	23	11	3	114	18	0	4	3	2	12	0	0	99	191	27	3	0	0	0	0	0	5	0	1	0	13	3	3	0	2	0	0	0	2	0	0	0	1	1	0	0	1	0	0	0	0	3	1	0	0	0	0	2	0	1	3	8	0	1	0	0	0	0	0	2	0	0	0	1	11	0	0	1	9	15	14	17	0	5	14	2	7	1	7	9	15	0	8	0	1	19	913	4	26	33	18	47	7	0	24	1	30	15	0	0	0	1	6	3	6	0	1	19	0	4	8	0	39	13	0	5	21	0	0	28	72	0	14	2	2	7	2	0	0	12	18	8	16	34	21	30	17	1	66	17	0	5	3	0	10	0	9	5	47	14	0	32	16	45	12	2	3	27	0	3	6	0	0	0	0	12	0	0	0	1	20	0	2	0	0	0	0	6	3	4	10	32	43	26	0	18	17	8	42	10	16	18	2	39	62	55	0	0	4	3	0	5	0	11	0	24	22	518	19	0	0	15	0	0	0	1	0	0	1	1	0	0	2	0	0	14	5	13	3	3	11	19	802	47	0	7	0	0	0	0	0	18	7	9	1	0	3	36	0	0	1	3	4	0	0	0	3	3	0	2	25	58	2	6	63	5	10	0	0	3	0	12	1	78	2	11	277	0	1	0	15	0	22	0	3	0	2	14	0	0	1	0	1	1	17	0	0	0	0	0	39	1	0	3	0	1	0	0	0	0	1	0	2	0	1	0	0	0	0	6	0	1	0	30	114	0	17	30	12	28	26	18	8	1	2	1	22	0	0	1	0	0	0	0	0	2	0	1	4	1	1	0	0	0	5	3	0	6	7	25	29	0	0	2	0	3	0	0	0	0	2	0	9	0	1	13	18	0	1	0	1	1	0	0	0	0	0	4	7	3	14	0	51	53	60	2	13	0	0	0	0	0	0	0	1	7	0	15	0	0	11	6	0	13	132	0	0	0	0	59	0	1	2	0	9	1	0	0	0	1	0	0	1	0	13	0	0	0	0	0	0	1	5	0	0	0	0	0	3	1	0	72	0	2	0	0	0	2	0	0	0	1	0	0	0	0	0	0	1	0	2	2	0	0	14	0	0	1	0	0	0	0	1	0	1	0	34	0	0	17	0	0	0	15	0	0	9	0	1	0	4	1	3	0	0	0	148	0	0	0	0	0	5	0	0	0	1	0	15	0	1	3	0	0	0	0	0	0	0	4	0	0	0	0	1	0	0	0	0	0	0	0	0	0	0	186	0	0	1	0	2	0	1	2	0	0	0	0	0	0	0	0	3	0	0	0	5	0	0	1	2	0	0	0	0	159	1	0	3	0	1	0	0	0	0	0	0	0	22	0	0	1	0	0	0	0	0	2	1	0	0	0	1	0	6	0	0	0	0	0	2	4	0	0	0	59	0	0	1	0	4	0	12	32	12	3	2	4	12	148	0	90	24	4	0	11	21	0	19	0	0	11	21	9	59	15	0	271	10	382	3	0	3	0	0	15	5	3	4	4	0	0	7	14	0	11	21	1	6	0	1	6	3	24	2	52	0	19	0	173	5	14	0	33	3	23	8	0	4	11	2	8	11	20	6	0	13	28	2	0	3	19	6	10	40	11	18	5	12	64	33	11	3	1	0	68	68	74	9	8	0	22	2	22	24	8	39	2	17	234	0	0	87	0	9	33	2	15	1	120	18	73	32	10	0	7	7	3	23	19	9	8	0	6	5	16	26	54	37	11	48	98	78	28	62	173	119	54	0	1	15	28	0	32	0	5	0	7	0	0	0	0	31	0	2	1	0	0	2	0	10	0	45	3	18	0	1	10	0	0	19	1	22	0	115	18	0	1	2	7	8	4	4	1	0	0	0	7	0	0	3	17	0	8	0	2	21	0	0	0	15	0	0	0	0	4	1	14	0	0	0	0	0	1	1	0	0	0	4	1	4	0	1	0	13	2	0	0	1	4	0	8	17	3	12	0	5	0	18	5	1	0	5	2	0	0	0	1	4	1	3	0	0	0	1	2	0	0	16	0	2	7	2	1	0	4	0	14	7	101	5	9	0	1	0	0	0	0	0	5	43	1	13	8	0	0	0	0	2	0	0	3	0	1	0	0	6	0	0	0	0	0	6	38	100	1	28	18	0	1	0	1	1	1	17	4	111	2	27	22	79	4	0	4	3	4	20	6	0	0	2	28	0	0	0	4	0	13	61	21	266	0	7	48	16	0	2	0	2	0	1	1	2	3	0	0	0	12	0	0	0	35	8	2	0	18	28	0	5	7	1	0	0	0	0	0	7	26	14	77	28	77	0	23	17	2782	0	33	1	4	43	0	0	13	13	0	2	0	3	0	5	1	6	0	0	0	0	35	14	1	0	0	10	0	0	3	0	6	3	3	0	25	32	22	4	0	67	0	0	0	0	1	0	1	4	8	0	4	12	4	13	6	32	0	9	1	49	0	0	0	0	19	0	14	0	16	1	30	26	12	7	13	25	0	28	5	32	29	221	77	0	1	0	0	0	0	5	0	0	4	0	0	0	1	1	0	15	14	30	1	4	1	11	7	9	14	0	12	0	2	2	34	5	10	0	5	0	0	4	12	21	52	38	5	23	0	0	2	8	0	0	2	8	14	5	47	64	65	0	30	0	0	17	13	3	1	0	2	0	0	47	125	51	144	88	6	8	37	257	0	22	10	14	3	3	10	9	14	60	11	8	7	85	59	1	0	0	7	0	0	3	73	3	0	44	2	20	1	2	3	15	1	83	11	12	0	0	0	0	2	0	0	0	9	12	0	2	1	1	0	15	17	3	38	8	6	0	3	0	11	0	6	0	2	0	6	0	0	3	13	1	2	22	30	6	73	0	4	0	4	33	0	0	5	0	0	29	0	5	1	0	0	0	0	3	6	31	0	23	3	2	15	1	1	0	1	0	1	0	95	0	2	1	25	0	0	10	3	2	17	0	5	19	1	2	0	0	0	32	28	0	0	7	10	3	8	0	0	6	3	11	0	0	29	48	7	4	0	0	0	4	12	0	0	0	0	3	1	33	3	2	100	6	6	130	64	61	216	19	19	37	57	48	20	69	65	88	74	53	104	49	0	4	0	6	6	23	0	9	2	2	7	8	8	3	0	0	0	0	0	8	0	0	0	1	1	14	10	2	5	5	18	0	0	0	0	0	0	0	0	0	0	1	0	1	2	0	2	0	0	1	0	0	0	0	0	1	1	21	6	1	0	0	0	0	0	1	0	0	0	0	0	0	0	0	1	0	0	1	0	0	0	5	0	10	8	1	51	11	0	0	11	0	0	0	34	12	20	16	4	19	17	8	0	4	2	9	3	0	0	1	0	0	0	0	26	32	4	30	7	22	0	3	2	10	7	12	6	2	1	1	72	5	1	1	0	3	1	17	12	5	7	3	2	23	30	39	25	17	0	10	10	11	0	21	29	3	0	2	7	1	0	0	3	27	0	0	0	0	0	0	0	5	3	11	0	0	45	11	1	10	2	33	0	3	0	0	124	2	3	3	60	10	5	17	0	3	180	0	0	0	5	6	2	18	3	1	27	0	2	0	20	3	25	27	30	0	7	52	0	0	1	5	0	2	0	8	2	5	14	7	34	21	0	5	0	11	0	32	4	0	5	3	4	7	22	11	7	6	2	14	0	6	1	0	35	6	1	0	1	16	0	2	10	6	4	0	5	24	0	3	0	0	0	6	0	9	0	1	3	0	0	0	0	2	1	1	0	0	2	2	0	0	0	0	0	4	11	8	5	0	33	5	0	0	0	1	5	10	11	6	10	0	35	0	0	426	14	28	18	11	0	1	411	95	6	37	42	7	4	0	13	12	8	1	1	11	0	44	26	41	2	5	17	2	0	9	9	28	0	0	3	6	44	19	0	0	3	0	0	0	91	0	3	3	1	0	0	0	0	0	0	2	1	319	45	100	28	19	0	65	10	3	0	1	1	0	1	3	0	1	0	12	0	15	0	4	38	14	2	34	7	397	53	6	0	0	28	16	13	71	26	31	9	34	234	0	38	121	3	0	0	0	0	3	7	2	421	217	20	0	28	0	1	0	0	20	1	0	11	10	0	2	0	55	279	0	0	0	67	89	105	67	36	12	15	20	25	2	3	100	0	0	18	33	6	2	0	1	0	0	1	0	25	7	0	1	1	2	2	0	1	0	0	0	0	0	3	0	140	0	0	1	1	41	30	7	0	2	8	1	32	3	0	1	0	7	12	28	1	54	0	17	9	2	2	13	19	0	42	10	0	3	67	25	12	16	18	43	21	0	6	4	190	8	125	155	0	0	0	1	0	0	0	0	6	1	2	1	3	0	0	0	2	0	0	0	14	13	12	22	8	4	4	0	2	4	3	12	0	0	4	3	5	0	0	4	10	4	19	16	12	7	26	2	3	1	0	1	0	0	3	0	0	0	0	1	0	0	0	0	0	0	0	3	0	0	0	24	0	1	0	3	4	0	4	3	1	19	0	61	0	0	14	2	0	24	0	0	0	0	0	4	5	0	0	2	1	6	11	13	10	5	0	14	14	31	0	20	0	66	0	100	275	4	2	8	0	10	3	2	1	3	50	211	21	49	16	18	97	18	6	17	15	3	3	1	6	6	0	0	15	76	0	1	1	1	1	4	62	0	1	0	0	0	4	4	30	0	0	0	0	3	0	1	0	0	1	0	0	1	0	0	0	0	0	1	0	0	0	0	0	0	0	4	4	0	23	17	0	58	0	24	45	118	8	1	0	1	6	0	1	14	0	1	49	0	0	33	18	0	0	0	3	2	18	0	120	15	20	0	0	1	0	1	0	0	0	0	1	2	0	1	1	11	9	8	0	26	5	19	11	1	3	4	4	6	3	0	31	68	17	0	5	5	13	0	26	9	1	9	9	0	5	0	26	20	0	3	7	1	0	0	0	3	10	23	0	0	78	7	24	0	6	7	9	2	10	1	1	0	0	0	1	0	2	2	5	0	18	27	0	1	0	0	0	0	0	0	4	0	6	0	3	0
LakWasMe92_HOW11_2_rpkm	0	0	0	0	0	4	5	0	0	0	1	211	1	1	0	0	1	2	3	0	0	0	0	6	0	1	0	0	1	2	0	0	0	3	1	4	2	0	1	0	0	0	0	0	12	9	21	7	1	1	2	73	0	0	0	0	1	10	4	8	256	0	0	3	1	1	0	0	3	42	1	0	0	0	1	1	0	1	0	0	0	23	1	2	0	0	1	4	2	0	0	0	3	0	2	2	0	0	1	0	0	2	0	0	0	0	0	1	0	0	0	0	25	3	11	0	0	4	0	0	16	0	0	104	0	0	2	1	0	0	0	20	4	1	0	0	1	0	4	1	0	0	0	6	0	1	0	0	8	2	15	15	4	1	27	0	2	9	15	0	1	4	0	2	6	0	0	3	0	7	0	0	0	0	0	0	0	0	1	0	0	0	0	0	1	1	1	0	0	3	1	0	2	2	5	0	0	5	0	53	16	0	10	0	0	0	4	0	21	0	9	3	19	6	3	0	5	0	0	3	2	0	8	3	2	6	0	0	2	0	3	0	5	0	0	0	13	5	6	0	0	0	8	5	11	50	0	0	11	6	3	4	3	0	246	66	0	1	0	0	2	1	1	17	1	0	4	0	2	12	8	0	5	0	0	0	0	2	66	31	0	18	9	8	13	0	1	0	3	1	1	0	0	2	0	0	1	4	7	0	0	13	13	1	2	2	6	22	5	0	6	1	11	3	0	0	0	2	203	0	0	1	5	1	2	4	1	1	3	0	1	0	0	0	0	0	2	0	0	0	0	1	0	1	3	1	4	3	0	1	1	3	6	1	5	0	1	0	0	9	2	0	4	0	0	9	4	8	11	5	0	17	0	0	8	1	0	25	0	2	1	0	4	2	2	0	40	0	1	0	0	0	14	0	0	16	17	1	0	2	0	7	0	2	1	0	4	0	1	0	0	6	25	1	1	7	30	2	5	0	0	0	1	0	0	0	0	3	4	0	4	4	0	1	1	2	0	0	4	0	85	15	0	18	3	10	0	0	0	0	0	55	11	905	0	17	10	1	0	2	0	0	0	2	2	9	1	0	0	2	0	30	5	2	0	0	8	2	90	1	17	0	5	1	1	0	0	26	11	1	1	1	30	24	6	0	0	1	0	0	0	1	0	0	0	0	1	0	0	2	1	0	0	0	1	0	2	0	1	8	1	0	0	0	0	0	0	0	0	0	0	0	0	0	3	0	4	0	0	4	1	7	0	7	15	0	0	0	9	0	0	0	0	0	0	7	0	0	0	0	0	5	0	0	7	2	8	0	9	0	0	0	1	17	0	2	0	38	1	12	35	52	9	2	9	1	10	1	9	0	0	0	2493	0	5	1	1	0	2	1	7	2	0	0	5	2	0	39	0	1	0	137	62	65	6	0	39	1	116	12	123	19	14	3	1	6	0	5	1	1	1	8	0	0	0	1	0	0	0	1	1	33	1	0	0	2	1	5	5	0	93	1	2	4	0	0	0	0	2	0	1	100	1	131	1	1	0	1	26	3	1	8	3	0	2	0	1	1	1	0	1	1	5	0	0	0	0	0	0	17	0	0	5	0	1	0	0	2	0	1	0	0	0	2	1	0	1	0	0	0	0	0	0	0	16	4	0	1	3	4	0	0	2	20	2	0	2	79	17	0	0	0	0	0	2	0	0	0	0	2	0	8	4	2	11	21	4	0	0	16	1	0	2	1	0	3	4	0	25	1	0	2	0	2	0	1	3	0	0	0	0	0	0	0	0	1	0	0	0	0	0	0	4	1	0	0	0	0	0	3	11	4	0	0	0	0	1	0	0	7	0	0	0	0	114	1	6	0	0	0	0	0	1	0	0	0	3	0	1	0	0	0	1	20	4	1	1	2	7	0	0	1	0	0	0	0	0	47	61	0	4	0	0	0	0	0	0	1	4	14	0	2	6	1	0	1	1	0	0	10	11	5	0	0	0	1	0	0	2	1	0	0	0	2	0	0	2	10	16	22	0	0	0	1	0	0	8	0	0	0	1	0	0	5	5	0	1	0	0	0	0	0	2	0	0	0	3	0	0	0	0	0	0	0	12	7	9	27	4	0	0	0	0	0	0	0	0	0	0	0	8	0	0	0	0	0	0	0	0	5	0	0	0	3	41	0	7	0	0	0	0	0	0	0	2	0	0	0	7	0	0	0	1	0	1	0	0	0	0	1	0	2	7	186	3	10	0	0	0	0	3	6	6	0	18	0	0	2	0	0	0	5	100	0	0	0	1	1	1	0	0	1	0	0	0	0	0	0	0	0	0	0	0	0	0	0	0	36	0	1	0	14	6	0	0	3	0	0	7	13	4	1	0	0	0	1	2	0	56	1	0	0	0	0	0	0	0	7	0	4	11	0	0	3	2	84	1	0	0	0	5	4	0	5471	0	0	0	0	10	0	8	0	2	0	4	3	5	17	6	2	0	3	1	0	0	0	0	0	0	5	1	0	4	0	0	0	0	0	0	3	0	0	0	0	0	6	14	1	2	21	0	5	0	0	4	0	0	6	0	0	36	6	0	0	0	2	37	80	20	0	1	0	0	0	0	4	0	0	0	0	0	0	0	0	4	0	0	1	0	0	0	0	0	1	8	0	0	0	0	0	0	1	0	0	0	0	0	0	2	0	1	4	0	0	0	0	0	1	14	0	0	0	7	1	0	0	0	3	0	0	1	1	2	6	89	35	2	0	0	4	1	0	0	2	0	1	3	0	0	0	0	0	13	1	0	1	1	2	0	1	1	0	2	0	1	0	1	0	12	2	0	0	0	0	1	0	0	0	0	1	12	0	1	4	0	1	2	1	1	0	1	0	0	35	16	0	0	1	2	0	7	1	0	6	0	10	0	0	0	0	0	0	0	3	3	11	1	532	1	3	3	0	13	1	0	4	0	0	3	0	0	0	1	1	0	12	0	1	1	0	1	0	2	0	0	0	1	1	0	6	0	0	0	1	0	1	1	2	0	3	0	0	27	0	0	0	2	1	2	0	0	0	0	6	2	0	16	6	6	7	2	0	4	1	0	0	0	0	0	8	1	1	0	0	0	0	9	3	0	1	1	0	3	1	533	0	2	2	1	6	0	2	13	3	1	2	5	2	3	0	0	0	1	0	11	0	1	0	0	6	3	11	24	0	0	0	6	9	0	2	0	1	3	8	2	0	0	2	1	1	0	1	6	27	11	0	6	0	1	0	0	0	2	0	3	0	1	0	6	1	16	7	2	0	14	0	6	6	0	1	3	4	0	4	6	3	0	1	0	0	0	0	3	424	11	3	30	1	4	1	0	0	0	0	1	29	1	18	0	52	1	0	0	8	186	46	11	56	0	1	0	27	0	0	0	0	3	0	0	0	26	4	13	24	44	22	0	9	76	4	0	0	0	0	0	0	56	1	0	0	0	6	0	3	0	0	0	1	0	2	0	5	0	0	0	0	10	0	5	0	0	0	0	5	2	8	0	0	0	0	0	7	0	1	0	0	0	0	4	1	0	0	3	2	0	0	0	0	0	3	0	0	0	1	0	0	0	0	0	0	0	0	0	0	1	0	0	0	0	0	0	0	0	0	0	0	0	67	1	0	12	2	0	0	0	31	0	2	10	0	1	169	0	0	9	3	0	0	1	1	9	0	90	0	0	0	0	1	0	0	2	1	34	0	1	0	13	1	1	0	1	0	0	0	0	0	0	8	0	20	4	16	0	0	3	17	0	0	0	21	3	0	0	2	2	0	0	0	1	2	1	0	4	5	9	0	5	0	0	0	0	3	0	0	1	2	1	0	8	0	0	0	1	2	0	0	3	0	6	6	9	16	5	6	37	3	0	0	0	0	5	28	0	0	1	4	69	0	2	0	4	51	3	0	0	2	8	0	15	5	0	6	0	7	3	3	3	0	14	1	2	0	0	0	0	0	0	22	2	0	23	6	0	1	15	2	23	77	8	1	4	0	4	1	0	8	26	181	4	44	0	15	1	3	2	3	0	1	4	6	0	0	47	0	2	0	0	3	0	1	2	1	7	1	0	0	0	0	0	2	0	2	0	0	0	0	2	0	30	0	0	0	14	0	97	10	0	2	17	0	2	4412	5	0	6	0	1	0	1	0	9	0	11	1	2	0	0	0	1	1	0	0	0	0	4	0	0	1	0	16	2	1	0	1	0	20	2	0	0	1	3	0	3	1	2	0	11	2	0	0	0	3	0	0	39	1	0	3	11	0	3	0	19	69	1	22	0	12	48	0	12	0	44	36	11	6	4	3	12	3	0	6	1	0	0	1	3	2	1	0	0	0	2	0	0	0	0	2	0	20	0	4	61	0	0	0	0	0	0	0	0	1	0	0	0	0	2	0	2	0	1	7	19	0	0	0	0	0	0	0	1	0	0	1	1	0	0	0	6	0	1	1	0	1	0	0	0	0	0	2	0	0	6	1	0	0	0	0	1	0	0	0	36	0	2	2	1	1	0	0	15	1	5	22	82	0	1	0	0	0	0	0	0	0	0	4	1	1	5	0	0	1	0	1	1	0	0	0	0	0	1	0	0	0	5	2	2	7	0	0	4	0	0	0	10	38	2	2	0	0	0	2	0	0	0	0	0	0	3	0	3	0	0	0	6	0	0	0	1	0	0	0	0	0	1	0	0	0	4	0	0	0	2	85	13	0	0	0	1	0	0	0	4	0	0	16	5	0	0	0	0	28	0	0	5	0	0	0	26	3	0	4	4	0	0	65	1	3	0	0	1	0	0	1	2	0	0	55	0	0	0	0	0	5	0	0	0	8	0	16	15	19	5	0	1	0	0	0	18	0	4	3	0	0	1	0	3	3	0	5	4	0	0	0	1	0	0	0	0	0	0	2	0	0	0	0	0	2	0	0	0	0	4	18	0	0	0	2	0	0	2	0	0	0	0	0	1	0	2	0	5	0	0	0	0	3	4	1	1	29	1	0	1	265	0	2	15	84	22	18	2	0	10	1	0	0	0	0	0	0	20	0	2	7	0	1	4	1	0	0	6	0	9	1	0	0	0	10	0	3	4	0	6	0	5	0	0	0	2	1	1	0	0	1	8	3	0	0	4	0	0	0	0	0	10	9	1	8	0	0	0	0	13	11	0	0	3	0	5	0	0	0	1	1	0	2	0	4	24	7	0	0	0	0	1	9	0	0	2	8	1	0	0	0	0	4	0	0	3	1	2	3	1	0	0	0	0	0	0	0	4	0	0	0	1	0	0	5	0	0	1	0	5	1	2	0	2	0	6	0	1	0	0	0	0	0	0	0	0	0	0	0	34	31	119	19	68	38	91	61	9	35	34	51	81	42	17	20	5	48	26	4	28	5	43	61	58	29	105	32	20	5	38	16	18	12	1	1	0	0	0	0	2	0	1	0	58	31	0	0	4	0	0	3	0	0	2	1	0	0	2	0	0	3	0	0	0	0	4	0	1	0	11	0	0	0	2	2	4	0	2	0	1	0	0	8	0	0	0	0	1	0	0	8	0	0	0	0	0	1	2	4	9	0	1	0	0	0	0	2	0	0	3	6	0	0	1	2	112	2	0	1	8	0	0	0	0	4	1	0	0	0	30	2	0	5	0	1	0	0	0	0	0	6	0	1	0	1	1	1	2	2	3	15	1	0	5	39	0	0	0	0	0	1	5	0	1	0	4	0	0	10	1	0	0	0	0	0	2	2	1	0	1	0	0	0	0	1	0	0	0	19	0	1	2	0	0	0	0	0	0	0	5	0	3	22	0	0	0	0	0	0	0	0	0	0	1	0	1	0	2	0	1	0	1	2	0	0	1	0	0	1	0	0	1	1	1	12	0	7	0	3	0	152	0	0	3	12	0	0	0	0	0	0	1	0	0	0	0	0	1	0	2	5	0	1	0	0	14	2	3	201	4	0	1	6	1	30	3	4	5	2	0	0	0	0	0	0	0	1	0	0	2	0	0	0	4	0	1	0	3	0	0	0	0	0	0	0	0	0	1	2	0	0	3	0	0	0	0	1	0	1	0	0	0	0	0	0	23	40	0	0	0	1	0	0	0	0	0	0	0	0	1	0	0	0	6	0	34	0	13	1	1	0	0	2	0	0	1	0	10	24	4	0	0	2	116	0	0	1	1	1	0	0	0	0	0	0	0	0	47	19	0	0	0	0	0	0	2	1	0	0	16	7	1	0	0	4	0	2	54	2	0	1	0	0	0	1	0	0	17	0	0	8	2	0	4	1	0	0	0	0	3	1	0	0	0	1	0	1	3	0	1	0	0	0	0	1	0	1	0	0	4	0	1	2	0	1	0	0	0	0	0	1	3	0	44	0	0	13	0	4	1	1	5	0	0	0	0	4	2	7	2	0	1	0	0	0	0	0	0	8	0	0	1	0	0	0	16	0	3	7	46	1	0	12	15	3	0	7	3	13	0	19	2	11	3	8	2	11	1	7	0	8	1	6	0	11	0	0	0	18	0	0	1	4	5	6	3	4	1	4	2	0	2	1	11	0	8	3	1	0	5	3	0	10	0	2	2	3	6	2	0	0	0	0	0	0	5	0	0	0	0	7	1	0	1	0	4	54	0	0	0	0	0	0	0	0	56	0	0	3	0	3	3	0	0	0	0	0	1	0	0	0	0	0	0	73	1	0	51	55	58	0	8	0	3	1	0	2	21	0	0	0	2	1	8	0	6	0	0	2	0	0	1	0	0	2	0	0	9	2	0	213	0	8	0	0	0	7	33	0	0	0	4	2	0	2	0	1	4	0	3	3	1	0	17	0	0	0	18	14	0	3	2	1	0	0	121	149	84	7	0	0	0	0	1	3	3	6	0	0	1	25	0	0	8	176	6	6	0	0	1	0	0	0	17	0	4	2	0	0	2	0	0	3	0	0	1	0	0	0	0	0	0	0	2	0	40	39	0	1	0	0	0	0	72	7	2	0	0	1	0	0	13	2	0	1	0	0	0	0	0	189	1	1	0	0	1	1	0	0	4	0	0	100	1	0	0	0	0	2	0	2	1	384	2	0	3	0	3	0	1	0	0	0	0	0	0	1	0	0	3	0	0	1	0	0	0	0	0	1	1	0	0	0	3	1	0	2	0	0	0	1	0	0	0	0	2	0	45	0	0	0	0	0	0	0	0	0	0	0	0	0	0	32	1	0	0	0	0	1	17	0	0	0	0	0	4	27	0	0	0	0	1	5	2	254	8	0	4	0	0	13	2	1	17	0	0	24	1	0	0	0	0	0	0	0	4	2	2	1	0	0	0	0	0	1	0	0	0	10	0	0	0	0	0	0	0	0	0	0	76	0	2	0	0	0	4	0	1	9	0	0	0	0	0	2	0	0	0	5	7	0	0	2	0	0	0	1	0	0	0	2	23	0	0	1	2	3	0	2	0	0	2	0	0	0	0	10	0	23	0	2	15	4	0	3	0	4	0	0	0	0	0	0	0	0	0	0	0	8	0	6	6	0	9	0	10	5	0	0	1	0	0	1	0	3	1	4	0	0	0	1	0	0	7	301	0	4	0	0	0	4	0	0	0	0	0	0	0	1	0	0	30	2	14	2	0	0	0	1	0	0	1	0	3	2	2	1	0	1	0	3	0	0	19	2	2	0	0	0	4	1	0	0	2	0	2	0	5270	0	0	0	0	0	0	1	15	0	1	0	7	0	2	0	0	0	0	0	60	0	0	12	0	22	0	0	0	0	0	0	10	0	0	1	0	0	0	85	1	1	1	0	0	0	0	12	0	0	0	0	0	0	1	0	0	0	0	0	1	0	0	2	2	0	0	0	0	0	0	0	1	0	0	1	6	0	0	1	2	0	7	0	1	0	2	0	9	0	0	4	0	0	2	0	1	0	0	0	0	1	0	0	0	0	3	0	0	1	0	0	1	0	2	0	0	0	0	0	0	5	0	0	0	0	1	0	0	0	0	0	2	0	0	0	10	0	0	1	1	0	1	0	1	0	0	0	0	0	0	0	0	0	1	1	2	0	24	1	1	3	0	0	1	3	0	2	0	0	16	0	0	0	4	1	0	1	0	0	1	1	0	4	0	0	0	0	0	0	0	0	1	18	3	0	1	0	4	1	0	1	0	0	0	0	0	0	0	0	1	0	0	95	0	0	0	4	7	0	0	0	6	0	0	0	0	52	0	0	0	0	0	0	0	0	3	0	19	0	0	0	0	0	0	0	6	3	0	3	0	0	0	4	0	4	0	0	0	0	1	0	0	2	0	0	0	0	0	0	0	0	0	0	0	1	0	1	0	0	0	0	0	0	0	2	22	0	1	0	0	0	1	0	2	0	3	0	0	0	1	0	0	0	3	0	0	0	0	0	1	0	0	0	3	0	0	0	0	0	0	0	0	0	0	3	0	0	0	0	0	0	0	0	0	0	0	0	0	4	0	0	0	0	0	1	0	2	0	0	0	0	0	0	0	2	17	0	0	18	1	3	10	0	0	3	0	0	4	1	0	0	1	0	0	6	4	0	2	0	0	0	0	11	16	1	0	0	2	39	0	0	1	0	0	9	1	19	0	0	0	2	6	0	0	0	0	0	2	3	0	0	0	0	1	1	0	0	0	4	0	0	0	0	0	0	0	0	0	0	0	0	5	0	0	0	0	0	0	23	0	30	5	0	4	0	0	0	0	0	0	0	6	0	0	0	3	1	2	0	0	0	0	0	0	0	0	2	3	0	2	0	0	0	0	0	1	2	0	0	1	0	8	0	0	0	0	2	0	3	0	4	3	0	0	1	0	0	0	0	0	0	1	0	0	0	13	1	0	0	0	1	3	0	0	35	0	0	0	0	0	1	0	0	1	0	1	0	2	0	1	0	0	0	1	0	2	0	0	0	0	0	0	0	0	19	0	0	0	0	1	1	0	0	0	2	0	1	0	0	1	0	0	2	0	1	0	0	0	0	3	0	3	0	0	0	0	0	0	0	1	0	0	0	0	0	0	0	2	0	1	0	0	0	1	0	1	0	0	0	1	0	2	0	0	0	0	0	0	1	0	18	0	0	1	11	15	0	29	0	0	0	0	0	0	0	1	0	34	2	0	0	0	8	0	0	9	0	29	1	3	1	0	2	0	0	1	2	2	10	0	0	0	0	0	0	0	0	0	0	11	29	2	0	4	0	0	0	1	7	1	0	2	0	0	3	0	0	0	0	3	0	0	0	0	1	0	3	0	0	0	0	0	0	0	0	54	2	0	2	0	0	2	1	2	0	0	0	7	0	0	0	0	0	0	1	0	0	2	4	3	3	0	0	1	0	0	0	0	0	0	7	0	0	0	12	2	5	34	115	0	0	1	0	283	0	10	39	10	0	1	0	34	337	0	54	0	8	43	0	186	0	7	0	3	2	0	0	5	7	1	23	0	0	7	0	8	16	11	0	0	1	2	5	0	7	0	0	0	1	3	11	0	0	0	1	0	46	4	1	0	0	0	1	1	0	6	0	2	0	0	0	1	0	0	0	0	4	0	0	1	12	0	1	6	10	0	0	0	3	6	5	0	0	0	5	0	0	1	0	1	0	20	27	0	0	0	0	0	0	1	1	0	0	0	0	0	0	0	10	2	0	0	0	0	0	0	24	1	1	0	0	1	0	0	0	0	0	1	4	53	0	6	2	0	1	3	0	0	3	0	2	2	2	3	0	1	0	10	0	1	2	0	34	12	3	3	0	0	0	0	1	0	0	2	0	0	0	0	11	0	0	0	23	26	106	6	14	5	16	107	1	38	3	39	11	50	327	27	1	109	13	95	17	18	1	56	13	47	0	6	0	4	0	0	0	0	2	0	1	1	0	0	1	0	3	1	0	0	0	0	0	50	1	0	2	4	3	8	1	1	0	1	0	1	2	3	0	0	0	0	0	0	8	0	0	0	0	0	0	0	57	5	0	0	5	4	2	0	12	1	1	0	32	0	2	0	4	3	0	2	20	4	7	1	20	0	0	0	0	1	0	4	1	0	0	0	0	0	0	2	12	0	0	0	0	4	0	0	0	2	14	0	0	4	0	3	0	1	0	0	1	0	2	0	1	0	0	2	0	0	0	6	6	3	11	3	3	4	0	1	0	0	1	0	0	0	0	0	34	0	0	13	2	0	2	0	0	0	0	50	0	6	0	0	3	2	0	0	0	9	0	0	17	1	0	1	1	0	1	1	0	0	0	0	0	1	0	0	0	0	0	0	0	0	0	0	0	0	4	1	0	0	2	0	0	0	2	0	0	0	1	23	0	0	0	1	15	4	3	4	18	17	0	0	7	39	5	0	0	10	0	12	2	0	0	0	10	0	0	0	0	0	0	0	0	1	20	1	2	0	19	0	0	0	0	0	0	0	7	5	0	0	0	3	1	0	0	1	0	1	12	1	2	2	0	2	0	11	0	2	0	0	0	0	9	3	1	3	17	0	4	0	0	1	2	3	3	2	7	0	0	1	1	37	0	17	0	0	0	0	0	0	8	0	5	0	0	0	0	0	1	0	0	10	1	2	0	11	3	3	1	0	12	39	0	0	0	33	0	0	7	1	1	0	5	1	3	0	0	1	0	2	1	0	0	0	0	0	0	0	4	22	0	2	0	1	0	0	0	0	0	11	0	1	0	5	0	0	0	3	1	0	0	3	0	0	0	1	3	0	0	1	0	0	1	1	0	1	0	0	0	0	0	2	0	0	0	0	0	0	0	0	0	0	1	0	1	2	0	0	152	38	11	7	0	0	0	0	0	0	0	0	0	0	0	52	8	0	1	0	0	0	7	0	2	6	0	4	7	6	5	1	0	0	1	0	0	18	1	2	2	3	1	0	0	0	0	1	1	0	1	16	1	12	3	9	1	0	0	0	0	16	0	0	0	4	0	0	7	1	0	2	1	0	0	0	1	0	0	1	2	4	0	0	67	0	2	0	33	0	0	0	2	0	0	5	9	0	2	0	1	1	0	5	4	0	0	0	0	9	0	5	56	0	0	1	8	0	0	3	2	0	2	0	0	0	1	0	2	1	0	0	35	0	0	3	1	0	12	3	1	0	0	2	0	0	4	3	0	0	0	0	0	0	0	2	0	0	9	0	1	3	3	0	0	0	1	0	1	2	4	1	5	12	2	0	6	1	0	0	0	2	7	0	10	20	0	4	0	4	0	2	1	0	0	0	2	0	0	2	0	0	0	0	0	2	0	2	15	0	0	0	1	112	0	9	0	14	2	3	0	0	1	1	0	1	14	0	5	3	0	0	0	0	1	4	0	0	1	0	2	0	139	3	4	1	1	0	0	0	114	3	0	0	1	0	1	0	4	0	0	7	0	0	0	0	0	1	16	0	1	0	0	2	0	0	0	0	2	0	2	0	1	1	0	0	0	0	0	1	1	1	0	0	0	0	0	0	0	0	0	0	0	45	1	0	4	0	0	0	3	0	8	0	3	11	0	0	0	2	0	2	0	0	0	2	0	0	0	0	0	0	0	0	0	2	1	0	3	0	2	0	1	0	242	0	0	0	0	1	8	0	1	0	0	5	0	2	0	0	121	0	0	2	0	0	0	1	2	0	1	7	0	2	7	0	0	0	0	0	7	0	0	7	0	4	0	0	2	0	4	1	0	5	0	0	34	1	0	0	0	1	0	0	1	1	0	3	0	0	0	0	0	0	6	11	0	0	0	0	0	1	0	0	0	0	1	0	3	0	0	0	2	0	0	0	0	28	0	0	2	2	0	0	0	0	16	2	0	0	8	0	0	0	0	0	0	0	0	1	0	0	6	2	5	0	1	0	0	1	0	0	1	0	0	1	0	0	0	0	0	2	0	0	0	0	2	94	6	0	0	0	0	0	2	0	5	10	0	0	0	0	1	1	3	0	4	2	2	0	0	0	0	0	0	0	0	1	0	0	0	0	1	1	0	33	1	18	3	1	0	0	0	0	1	11	1	2	0	5	108	1	18	32	0	5	11	0	13	0	1	2	19	1	0	14	5	0	1	5	2	8	0	0	37	8	2	2	66	169	0	0	0	267	0	21	0	1	5	2	1	0	3	0	5	0	0	0	1	2	0	0	66	0	1	7	0	0	1	0	0	7	0	11	1	3	1	8	2	40	10	1	13	0	3	1	1	1	0	0	0	0	2	0	3	5	0	0	1	0	3	0	11	0	1	0	0	0	11	13	1	10	2	2	65	4	3	0	4	2	0	3	0	0	0	0	1	0	0	3	0	1	1	0	4	0	33	6	36	2	0	2	0	0	2	0	0	0	0	0	1	1	1	0	1	0	0	0	0	0	0	0	1	0	0	3	0	0	0	3	0	0	1	0	0	2	0	0	0	4	1	2	0	5	0	0	4	0	24	0	0	0	3	0	2	1	15	14	1	0	1	1	0	0	2	0	0	1	8	70	0	0	2	0	0	14	17	5	3	8	1	14	0	0	15	1	0	0	5	8	0	0	0	1	2	0	1	1	1	1	0	0	0	0	0	7	4	0	0	24	0	0	8	7	0	0	0	0	0	0	5	0	0	0	10	9	1	0	0	1	0	11	0	0	0	6	4	3	17	1	8	1	4	0	5	1	137	0	2	0	190	0	0	0	1	0	2	0	0	0	0	16	0	15	10	0	7	0	0	0	2	5	0	0	0	0	0	17	33	13	4	12	1	0	0	1	14	0	1	0	0	2	1	0	2	0	0	0	0	0	1	0	0	0	0	0	3	0	7	1	0	1	13	0	3	5	0	10	8	0	0	1	29	0	7	3	1	4	14	2	7	28	10	11	6	62	15	0	0	0	0	4	0	0	1	0	0	3	1	0	0	0	0	1	6	4	9	2	0	25	13	13	0	29	2	1	0	0	8	1	0	0	0	0	0	0	0	0	0	3	3	0	0	8	11	5	0	3	2	0	0	0	0	1	5	0	150	0	6	0	1	0	2	0	0	1	0	0	6	0	0	5	0	8	0	18	36	7	0	2	0	21	1	0	0	21	5	0	2	1	0	2	0	2	111	0	0	0	35	6	20	52	0	0	4	0	0	2	2	1	8	0	5	1	1	2	0	0	0	14	14	29	0	5	19	0	2	2	8	6	0	2	0	0	14	6	0	2	0	10	0	33	49	47	5	1	1	13	1	0	0	1	0	1	2	0	0	1	0	0	6	63	9	0	2	0	47	3	2	2	1	0	0	0	6	0	11	19	16	2	3	0	37	0	7	7	9	2	2	7	0	30	108	16	0	3	2	4	0	9	1	1	0	1	0	0	0	0	0	0	3	1	0	0	0	1	0	8	25	63	419	446	2	4	0	2	0	4	4	2	0	0	2	0	0	0	0	2	0	0	1	1	2	0	0	0	0	0	0	1	1	61	0	0	3	0	0	1	1	2	8	0	1	13	3	16	4	2	5	8	11	6	5	1	0	0	0	49	16	3	0	0	0	3	1	5	0	3	1	0	1	1	5	1	3	0	0	3	0	0	11	5	0	0	0	0	0	0	3	0	7	0	0	0	0	0	316	2	5	6	20	3	4	0	0	0	0	44	0	2001	0	3	0	6	34	22	3	0	0	0	1	0	0	0	0	11	1	30	0	0	0	0	0	1	6	96	8	0	0	25	0	1	2	0	0	0	1	0	0	12	38	1	0	0	0	0	0	0	0	1	6	0	2	0	0	0	0	0	0	0	0	0	0	0	0	2	2	15	0	11	0	0	18	0	0	1	0	2	14	0	0	0	0	0	2	0	0	9	1	0	1	0	0	0	0	0	0	0	0	257	10	1	0	102	0	2	1	0	9	0	62	8	24	3	0	0	0	2	5	0	0	11	0	0	0	0	15	1	0	2	2	0	3	0	2	0	1	1	0	0	836	3	7	3	1	810	0	8	14	7	7	1	49	33	24	6	12	12	8	1	1	27	17	14	7	10	0	0	0	1027	1	3	11	3	1	13	2	0	0	435	2	0	0	1	2	4	0	17	0	2	0	1	12	10	109	4	3	21	0	2	2	1	0	8	6	3	4	1	10	0	0	0	0	0	0	0	0	153	1	0	7	0	2	0	3	1	0	1	0	1	1	3	1	1	0	6	0	0	5	6	0	1	0	0	0	7	0	0	0	2	0	4	14	0	10	5	0	0	5	29	65	0	2	1	9	77	1	3	10	0	2	0	2	1	0	25	0	2	4	1	5	43	3	0	11	8	27	5	0	0	6	2	1	0	10	4	6	3	0	2	12	0	1	2	2	1	0	1	0	1	0	8	0	1	1	0	0	0	0	0	0	2	0	0	5	0	2	4	13	0	42	2	4	1	0	2	28	1	5	0	1	2	2	0	0	54	2	0	49	56	0	16	4	1	1	9	2	6	1	1	1	3	11	3	5	20	8	4	0	3	0	0	0	0	2	1	0	0	1	22	5	0	0	0	0	1	12	23	43	0	6	0	0	0	0	0	0	2	1	2	0	0	0	0	0	0	0	4	0	0	0	0	0	0	0	0	0	4	0	0	1	0	0	0	6	12	1	1	0	2	1	0	0	0	1	0	0	0	2	0	0	0	0	0	0	0	2	0	0	0	0	0	0	2	1	0	0	0	0	0	1	0	3	84	0	0	12	11	0	1	2	1	11	0	0	0	0	0	21	0	8	1	2	16	0	0	0	1	0	1	0	0	1	0	7	15	15	2	2	2	1	2	2	5	0	5	8	16	2	9	132	17	16	8	12	24	3	2	0	3	0	0	13	0	1	8	10	6	48	51	34	8	10	35	4	7	6	3	5	5	7	1	6	0	0	1	0	27	115	0	0	1	19	7	0	3	827	137	48	288	0	138	1	2	0	3	0	0	4	1	55	31	36	0	209	499	13	1	0	74	0	0	0	0	0	54	10	46	22	45	18	105	1	11	3143	0	0	7	10	8	0	1	2	7	0	17	2	1	2	6	18	0	4	4	4	13	3	0	0	0	1	1	0	0	1	0	0	6	0	0	1	0	10	1	0	0	0	0	20	5	4	2	0	0	11	0	0	5	4	0	0	1	0	0	0	0	0	0	0	0	0	2	0	1	1	1	1	3	0	7	7	13	10	11	2	26	137	0	2	0	0	0	1	1	0	0	1	0	1	0	0	0	0	0	1	0	6	0	2	1	0	2	0	0	2	0	1	1	0	0	0	0	0	1	1	2	0	0	1	3	2	3	0	0	3	0	17	2	6	15	0	12	2	12	1	0	0	0	2	1	0	1	1	0	0	1	0	4	4	9	9	0	0	0	1	0	0	1	3	3	8	0	3	31	0	4	1	2	20	43	0	0	1	15	0	1	10	13	18	13	3	0	0	19	0	0	8	0	15	0	0	0	7	12	2	0	1	3	3	9	13	0	0	25	37	0	4	36	79	7	7	4	2	0	27	3	12	11	0	3	0	0	0	2	4	0	45	0	0	0	0	0	0	0	0	7	2	1	0	0	0	0	15	5	4	0	17	0	0	0	2	0	0	0	0	0	4	6	8	0	0	11	0	3	3	1	4	3	5	0	0	9	0	0	0	0	2	0	0	0	0	0	1	2	1	6	1	1	0	4	0	0	0	1	0	0	5	2	1	8	3	1	0	0	0	2	0	0	1	20	6	6	13	9	6	0	0	5	1	0	2	2	0	0	1	0	0	0	1	4	0	0	3	2	2	1	1	1	0	6	17	2	0	0	0	0	0	1	8	1	6	2	4	0	1	0	0	2	0	1	17	12	7	0	0	8	0	0	0	0	4	6	0	0	4	13	3	0	5	15	0	3	8	3	140	0	0	13	0	10	0	0	0	0	1	0	1	21	10	0	23	2	11	2	0	0	0	4	0	0	0	0	0	13	0	0	0	0	0	0	0	0	1	0	0	1	0	0	0	1	0	7	0	1	0	1	22	6	0	0	1	0	12	4	0	0	1	1	27	16	0	0	2	0	8	1	44322	0	0	0	0	1	1	0	8	0	0	0	0	0	0	0	0	1	0	0	0	0	11	8	9	13	0	6	11	6	0	4	0	0	0	0	0	1	5	18	0	76	8	0	0	0	0	1	2	1	4	0	0	4	0	20	4	3	21	112	7	14	9	0	9	2	0	5	0	2	56	13	13	15	0	0	0	2	2	18	0	70	69	60	1	53	0	0	0	0	8	0	2	4	0	37	7	0	67	4	0	0	22	16	1	0	24	13	0	1	0	1	0	0	0	0	0	0	0	23	53	19	14	43	1	15	12	0	13	13	15	18	58	2	5	15	2	25	55	1	5	10	0	0	0	4	0	0	10	12	39	56	17	0	1	1	0	8	12	1	2	3	0	0	0	0	0	0	0	0	0	0	0	1	1	0	1	0	1	3	0	0	3	1	0	0	0	11	10	4	3	0	1	0	2	0	2	0	13	0	0	0	0	1	40	2	8	4	0	5	0	0	0	16	2	0	0	0	14	0	0	0	0	1	1	0	0	0	2	17	1	3	1	2	2	17	0	4	1	0	1	0	1	3	1	8	1	13	0	2	1	21	21	0	2	43	0	66	4	0	3	4	0	7	0	0	0	2	0	2	1	0	1	1	0	0	0	0	0	0	0	0	6	0	4	0	0	0	0	3	0	0	0	5	2	2	0	1	0	0	0	0	0	0	0	0	0	0	1	1	1	1	0	6	0	1	3	0	0	1	1	0	15	0	0	1	3	4	4	0	55	0	1	8	91	4	3	5	3	0	0	1	0	6	0	5	2	0	12	4	5	2	0	0	0	0	0	0	0	1	10	1	44	0	1	5	18	0	0	0	0	22	156	0	4	0	1	0	0	0	2	12	52	4	2	10	0	13	20	2	3711	6	9	0	2	8	8	14	1	42	0	0	16	0	11	0	0	1	1	0	2	0	1	3	0	1	16	3	3	0	0	0	13	16	0	1	0	2	0	0	0	0	0	3	0	0	5	2	6	0	5	1	1	3	3	1	2	7	4	8	9	1	0	0	0	1	0	1	12	120	10	10	15	4	6	17	7	0	3	4	259	6	0	0	2	0	3	1	3	1	0	0	0	3	17	2	0	0	1	1	0	5	0	1	2	6	0	5	1	12	1	3	1	3	4	1	0	2	0	4	0	1	0	107	1	2	0	1	0	1	2	2	0	3	0	5	0	2	0	2	0	1	0	1	0	2	81	0	1	2750	0	0	1	5	1	1	3	6	3	8	1	0	0	0	0	0	0	0	0	0	0	5	0	0	2	0	0	0	3	0	24	0	0	3	32	6	3	34	0	0	0	0	0	0	0	0	0	0	3	0	0	0	1	1	0	24	1	0	0	5	0	2	0	0	0	0	0	0	1	0	0	0	35	1	0	0	19	2	6	1	0	2	4	0	3	1	0	1	4	115	12	0	14	2	4	91	67	8	12	46	0	1	12	2	0	3	4	19	3	2	0	0	0	0	0	211	1	0	1	0	42	0	20	0	0	5	52	1	2	2	1	0	3	2	0	0	1	0	0	0	2	1	0	0	0	0	4	30	5	0	1	0	7	0	0	0	1	6	0	0	0	1	0	2	5	17	0	0	0	0	4	9	2	0	20	3	0	9	5	6	2	3	0	0	1	6	5	8	1	2	0	3	0	0	26	1	0	3	0	3	7	0	0	4	29	1	6	25	0	1	3	0	0	0	0	26	7	10	0	0	1	0	155	1	13	1	17	0	1	1	0	8	0	35	1	41	48	0	102	2	0	6	33	0	1	1	2	0	5	3	0	1	1	0	35	6	0	2	1	0	0	0	0	0	7	0	1	11	2	0	0	0	2	1	2	0	0	3	19	3	7	0	1	38	1	0	0	0	0	1	7	6	2	14	4	33	31	1	5	30	3	29	23	71	0	0	0	1	1	0	1	0	0	125	0	0	1	5	8	13	0	11	7	1	4	2	17	0	0	26	6	1	0	1	0	1	0	0	30	277	16	15	0	1	0	8	1	1	0	0	0	0	1	3	1	0	0	0	1	0	0	0	0	5	0	0	0	0	1	0	0	0	1	0	2	0	0	0	2	0	0	4	10	1	0	0	0	0	0	0	0	0	0	0	0	3	0	0	0	6	1	4	1	0	5	5	1	3	0	2	0	1	2	0	1	0	10	835	7	10	19	2	9	2	2	2	7	6	2	2	1	0	0	1	4	4	0	0	3	0	4	3	0	19	4	0	7	6	1	0	25	6	0	1	0	0	0	0	0	0	10	6	18	8	23	4	11	7	1	21	2	3	1	0	2	1	0	7	2	16	3	0	14	11	24	1	1	0	6	0	0	0	0	0	0	43	4	0	0	0	0	25	0	1	0	0	0	0	1	2	1	5	4	7	16	10	2	1	15	7	3	7	4	0	244	21	34	0	0	1	0	0	1	0	1	2	21	1	40	23	0	0	39	0	0	0	0	0	4	0	0	0	0	1	5	2	3	5	17	1	58	12	7	982	10	0	5	0	0	0	0	0	13	4	2	0	0	3	7	0	1	1	1	5	0	0	0	0	1	0	35	3	10	0	5	12	1	2	0	1	0	0	3	0	47	0	0	158	0	0	0	11	0	11	0	0	0	1	2	0	0	1	2	0	0	4	0	0	0	0	0	27	0	0	0	1	0	0	0	0	0	0	8	2	1	0	0	0	2	0	1	0	1	0	45	108	0	4	7	32	11	3	6	6	0	1	1	11	0	0	1	0	0	0	0	0	3	1	0	27	0	1	4	0	4	1	0	0	1	2	2	20	0	2	2	0	0	1	0	5	0	0	1	6	0	0	6	2	0	2	0	0	0	0	0	0	0	4	0	1	1	4	1	8	20	14	3	6	3	0	1	0	0	0	0	1	50	0	16	0	1	2	3	1	7	189	0	0	0	0	3	0	0	0	0	5	0	0	0	0	1	0	0	2	0	10	0	0	0	0	0	0	1	4	1	0	2	0	0	0	0	0	76	0	0	0	0	0	1	0	0	0	0	0	5	0	2	0	0	0	1	23	0	0	1	0	0	0	0	0	0	0	0	0	1	1	0	16	0	0	2	0	0	0	4	0	0	5	0	2	0	1	0	1	0	1	0	15	0	0	1	0	0	6	0	0	3	0	2	0	0	1	2	0	1	0	0	0	0	1	0	0	0	0	0	0	0	182	0	1	0	0	0	0	0	1	1	0	0	0	0	2	0	0	2	0	0	0	0	0	0	0	1	3	41	0	0	1	0	0	1	0	0	0	1	0	13	0	0	0	0	1	0	0	1	0	0	0	3	5	0	0	2	0	0	0	0	0	0	0	0	0	0	0	0	0	0	0	0	0	1	0	1	2	0	0	34	1	0	0	0	0	0	2	3	0	2	0	0	1	36	0	16	4	0	0	0	0	4	3	2	0	7	74	0	1	0	0	550	1	18	0	0	2	0	0	1	1	1	1	1	0	0	3	2	0	1	1	0	2	0	0	5	0	3	0	3	0	2	0	1	6	3	4	10	0	5	11	0	2	1	0	2	1	3	1	0	1	4	0	0	2	4	1	1	12	0	4	0	2	12	11	5	1	0	0	12	6	2	2	5	0	91	0	7	1	0	4	1	1	15	0	0	130	0	1	1	0	3	0	80	1	7	24	4	0	2	0	3	5	4	5	32	3	0	1	0	6	12	1	0	15	18	3	4	53	40	15	5	0	1	0	33	0	3	0	0	0	5	0	0	0	0	3	0	187	0	0	0	14	0	2	0	21	1	5	0	0	4	0	1	5	1	25	0	232	13	0	0	3	8	2	0	1	0	0	0	0	1	0	1	1	2	0	4	2	4	3	1	0	1	1	0	0	0	0	2	0	3	1	0	0	0	0	3	0	0	0	0	0	0	17	0	0	2	2	0	0	1	4	1	0	31	18	2	0	0	4	0	11	1	0	0	1	0	0	0	2	1	21	2	12	0	0	0	0	0	0	1	5	1	4	3	0	0	0	2	0	1	0	63	0	1	0	0	0	0	0	0	0	0	16	0	5	2	0	0	0	1	0	1	0	0	0	0	0	0	0	0	0	0	1	0	1	20	3	6	6	74	0	3	0	2	0	9	22	1	393	0	2	2	28	0	0	1	0	27	27	11	0	0	0	8	2	0	1	2	0	8	7	8	221	1	5	28	3	0	1	0	0	0	1	1	5	2	0	0	0	0	0	0	1	3	2	0	0	8	9	0	0	4	0	0	0	0	0	0	291	9	1	4	24	8	1	7	6	2486	0	10	22	3	17	0	3	5	14	0	1	0	0	0	0	5	5	0	0	0	1	17	4	0	0	1	7	0	0	1	0	0	3	3	0	8	6	5	1	0	83	0	0	0	0	1	0	1	7	1	2	3	1	16	2	0	5	0	9	0	46	0	0	0	0	6	0	11	0	4	1	8	4	1	0	9	2	1	4	2	5	2	89	1	3	0	0	0	0	0	0	0	1	1	0	0	0	0	0	1	13	14	6	0	0	0	2	2	1	8	0	1	0	1	0	4	3	5	0	1	0	0	6	7	4	17	9	0	0	0	0	5	6	0	1	2	3	11	2	24	19	21	4	23	0	0	2	4	1	0	0	0	1	2	1	13	2	9	2	2	5	2	15	0	3	0	0	1	0	0	3	3	18	1	0	6	25	21	4	0	0	1	0	0	1	7	0	0	30	0	2	2	3	1	2	2	36	2	1	0	0	0	0	2	0	0	0	2	3	2	1	0	0	0	34	8	0	39	1	0	0	1	0	4	0	0	0	1	0	2	0	3	0	16	0	1	100	32	6	45	0	1	0	8	12	0	0	2	1	0	4	0	0	5	0	0	0	0	1	7	4	1	8	2	3	3	0	0	0	0	38	7	0	53	0	0	2	6	0	1	17	0	4	3	0	8	27	0	0	0	0	0	23	8	0	5	0	0	2	2	0	0	9	23	3	0	1	10	21	6	9	0	0	0	3	1	0	0	0	0	2	4	8	21	0	41	2	0	16	3	2	56	24	1	36	9	44	1	19	29	12	20	4	10	7	0	0	0	2	1	2	0	1	0	0	1	0	6	1	1	1	0	0	0	2	8	0	0	0	0	4	0	0	4	52	7	0	0	0	0	0	0	1	0	1	0	0	2	0	0	0	1	0	0	0	0	0	0	0	0	0	1	5	1	0	0	0	0	0	1	1	3	3	0	0	0	0	0	0	0	0	0	0	0	0	0	1	0	4	5	0	33	5	0	0	19	0	0	0	14	12	23	11	2	10	28	2	0	5	0	0	1	0	1	0	0	0	0	0	6	32	1	37	1	21	0	0	0	4	1	7	2	0	1	1	0	1	0	0	0	0	1	21	3	2	0	1	0	10	5	14	1	8	0	8	6	8	1	10	24	1	1	0	0	0	0	0	21	15	0	2	0	4	0	0	0	2	0	1	0	0	53	156	0	17	0	24	0	0	0	0	2	0	1	0	70	1	1	0	0	1	121	0	0	0	3	11	3	5	0	0	7	0	0	0	6	0	11	6	0	4	21	7	1	1	0	7	0	1	1	8	0	0	3	1	4	17	0	2	0	0	1	3	1	0	1	7	4	1	27	5	1	2	2	6	1	9	0	0	10	1	2	0	0	2	0	4	2	3	1	0	1	1	2	0	0	0	0	0	0	4	0	0	0	0	0	0	1	0	0	1	0	0	1	22	0	0	0	0	0	0	1	3	3	0	8	1	0	0	0	0	1	12	5	3	2	0	8	0	0	52	3	23	5	4	0	0	100	14	2	14	61	2	0	1	13	10	5	0	0	7	0	9	5	2	3	2	3	0	3	0	139	11	0	0	4	3	8	2	0	0	0	0	0	0	81	0	1	2	3	2	0	0	0	0	0	1	1	50	1	15	10	14	0	15	6	6	0	0	0	0	0	4	0	4	0	66	0	18	0	27	17	1	0	19	1	661	11	4	0	0	14	16	1	92	26	18	98	7	33	1	15	38	6	0	0	0	2	3	3	1	506	25	16	1	4	0	0	1	0	24	0	0	1	4	0	0	0	24	65	0	0	0	65	21	6	4	0	83	0	6	41	1	2	28	0	0	19	2	7	6	0	0	1	0	0	1	13	6	0	0	1	0	0	1	2	0	0	0	0	0	1	0	31	0	0	0	0	14	3	34	0	0	0	1	5	2	0	0	1	99	4	0	1	14	0	12	8	0	1	0	5	0	9	5	0	0	11	6	5	3	9	16	3	2	2	6	79	1	26	26	0	0	0	0	1	0	0	3	1	0	1	0	2	0	0	0	0	0	0	0	7	1	10	2	0	10	4	0	0	2	0	2	0	1	1	0	5	1	0	0	1	0	1	2	1	1	76	0	0	0	0	1	0	1	1	1	0	0	0	0	1	0	0	0	0	0	1	1	0	0	0	6	1	2	2	1	6	0	3	1	0	7	1	24	1	0	6	0	2	6	1	0	0	0	0	5	1	0	0	2	0	0	0	8	6	1	0	25	2	15	0	4	0	79	0	19	197	0	2	1	0	1	0	0	1	100	19	214	8	16	19	1	12	2	3	2	1	4	2	0	2	3	6	0	0	3	0	0	0	3	0	0	9	0	0	4	0	1	0	1	5	0	0	0	0	0	0	0	0	0	1	1	0	0	0	2	0	0	0	0	0	0	0	0	0	0	0	2	0	0	9	6	0	15	0	4	22	5	68	0	0	0	7	0	0	5	0	2	15	2	0	11	9	0	0	0	66	0	11	0	2	3	5	0	1	1	0	8	0	3	1	0	0	0	0	0	21	4	3	4	0	8	8	2	0	3	1	1	0	2	0	1	15	3	2	0	0	1	7	0	10	1	2	2	11	0	2	1	15	0	3	1	0	0	0	0	1	3	2	2	20	0	17	1	1	0	0	2	9	5	6	0	0	2	0	0	0	0	0	3	3	3	7	9	0	0	1	1	0	8	0	0	4	0	2	9	1	0
LakWasMe93_HOW11_2_rpkm	0	0	0	1	0	12	4	3	11	1	0	468	1	1	1	1	0	0	2	0	0	0	0	52	0	0	0	0	1	12	0	0	0	28	0	15	0	1	1	0	0	0	0	3	39	78	62	14	2	26	0	165	1	1	0	0	0	3	60	17	16	3	0	9	0	0	0	0	8	64	1	0	174	0	278	1	0	0	0	0	0	33	3	0	0	0	1	0	0	2	1	9	14	0	27	0	1	0	3	0	0	7	1	0	0	1	0	1	0	0	2	2	189	2	82	2	0	10	0	0	0	0	2	6	1	0	2	3	0	0	29	125	1	0	0	0	0	0	2	0	0	1	0	7	0	2	0	0	30	3	11	35	0	4	71	1	5	4	61	0	17	0	0	0	6	0	0	10	2	22	0	0	3	0	0	0	0	0	1	0	1	0	0	0	0	7	2	0	0	2	10	11	21	22	26	0	4	13	53	55	2	0	5	0	1	2	2	0	2	1	56	17	31	46	9	0	14	12	0	0	1	1	4	9	1	1	0	1	46	0	1	10	0	1	1	0	46	5	19	2	0	0	37	2	50	0	0	0	3	1	5	11	14	0	1342	92	0	0	0	1	7	0	1	91	5	0	11	0	23	149	3	0	32	0	0	1	0	6	6	9	0	68	8	73	46	1	0	0	24	3	0	1	0	2	4	1	0	9	20	0	0	47	51	5	0	2	9	154	6	2	2	0	94	49	0	1	2	0	210	0	1	1	0	2	0	18	1	0	2	0	0	3	9	0	0	0	83	0	0	0	0	4	25	3	29	1	10	4	1	1	5	13	1	2	7	0	1	0	0	19	14	0	5	0	0	59	3	47	3	24	0	78	0	0	17	0	0	70	4	11	0	0	19	4	8	0	66	0	0	0	0	1	449	2	1	13	31	0	0	36	1	8	0	6	39	1	4	0	2	13	0	10	14	469	1	19	57	5	4	0	0	0	0	0	0	0	0	2	1	1	0	0	0	0	0	2	1	2	8	0	48	2	0	1	0	76	0	0	0	2	0	185	2	1257	2	8	75	6	0	4	4	0	5	18	5	22	29	1	0	1	56	7	122	0	1	0	20	1	1	0	1	0	7	0	0	0	0	1	13	0	0	1	62	99	4	0	0	0	0	0	0	2	22	3	0	1	0	0	0	3	0	0	0	1	3	0	4	0	0	17	1	0	0	0	3	0	0	0	0	0	2	1	48	12	22	0	9	1	0	29	0	0	0	21	20	1	0	1	3	0	0	0	5	0	0	3	0	6	0	0	0	3	0	2	29	1	2	0	91	0	0	1	6	14	3	13	6	164	0	17	15	71	10	6	158	3	3	0	46	0	0	0	2851	0	21	14	0	0	0	0	59	1	8	31	15	8	0	25	1	0	0	406	24	78	3	0	340	2	549	1	25	6	170	27	0	14	0	8	1	11	1	2	0	0	1	0	0	0	0	7	2	252	0	2	0	6	1	23	5	1	8	0	8	7	4	0	4	1	5	3	0	23	3	1	1	0	7	0	4	1	0	31	1	0	2	0	3	0	2	0	1	0	10	1	0	0	8	0	0	45	0	0	22	0	0	0	1	18	0	2	0	0	0	10	5	7	5	0	80	0	2	0	2	22	16	6	2	0	19	2	0	3	8	11	0	0	1	185	33	2	0	4	1	0	0	0	0	2	0	0	0	45	8	1	5	125	4	0	0	4	0	0	34	0	0	2	3	0	66	3	0	5	0	98	0	3	11	0	0	0	0	0	0	1	0	91	0	0	0	0	0	0	7	2	0	3	0	0	0	2	3	13	1	0	0	1	7	1	0	5	0	1	1	0	4	5	83	1	0	0	0	0	6	0	30	0	1	0	0	0	0	0	0	0	73	1	0	5	2	4	17	0	0	0	0	3	2	130	62	0	0	0	0	0	0	0	0	1	35	85	0	0	9	0	0	1	0	2	0	4	45	2	0	2	0	4	0	0	7	1	0	0	0	0	0	0	3	0	2	0	0	0	0	2	1	20	48	0	0	0	0	0	0	0	0	0	0	4	0	0	0	0	2	2	0	0	2	0	0	0	0	0	0	1	21	6	6	25	4	1	0	0	0	2	0	1	0	0	0	0	0	1	0	2	0	0	1	0	0	4	0	0	0	29	13	0	0	6	0	0	0	0	0	0	2	1	0	0	4	0	0	0	0	1	5	1	0	0	0	51	0	4	22	94	2	21	0	66	0	0	75	24	11	0	5	0	0	1	0	0	0	2	2	0	0	0	1	0	0	0	0	2	0	2	0	0	0	0	1	0	0	0	0	0	0	0	0	169	1	0	1	51	1	1	0	26	0	0	14	2	20	0	0	0	0	0	0	3	11	2	0	2	0	0	0	0	0	0	0	0	4	0	0	7	1	1	0	0	0	6	0	0	0	6909	17	0	1	0	0	3	11	0	8	6	4	0	0	2	2	90	0	0	0	0	0	0	0	0	1	40	1	0	0	0	0	0	1	0	0	0	0	0	0	1	0	11	10	0	3	3	0	0	0	0	13	0	0	62	2	0	3	0	0	0	0	0	2	7	21	0	0	0	0	0	0	2	1	4	0	0	0	1	0	20	0	0	0	0	0	0	0	0	0	0	3	0	0	2	0	21	0	0	0	1	0	0	0	0	0	0	28	4	0	0	0	0	9	0	16	1	0	0	15	0	2	0	0	11	0	0	0	10	15	53	114	63	0	0	0	55	9	0	0	1	0	20	0	0	0	0	0	0	0	8	1	0	3	7	0	2	0	6	16	0	4	0	1	0	6	0	0	0	0	6	3	0	0	3	6	0	8	0	184	6	4	1	0	0	14	0	49	0	3	64	194	0	0	6	13	0	1	0	0	41	0	7	0	0	0	1	1	0	3	72	1	179	60	1825	4	74	0	3	0	3	0	35	3	0	23	1	0	1	0	0	2	13	0	2	3	2	3	0	0	0	4	45	4	0	0	4	0	2	0	0	1	0	1	0	0	1	1	0	25	0	0	0	3	0	8	0	0	0	0	4	2	0	40	7	70	3	0	0	26	1	0	1	1	0	3	15	0	0	3	0	0	0	20	17	0	1	0	0	0	3	9	0	13	0	1	4	0	1	23	40	2	0	13	2	0	0	0	0	2	0	38	2	34	127	14	24	35	8	19	0	0	43	4	14	0	3	3	6	0	22	16	0	16	0	10	1	1	1	23	12	5	0	40	0	0	0	0	0	1	45	1	0	0	0	6	1	2	53	4	0	7	0	21	17	0	2	0	2	1	2	0	1	1	7	0	0	0	7	2	1727	29	137	40	2	102	5	0	0	0	0	0	17	3	14	9	16	0	2	0	4	426	300	70	97	1	2	64	145	1	0	0	0	1	0	0	0	160	2	90	6	174	8	0	68	4	12	3	0	0	0	0	0	16	75	0	0	0	6	0	22	0	4	1	1	0	35	0	7	0	1	1	14	42	0	0	1	0	0	0	8	2	9	0	0	0	0	0	0	0	1	0	2	0	0	0	4	0	0	11	1	0	0	0	0	1	41	0	1	0	10	0	0	0	0	0	0	0	0	0	12	0	0	0	0	0	0	0	0	0	0	0	0	0	9	0	0	2	0	0	0	1	97	0	74	199	0	0	33	0	20	3	6	0	1	0	0	77	2	12	0	0	1	1	2	0	0	0	2	123	1	0	0	14	0	5	0	0	0	0	1	0	11	0	6	1	70	2	0	0	0	41	8	0	0	3	5	7	0	0	2	2	26	0	1	4	0	0	0	1	55	15	0	1	20	0	0	0	2	0	8	5	29	3	0	2	1	0	0	0	0	0	0	3	0	89	25	223	122	349	90	104	293	0	0	0	7	1	31	0	1	4	1	77	0	0	0	0	0	5	0	1	18	24	7	52	0	0	28	0	28	1	13	1	0	23	1	0	0	0	0	0	5	0	49	2	3	3	2	0	0	5	0	7	191	8	0	9	0	2	0	0	0	4	119	6	692	0	0	0	68	0	4	0	2	1	0	0	0	19	1	2	2	0	3	0	2	2	27	0	0	0	0	0	1	0	1	0	0	0	0	2	0	5	0	25	0	0	0	8	0	3	0	0	3	32	29	2	12	0	0	3	0	2	1	0	2	9	16	19	0	0	14	1	0	0	74	1	0	1	5	0	0	0	1	0	56	0	0	0	0	0	2	9	0	0	2	2	0	0	19	1	1	10	0	2	0	2	0	0	0	30	1	0	80	1	0	0	3	90	22	37	44	0	37	194	0	31	1	304	203	30	3	3	1	2	7	0	29	5	0	0	0	3	0	0	0	0	0	8	2	0	0	104	7	3	84	0	11	74	0	0	1	0	1	2	0	0	0	0	0	1	0	0	10	0	0	0	30	8	53	0	0	2	0	0	0	7	0	1	18	15	0	0	0	5	0	0	0	0	2	0	0	0	0	0	14	0	0	0	1	0	3	0	0	0	0	0	0	180	0	19	16	22	7	9	0	11	0	4	52	195	11	1	0	1	0	1	0	0	0	0	2	0	0	0	0	0	0	0	1	0	1	0	11	5	7	0	0	1	6	0	0	21	3	1	35	12	0	6	0	65	130	29	0	1	0	0	0	0	0	0	0	2	0	8	0	0	0	13	2	0	0	1	0	0	0	0	0	0	0	1	0	1	0	4	0	0	0	1	1	0	0	0	0	0	0	0	2	1	0	0	27	2	0	1	0	2	3	0	0	19	0	0	0	941	0	0	246	11	0	1	197	1	0	0	0	0	0	0	0	0	0	0	6	0	0	0	0	1	31	3	0	6	23	0	26	34	12	1	0	2	0	0	0	11	0	64	1	0	2	0	0	0	0	0	2	0	1	0	1	0	2	0	0	14	0	0	0	0	0	0	0	0	0	0	0	5	0	2	145	0	0	0	133	0	0	4	0	0	0	0	0	0	1	0	0	0	0	0	0	0	0	4	1	0	9	8	0	0	17	0	4	1	12	2	27	0	13	17	2	0	0	0	0	0	0	60	3	6	6	4	0	0	1	3	0	33	24	30	0	0	0	2	3	0	0	4	0	2	0	0	2	0	0	2	7	3	0	0	2	6	1	6	0	0	5	0	0	2	0	16	2	0	16	1	0	1	0	1	1	1	0	0	0	4	0	0	0	7	1	12	2	0	10	40	2	0	0	0	0	3	3	0	14	16	16	0	0	0	1	0	8	0	0	2	0	3	0	1	0	0	0	0	0	1	0	12	0	0	0	1	2	0	0	0	1	14	0	3	1	8	0	4	17	0	3	14	1	0	0	0	8	28	0	0	0	0	0	24	188	82	128	83	47	187	23	15	262	19	298	21	32	8	15	4	21	42	0	37	4	51	70	54	375	104	187	45	6	16	9	32	14	0	0	0	0	0	0	1	0	0	0	4	166	1	0	1	0	0	0	1	0	0	0	0	0	0	0	0	2	0	1	2	0	17	0	39	0	926	5	0	0	0	2	1	2	0	0	1	3	0	121	0	0	0	1	0	1	0	55	1	0	0	0	3	21	6	15	2	0	3	9	0	2	0	1	0	0	15	0	0	2	0	2	10	2	0	6	34	0	0	0	0	15	1	0	0	1	11	26	0	8	0	0	0	1	0	0	0	6	0	1	7	0	0	1	1	7	11	296	6	0	24	13	0	0	1	0	0	1	0	0	2	0	1	0	0	0	31	1	0	0	0	0	0	0	125	47	50	0	2	56	48	42	5	16	0	3	47	74	0	0	0	0	0	0	0	0	29	0	7	1	1	0	0	0	0	5	3	0	0	1	0	0	0	0	4	0	0	0	0	1	1	0	4	3	1	1	0	2	16	8	2	0	0	13	0	43	0	193	0	0	0	25	0	0	0	0	0	1	2	0	0	4	0	0	15	0	7	5	1	1	5	1	42	0	2	60	7	0	1	1	0	127	1	1	7	0	0	0	0	1	0	0	0	10	0	1	0	0	0	0	2	0	1	0	11	3	0	0	0	0	6	0	0	0	1	0	2	0	2	0	4	0	0	0	7	1	0	3	3	4	0	5	112	47	1	1	50	0	0	1	0	0	0	0	0	0	0	0	1	0	0	0	289	6	21	39	0	1	2	14	0	0	0	0	31	93	8	0	2	1	0	0	1	6	0	0	0	0	0	0	0	0	0	1	55	4	1	3	3	0	0	0	4	1	1	42	23	4	5	0	13	0	0	3	58	0	0	1	0	0	0	0	0	0	10	1	6	2	0	0	24	4	0	0	1	0	6	1	3	0	2	1	1	0	4	2	1	0	2	0	0	1	0	3	0	0	0	0	0	9	0	0	0	0	0	0	2	15	6	0	95	0	0	23	0	9	1	0	4	1	3	0	2	30	4	35	2	0	0	1	0	0	0	0	0	2	0	0	4	3	0	0	177	2	0	2	66	9	0	7	10	17	0	5	2	7	0	6	4	8	0	5	0	5	9	3	4	4	3	2	0	7	2	0	0	27	2	7	0	28	64	44	61	55	40	73	31	0	60	64	83	3	2	2	0	0	15	16	4	17	0	5	3	16	38	3	0	0	0	0	0	0	4	0	0	0	0	11	13	0	0	0	3	8	0	0	1	0	0	0	0	0	0	1	0	8	0	2	13	0	7	0	0	14	0	0	1	2	0	0	0	33	0	0	37	169	116	0	108	2	2	0	2	0	78	0	0	1	0	1	0	0	0	0	5	0	0	0	0	0	0	30	0	0	106	9	0	47	0	4	1	7	0	41	17	0	0	0	20	6	2	4	1	0	4	0	8	8	0	2	7	2	0	0	44	0	2	0	0	0	0	0	1324	43	6	5	0	0	0	1	2	0	0	66	0	21	0	1	0	0	833	221	206	2	2	0	21	0	0	0	92	1	5	0	0	2	2	0	0	1	0	0	1	0	0	0	1	0	0	0	0	0	98	463	0	5	0	0	0	0	0	3	4	3	0	0	0	0	0	10	0	4	2	0	3	4	0	11289	19	83	0	0	0	1	0	1	9	0	0	84	0	3	0	0	0	4	0	0	0	1412	0	2	12	0	3	0	0	0	0	0	0	0	0	0	0	0	0	50	0	0	0	0	0	0	0	0	0	0	0	0	0	0	0	0	0	0	0	1	0	0	0	0	0	0	1	1	4	0	0	0	0	0	0	0	0	0	0	1	1	17	0	0	0	1	0	0	67	0	0	0	1	0	0	230	1	0	1	0	2	0	2	257	14	0	2	0	0	24	0	0	74	0	0	5	5	2	0	0	0	0	2	0	1	0	0	0	0	1	0	0	0	0	0	0	0	0	0	0	0	0	2	0	0	0	2	0	1	3	0	1	1	1	2	0	0	4	2	1	0	0	0	14	0	5	0	2	76	5	3	15	0	0	0	1	0	0	0	15	21	0	1	2	0	14	2	19	0	0	0	0	1	0	0	8	2	5	0	3	6	0	1	1	0	8	0	1	0	5	6	0	0	0	3	0	0	5	0	0	3	0	0	6	89	6	0	0	0	1	0	0	0	6	9	57	0	0	0	0	0	0	61	533	0	24	0	0	3	1	0	0	0	0	0	0	0	4	1	0	17	1	1	2	0	0	0	0	0	0	0	0	90	12	30	5	0	1	3	0	0	14	0	9	0	0	0	0	27	11	0	0	16	0	17	7	617	0	0	106	0	1	0	8	67	0	0	0	7	8	5	0	0	0	0	0	7	0	0	38	3	0	2	0	0	0	0	0	2	0	1	0	0	2	0	521	1	0	0	0	0	0	3	308	0	1	0	24	0	2	0	0	0	0	0	1	12	0	0	2	1	0	0	4	1	11	0	0	2	0	0	0	0	0	0	0	2	0	0	0	7	9	3	1	7	0	0	55	0	2	0	0	5	0	0	1	0	0	0	0	0	0	2	5	0	0	0	0	3	0	0	0	0	0	0	0	1	2	3	0	0	0	0	0	0	0	0	4	9	0	0	0	108	1	5	38	39	0	0	2	0	0	0	0	0	0	0	1	0	0	1	1	3	0	69	0	1	0	0	4	0	2	0	7	0	0	12	0	0	0	20	1	0	9	0	0	0	0	0	16	0	0	0	0	0	1	0	0	0	37	3	1	2	2	3	1	0	0	0	0	0	0	0	0	0	1	1	0	0	0	0	0	0	0	2	0	0	0	32	0	0	0	0	143	0	4	0	0	0	2	0	0	12	0	6	3	0	0	1	0	0	5	19	4	0	0	0	5	0	5	1	0	0	0	0	0	2	0	0	17	0	0	0	0	0	1	0	0	1	1	0	0	2	0	0	0	0	2	0	0	20	0	151	0	1	0	0	1	0	0	6	0	2	12	0	0	3	0	0	12	2	0	0	13	0	0	2	0	0	0	42	0	5	11	0	0	0	0	0	0	0	0	0	0	0	0	0	0	0	0	0	0	0	0	0	0	0	0	0	0	0	23	0	0	0	0	0	0	0	0	0	2	61	0	3	25	13	16	0	0	0	16	0	0	25	1	4	97	0	0	3	2	3	1	6	2	0	0	0	8	27	4	0	1	9	105	0	6	2	1	0	26	2	7	3	2	0	1	0	0	3	0	0	0	1	0	0	0	0	0	0	12	0	17	0	0	0	1	2	0	0	0	0	0	0	0	0	0	5	1	0	0	0	0	0	90	0	47	4	0	0	0	0	0	0	0	0	2	31	0	0	0	0	0	0	0	0	0	0	0	0	0	0	0	5	0	0	0	0	29	0	3	2	31	0	0	0	0	0	85	0	1	0	0	0	3	0	12	4	0	9	4	3	0	0	3	0	0	0	0	0	0	291	0	0	0	9	2	10	0	0	287	0	10	0	0	2	2	0	0	2	0	2	0	30	0	12	0	0	0	0	0	0	0	3	1	0	2	0	0	0	45	0	0	0	0	0	0	0	0	0	1	0	0	0	0	0	0	0	0	0	0	0	3	0	0	0	0	59	2	0	0	0	0	3	13	5	1	0	0	0	0	0	0	0	0	0	0	6	0	4	0	0	0	6	0	0	0	6	0	1	2	0	0	0	0	0	0	1	0	1	15	28	0	14	0	2	0	0	0	1	1	0	0	56	6	0	0	1	0	0	0	26	0	129	1	2	1	1	0	1	0	0	4	1	33	0	0	0	0	0	5	0	0	0	4	2	129	3	0	7	2	0	0	0	0	5	0	45	0	0	33	2	0	0	1	0	1	0	1	11	0	0	3	0	0	0	0	0	0	3	0	8	0	2	0	0	5	6	0	0	0	0	0	6	0	0	0	0	0	0	2	0	0	7	2	2	25	0	5	0	0	1	5	0	1	0	16	2	0	0	74	122	8	541	1093	0	0	4	0	41	0	42	16	5	0	0	0	8	9	0	45	0	1	60	3	53	0	0	0	0	8	0	0	3	6	2	5	0	2	7	1	4	8	78	4	3	8	0	11	0	1	0	0	0	0	4	0	0	0	0	0	0	5	0	0	0	0	1	37	13	0	0	0	4	0	2	0	1	0	0	0	0	0	0	0	0	7	4	0	16	84	1	3	0	8	9	15	5	0	1	0	0	0	0	0	0	2	13	62	0	0	0	3	0	1	0	0	0	0	0	0	0	0	0	33	15	0	0	0	0	0	0	1	1	2	0	1	0	0	0	0	0	0	0	39	25	0	7	4	0	3	0	2	0	2	1	18	0	4	0	0	1	0	76	0	0	12	0	36	2	6	1	0	0	0	3	27	0	0	0	0	0	0	0	9	0	0	1	290	207	274	9	0	34	5	94	29	6	22	23	11	15	322	27	0	16	19	56	23	4	29	80	4	416	20	39	0	1112	0	0	0	0	4	0	56	0	0	0	1	0	1	0	0	1	0	0	0	5	4	0	2	28	1	9	0	1	0	6	1	0	0	52	0	0	0	1	0	0	78	0	55	0	0	0	0	0	108	12	0	1	0	0	7	0	3	4	4	1	17	0	0	0	0	4	0	15	35	1	25	53	23	0	0	0	1	0	0	0	0	0	0	1	0	0	0	3	2	0	0	0	0	6	0	0	0	0	51	2	0	1	0	3	2	0	0	2	21	3	4	3	24	0	1	1	0	1	0	17	4	1	8	5	5	28	0	0	0	0	5	0	0	0	12	0	2	1	0	176	5	0	3	2	0	0	0	8	0	9	2	0	4	151	34	0	0	14	0	0	39	5	6	18	3	2	4	2	0	0	0	0	0	0	0	0	0	0	0	0	0	0	0	0	0	0	4	53	0	0	2	25	1	0	0	0	0	0	1	84	0	0	9	3	20	14	5	22	19	1	0	1	35	2	14	0	0	41	0	21	0	0	0	4	18	0	0	0	12	0	0	1	0	0	9	0	0	0	58	0	0	0	0	7	0	0	0	11	0	0	2	7	0	0	0	0	0	6	25	1	0	0	0	0	0	2	0	2	0	0	0	0	0	0	1	18	26	0	43	0	0	1	0	1	0	4	59	0	0	1	0	6	0	26	0	0	0	0	0	0	5	0	18	0	0	0	0	0	2	0	0	8	0	2	1	25	5	12	3	0	84	1	0	20	1	5	1	0	0	0	1	2	13	2	0	0	0	1	0	0	2	0	0	0	0	0	0	0	13	76	0	0	0	0	2	0	0	0	0	141	3	8	0	16	0	0	0	38	0	0	0	10	0	0	0	19	18	0	1	0	26	0	5	5	0	2	0	8	0	0	0	0	0	0	0	0	2	0	1	0	2	0	1	19	1	0	0	0	83	7	37	5	0	0	1	2	0	1	1	0	3	0	0	62	6	0	0	0	0	1	2	0	2	39	1	69	7	14	83	1	0	2	0	0	1	67	9	2	2	12	6	5	0	0	0	4	75	0	25	10	10	30	20	33	124	0	0	0	0	24	0	18	0	9	0	3	0	0	0	0	0	0	0	0	0	7	0	2	0	1	0	3	0	0	0	0	106	45	0	0	0	0	19	6	101	0	5	0	2	0	0	11	0	0	0	0	0	4	10	3	81	0	0	0	3	2	0	12	0	7	0	0	0	0	0	0	3	0	0	2	10	0	0	7	0	1	16	0	1	0	0	1	0	0	59	1	0	1	2	0	1	26	0	6	0	0	185	1	0	2	3	0	6	0	0	1	0	0	6	0	0	19	0	9	8	2	0	1	1	0	246	2	2	11	0	45	0	6	0	0	16	0	0	0	1	3	3	2	0	0	3	0	0	0	2	0	252	0	9	0	0	387	0	0	0	0	0	8	10	0	10	0	0	1	135	0	16	38	0	0	1	0	0	4	0	0	7	0	1	0	9	0	4	1	0	0	0	0	24	10	0	0	15	0	0	0	13	0	0	15	8	4	0	0	0	0	7	0	4	0	0	1	1	0	0	0	0	0	2	0	0	0	0	0	0	0	0	0	0	0	0	0	0	0	0	0	0	0	0	0	0	181	0	0	0	0	0	2	97	0	5	0	0	10	0	0	0	0	0	2	0	1	2	13	0	0	0	0	0	0	0	0	0	1	19	0	2	4	0	0	8	0	0	0	0	0	1	2	8	0	1	0	0	6	1	2	0	1	151	2	0	0	0	0	0	0	2	0	0	4	0	3	4	0	0	5	0	0	1	0	0	6	0	4	0	0	0	0	15	0	0	0	0	0	15	1	1	0	0	2	0	0	1	0	0	5	0	5	0	0	0	0	10	40	0	0	0	0	0	0	0	0	0	0	0	9	0	6	0	0	0	0	0	0	0	2	43	0	0	0	0	0	0	0	0	17	0	0	11	0	0	0	0	0	0	0	0	0	0	0	5	0	0	0	0	0	0	0	0	0	2	5	0	0	0	0	0	0	0	14	0	0	2	0	4	318	16	0	0	0	0	0	7	2	3	8	0	5	0	0	2	0	30	0	1	0	0	0	0	0	0	0	0	0	3	3	3	0	3	0	0	1	0	88	8	26	3	10	0	1	2	0	1	24	3	4	0	7	515	45	54	28	1	3	34	0	70	0	1	1	14	37	0	5	55	1	0	3	5	0	0	0	214	12	7	6	92	445	0	0	0	388	5	11	0	4	6	2	0	0	21	0	3	0	0	3	0	0	0	0	43	0	0	22	4	0	1	1	2	45	1	953	1	13	3	35	11	60	2	7	21	0	13	1	1	27	9	0	0	0	11	0	5	0	0	0	0	0	17	1	26	1	3	0	0	3	36	40	2	3	0	9	279	27	2	0	1	1	0	0	1	0	0	0	0	1	0	10	0	0	0	0	11	0	7	1	7	8	0	2	0	0	4	0	1	8	1	2	1	2	0	0	4	0	0	0	0	0	0	2	0	0	6	0	0	0	2	2	0	1	1	8	1	1	0	0	1	3	2	6	1	1	7	0	5	5	2	0	4	0	14	0	3	0	76	4	1	3	2	4	2	0	0	3	1	0	17	29	0	0	239	0	0	80	10	20	7	24	7	38	3	0	24	2	0	1	22	8	0	0	2	1	1	1	3	0	0	0	0	0	0	0	0	0	3	0	2	7	0	0	19	1	0	0	0	0	0	0	5	3	2	31	14	412	4	0	0	2	0	39	0	0	0	15	4	26	29	5	6	0	0	0	3	2	2	0	0	0	452	0	0	6	43	0	51	0	3	0	0	31	4	37	3	0	36	0	0	0	4	19	0	0	15	2	0	50	11	44	4	34	1	2	0	2	23	0	0	0	0	0	0	0	0	0	2	0	0	0	15	0	1	1	0	1	5	1	8	0	1	0	93	7	23	2	0	120	9	1	0	1	8	0	143	0	10	34	35	6	10	49	7	47	6	48	0	1	1	0	4	30	2	0	0	0	1	1	2	0	0	0	0	0	20	1	6	5	3	46	20	308	0	86	319	0	0	14	2	1	0	0	0	0	1	1	1	0	0	0	0	0	0	28	30	6	0	1	8	6	0	13	0	4	2	1	9	0	0	0	5	0	4	0	0	3	0	1	32	2	136	3	0	9	0	414	206	47	14	0	0	7	2	0	0	36	5	2	0	1	0	0	0	4	89	0	2	0	67	33	49	148	0	0	0	0	1	15	0	1	25	0	7	0	1	1	1	3	0	60	62	37	4	5	4	5	14	8	4	15	0	2	0	0	9	2	0	2	3	12	0	59	141	13	16	265	5	59	1	0	0	4	2	1	8	0	0	1	0	0	59	24	0	0	9	0	158	12	1	2	0	0	0	0	56	16	9	1	10	0	1	0	328	0	46	49	61	46	67	52	1	1	206	50	0	42	5	2	0	27	41	3	10	4	0	0	0	0	0	0	0	92	6	0	0	0	1	2	8	2	464	472	4	15	0	75	0	312	219	125	2	0	129	3	0	0	1	0	0	0	0	1	0	0	1	0	1	0	0	4	0	10	0	0	3	1	0	0	17	0	20	0	1	71	3	14	1	23	4	65	37	0	1	0	0	0	0	117	108	5	1	14	3	1	1	37	0	0	7	0	3	1	16	0	0	0	0	2	1	1	25	60	0	2	0	1	0	2	2	0	6	0	0	0	0	0	88	2	9	9	865	6	0	0	0	0	0	11754	4	1412	0	22	0	18	13	6	5	0	0	0	0	0	0	0	4	43	1	21	2	0	0	0	0	0	45	201	2	0	5	634	1	0	19	0	0	4	0	0	0	1	350	0	2	0	0	0	0	0	0	0	15	1	2	2	1	0	0	1	5	0	0	0	0	0	1	1	15	10	0	68	0	0	1	0	0	5	0	0	79	0	0	4	0	0	0	0	0	58	1	0	18	3	0	3	0	1	0	3	0	712	0	1	12	26	0	0	4	4	10	0	30	17	29	1	0	0	0	0	3	1	0	5	0	1	0	1	85	0	0	2	8	2	4	0	4	0	0	10	0	2	2345	0	34	10	0	216	0	2	104	4	51	24	427	308	227	17	89	41	121	0	3	43	3	7	16	2	1	3	0	1832	2	11	5	15	0	46	1	0	0	4	59	28	0	1	8	18	0	23	0	1	1	23	17	49	8	32	9	21	0	29	0	2	0	41	2	14	42	4	5	0	0	1	0	0	0	0	4	31	2	0	0	1	59	0	1	29	0	3	0	0	0	40	0	1	0	6	0	1	54	0	0	0	4	0	2	2	0	26	4	10	0	43	5	0	61	5	1	0	4	124	693	0	46	0	9	235	0	7	12	0	15	1	50	2	0	5	0	1	8	4	23	153	4	0	6	0	70	7	0	0	18	3	2	0	10	1	24	0	1	14	90	0	0	2	0	1	0	6	8	0	3	14	0	3	2	0	0	1	0	1	0	2	0	0	58	0	4	16	5	1	11	61	23	0	0	0	0	0	4	1	1	31	0	0	1	6	58	0	53	80	0	0	19	2	2	2	2	6	0	2	0	2	26	1	42	103	66	41	1	0	0	0	0	0	0	0	0	8	2	0	2	1	0	0	0	3	27	67	3	0	7	0	4	1	0	0	0	10	6	1	2	0	0	4	0	0	0	4	3	0	0	0	0	0	2	0	0	24	0	0	0	0	0	0	27	7	0	1	0	25	27	0	0	0	3	0	0	0	22	0	0	42	0	0	0	0	5	0	1	6	5	9	0	8	0	0	1	0	0	0	0	0	20	65	0	0	0	1	0	2	42	2	71	0	1	0	0	0	8	0	27	1	39	22	5	0	1	0	1	91	0	0	0	0	5	312	339	56	208	2	236	168	2	330	0	187	3	0	17	347	444	227	353	367	43	84	145	95	0	108	2	0	51	91	36	0	15	524	0	328	272	3	180	1	341	15	0	147	7	101	135	18	174	0	0	0	6	151	2	0	213	186	82	55	1	6	12	322	620	1719	0	20	147	1	0	0	0	0	31	3	73	0	4	0	34	14	132	5	0	13	1	0	1	1	0	38	19	27	15	11	13	12	16	61	103	0	7	41	46	1	38	2	2	1	49	56	0	5	73	9	19	1	58	2	1	22	3	0	0	0	32	0	8	2	72	0	0	3	1	0	0	0	58	1	2	0	0	3	34	2	6	5	1	0	21	1	1	7	52	0	1	0	0	0	0	0	0	3	2	1	1	1	0	0	4	7	0	5	2	10	2	5	32	67	36	43	4	10	0	25	2	0	0	7	0	0	0	0	1	1	0	0	0	0	0	0	2	1	3	1	0	1	45	1	1	0	1	3	0	0	0	0	0	0	3	4	20	0	0	36	0	0	0	0	4	0	95	1	44	107	0	82	1	172	1	0	0	0	3	6	0	0	0	2	1	0	0	17	3	18	0	1	1	2	3	0	1	0	0	2	8	0	2	10	1	6	0	1	73	50	0	0	0	27	2	0	20	5	69	16	14	1	0	4	0	0	104	0	217	0	0	0	5	24	2	1	15	24	2	20	81	0	0	70	10	0	13	120	47	16	0	9	3	0	6	57	12	13	1	0	3	1	0	0	4	2	17	1	2	0	15	1	17	33	8	37	1	0	0	0	0	0	3	5	6	0	97	11	0	0	6	1	0	0	0	0	66	12	5	0	6	3	3	1	6	2	2	1	0	0	0	3	0	0	0	0	2	1	0	0	0	3	0	39	2	27	2	2	18	2	1	0	0	1	2	0	30	6	1	0	20	0	7	0	0	0	0	2	0	19	0	2	42	58	31	0	0	3	0	4	2	1	1	0	0	0	0	6	2	1	0	0	0	0	0	2	2	0	0	0	30	31	0	2	0	0	0	1	0	30	0	17	15	0	0	0	0	6	3	1	3	6	11	1	0	4	0	0	3	1	16	8	0	0	59	9	1	0	0	61	0	33	0	2	174	0	0	30	0	0	1	0	0	0	2	2	20	80	2	1	21	4	34	0	4	1	0	110	0	0	0	0	0	497	0	1	0	0	0	1	1	1	0	1	0	2	2	2	0	0	1	0	0	0	1	5	24	15	0	0	1	0	43	2	3	0	0	2	82	27	0	3	4	1	249	2	73843	0	0	0	0	1	2	0	0	0	0	0	0	0	0	6	0	51	0	0	0	0	2	13	134	1	10	3	28	3	0	2	0	1	0	0	4	2	22	54	4	22	6	0	0	0	0	0	1	0	13	0	0	6	0	9	23	19	115	102	0	8	16	0	13	0	0	2	2	0	137	71	173	204	4	0	0	9	5	12	0	4	227	7	1	343	0	0	0	0	8	0	495	17	5	78	4	0	117	23	0	0	36	66	1	0	94	2	0	1	1	2	0	0	1	2	0	6	0	60	130	8	167	304	0	17	237	0	355	67	16	489	149	218	161	71	82	102	217	0	28	162	4	86	48	5	0	0	160	124	154	369	241	6	22	1	0	106	50	3	7	4	0	0	0	0	0	2	0	0	0	0	0	0	8	3	8	3	28	0	0	0	34	0	11	7	0	17	58	20	12	0	1	0	2	0	14	3	0	0	5	0	1	0	0	0	29	16	0	6	1	0	0	213	72	0	1	0	7	0	1	0	0	5	2	0	0	0	0	2	2	16	1	6	9	43	2	0	0	15	0	0	94	0	1	70	0	23	0	0	9	45	11	0	10	19	1	43	9	0	14	11	0	5	1	0	1	2	0	0	5	0	0	3	0	2	3	0	4	2	0	0	6	0	28	2	4	0	0	1	0	1	0	2	0	1	0	2	0	0	0	2	0	1	2	1	0	0	0	0	4	0	5	46	2	4	3	2	1	0	1	0	0	1	5	5	25	38	57	62	73	14	0	13	22	120	91	33	38	0	3	4	0	46	0	0	9	0	38	4	15	6	0	0	0	0	0	0	0	0	101	10	151	0	29	14	10	0	0	0	0	615	9324	0	0	0	0	0	8	0	56	3	53	3	2	18	1	45	23	1	3635	0	4	0	35	23	1	23	1	630	0	0	25	2	447	1	0	0	0	10	0	0	0	42	0	8	134	43	53	0	1	0	46	3	0	6	1	2	0	2	6	0	0	0	3	0	6	12	1	0	0	0	0	2	10	2	3	9	14	0	7	5	1	1	0	0	0	2	51	111	35	56	82	44	26	135	1	4	18	16	32	17	0	0	4	1	5	0	1	0	5	0	0	0	44	1	3	1	1	1	0	8	0	13	3	13	0	3	2	2	6	3	0	3	19	1	0	5	1	2	0	3	0	94	1	61	0	4	0	2	3	18	1	13	0	2	0	0	0	18	0	13	0	0	0	10	145	0	0	2854	0	3	1	2	0	1	5	7	14	9	3	0	1	0	0	0	0	0	2	0	2	0	0	0	0	0	3	1	0	0	19	0	24	33	220	95	33	64	0	0	0	0	0	0	0	0	0	0	0	1	0	0	0	0	0	97	2	1	1	1	2	9	2	0	0	0	0	0	1	38	0	1	146	0	0	5	3	1	38	0	0	37	2	12	6	20	41	8	98	150	155	0	273	15	2	209	168	30	9	78	0	0	52	3	0	3	11	419	126	3	0	0	1	0	0	252	0	22	1	0	620	0	44	2	0	5	1	4	2	12	0	0	0	2	0	0	0	0	0	0	0	1	2	0	0	2	21	196	8	0	0	0	7	0	0	0	0	47	3	0	1	0	0	0	39	7	0	1	0	0	8	2	1	0	23	4	0	65	5	15	0	3	0	0	0	34	2	29	0	1	0	4	0	0	250	0	3	1	0	14	3	1	0	43	117	11	0	315	1	28	51	16	0	55	0	287	61	73	9	104	0	0	30	3	27	0	10	0	68	1	0	1	0	101	1	2	242	2	1	0	1	6	89	0	0	1	0	0	19	16	1	0	1	0	55	0	0	16	0	2	1	12	13	6	2	0	0	113	10	9	0	0	3	0	3	0	0	8	0	3	3	0	0	9	0	0	0	0	1	0	0	7	15	18	7	33	13	0	14	30	38	50	93	203	0	0	0	16	0	0	0	0	0	304	2	0	1	176	86	36	18	2	137	1	0	22	13	0	2	12	4	0	0	0	1	0	0	0	4	184	101	6	0	0	0	0	2	3	0	0	0	139	6	7	10	0	0	0	0	0	0	0	0	0	0	0	0	0	0	0	0	1	0	2	0	1	0	0	0	0	0	0	0	1	0	0	0	1	0	0	0	0	0	0	1	6	0	0	0	20	0	9	0	0	6	1	9	1	0	1	4	0	0	7	0	4	19	806	26	70	7	0	4	2	2	0	2	11	28	0	0	0	0	30	0	25	1	0	41	0	2	22	0	10	27	0	5	7	61	11	139	3	0	3	0	4	0	0	0	0	35	2	25	3	25	3	63	8	2	131	1	3	14	5	0	2	0	19	129	108	100	0	66	31	39	1	70	0	11	0	2	25	0	1	1	2	5	0	1	0	0	1	0	121	21	0	0	0	18	2	15	60	2	42	2	0	20	4	38	3	16	40	7	7	57	7	64	2	0	0	2	0	28	0	1	0	140	2	25	4	0	0	32	2	0	0	0	0	0	0	2	0	0	3	3	0	5	37	20	4	188	45	76	314	19	1	17	0	0	0	0	0	36	2	10	0	0	4	49	0	0	4	15	7	8	0	1	1	0	0	70	15	89	1	12	94	0	0	0	0	0	0	51	0	78	0	9	350	0	1	1	28	4	9	0	0	0	0	0	0	1	0	0	0	11	11	0	1	0	0	0	0	1	0	0	0	0	2	1	0	0	0	14	3	1	0	0	0	1	5	3	0	54	8	69	31	0	33	65	22	60	51	22	35	0	0	1	2	0	0	0	0	0	0	0	0	2	0	0	10	0	0	0	3	13	0	0	1	4	5	0	41	0	0	0	0	12	11	0	3	0	0	0	2	0	0	10	3	0	0	0	0	0	0	0	0	50	0	3	4	4	6	0	7	24	7	3	38	0	0	0	0	0	2	0	6	28	0	78	0	0	4	4	1	31	542	0	0	2	0	0	0	0	0	0	4	0	0	0	0	2	0	0	9	0	24	0	0	0	0	0	6	0	28	1	0	5	0	0	3	3	0	142	0	1	0	0	0	4	0	0	1	0	0	0	0	29	0	2	3	0	6	0	0	0	0	0	1	0	0	0	0	0	0	1	0	0	41	4	1	0	0	0	0	28	0	0	47	0	1	0	0	0	5	12	0	0	4	0	0	0	0	0	0	2	0	2	0	2	0	0	2	3	0	0	0	0	0	0	0	0	0	0	0	0	0	0	0	0	0	0	0	0	0	0	0	0	0	0	0	0	11	0	0	2	0	0	0	1	12	0	0	0	8	0	0	0	14	0	0	2	0	0	0	4	0	2	0	0	0	0	1	0	0	0	0	1	0	0	15	2	0	2	0	0	0	1	0	0	0	0	0	0	0	0	0	0	0	0	0	2	0	0	0	1	0	6	0	0	1	1	0	0	3	0	0	0	3	0	0	3	0	0	4	0	0	0	4	1	2	1	0	1	4	0	2	0	1	45	1	14	0	0	2	0	0	0	5	0	2	0	0	0	1	1	0	0	2	0	1	0	0	4	0	2	6	0	0	4	1	1	3	0	0	1	1	0	11	0	2	0	0	1	2	4	0	4	0	0	0	0	1	1	0	0	3	0	0	0	1	5	0	0	0	0	0	0	0	6	0	1	0	112	0	0	0	0	0	1	2	3	0	0	5	0	0	4	0	0	0	5	1	6	4	0	0	3	0	2	2	4	0	0	0	0	0	1	73	0	5	0	8	3	9	1	11	114	5	0	0	0	1	54	0	1	0	4	0	0	0	0	0	0	49	1	635	0	0	0	10	0	0	0	242	6	2	0	1	1	0	0	277	2	112	0	760	29	0	2	0	53	0	6	0	0	0	0	0	0	0	0	4	6	3	24	0	27	10	1	0	0	3	5	0	0	0	5	3	4	0	0	0	0	1	0	0	0	0	0	0	0	0	0	0	0	43	0	1	0	0	1	0	6	11	3	0	0	0	0	2	1	0	0	6	0	0	0	288	2	0	7	93	0	2	0	0	6	0	0	0	1	1	0	1	1	0	0	1	1	0	267	0	1	0	0	0	2	2	1	0	0	189	0	9	1	2	0	1	0	0	0	0	2	0	0	0	0	0	0	0	0	1	0	1	47	26	6	86	47	0	5	0	0	0	35	51	0	3973	0	5	5	5	0	0	0	0	104	19	16	0	2	0	0	15	7	0	0	0	37	7	4	31	0	11	33	78	0	3	0	1	0	1	6	4	6	0	0	6	6	0	0	0	0	1	0	1	1	20	3	4	17	0	0	0	0	0	0	16	1	22	14	42	41	0	69	92	2429	1	110	3	7	78	1	0	12	1	1	2	0	0	0	1	29	9	0	0	0	0	87	5	0	0	0	144	0	0	3	0	2	14	2	0	8	0	6	115	0	66	0	0	0	0	0	0	0	5	9	2	9	3	15	0	8	0	0	11	0	7	0	0	0	0	25	0	30	0	2	0	41	65	2	5	20	2	2	0	0	10	2	58	33	0	1	0	1	0	1	1	0	0	0	1	0	0	11	1	0	15	85	0	0	25	1	2	51	29	22	0	0	0	5	24	2	41	71	0	0	0	1	26	7	20	37	7	28	8	0	1	0	4	0	0	0	3	57	5	116	4	63	10	4	0	0	1	1	46	21	0	0	2	0	3	11	3	0	8	16	8	0	20	0	0	1	3	14	1	15	35	31	58	1	3	21	54	29	2	0	1	7	0	0	2	2	0	0	106	0	36	0	1	12	11	17	77	18	9	0	0	1	0	32	0	0	0	1	6	0	2	0	0	0	34	23	29	65	1	26	0	1	0	6	0	14	0	23	0	12	0	1	0	21	7	5	29	5	31	4	0	0	0	32	85	0	0	4	0	0	19	0	1	6	0	0	0	0	14	33	7	0	14	2	25	0	1	1	0	0	0	6	0	50	0	0	0	67	0	0	190	0	40	1	2	23	2	0	0	1	1	0	40	7	0	1	4	1	0	5	0	0	5	59	18	0	1	37	22	12	0	1	0	0	2	13	0	0	0	0	11	33	0	0	0	164	38	0	203	52	104	129	193	0	72	102	192	0	247	1135	179	174	5	46	45	0	1	1	7	0	0	0	2	2	1	2	3	17	2	0	1	12	0	0	0	1	0	0	1	0	42	0	9	13	10	6	0	0	0	0	0	0	0	0	0	0	0	0	0	0	0	1	0	0	1	0	0	0	5	0	0	0	17	24	0	0	0	0	0	0	0	0	0	0	0	0	0	0	0	0	0	0	0	0	0	0	15	0	57	38	1	192	5	0	1	10	1	0	0	44	14	37	4	3	8	50	0	0	2	2	3	9	1	0	0	0	0	0	0	57	11	4	7	87	108	0	3	2	21	4	31	1	18	0	1	12	0	5	3	0	0	4	50	0	2	1	1	1	32	2	50	9	18	0	34	28	19	0	19	3	4	0	0	17	0	0	0	185	58	0	0	0	2	1	0	0	13	9	17	0	0	19	285	6	7	4	8	0	0	0	0	18	7	2	3	810	8	0	0	0	2	119	0	0	0	0	19	0	7	8	0	2	0	0	5	12	0	3	9	63	67	5	20	0	6	7	26	0	12	0	4	0	1	7	9	1	28	0	0	1	0	1	26	11	0	0	46	25	4	34	6	26	1	19	18	0	13	2	29	7	0	8	0	0	26	1	3	2	6	22	3	14	1	4	2	0	0	0	0	2	2	0	0	0	0	2	0	9	2	0	0	0	0	3	0	0	0	0	0	0	1	1	0	7	0	0	1	2	0	0	0	20	5	0	21	41	0	5	0	3	28	341	59	63	29	0	13	408	88	0	8	99	0	23	0	35	2	16	1	0	48	0	54	23	3	4	3	1	1	6	2	257	13	0	0	58	14	411	0	0	0	0	0	0	0	9	0	0	1	0	25	0	0	0	0	0	12	1	180	0	88	23	11	0	54	1	13	0	0	0	0	0	4	0	0	0	97	0	59	2	0	9	114	0	35	13	770	6	1	0	0	1	110	0	42	21	27	32	10	23	1	19	19	2	0	0	0	2	2	6	0	1079	74	19	0	2	0	0	0	0	39	0	1	0	4	0	4	0	146	28	0	0	1	164	15	4	3	0	15	136	51	94	1	3	0	0	0	3	0	34	2	6	2	1	0	1	2	6	0	0	20	1	0	2	0	3	0	0	0	0	0	3	0	240	1	0	3	0	199	10	104	1	1	0	9	7	20	0	0	1	53	32	0	4	12	0	43	4	0	1	7	0	0	0	0	0	0	5	8	4	84	85	22	18	59	1	0	76	8	13	28	0	0	0	1	3	0	1	2	6	0	2	3	71	0	0	0	0	0	0	0	31	0	4	3	51	2	30	4	3	18	1	35	0	0	11	1	5	0	0	9	18	22	18	47	61	27	198	1	159	0	0	0	0	0	8	0	0	0	4	6	7	1	2	1	0	0	3	11	0	0	0	26	0	0	0	2	9	5	5	3	0	270	0	410	0	0	377	0	0	0	0	0	0	0	0	11	83	0	0	0	0	0	3	4	2	3	0	65	1	12	0	1	0	4	0	3	152	0	0	37	0	6	1	2	0	32	4	1876	86	103	89	19	84	64	65	54	123	76	16	0	15	24	0	0	2	2	0	1	0	5	4	2	3	7	0	1	0	0	1	3	2	0	0	0	0	0	0	0	0	0	2	0	0	0	2	0	0	0	0	0	3	0	0	0	0	5	0	1	0	0	21	1	0	91	1	103	131	2	94	0	0	0	13	0	0	11	0	2	1315	0	0	62	41	0	0	0	116	0	10	1	7	26	57	0	0	1	0	4	0	0	2	1	0	1	0	0	0	14	5	22	0	73	1	12	9	8	2	0	0	1	0	0	20	1	10	0	12	87	49	0	22	1	8	2	27	0	0	0	39	2	1	4	0	0	0	1	0	1	11	1	0	0	2	13	0	3	4	11	14	2	2	0	0	0	0	0	0	0	4	4	0	4	10	19	0	4	2	0	3	0	0	0	7	0	0	4	5	3
LakWasM100_LOW12_2_rpkm	0	0	0	0	0	19	9	0	0	0	2	2	6	0	0	0	0	0	11	0	0	0	0	28	0	1	0	0	0	7	0	2	0	6	6	8	6	0	0	0	0	0	0	7	30	43	61	11	0	6	0	30	0	0	0	5	0	21	147	10	305	0	0	5	0	2	0	0	5	46	0	1	0	0	2	0	0	2	0	0	0	11	0	0	1	0	0	0	0	0	0	0	7	2	12	0	0	0	0	4	0	0	0	1	0	0	0	0	0	0	0	3	133	1	64	2	0	0	0	0	0	0	0	5	0	0	1	0	0	0	0	47	24	0	0	0	1	0	37	0	0	0	0	7	0	0	0	0	14	5	5	26	13	1	30	0	8	7	22	1	10	3	0	3	26	0	0	5	0	18	0	0	0	0	0	0	0	0	0	0	0	0	0	0	0	8	0	0	0	16	2	2	3	12	0	0	0	15	14	83	17	0	17	0	0	0	26	0	21	4	9	4	48	13	11	0	38	1	0	6	1	4	25	1	3	15	0	2	13	0	0	0	0	1	0	0	12	23	20	6	0	0	21	11	30	37	0	0	14	13	14	4	14	0	1346	476	0	0	0	0	1	0	0	14	12	0	0	2	0	18	21	0	2	0	0	0	0	0	50	68	0	23	37	28	29	0	1	0	9	0	1	0	0	0	2	0	0	6	2	0	0	11	65	0	12	0	17	26	29	0	36	0	21	12	0	0	0	0	0	0	0	0	0	1	13	43	1	1	3	0	1	0	0	0	0	0	0	0	0	0	0	0	34	45	7	9	5	13	0	0	3	0	44	0	10	0	0	0	0	113	17	0	1	0	0	59	7	28	38	105	0	31	0	0	3	6	0	18	0	3	0	0	2	3	8	0	94	0	0	0	0	0	82	2	0	8	139	0	0	36	0	22	0	0	16	0	19	0	0	2	0	13	15	2	1	51	32	2	0	0	0	0	0	0	0	0	0	0	4	0	17	3	1	0	0	0	0	0	5	0	17	50	0	0	51	65	0	0	0	0	0	128	48	76	0	44	26	5	0	19	0	0	1	3	0	18	11	0	0	18	29	231	8	1	0	0	10	3	875	0	2	0	9	1	0	0	0	164	15	6	0	0	58	38	7	0	0	0	0	0	0	1	4	0	0	1	0	1	0	0	0	0	3	0	1	0	0	0	0	9	0	0	0	0	0	0	0	0	0	0	0	0	1	1	15	0	4	1	0	8	0	20	0	11	7	0	0	0	15	0	0	0	1	0	3	30	0	0	0	0	0	1	0	0	20	0	33	6	37	0	0	1	0	0	31	138	243	240	0	62	339	214	110	123	43	0	29	4	10	0	0	0	10	0	3	9	0	0	4	0	12	0	0	0	6	7	0	85	0	32	0	117	173	46	0	0	49	0	142	0	230	53	39	7	0	3	2	18	0	1	2	11	0	0	0	0	0	2	0	1	1	62	0	0	0	1	7	6	2	1	87	0	3	25	0	0	1	0	0	0	8	116	0	159	0	0	0	0	6	16	92	20	1	0	2	0	9	0	0	2	1	1	2	0	0	0	1	0	0	19	0	0	3	1	1	0	0	10	0	6	0	0	0	3	0	0	1	0	21	0	1	0	0	1	10	7	0	0	7	0	0	0	3	0	6	0	7	0	14	1	0	0	2	0	0	0	0	0	0	27	0	23	11	0	22	47	18	0	0	24	1	0	2	0	0	10	0	0	152	0	1	12	0	57	0	3	1	0	0	0	0	0	0	0	0	30	0	0	0	0	0	0	2	0	0	0	10	0	0	7	3	0	1	0	0	0	7	0	0	20	0	0	0	0	281	0	10	0	0	0	0	0	0	0	0	0	13	0	0	0	0	0	0	48	13	0	0	3	1	0	1	0	0	0	0	0	0	53	36	0	0	0	0	0	0	0	0	12	26	27	0	0	5	0	0	0	4	0	0	31	25	0	0	1	0	0	0	0	4	5	0	0	0	1	0	0	0	23	0	67	0	0	0	0	0	2	2	0	0	0	0	0	0	0	1	0	0	0	0	0	0	0	17	3	0	0	1	0	1	0	0	0	0	1	39	36	86	18	28	0	0	0	0	0	0	0	0	0	0	0	23	0	1	0	0	0	0	0	0	27	0	0	0	5	9	0	29	4	0	0	0	0	0	0	0	1	0	0	0	0	0	0	0	0	0	0	0	0	0	0	1	14	8	266	6	34	0	0	0	0	26	7	15	0	33	0	0	14	1	0	0	1	0	0	0	0	0	14	16	0	0	7	0	0	22	0	0	0	0	0	0	0	0	0	0	0	0	60	0	0	0	77	10	0	2	3	0	0	0	6	0	0	0	0	0	0	0	0	251	0	0	0	0	0	0	0	1	11	1	0	0	0	0	7	7	0	0	0	0	0	6	5	0	34	0	0	0	0	244	2	26	0	0	0	2	0	12	2	4	18	0	0	0	0	0	0	0	0	0	15	0	3	0	0	0	0	2	0	0	1	0	0	0	0	0	9	89	0	11	95	0	0	0	0	14	0	0	8	2	0	0	4	0	0	0	0	28	47	12	0	10	0	0	0	0	6	1	0	0	0	0	0	0	0	0	0	0	0	0	0	0	1	0	0	20	0	0	0	0	22	0	11	0	0	0	0	0	0	0	0	31	14	1	0	1	0	5	0	2	0	0	0	5	0	0	0	0	2	0	0	0	1	5	10	112	109	7	2	0	10	1	0	0	5	0	1	8	0	0	0	0	0	9	0	0	1	1	2	0	0	0	1	6	0	0	0	0	0	45	0	0	0	0	1	0	0	0	26	10	1	18	0	0	14	0	0	0	1	0	0	2	0	0	84	77	0	0	3	0	0	40	0	0	18	0	1	0	0	0	0	1	1	10	12	6	42	5	12	0	37	0	3	5	7	0	2	1	0	7	0	0	1	0	0	0	5	0	0	5	6	0	1	8	0	1	0	0	2	0	16	0	0	0	0	0	0	0	0	0	0	0	0	112	0	0	0	0	0	2	0	0	0	0	15	21	0	22	38	33	29	0	0	9	0	0	0	0	4	5	6	0	3	2	0	0	0	24	13	0	6	0	0	14	1	16	0	5	3	1	16	0	1	20	9	5	10	4	8	1	0	0	0	11	0	41	0	11	16	3	47	9	6	67	0	0	8	2	16	0	0	0	0	5	9	6	0	12	0	1	4	0	19	35	17	0	0	8	0	0	0	0	0	1	5	24	0	0	0	12	1	8	32	0	7	25	0	6	1	5	7	1	0	1	17	12	21	0	0	0	0	0	0	7	359	56	15	18	0	0	0	0	0	0	0	0	49	1	66	4	7	0	1	0	2	71	21	41	26	0	0	0	247	0	1	0	0	3	0	1	0	245	23	34	45	75	36	0	16	57	14	0	0	0	0	0	0	88	0	0	0	0	22	1	14	0	0	0	0	0	3	0	0	0	0	0	0	6	0	0	0	0	0	0	0	13	13	0	0	0	0	0	0	0	3	0	0	0	0	20	3	0	0	5	0	0	0	0	0	0	1	0	0	3	1	0	0	0	0	2	0	0	0	0	0	0	0	0	0	0	0	0	0	0	0	2	0	1	458	0	0	83	0	1	0	0	150	0	25	20	0	0	87	1	8	8	18	1	0	3	0	14	0	46	0	0	0	0	0	1	0	0	11	2	0	1	0	10	0	1	7	0	0	0	0	0	0	0	4	0	69	13	50	0	0	1	42	0	0	0	143	0	0	0	0	2	1	0	2	3	0	16	2	7	19	14	0	0	8	0	0	0	5	0	10	3	7	4	0	15	0	0	1	0	0	0	0	6	0	76	11	101	142	166	114	134	8	0	0	0	5	0	64	0	1	1	16	98	0	0	0	15	0	2	0	0	11	32	0	37	26	0	3	0	9	7	1	1	1	112	13	17	0	0	3	0	1	0	123	0	13	15	12	0	0	0	16	1	22	0	5	17	1	0	7	0	1	49	275	10	178	0	11	47	13	13	7	0	0	16	0	4	0	287	1	0	0	0	1	0	4	12	1	2	3	0	0	0	1	0	0	0	38	0	0	0	0	0	0	0	0	0	0	72	0	777	0	0	16	313	1	0	13520	11	0	8	0	0	1	1	0	1	0	0	0	0	0	0	0	1	37	3	0	0	0	0	0	0	1	0	40	0	0	0	1	1	11	0	0	0	0	18	0	1	3	0	0	27	0	0	0	2	0	0	0	14	3	0	11	30	0	0	0	83	145	3	12	1	44	99	0	40	8	72	0	30	23	39	9	75	37	0	13	1	0	0	0	1	0	0	0	0	0	0	1	0	0	20	0	0	14	0	13	66	0	0	1	0	0	0	0	1	0	0	0	2	0	0	0	0	0	16	4	51	0	0	1	7	0	0	0	0	0	0	0	8	0	1	0	0	0	0	0	0	0	2	0	1	0	0	0	0	0	0	1	0	0	1	0	0	0	0	0	48	0	0	0	1	2	1	0	10	0	31	9	61	1	0	2	0	0	0	0	0	0	0	16	0	0	25	0	0	0	2	7	0	0	0	0	0	2	1	0	8	0	19	14	26	11	0	22	1	0	0	0	32	35	54	7	0	0	0	0	0	2	0	0	0	0	1	0	3	0	0	12	1	0	0	0	0	0	0	0	0	0	5	1	0	0	0	0	0	0	2	264	36	0	1	0	0	0	0	0	8	0	0	6	0	0	0	0	0	3	0	0	2	0	0	41	59	0	0	1	2	0	0	26	0	2	0	0	2	0	0	0	0	0	0	79	0	0	0	0	0	17	0	0	25	14	2	18	28	55	7	0	8	0	0	0	56	0	41	1	0	0	0	0	0	9	0	20	0	1	0	0	0	0	0	0	1	0	0	7	0	0	0	0	0	0	0	6	0	0	19	31	0	0	0	0	0	0	2	0	0	1	0	0	1	0	0	0	9	0	0	0	0	14	0	1	0	119	1	0	0	709	0	3	104	166	45	1	5	0	23	12	0	0	0	0	0	8	47	0	2	0	4	7	0	0	0	0	12	1	27	0	0	3	0	37	0	0	10	0	29	0	0	1	0	0	0	8	0	0	0	1	1	4	1	0	0	2	0	1	1	2	39	13	0	27	4	0	0	0	29	7	0	0	8	0	0	0	0	0	7	2	1	1	1	0	73	0	0	0	0	0	0	0	0	6	0	0	2	0	0	0	0	1	0	0	0	0	0	0	1	0	0	0	0	0	0	0	1	1	0	0	1	0	1	20	0	0	3	1	0	0	16	0	13	0	30	1	2	0	0	0	0	6	6	0	0	0	1	0	339	254	244	252	387	139	924	266	1	254	119	334	236	165	23	126	62	309	194	51	32	0	492	458	113	211	183	121	235	98	146	4	177	0	0	6	0	0	0	0	0	0	5	0	89	74	0	0	0	0	0	0	0	0	0	0	0	0	0	0	0	6	0	0	0	0	8	0	7	0	12	3	0	0	0	1	69	2	6	0	0	1	0	9	0	0	0	0	0	0	0	9	0	0	0	0	6	8	0	11	38	0	0	7	0	0	0	15	0	0	1	0	0	0	0	0	127	0	0	19	0	0	0	0	0	2	1	0	0	0	0	8	0	2	0	0	0	0	0	0	0	4	0	0	0	1	0	4	0	2	0	125	3	0	4	4	0	0	0	0	0	0	0	0	0	0	2	0	0	29	6	0	0	0	0	0	15	0	8	8	5	1	1	5	4	2	2	2	1	80	5	1	0	1	0	0	5	0	0	0	20	0	2	81	0	0	0	0	0	11	0	0	0	0	1	0	0	0	0	0	0	0	1	1	0	0	2	0	0	0	0	0	2	0	0	0	0	24	0	1	0	205	1	0	0	0	0	0	0	0	0	1	0	0	0	0	0	0	9	0	21	38	0	0	0	0	41	0	0	11	17	0	3	2	0	46	6	7	0	2	0	0	0	0	0	1	0	6	0	2	1	0	0	0	3	0	11	0	0	0	5	0	0	0	0	0	0	0	0	0	0	0	2	0	0	0	0	0	30	1	1	0	0	18	0	5	98	141	9	0	1	0	0	0	0	0	0	0	0	1	0	0	0	0	0	0	14	0	0	2	1	5	0	2	0	1	1	0	28	19	2	0	0	0	454	0	0	0	0	0	0	0	0	0	0	0	0	0	126	24	0	0	0	0	0	0	0	1	0	1	14	26	2	3	0	4	0	0	14	3	2	14	0	0	0	10	0	0	0	0	1	1	0	0	30	1	0	0	0	1	0	0	0	0	0	0	0	0	29	0	1	0	0	0	2	0	0	4	0	0	0	0	0	6	0	0	0	0	0	0	0	1	5	0	117	0	0	15	0	0	0	0	0	1	7	0	0	20	7	20	12	0	9	0	0	0	0	1	0	31	0	0	0	0	0	0	35	0	21	14	51	12	0	51	65	14	0	43	2	53	0	47	1	15	2	26	19	10	19	2	1	18	0	8	0	14	0	0	0	22	0	18	0	38	51	34	30	35	13	21	2	0	11	15	13	0	52	2	0	0	4	29	0	33	0	0	0	5	21	9	0	0	0	1	0	1	23	0	0	0	0	2	1	0	0	0	1	205	0	0	0	0	0	0	0	0	1	1	0	6	0	0	3	5	0	0	0	0	0	0	0	0	1	0	0	536	5	0	12	4	65	0	26	1	11	0	0	0	91	0	0	0	0	0	2	0	217	0	0	8	0	0	1	0	0	5	0	0	23	3	0	1610	0	8	0	0	0	47	61	2	0	4	0	5	1	0	0	0	11	0	5	1	0	0	13	0	0	0	51	22	0	0	0	0	0	0	282	814	1925	1	0	0	0	10	0	3	8	31	0	0	0	0	0	7	46	166	23	1	0	0	0	0	0	0	103	0	8	78	0	0	0	0	0	11	0	0	2	0	0	0	0	0	0	0	0	0	155	210	3	0	0	0	0	0	0	49	0	0	0	0	0	0	42	3	0	0	0	0	0	0	0	46	2	0	0	0	0	9	0	0	1	0	0	15	3	5	0	0	0	0	0	0	0	3129	2	1	3	0	3	0	0	0	0	0	0	0	0	0	0	22	1	12	0	0	0	0	0	0	0	0	0	0	0	0	1	0	0	0	0	0	0	0	0	0	0	0	25	0	0	0	0	0	0	0	0	0	2	0	0	0	0	0	0	272	0	0	0	0	0	0	47	0	0	0	0	0	1	108	4	1	0	0	0	33	9	9	1	0	28	0	0	35	1	0	33	0	0	11	1	0	0	0	0	0	0	0	19	0	0	4	0	0	0	0	0	0	0	0	0	313	1	0	0	0	0	0	0	0	1	0	0	0	0	0	0	0	1	0	0	0	0	0	0	0	0	8	0	0	0	24	17	7	12	5	0	1	0	0	0	1	0	0	26	1	0	6	0	6	0	7	0	0	0	0	0	5	2	1	0	9	0	35	16	24	0	16	0	5	0	0	0	0	9	0	0	0	0	0	0	8	0	40	27	0	3	0	22	10	0	0	0	0	0	0	0	0	0	23	0	0	0	0	0	0	17	146	0	22	0	0	0	8	0	0	0	0	0	0	0	0	0	0	1	14	83	9	0	0	0	0	0	0	2	0	43	0	18	1	0	0	0	0	0	0	1	0	0	0	0	0	10	0	0	0	1	0	4	0	17	14	0	20	8	0	7	0	24	0	0	0	13	0	0	7	0	0	0	0	124	0	0	0	0	0	0	0	0	0	0	0	1	0	0	0	1	0	0	73	0	0	0	1	0	0	0	29	0	0	0	0	0	0	0	0	0	0	0	0	0	0	4	0	0	0	5	1	0	5	0	0	0	0	9	0	0	0	0	0	0	0	0	0	4	16	11	0	0	1	2	17	0	6	0	0	3	0	0	0	0	0	1	0	0	0	0	0	0	0	1	0	1	1	0	0	0	0	0	0	0	1	0	1	0	3	60	0	0	0	0	0	3	0	0	0	19	0	1	1	3	0	3	5	0	0	1	0	0	0	0	0	0	0	0	1	0	0	0	0	0	0	0	0	0	34	0	0	5	0	136	0	0	0	19	0	1	0	0	0	0	0	0	8	0	0	0	0	26	0	0	0	0	67	4	0	3	0	11	0	0	0	0	0	0	0	0	0	3	0	10	0	0	1036	0	0	1	0	0	0	2	0	2	0	0	0	0	0	0	0	0	0	0	0	0	1	0	0	4	0	0	0	0	0	0	7	1	37	0	0	0	0	0	0	0	1	0	0	0	0	0	0	0	12	0	1	0	0	0	0	0	0	0	0	0	0	0	0	0	0	0	0	0	0	0	0	0	0	0	0	0	0	0	0	0	0	1	1	0	0	0	7	0	0	1	0	0	1	0	0	0	0	0	0	1	0	0	0	0	0	0	0	0	0	0	0	0	0	0	0	0	0	0	0	0	0	0	0	0	0	0	0	0	0	0	0	0	0	0	0	0	0	0	0	0	0	39	0	0	5	0	0	0	0	0	20	0	0	9	1	0	0	0	0	5	2	2	0	1	0	1	4	0	148	36	5	0	6	0	742	0	0	0	0	1	0	7	413	0	0	0	0	0	0	0	0	0	0	0	0	0	0	0	0	0	10	0	0	0	0	0	0	0	1	0	0	0	0	0	0	0	0	0	0	0	0	0	0	0	127	0	39	15	0	0	0	0	0	0	0	0	0	50	0	0	0	0	0	0	0	0	0	0	0	0	0	0	4	0	0	0	0	0	2	0	1	0	4	0	0	0	0	12	1	0	0	0	0	0	0	0	3	8	0	3	0	0	0	0	0	0	0	0	0	0	0	24	3	0	0	0	0	17	0	0	35	0	0	0	0	0	0	0	0	0	0	0	0	0	0	4	0	0	0	0	0	0	0	2	0	0	0	0	0	0	18	0	0	0	0	0	0	0	0	0	0	0	0	0	0	0	0	0	5	0	0	0	1	0	0	0	0	15	0	0	0	0	0	0	0	0	1	0	0	0	0	1	0	0	0	0	0	0	1	3	1	3	0	3	0	1	0	0	0	0	0	0	0	0	0	0	0	0	0	1	32	2	0	3	0	2	0	0	0	0	7	0	0	0	0	0	0	0	1	0	0	131	0	1	0	16	0	1	0	6	0	0	2	9	55	0	0	0	0	0	0	0	0	0	0	1	70	3	0	0	0	0	0	0	62	1	0	22	0	1	0	0	0	0	0	0	0	0	0	0	1	0	0	0	0	0	0	0	0	0	0	4	0	0	0	0	0	0	0	1	0	0	0	52	0	0	0	0	1	0	0	0	0	2	34	0	2	0	0	0	0	0	0	0	0	0	6	4	14	0	36	5	1	89	617	0	0	10	0	321	1	30	51	1	0	0	0	50	342	0	97	0	13	39	0	467	0	0	0	0	2	0	0	9	31	1	14	0	1	10	0	31	46	13	0	0	7	1	14	0	40	1	0	15	13	0	0	0	0	0	7	0	14	16	0	0	0	0	21	0	0	50	0	0	0	0	0	0	0	0	0	0	40	0	0	0	2	0	9	2	69	0	0	0	22	0	6	1	0	0	13	0	0	0	0	0	0	112	108	0	0	0	1	0	1	0	4	19	0	0	0	0	0	0	21	3	0	0	0	0	0	0	73	0	0	0	0	0	0	1	0	0	0	0	0	5	0	0	0	0	11	1	0	0	2	3	2	0	0	3	0	0	0	12	0	0	9	0	16	6	1	0	0	0	1	4	7	3	0	6	0	0	0	0	11	0	0	0	83	74	338	0	22	23	20	332	0	215	79	19	5	435	399	167	0	456	132	222	74	168	5	314	57	350	0	13	0	63	0	0	0	0	0	0	7	5	0	0	1	0	9	11	0	1	0	0	0	25	0	1	29	1	0	0	0	1	0	0	0	2	9	7	0	0	0	0	0	0	29	0	102	0	5	0	0	0	102	6	0	0	0	35	0	0	6	2	6	1	35	0	0	0	0	4	0	14	61	15	16	0	91	0	0	0	1	2	0	1	0	0	0	0	0	0	0	1	13	0	0	0	0	1	0	0	0	2	45	0	0	15	0	12	0	0	0	0	1	7	21	9	0	0	4	0	0	0	3	0	1	1	6	3	0	8	0	0	0	0	0	0	0	0	2	0	269	0	1	125	13	0	0	0	0	0	0	24	0	0	0	0	1	0	0	0	0	10	0	0	20	2	3	3	0	0	0	0	1	1	0	0	0	0	0	0	0	0	0	0	0	0	0	1	0	0	47	0	0	0	0	1	0	0	0	0	0	0	0	79	0	0	0	0	1	6	1	0	14	1	0	0	196	149	138	0	0	1	0	28	2	0	0	0	3	0	0	0	0	0	0	1	0	0	112	9	18	0	43	0	0	0	0	0	0	0	7	11	1	1	0	0	0	0	0	0	0	0	20	0	19	9	0	3	0	22	0	0	6	0	0	0	1	9	1	8	5	0	26	0	0	1	1	45	0	0	22	0	0	2	0	127	0	62	0	0	0	0	0	0	20	0	11	0	0	0	0	0	0	0	0	9	0	0	0	129	1	2	0	0	2	9	0	0	0	2	0	0	0	0	2	0	10	0	0	0	0	0	0	0	0	0	0	0	0	0	0	0	2	8	0	7	0	4	0	0	0	0	10	45	2	11	0	0	0	0	0	12	0	0	0	2	0	0	0	0	0	0	0	0	0	0	7	0	0	16	2	0	0	0	0	0	0	0	0	0	5	1	0	0	0	0	10	7	3	3	0	0	50	74	18	24	0	0	0	0	0	0	0	0	0	0	0	103	3	0	2	0	0	0	19	0	8	11	16	24	8	29	16	2	0	0	0	0	0	6	1	1	3	1	1	0	0	0	0	0	13	0	23	9	0	15	4	13	0	0	0	0	0	484	0	2	0	0	1	2	9	0	0	0	15	0	0	2	0	3	0	0	0	9	0	1	0	4	1	0	20	2	0	0	0	0	49	18	3	0	0	0	0	0	0	4	6	0	0	0	0	0	7	3	33	0	0	0	1	0	0	18	0	5	1	0	0	0	0	0	0	0	0	26	4	0	15	0	0	0	5	0	4	0	0	30	0	0	4	0	0	0	2	0	1	0	3	0	0	0	216	0	0	1	39	0	0	0	0	0	0	2	5	0	0	44	1	1	5	0	0	6	0	3	4	0	13	4	0	15	0	29	0	62	0	0	0	0	7	1	1	0	2	0	0	0	0	24	9	0	8	0	1	0	3	182	0	3	0	0	0	6	1	0	10	0	0	2	7	0	25	9	0	0	0	0	0	0	0	0	1	0	0	0	47	0	2	0	1	0	0	0	117	3	0	0	0	3	4	0	19	3	0	1	1	7	0	1	0	0	0	0	0	0	0	0	0	0	0	0	0	0	3	0	2	4	0	0	0	0	0	0	0	0	0	0	0	0	0	0	0	0	0	0	0	59	0	0	0	0	0	0	19	0	4	0	0	5	0	0	2	0	0	0	0	0	0	5	0	0	0	0	0	0	0	0	0	0	18	0	0	1	0	0	0	0	100	0	0	0	0	0	21	0	7	0	0	1	0	0	0	5	8	0	0	0	0	0	0	0	12	0	3	67	0	2	37	0	0	1	0	0	1	0	0	9	0	33	0	0	0	0	0	1	0	0	0	0	68	0	0	0	0	2	0	0	0	1	0	0	0	0	0	4	12	0	8	33	0	0	0	0	1	1	0	1	2	0	0	0	0	0	0	0	3	0	3	0	0	82	0	0	0	11	1	4	0	0	46	4	0	0	16	0	0	0	0	0	0	0	0	0	0	0	96	0	0	0	0	1	0	1	0	0	0	2	0	35	0	1	0	0	6	3	0	0	0	0	1	7	51	0	0	0	0	0	15	0	9	6	1	0	0	0	7	0	31	0	2	0	1	0	0	0	0	0	0	0	26	11	1	0	0	0	0	0	0	55	34	59	25	1	0	0	0	0	1	8	2	1	0	1	24	23	33	67	0	48	52	0	40	0	1	2	55	12	0	20	0	0	0	0	0	0	0	0	98	26	1	8	10	980	0	0	0	4	8	2	0	0	0	3	0	0	7	0	18	0	0	0	0	1	0	0	28	0	1	8	2	0	0	0	0	73	0	5	1	12	1	18	5	63	14	0	20	0	2	0	9	20	2	0	0	0	0	0	0	0	0	0	0	0	3	4	29	1	6	0	0	0	31	43	10	4	10	2	111	2	2	0	9	0	0	3	0	0	0	0	0	0	1	0	0	0	0	0	0	0	15	2	79	0	0	1	0	0	4	0	0	0	0	0	0	0	0	1	0	0	0	0	0	0	0	0	0	0	0	0	0	0	0	0	0	0	1	3	0	0	6	0	0	0	0	0	0	100	2	0	8	0	2	0	0	2	0	0	16	0	59	52	1	1	0	0	2	1	0	7	0	0	1	213	0	1	17	0	0	10	1	5	0	35	4	4	3	0	3	1	0	1	8	48	0	0	0	0	0	0	11	0	0	0	0	0	0	0	0	23	3	0	0	45	0	0	19	19	0	0	0	0	0	0	19	0	1	2	78	117	0	0	0	0	0	3	1	0	0	10	9	31	26	0	30	0	0	0	11	0	350	0	27	0	839	0	0	0	4	0	0	1	0	0	0	65	2	21	128	0	15	0	0	0	4	30	0	0	4	0	0	27	33	34	7	29	7	0	0	0	2	0	1	0	0	0	0	0	5	0	0	0	0	0	4	0	0	6	0	0	1	0	7	0	0	0	40	0	9	5	0	44	31	0	0	0	45	0	18	3	6	6	65	1	0	35	18	32	28	75	35	0	1	0	0	27	0	0	20	0	1	2	5	0	0	0	0	0	2	3	13	6	3	134	34	230	0	133	1	11	0	0	0	3	0	0	0	0	0	0	0	0	1	0	0	0	0	17	28	16	0	35	0	3	0	0	0	0	0	1	168	0	0	0	1	0	1	10	0	5	0	0	14	0	0	1	0	31	0	160	78	7	4	11	0	42	0	0	0	40	39	0	0	0	0	3	0	1	62	0	0	0	24	5	19	10	0	0	0	0	0	8	7	0	27	0	0	7	0	1	0	2	0	88	78	50	0	0	1	3	2	2	6	4	0	1	0	0	24	30	0	5	1	8	0	90	104	146	2	1	20	53	0	0	0	5	0	1	1	0	0	0	3	0	39	24	8	1	0	0	50	0	0	0	0	0	0	0	26	16	0	10	7	0	14	0	81	0	18	46	23	20	14	4	0	6	185	61	0	20	2	0	1	10	7	6	3	4	0	0	0	0	0	0	0	1	5	0	0	0	0	7	45	30	230	436	18	39	0	5	1	26	30	31	0	0	24	0	0	0	0	0	0	0	0	0	0	0	1	0	0	1	3	2	0	2	0	0	0	0	0	0	16	8	27	0	4	61	8	38	4	13	21	13	16	18	16	0	0	0	0	143	36	22	0	1	3	25	11	25	0	16	7	0	3	4	5	6	1	0	0	0	0	0	26	14	0	1	0	0	0	7	1	0	7	1	1	0	0	2	164	10	2	5	149	12	0	0	0	0	0	81	0	7076	0	6	0	3	39	16	2	0	0	0	0	0	0	0	0	17	5	8	2	0	0	0	0	0	0	135	0	5	0	134	0	0	1	0	0	3	3	0	0	32	46	3	0	1	0	0	0	0	0	0	9	10	0	0	0	0	0	0	0	0	0	0	0	0	0	1	0	2	0	34	7	0	53	0	0	2	0	4	53	0	0	0	2	0	0	0	0	58	0	0	6	1	0	1	0	0	0	0	0	162	24	0	5	75	0	5	0	0	25	0	78	7	25	7	0	0	0	1	7	0	0	84	0	0	1	1	41	0	0	1	1	0	0	0	0	0	0	1	0	0	1588	15	16	1	8	1947	0	102	40	58	13	3	210	90	104	20	23	23	18	0	73	487	458	405	53	53	0	1	1	677	0	0	3	2	0	76	44	0	0	1357	0	0	0	0	0	0	1	32	0	0	0	9	13	34	15	12	29	46	10	8	0	3	0	18	25	9	18	0	0	0	0	0	0	0	0	0	1	12	3	0	23	2	20	0	4	44	0	1	0	5	1	3	3	4	0	3	0	0	5	41	0	1	0	0	0	22	0	1	0	9	6	13	15	0	27	7	0	0	37	150	203	3	0	28	116	142	5	28	81	0	14	0	39	7	0	108	0	0	10	5	7	66	16	0	12	15	47	24	0	0	14	17	0	0	22	8	18	0	0	1	40	0	0	10	4	3	0	5	9	0	0	25	0	0	3	1	0	0	0	0	0	6	0	0	12	0	1	0	3	0	459	11	10	0	0	5	35	0	33	5	0	13	0	0	0	82	8	0	90	160	0	12	10	7	3	8	4	7	7	7	5	17	6	66	15	115	21	37	0	0	0	5	0	0	0	0	0	2	0	0	22	0	0	0	0	0	2	32	49	0	4	0	0	0	0	0	0	7	8	1	0	0	0	0	0	0	2	2	0	0	0	0	0	0	1	1	0	6	0	0	11	0	1	0	18	7	1	0	0	7	0	0	0	0	0	0	0	1	8	1	0	1	0	0	0	0	2	1	4	1	9	7	0	7	0	0	0	0	0	0	0	0	0	44	2	1	110	0	0	0	26	34	18	0	0	0	0	0	46	0	11	12	21	13	1	0	3	0	1	2	0	0	0	0	73	42	86	19	19	9	14	30	11	14	0	46	23	66	17	12	89	43	51	88	22	14	18	20	1	10	0	0	225	12	10	14	21	36	83	40	140	30	46	106	35	87	22	19	26	21	28	10	27	0	0	12	0	403	474	0	9	9	118	76	0	16	604	250	138	1414	0	490	19	0	3	0	0	0	20	9	15	0	29	0	501	1336	108	0	0	1	0	0	0	0	0	198	16	174	10	125	10	292	18	8	5	0	27	1	41	31	0	1	1	1	0	3	27	9	8	44	152	10	1	7	23	28	27	0	0	1	3	0	0	0	28	0	4	1	5	0	0	0	33	1	0	0	0	1	23	8	1	2	0	0	0	0	0	3	8	0	0	0	0	0	0	0	0	1	2	0	0	3	0	0	0	0	0	0	0	9	0	0	12	7	0	32	230	2	0	0	0	0	0	4	0	0	0	0	0	1	1	0	0	0	0	0	45	0	0	0	0	0	18	0	0	0	0	0	0	0	0	0	0	0	0	0	0	0	0	23	0	1	0	0	19	0	53	0	33	51	0	54	2	42	0	0	0	0	0	0	0	0	0	0	0	1	0	37	15	25	7	0	0	0	0	0	0	0	0	2	7	4	0	78	1	9	0	0	34	97	0	0	1	17	0	0	15	30	33	42	11	0	0	17	0	0	33	4	106	0	0	0	18	11	8	0	2	7	18	18	22	0	8	30	3	0	2	66	257	19	9	0	0	0	0	1	17	5	0	25	2	1	0	0	8	0	1	0	1	1	0	0	10	0	0	35	0	0	0	0	0	0	0	4	0	0	75	1	0	0	0	0	0	0	0	0	31	9	5	0	13	23	0	7	1	0	10	14	40	0	0	12	4	5	0	3	9	2	0	0	0	0	0	14	4	12	2	0	2	1	0	0	0	0	0	5	23	12	0	0	3	0	0	0	0	1	0	0	6	36	16	0	86	15	16	0	0	30	0	4	8	4	0	0	0	0	0	0	1	0	2	0	0	0	0	4	0	0	0	21	39	1	0	1	0	0	0	1	8	0	4	4	4	0	1	1	0	0	0	0	1	1	1	0	2	51	0	2	0	0	32	41	0	0	35	41	18	0	0	41	0	24	21	23	913	0	0	55	0	0	0	0	0	0	1	0	0	20	34	0	42	7	13	10	0	0	0	31	0	0	0	0	0	7	0	0	0	0	0	1	0	2	0	0	0	1	1	0	0	0	0	7	0	4	0	2	7	22	0	0	3	0	12	8	1	0	0	0	136	30	0	4	0	0	6	0	34514	0	0	0	0	0	0	0	0	0	0	0	0	0	0	0	0	11	0	0	1	1	32	12	35	66	0	17	15	8	0	0	0	0	0	0	0	0	14	74	0	68	34	0	0	0	0	0	17	2	4	0	0	2	0	49	11	14	51	60	68	124	22	0	13	1	0	43	1	2	210	33	11	15	0	1	0	1	2	3	0	33	41	67	5	5	0	0	0	0	18	3	0	6	0	62	34	0	64	9	0	0	21	19	0	0	104	43	0	6	0	0	0	0	0	0	0	0	0	84	128	117	147	134	0	10	28	2	135	108	98	224	290	122	4	59	33	146	20	0	15	49	45	1	0	3	0	0	64	48	177	95	104	0	6	0	0	24	17	17	8	5	0	0	0	0	0	0	0	0	0	0	2	6	26	0	7	0	8	3	0	5	15	0	0	0	0	16	26	12	5	6	2	15	15	0	0	0	109	0	2	0	8	2	22	11	16	23	0	6	0	0	0	38	21	0	0	0	1	6	0	0	0	0	0	0	0	0	6	0	0	0	0	16	22	2	0	0	0	1	0	0	1	12	2	8	0	23	0	0	0	47	82	0	0	3	0	54	1	0	15	10	1	25	1	0	0	3	0	0	0	0	0	4	0	0	0	0	0	0	0	0	1	0	7	0	0	0	0	0	0	0	0	0	1	0	0	0	0	0	0	1	0	0	0	0	0	0	4	0	0	0	3	41	0	0	3	0	0	0	1	2	16	0	2	0	1	9	11	0	145	0	0	1	227	22	28	8	1	0	1	5	17	20	0	1	13	4	11	1	8	3	1	0	0	0	0	0	0	0	0	2	0	0	1	20	16	0	2	0	0	684	7573	0	0	0	0	0	0	10	17	29	60	21	3	43	0	50	23	6	22	8	2	0	19	21	17	26	2	83	0	0	91	1	86	11	3	0	0	0	0	0	0	7	0	6	108	12	2	0	0	1	13	24	0	0	1	2	0	0	1	0	0	2	0	0	13	26	12	0	22	0	4	14	0	5	0	1	0	19	18	0	0	0	0	0	0	0	42	94	10	19	12	14	44	12	0	0	6	4	1	8	0	4	1	1	2	0	5	5	0	0	0	0	6	0	6	2	0	0	0	11	0	4	3	2	0	13	1	18	11	5	0	0	100	0	0	0	0	0	1	0	0	168	0	11	0	0	0	4	14	0	4	0	3	0	0	0	0	0	0	0	0	1	0	0	16	0	0	1	0	1	4	2	0	0	1	0	0	11	0	1	0	5	2	7	0	0	0	0	0	0	0	0	0	0	1	0	0	0	110	0	8	10	85	235	12	19	0	0	0	0	0	0	0	0	0	0	0	0	3	0	0	0	1	11	0	0	0	7	0	1	3	0	0	0	0	0	0	0	0	0	113	0	0	0	1	10	2	8	0	5	17	4	8	48	2	3	39	9	9	1	26	37	30	111	442	146	192	745	0	0	14	1	0	4	23	25	8	0	0	0	0	0	0	324	0	0	8	1	334	0	0	0	0	0	488	8	110	1	4	0	9	1	0	0	0	0	0	0	2	2	0	0	0	0	2	124	58	0	0	0	1	1	0	0	0	32	0	0	1	0	0	0	41	21	0	0	0	0	3	0	0	0	33	8	0	17	21	0	1	2	0	5	1	8	10	28	3	0	1	0	0	0	1	0	0	6	0	26	7	0	0	27	164	12	25	312	1	0	1	0	0	0	0	70	14	15	0	0	0	7	79	1	53	6	17	0	3	0	0	45	0	0	0	84	196	8	63	2	0	106	920	0	0	0	0	0	22	5	1	0	3	0	11	0	0	7	2	11	1	0	0	0	0	0	0	11	0	2	0	0	12	4	0	0	0	3	11	4	49	0	6	99	11	0	0	0	0	0	11	19	9	26	16	212	71	1	0	37	0	14	41	55	0	0	0	1	3	0	7	0	0	344	6	0	15	39	29	46	0	31	1	0	7	2	17	5	1	129	27	0	3	4	0	15	0	0	8	222	38	0	0	0	0	0	0	3	0	1	0	3	0	0	0	0	0	0	0	0	0	0	0	0	0	0	0	0	1	0	0	0	2	0	0	0	0	0	4	0	1	0	25	0	0	0	0	0	0	0	0	0	0	0	0	4	0	0	0	17	10	22	5	0	1	12	2	4	0	8	2	13	0	0	0	0	20	6	4	20	18	8	59	1	0	18	0	22	5	0	0	0	0	9	7	3	0	0	16	0	3	10	1	41	13	0	3	4	0	0	39	42	0	17	0	2	0	0	0	0	18	10	14	8	37	10	34	19	4	51	13	2	1	0	0	2	0	3	26	55	26	0	49	12	22	3	0	0	30	0	1	0	0	0	0	0	2	0	0	0	0	12	0	0	1	0	0	0	8	1	7	27	30	18	18	0	18	10	52	41	13	25	11	2	66	66	68	0	0	1	1	0	2	0	5	0	27	6	547	26	0	0	12	0	0	0	0	0	0	0	1	0	0	0	0	0	24	21	186	7	5	80	41	15724	24	0	12	0	0	0	0	0	17	1	4	0	0	0	39	0	0	2	1	0	0	0	0	0	0	0	0	11	106	1	13	57	1	2	0	0	0	0	9	0	23	1	10	35	0	0	0	15	0	108	0	2	0	4	33	0	0	0	0	0	0	28	0	0	0	0	0	73	0	0	0	0	0	0	0	0	0	0	0	0	0	1	0	0	0	2	1	0	11	0	408	499	0	16	36	14	47	21	50	21	0	1	1	20	0	0	0	1	0	0	0	0	1	0	0	8	0	0	0	0	0	15	1	0	1	10	4	5	0	0	0	0	7	0	0	0	0	4	0	9	0	0	12	14	0	0	0	0	1	1	0	0	2	0	1	2	0	9	0	53	60	61	0	28	0	0	0	0	0	1	0	0	15	0	34	0	0	2	14	0	29	38	0	0	0	0	17	0	0	0	0	11	0	0	0	0	0	0	0	0	0	9	0	0	0	0	0	0	0	9	0	0	0	0	0	0	0	0	138	0	0	0	0	0	0	1	0	0	2	0	0	0	0	0	0	0	0	9	0	0	0	8	0	0	0	0	0	0	0	0	0	0	0	56	0	0	48	0	0	0	28	0	0	1	0	0	0	0	1	1	0	0	0	3	0	0	0	0	0	16	0	0	1	0	0	4	0	0	4	0	0	0	0	0	0	0	0	0	0	0	0	0	0	0	0	0	0	0	1	0	0	0	177	0	0	0	0	11	0	0	0	0	0	0	0	0	0	0	0	1	0	0	0	1	0	0	1	0	0	0	0	0	161	0	0	1	0	0	0	0	0	0	0	0	0	23	0	0	0	1	0	0	0	0	0	0	0	0	1	0	2	1	0	0	0	0	0	5	3	0	0	0	198	0	0	0	0	0	0	6	20	1	0	1	1	9	180	0	111	42	1	0	1	13	0	16	0	0	9	156	0	36	1	0	110	6	49	1	0	3	0	0	2	3	0	4	5	1	0	7	15	0	4	24	0	7	0	1	1	0	36	0	50	0	5	0	12	4	13	3	135	10	19	8	0	1	3	5	10	0	35	4	1	7	17	1	0	2	6	5	21	23	5	2	3	5	57	14	4	0	0	0	102	31	47	5	9	0	18	3	12	2	6	29	0	4	85	0	0	342	0	0	7	0	5	0	313	6	37	33	8	0	5	4	6	34	10	1	7	2	1	2	1	32	47	44	13	35	54	72	20	73	205	84	51	0	0	18	33	0	22	0	2	0	8	0	0	0	0	9	0	0	0	0	0	3	0	4	0	41	10	33	0	1	7	0	0	30	0	59	0	141	17	0	1	0	18	9	0	2	0	0	0	0	8	0	0	0	12	1	7	0	0	13	0	0	0	8	0	0	0	0	1	0	1	0	0	0	0	0	4	1	0	0	0	2	2	11	0	0	0	7	0	0	2	0	2	0	9	30	0	2	0	0	0	63	2	0	0	3	0	0	0	0	0	25	0	2	0	0	0	0	1	0	0	12	0	0	3	0	1	0	1	0	17	7	55	1	12	0	0	0	0	0	1	0	0	95	1	8	3	0	0	0	0	0	0	0	0	0	0	0	0	0	0	0	0	0	0	5	62	55	0	22	21	1	0	0	0	0	0	2	1	265	1	17	23	94	0	1	7	1	1	6	1	0	0	1	44	1	0	0	2	0	8	14	50	476	0	4	88	31	0	1	0	0	0	0	0	3	1	0	0	0	40	0	0	1	25	0	1	0	42	99	0	1	9	0	0	0	1	0	0	10	17	19	31	68	90	0	32	34	6	0	44	1	1	45	0	0	27	20	0	0	0	0	0	1	12	5	0	0	0	0	49	12	1	0	0	11	0	0	0	0	1	1	0	0	32	35	7	1	0	81	0	0	0	1	2	0	0	1	2	0	4	10	8	17	4	28	1	18	0	9	0	0	0	2	12	0	27	0	20	0	13	54	41	47	29	3	0	39	20	25	10	394	76	0	1	0	0	0	0	1	0	0	3	0	0	0	0	0	0	19	12	31	0	1	0	1	12	14	9	0	12	0	1	8	15	6	15	0	2	0	1	14	70	31	127	17	0	1	0	0	0	54	0	0	0	0	5	0	81	103	81	0	36	0	0	6	6	7	8	0	0	0	0	14	75	4	128	9	20	8	16	184	0	5	2	0	14	1	3	11	20	45	11	1	3	60	75	0	0	0	0	0	0	1	51	0	0	71	0	3	0	0	0	7	2	65	11	4	0	0	0	0	3	0	0	0	5	1	0	0	0	0	0	6	5	2	117	4	1	0	1	0	0	0	11	0	0	0	6	0	0	1	11	0	3	24	20	2	88	0	2	0	6	32	0	0	2	0	0	16	0	3	0	0	0	0	0	0	17	27	1	5	1	14	10	0	2	0	1	0	0	0	110	1	2	0	60	0	0	36	1	7	9	0	18	46	0	0	0	0	0	41	23	0	0	2	11	1	16	0	0	10	1	3	1	0	32	71	15	8	0	0	0	1	8	0	0	0	0	0	0	42	8	0	125	0	0	214	163	95	270	86	12	58	90	169	96	104	177	107	101	27	115	15	0	3	0	2	0	19	0	4	0	0	2	3	12	0	0	0	0	0	0	2	0	0	0	0	0	8	2	0	0	1	0	0	0	0	0	0	0	0	0	0	0	0	0	0	0	0	0	0	0	0	0	0	0	0	0	0	0	21	5	0	0	0	0	0	0	0	0	0	0	0	0	0	0	0	0	0	0	0	0	0	0	1	0	11	9	0	50	16	0	0	16	0	0	0	19	20	30	30	0	16	53	3	0	2	1	2	0	0	0	0	0	0	0	0	14	28	1	28	12	28	0	0	0	21	1	12	3	1	0	0	2	2	1	0	0	0	0	11	4	3	2	2	0	29	17	73	8	16	0	7	7	4	0	18	67	0	0	0	2	1	0	0	0	46	0	0	0	0	0	0	0	1	2	4	0	0	154	6	0	40	0	83	0	2	0	0	3	1	0	1	161	21	3	7	0	0	236	0	0	0	4	5	0	12	1	0	39	0	0	0	12	0	47	23	41	0	12	69	0	0	5	52	1	1	0	2	1	2	6	12	22	24	0	10	0	6	0	71	6	0	1	12	10	6	22	6	5	4	4	2	0	9	0	0	26	1	0	0	0	26	0	0	12	5	6	0	2	9	0	1	0	0	0	20	0	1	2	0	0	0	0	0	0	0	0	1	0	0	0	3	0	0	0	0	0	1	3	12	6	0	21	3	0	0	0	1	15	17	7	6	0	0	46	0	0	306	76	52	22	15	0	4	312	187	0	17	68	0	0	0	2	38	2	0	0	22	0	46	29	29	0	3	19	0	0	10	15	11	0	0	1	19	52	16	0	0	1	0	0	0	149	0	8	3	1	0	0	0	0	0	0	0	0	185	11	79	31	21	0	39	7	5	0	0	0	0	0	6	0	0	0	14	0	57	0	0	21	3	0	10	0	315	38	5	0	0	13	11	46	194	24	2	8	22	196	2	14	94	1	0	0	0	0	1	0	2	260	146	2	0	1	0	2	0	0	29	0	0	2	4	0	1	0	115	127	1	0	0	47	78	64	54	5	6	9	21	25	1	3	102	0	0	22	10	1	3	0	0	0	0	0	0	19	8	0	0	0	0	0	0	0	0	0	0	0	0	1	0	146	0	0	1	0	63	25	1	0	0	5	6	24	1	0	0	0	28	20	15	1	49	0	24	9	0	0	3	39	0	18	20	0	1	40	22	28	22	40	49	63	2	9	7	194	13	78	99	1	0	0	0	1	0	0	0	3	0	0	1	0	0	0	0	1	0	0	0	16	3	3	27	11	1	11	0	0	23	2	7	0	0	3	2	9	0	0	0	4	1	3	14	12	7	8	0	6	0	0	0	0	0	5	0	0	0	0	0	1	0	0	0	0	0	0	0	0	0	0	23	0	0	0	0	1	0	1	3	0	22	0	91	0	0	7	0	0	23	0	0	0	0	0	4	2	0	0	1	0	1	3	7	15	0	0	56	6	63	0	24	0	462	0	239	268	0	0	3	0	17	2	1	0	48	107	685	39	39	98	15	85	14	23	32	30	31	34	1	34	19	0	0	7	43	0	0	0	0	0	0	49	1	0	0	0	0	0	3	25	0	0	0	0	1	0	1	0	0	0	0	0	0	0	0	0	0	0	0	0	0	0	0	0	0	0	4	6	0	46	11	0	50	1	37	44	74	29	0	0	0	3	0	0	2	0	0	83	0	0	72	31	0	0	1	7	0	56	0	60	13	9	0	0	0	0	3	0	1	0	0	0	1	0	0	0	3	6	2	0	9	2	8	6	1	2	0	0	1	0	0	56	42	18	0	6	1	16	0	17	6	0	11	5	0	3	0	34	7	0	0	1	0	0	0	0	0	13	2	0	0	256	2	5	0	3	3	8	0	4	0	1	0	0	0	0	0	0	4	8	0	43	80	0	0	0	0	0	0	0	0	10	0	7	0	2	0
LakWasMe97_LOW12_2_rpkm	0	0	0	0	0	2	5	0	0	0	0	3	3	5	0	0	0	0	2	0	0	0	0	3	0	0	0	0	0	0	0	0	0	0	1	1	1	0	0	0	0	0	0	1	2	6	3	3	0	1	0	0	1	0	0	2	0	5	13	23	64	2	0	0	0	0	0	0	1	5	0	0	0	0	0	0	2	0	0	0	0	5	1	0	0	0	0	0	0	0	0	1	0	0	4	0	0	0	0	0	0	0	0	0	0	0	0	0	0	0	1	0	7	0	4	0	0	0	0	0	0	0	0	0	0	0	4	0	0	0	0	6	13	0	0	0	0	0	3	0	0	0	0	0	0	0	0	0	2	1	0	5	3	1	5	0	1	2	2	0	1	0	0	0	4	0	0	2	0	13	1	0	0	0	0	0	0	0	0	0	0	0	0	0	0	33	0	0	0	3	0	0	0	1	0	0	2	6	1	8	1	0	2	0	0	0	3	0	3	0	2	0	5	1	3	0	4	0	0	9	0	0	3	3	0	3	4	0	12	0	0	3	0	0	0	0	0	4	1	0	0	0	2	1	6	5	0	0	3	2	6	0	13	0	145	82	0	0	0	0	0	0	0	2	3	0	145	0	0	9	46	0	14	0	0	0	0	0	8	5	1	1	4	2	1	0	0	0	0	0	0	0	0	0	0	0	0	12	0	0	0	9	7	0	0	0	4	4	14	0	5	0	2	0	0	0	0	0	38	0	0	0	0	0	6	1	0	0	0	0	0	1	0	0	0	0	0	3	0	0	0	0	3	4	0	0	0	0	13	0	2	0	0	0	0	0	0	0	0	14	1	0	0	0	0	3	1	1	5	0	0	7	0	10	21	2	0	0	0	2	0	0	0	1	1	0	23	1	0	0	0	0	13	0	0	4	25	0	0	2	2	2	0	2	1	0	1	0	0	0	0	0	4	3	0	5	2	2	0	7	0	0	1	0	0	0	0	0	0	0	0	0	0	0	0	6	0	1	1	0	3	7	0	0	9	9	0	0	0	0	0	19	7	145	0	13	2	0	0	1	0	0	0	1	0	2	1	0	0	2	1	17	1	0	0	0	11	2	108	0	5	1	9	940	2	0	0	29	10	1	0	0	7	21	1	0	7	0	0	0	0	0	2	0	0	1	0	0	0	0	0	0	0	0	1	0	0	0	0	8	0	0	0	0	0	0	0	0	0	0	0	0	2	0	1	0	0	4	0	0	0	3	0	1	0	0	0	0	0	11	0	0	2	3	0	5	0	3	0	0	0	0	0	0	1	0	4	0	2	0	0	0	0	0	5	20	27	23	4	8	27	32	18	11	1	0	6	4	28	0	0	0	518	0	41	1	1	0	4	0	0	0	0	0	0	1	0	6	0	28	1	23	83	37	0	0	4	0	17	0	18	8	1	0	0	2	0	1	0	0	0	1	0	0	2	0	0	0	5	2	2	15	0	0	0	3	2	1	0	3	11	0	0	15	1	0	1	0	1	0	0	23	0	41	0	0	0	0	1	1	4	2	9	0	0	0	3	1	0	0	1	0	2	0	0	0	1	0	0	3	0	0	2	0	0	0	0	0	0	0	0	9	0	5	1	0	4	0	1	0	0	0	0	0	1	4	0	0	3	4	0	0	0	4	0	0	0	0	2	0	0	0	0	0	0	0	0	0	0	1	0	4	2	0	3	7	3	0	0	7	0	0	1	0	0	1	0	0	26	7	0	2	0	2	0	0	0	0	0	0	0	0	0	0	6	2	0	0	0	0	0	0	3	0	0	0	0	0	0	0	0	2	0	0	0	0	0	4	0	4	0	0	0	0	41	0	5	0	0	0	0	0	0	0	0	0	3	0	0	0	0	0	0	4	3	0	0	0	22	1	0	0	0	0	0	0	0	8	14	0	0	0	0	0	0	0	0	1	4	6	0	0	1	0	0	0	0	0	0	3	3	0	0	2	0	0	0	0	5	1	0	0	0	0	0	0	0	4	1	6	0	0	0	0	0	0	4	0	0	0	0	0	0	0	0	0	0	0	0	0	0	0	1	17	0	0	0	0	0	0	0	0	0	0	3	5	6	5	1	0	0	1	0	0	0	0	0	0	0	0	7	0	0	0	0	0	0	0	0	5	0	0	0	0	1	0	4	1	0	0	0	0	0	0	0	0	0	0	0	0	0	0	0	0	0	0	0	0	0	0	0	3	1	62	0	9	0	0	0	0	0	1	1	0	41	0	0	1	0	0	0	0	0	0	0	0	0	3	3	0	0	0	0	0	0	0	0	0	0	2	0	0	0	0	0	0	0	8	0	0	0	7	1	0	0	0	0	0	9	0	2	0	0	0	0	0	2	0	30	0	0	0	0	0	0	0	0	2	0	0	0	0	0	0	0	0	0	0	0	0	2	3	0	835	0	0	0	0	16	0	3	0	0	0	0	0	0	0	2	0	0	0	0	0	0	0	0	0	0	1	0	0	3	0	0	0	0	0	0	0	0	0	0	0	0	2	22	0	1	87	0	93	0	0	1	0	0	16	0	0	7	0	0	0	0	0	2	6	13	0	0	0	0	0	0	0	0	0	0	0	0	0	0	0	0	0	0	0	0	0	0	3	0	0	0	0	0	0	0	0	0	0	0	0	0	0	0	0	0	0	3	2	0	0	44	1	1	0	0	0	0	0	0	1	0	0	0	2	0	0	0	0	2	8	16	25	0	0	0	4	0	0	0	1	0	3	3	0	0	0	0	0	0	0	0	0	0	1	0	0	0	0	0	0	0	0	0	0	11	0	0	0	0	0	0	0	0	0	0	0	11	0	0	2	0	1	17	0	0	0	1	0	0	5	3	0	0	0	0	0	9	0	0	5	0	9	0	0	0	0	0	0	3	13	1	13	1	0	0	2	0	0	2	0	0	30	9	5	8	0	0	0	0	0	0	0	0	0	1	0	0	0	0	0	0	0	0	0	0	1	0	0	0	0	0	0	0	0	0	1	0	0	9	0	0	1	0	0	1	0	0	0	0	0	6	0	0	13	6	6	0	0	2	8	0	0	3	1	0	0	0	1	0	0	0	0	3	1	0	0	0	0	2	0	10	0	0	1	2	2	0	0	4	0	1	1	1	0	0	0	0	0	2	0	3	0	0	0	4	11	0	2	16	0	0	0	0	2	0	0	0	0	1	2	1	0	1	0	0	6	2	3	9	3	1	0	7	0	0	0	0	0	0	1	5	0	0	3	3	0	1	3	7	1	4	0	0	0	0	1	0	0	0	7	1	2	0	0	1	0	0	0	2	12	7	4	34	0	0	0	0	0	0	0	0	8	8	0	0	7	0	0	0	0	47	45	9	9	0	0	0	24	0	0	2	0	1	0	0	0	20	4	1	6	17	5	0	0	10	8	0	0	0	0	0	0	24	1	0	0	0	1	0	2	0	0	0	0	0	6	0	0	0	0	0	0	1	0	0	0	0	0	0	1	2	6	0	0	0	0	0	0	0	0	0	0	0	0	0	16	0	0	3	0	0	0	0	0	0	1	0	0	0	0	0	0	0	0	0	0	0	0	0	0	0	0	0	0	0	0	0	0	0	0	0	0	1	86	1	0	14	0	0	0	0	11	0	2	24	0	0	2	0	6	2	0	1	0	0	0	3	0	13	0	0	0	0	0	4	0	0	1	2	0	0	0	6	0	0	3	0	0	0	0	0	0	0	9	0	12	3	3	0	0	0	5	0	0	0	3	0	0	0	0	0	0	0	0	0	0	3	0	7	4	1	0	0	1	0	0	0	0	0	0	1	0	1	0	2	0	0	0	0	0	0	0	2	0	5	3	181	10	6	8	0	2	0	0	0	0	0	7	0	0	1	2	6	0	0	0	3	1	0	0	0	15	5	0	2	2	0	24	0	0	1	3	3	0	2	0	0	0	0	1	0	1	0	10	0	0	4	1	0	0	0	2	0	1	0	0	2	0	0	0	0	0	8	54	3	14	0	1	0	1	3	2	0	0	1	0	0	0	66	0	0	0	0	1	0	1	1	0	1	0	0	0	0	0	0	0	0	1	0	0	0	0	0	3	14	0	0	0	8	0	137	0	0	1	30	0	6	2093	2	0	1	0	0	0	0	0	0	0	0	0	0	1	0	0	0	1	0	0	0	0	0	8	0	160	0	0	0	0	0	0	0	2	0	0	0	0	6	0	1	17	4	15	28	0	0	0	0	0	0	0	10	0	0	1	3	0	0	0	8	22	8	4	0	3	6	0	4	1	23	0	3	2	4	1	13	4	0	5	0	0	0	0	0	0	0	0	0	0	0	0	0	0	1	0	0	21	0	3	39	0	0	0	0	0	0	0	0	0	0	0	0	0	0	0	0	0	0	1	10	0	0	0	0	0	0	1	4	0	2	1	2	0	0	0	0	0	0	0	0	0	0	0	0	0	0	0	0	0	2	136	1	0	0	0	0	0	0	0	23	0	10	4	14	2	0	0	13	0	5	14	14	1	0	0	0	0	0	0	0	0	0	2	0	0	6	0	0	0	0	0	0	0	0	0	0	0	0	0	1	17	3	2	4	3	0	3	18	0	0	0	65	0	5	1	0	0	0	0	0	0	0	0	0	0	0	0	1	0	0	1	8	0	1	0	0	0	0	4	0	0	0	0	0	0	0	0	0	0	1	47	7	0	0	0	0	0	0	0	0	2	0	5	0	0	0	0	0	0	0	0	1	0	1	0	10	0	0	1	1	0	4	129	0	0	0	0	0	0	2	0	0	0	0	1	0	0	0	0	0	6	0	0	2	3	0	2	72	8	2	0	3	0	0	0	16	0	6	0	0	0	0	0	1	0	0	3	0	0	2	0	0	0	0	0	1	0	1	0	0	0	0	0	0	1	0	0	1	0	2	9	0	0	0	0	0	12	4	0	0	0	0	0	51	0	0	0	2	0	0	0	0	1	6	1	8	67	1	0	0	94	0	1	21	26	5	1	1	0	4	1	0	0	0	0	0	1	8	0	0	1	0	1	0	0	0	0	24	28	1	0	0	0	1	8	0	9	0	0	6	0	44	0	0	0	0	3	0	0	0	0	0	0	1	0	0	3	0	0	0	0	4	0	0	0	0	0	0	0	3	5	0	0	5	0	1	0	0	0	0	0	0	0	0	0	9	0	0	0	0	0	0	0	0	0	0	0	15	0	0	0	0	0	0	0	0	0	2	0	0	0	0	1	0	0	0	0	0	0	0	0	5	1	0	4	0	0	0	0	0	1	2	0	0	1	1	0	2	0	0	0	0	0	0	0	0	0	0	0	28	22	429	30	28	9	37	32	1	19	19	53	30	11	4	20	4	21	28	7	2	0	50	30	7	14	7	20	34	14	27	0	17	5	0	0	0	0	0	0	0	0	0	0	11	15	0	0	0	0	0	0	0	0	0	0	0	0	0	0	0	1	0	0	0	0	1	0	3	0	20	0	1	0	16	0	6	0	0	0	13	0	0	0	1	0	0	0	0	0	0	0	0	0	0	0	1	12	0	0	1	0	0	0	0	0	0	1	0	0	1	2	0	0	0	0	34	0	0	2	0	0	0	0	0	1	0	0	0	0	0	3	0	2	0	0	0	0	0	2	0	1	0	0	0	0	0	0	0	0	0	15	3	0	0	3	0	0	0	0	0	0	0	0	0	0	4	0	0	8	0	1	0	0	0	0	1	0	6	0	1	0	0	0	1	0	0	0	0	5	0	1	0	7	0	0	0	0	0	0	1	0	2	14	0	0	0	0	0	1	0	0	2	0	1	0	0	0	0	0	0	1	0	0	0	0	2	0	0	0	0	0	0	0	0	0	0	1	0	8	0	6	0	0	0	1	0	0	2	0	0	0	0	0	0	0	0	0	0	0	3	2	0	0	0	0	6	0	0	16	1	1	1	0	0	22	2	3	6	1	0	0	0	0	0	2	0	12	0	1	0	0	0	0	0	0	1	6	0	0	0	0	0	0	0	0	0	11	0	0	0	0	0	0	0	0	0	0	3	0	0	0	0	6	15	9	11	33	1	0	0	0	0	0	0	0	0	0	2	0	0	0	0	0	0	0	1	5	1	2	0	0	0	1	0	0	0	0	2	3	0	0	0	0	85	0	0	0	0	2	0	0	0	0	0	0	3	0	11	5	0	0	0	0	0	0	8	1	0	0	0	3	0	0	0	0	0	0	8	4	0	0	0	0	0	0	0	0	0	0	0	1	0	0	2	0	0	0	0	0	0	0	0	0	0	0	0	0	0	0	0	0	9	0	0	0	0	3	0	0	0	0	0	0	0	0	0	0	0	0	0	0	0	0	51	0	0	15	0	22	0	8	3	0	0	0	0	1	0	1	2	0	0	0	0	0	0	0	0	4	0	0	4	0	0	0	12	0	1	3	10	0	0	4	7	0	0	3	0	9	0	88	0	3	0	0	0	2	3	0	0	6	0	0	0	2	0	0	0	3	0	0	0	5	1	1	5	1	0	3	0	1	6	1	0	0	7	0	0	0	3	1	0	2	0	0	0	0	15	3	0	0	0	0	0	6	27	1	0	0	0	10	0	0	0	0	0	43	0	0	0	0	0	0	0	0	0	0	0	12	0	0	0	0	3	0	0	0	0	0	0	0	0	0	0	17	0	0	48	14	5	0	14	0	3	0	0	0	5	0	1	0	0	0	0	0	13	0	0	1	0	0	0	4	0	2	0	0	4	0	0	74	0	2	0	0	0	17	13	0	0	0	1	2	0	0	0	0	4	0	0	0	0	2	9	0	0	0	30	5	0	0	0	0	0	0	30	172	151	1	0	0	0	1	0	0	1	5	0	0	0	2	0	0	3	21	4	0	0	0	0	0	0	0	46	0	4	0	0	0	16	0	0	2	0	0	0	0	0	0	0	0	0	0	0	0	150	51	0	0	0	0	0	0	3	9	0	0	0	0	0	0	3	2	0	7	0	0	0	0	0	111	1	1	0	0	1	0	0	0	0	0	0	0	1	0	0	0	0	0	0	0	0	508	0	0	1	0	0	0	1	0	0	0	0	0	0	0	0	3	0	0	0	0	0	0	0	0	0	0	0	0	0	0	0	0	0	0	0	0	0	0	0	1	0	7	2	0	0	0	0	0	0	0	0	0	0	0	0	0	0	0	0	8	0	0	0	1	0	0	368	0	0	0	0	0	3	17	1	0	0	0	0	7	3	29	3	0	3	0	0	5	50	0	3	0	0	2	0	2	0	0	0	0	0	0	11	0	0	0	0	0	0	0	0	0	0	0	0	4	0	0	0	0	0	0	0	0	0	0	7	0	13	0	0	0	0	0	0	0	0	1	0	0	0	1	0	0	0	6	2	0	0	0	0	1	0	6	0	0	0	0	2	0	0	4	0	15	0	1	0	0	0	0	0	0	0	0	0	0	0	4	0	2	25	5	2	6	0	0	0	0	1	0	0	0	2	0	0	1	0	3	7	0	0	0	225	8	0	0	0	0	0	0	0	218	0	1	0	0	0	0	0	0	1	4	0	10	0	0	0	1	0	0	0	0	0	0	7	6	44	0	0	2	10	5	0	0	0	0	0	0	0	0	3	31	1	8	0	0	0	0	0	0	0	30	0	0	0	0	1	0	0	0	0	0	0	0	1	1	0	3	0	0	0	0	10	0	7	0	0	0	7	0	0	0	0	0	27	0	0	0	0	0	0	0	0	0	1	0	2	0	0	0	0	0	0	26	0	0	0	0	0	0	0	9	0	0	0	0	0	2	0	0	0	0	0	0	0	0	1	0	0	0	0	0	0	0	0	0	0	0	0	0	0	0	0	0	0	0	0	0	0	1	1	0	7	0	0	0	0	0	0	0	0	0	0	0	0	0	0	0	0	0	0	0	0	0	0	3	0	0	0	0	0	0	0	0	0	3	0	0	0	0	0	0	0	0	0	0	0	0	0	0	1	0	0	0	0	0	0	0	0	0	0	0	0	0	0	0	0	0	0	0	0	0	0	0	0	0	3	3	3	0	0	2	1	0	19	0	0	0	1	0	0	0	0	0	0	10	0	2	0	0	0	0	0	0	0	0	0	27	0	0	0	0	2	0	0	0	0	0	0	0	1	0	0	0	2	0	0	84	0	0	0	0	0	0	0	0	0	0	0	0	0	0	0	0	0	0	0	0	0	0	0	0	0	0	0	0	2	0	0	3	0	4	0	0	0	0	0	2	0	2	0	0	0	0	0	0	0	6	0	0	0	1	0	0	0	0	0	1	0	0	0	0	0	0	0	0	0	0	0	0	0	0	0	0	0	0	0	0	0	0	0	0	0	0	0	0	0	0	0	0	0	0	0	0	0	0	0	0	0	0	0	0	0	0	1	0	0	0	0	0	0	0	0	0	0	0	0	0	0	0	0	0	0	3	0	0	2	0	0	0	0	0	0	0	0	0	0	0	0	0	4	0	0	15	0	3	1	0	0	1	0	0	1	1	0	10	0	0	0	0	0	0	0	0	0	0	0	25	0	0	0	0	0	76	0	1	0	0	0	2	0	1	0	0	0	0	0	0	3	0	0	0	0	0	0	0	0	0	0	0	0	0	0	0	1	0	0	0	0	5	0	0	0	0	0	0	0	0	0	0	0	0	0	14	0	0	1	0	0	0	0	0	0	0	0	0	1	0	0	0	0	0	0	0	0	0	0	0	0	0	0	0	0	0	0	0	0	1	5	0	0	0	0	0	0	0	4	1	0	0	0	0	0	0	0	4	2	0	0	1	0	0	0	0	0	0	0	0	0	0	2	3	0	0	0	0	0	0	0	5	0	0	0	0	0	0	0	0	0	0	0	3	0	0	0	0	0	0	0	0	0	0	0	0	0	0	0	0	0	5	0	0	0	0	0	0	0	0	0	0	0	0	0	0	0	0	0	1	0	0	0	1	0	0	45	0	0	0	0	0	0	0	4	1	0	0	0	0	0	0	1	0	0	0	0	0	3	0	1	0	1	0	0	0	0	0	1	0	0	0	0	0	0	0	0	0	0	0	0	5	3	0	4	0	0	0	0	0	0	0	0	0	0	0	0	0	0	0	2	0	14	0	0	2	3	0	0	0	0	2	2	0	0	4	0	14	0	0	0	0	0	0	0	0	0	1	33	0	0	0	0	0	0	0	0	0	5	0	0	1	0	0	0	1	0	0	0	0	0	0	0	0	0	0	0	0	0	0	0	0	1	0	0	0	0	0	1	0	0	0	0	0	6	0	0	0	0	0	1	0	0	0	0	4	0	0	0	0	0	0	3	0	0	0	0	0	0	1	0	3	3	2	11	63	0	0	2	0	42	0	3	7	0	0	0	0	15	42	0	8	0	3	2	0	94	0	0	0	376	0	0	0	1	5	0	1	0	0	1	0	6	19	31	0	0	0	0	1	0	3	0	0	2	1	0	0	0	0	0	0	0	1	3	0	0	0	0	2	0	0	8	0	0	0	0	0	0	0	0	0	0	4	0	0	0	33	0	0	0	3	0	0	0	61	0	1	0	0	0	0	0	0	4	0	0	0	23	94	0	0	0	0	0	0	0	1	1	0	0	0	0	0	0	3	0	0	0	0	0	0	0	12	2	0	0	0	0	0	0	0	0	0	0	0	3	0	1	0	2	3	0	0	0	0	0	4	0	1	0	0	0	0	2	0	0	0	0	2	0	1	0	0	1	0	2	3	0	0	0	0	0	0	0	25	0	0	0	12	2	39	0	3	1	0	30	0	18	3	2	1	66	41	19	0	94	18	17	7	19	0	23	3	32	0	0	0	19	0	0	0	0	0	0	0	0	0	0	46	0	3	0	0	0	0	0	0	1	0	0	3	0	1	0	2	7	0	0	0	0	1	3	0	0	0	0	0	0	16	16	1	0	1	0	0	0	45	0	0	0	0	3	0	0	19	0	4	0	4	0	0	0	0	0	0	10	7	1	0	4	8	0	0	0	0	0	0	0	0	0	0	0	0	0	0	0	1	0	0	0	0	3	2	0	0	0	6	0	0	2	14	0	0	0	0	0	5	2	2	11	0	1	0	0	0	0	0	0	14	0	1	5	0	0	0	0	0	0	0	0	0	0	0	0	28	0	0	22	1	0	0	2	0	0	0	7	0	1	0	1	2	1	1	14	0	1	0	0	1	0	0	1	0	0	0	1	0	0	0	0	0	0	0	0	0	0	0	0	0	0	0	0	0	0	8	0	0	0	0	0	0	0	0	0	0	0	0	17	0	0	0	0	11	6	3	0	0	0	0	0	14	13	44	0	0	1	0	17	2	0	0	0	2	0	0	0	0	0	0	0	0	0	16	2	3	0	8	0	0	0	0	0	0	0	2	1	0	1	0	0	0	0	0	0	0	0	1	0	5	1	0	0	0	1	0	0	1	0	0	0	1	1	0	0	0	0	3	0	0	3	0	5	0	2	3	0	3	3	1	24	0	4	0	0	0	0	0	0	4	0	9	0	0	0	0	0	0	0	0	0	0	0	9	12	1	1	0	0	3	10	0	0	0	0	0	18	0	0	2	0	27	0	0	0	0	7	0	23	5	0	0	0	0	0	0	0	0	2	0	0	0	1	0	0	0	0	0	21	1	0	0	0	3	0	0	0	0	0	0	1	0	0	0	0	0	0	1	0	0	0	1	0	0	0	0	0	0	0	0	0	0	0	0	0	0	0	1	3	0	0	0	1	0	5	0	0	5	11	2	5	0	0	0	0	0	0	0	0	0	0	0	11	1	0	1	0	0	0	3	0	2	1	12	4	3	3	4	1	0	0	0	0	0	2	0	0	3	0	0	0	7	0	0	0	0	0	4	0	0	1	1	1	0	0	0	0	0	36	0	1	0	0	0	0	2	0	0	0	1	0	0	0	0	1	0	0	0	0	0	0	0	0	0	0	20	0	0	0	0	0	11	0	0	0	1	0	0	0	0	4	0	1	0	0	0	0	2	0	9	0	0	1	1	0	0	1	0	0	5	0	0	0	0	0	0	0	0	1	12	0	1	0	0	0	77	0	1	0	2	0	0	0	12	1	0	0	0	0	0	11	0	0	0	0	3	0	0	0	7	0	1	0	0	0	0	0	0	0	28	3	0	4	0	2	0	1	0	0	27	0	0	0	0	1	0	0	0	0	10	0	0	0	0	1	0	0	0	0	0	0	0	1	0	40	28	1	0	0	2	43	0	0	0	0	0	2	0	0	0	8	0	3	0	0	2	0	0	0	0	0	0	0	0	0	0	0	0	0	4	0	0	0	0	0	0	0	14	0	0	0	0	0	0	0	1	0	0	18	17	0	0	0	0	1	0	0	0	0	0	0	0	0	0	0	0	0	0	0	11	0	0	0	0	0	0	0	0	0	0	0	0	0	0	0	0	0	0	0	0	5	0	0	0	0	1	0	1	0	0	0	0	2	0	2	0	0	0	0	0	0	0	0	0	0	0	0	0	0	0	0	0	0	1	0	0	0	0	0	0	0	17	0	0	0	0	0	1	0	1	0	0	5	0	0	0	1	25	0	0	0	0	0	0	0	0	0	0	10	0	0	7	0	0	0	0	0	0	0	0	0	0	5	0	0	0	0	0	0	0	0	0	0	14	0	0	0	0	1	0	0	0	0	0	0	0	0	0	1	2	0	5	6	0	0	0	0	0	1	0	0	9	0	0	0	0	0	0	0	0	0	0	0	0	18	0	0	0	3	1	0	0	0	0	1	0	0	1	0	0	0	0	0	0	0	0	0	0	0	10	0	0	1	0	0	0	0	0	0	0	0	0	1	0	0	0	0	0	3	0	0	0	0	0	6	1	0	0	0	0	0	1	0	2	0	0	58	0	0	0	0	3	0	0	0	0	0	0	0	0	0	0	0	3	3	0	0	0	0	0	0	0	59	3	3	1	14	0	0	0	0	0	17	1	0	0	0	0	1	3	8	0	4	4	0	6	0	0	0	12	1	0	6	9	0	0	0	0	0	0	0	15	4	0	2	0	90	0	0	0	2	0	4	1	1	0	0	1	0	4	0	2	0	0	0	0	0	0	0	0	0	0	1	0	0	0	0	3	5	0	1	0	0	2	13	1	9	7	0	2	0	2	0	1	154	0	0	0	0	0	0	3	0	1	0	0	0	0	3	1	1	2	0	0	0	6	31	6	22	3	0	22	8	1	0	3	0	0	0	0	0	0	0	0	0	0	1	0	0	0	0	8	0	1	0	21	4	2	0	0	0	3	0	0	0	0	0	0	0	0	0	0	0	0	0	0	0	0	0	1	0	0	4	0	0	0	3	0	0	0	0	1	0	21	0	0	0	0	0	0	2	0	0	2	1	0	0	0	0	0	0	2	0	5	8	0	57	0	0	0	0	0	1	0	0	0	22	0	0	186	0	0	77	11	2	8	0	10	1	2	0	2	3	0	14	22	6	0	0	0	0	0	0	3	0	0	0	0	0	0	0	0	3	8	0	0	11	0	0	2	3	0	0	0	0	0	0	4	0	0	0	12	4	0	0	0	0	0	0	0	0	0	4	0	6	0	0	6	0	0	0	1	5	34	0	2	0	117	0	0	0	1	0	0	0	0	0	0	6	1	1	4	0	0	0	0	0	0	2	0	0	0	0	0	2	20	4	0	2	1	0	0	0	4	0	1	0	0	0	4	0	0	0	0	0	0	0	0	0	0	0	0	0	9	15	0	0	0	0	4	1	0	1	0	3	5	0	0	0	5	0	0	1	4	0	10	1	0	5	2	1	2	4	9	8	0	0	0	4	0	0	4	0	0	0	1	0	0	3	0	0	0	1	2	0	0	7	135	23	0	12	0	2	0	1	25	0	0	0	0	0	0	0	0	0	0	0	0	0	0	1	5	1	0	1	10	21	0	0	0	0	0	0	36	0	0	0	0	0	0	1	2	0	0	0	4	2	0	0	0	3	0	5	7	0	0	1	0	7	0	0	0	1	7	0	0	1	3	0	0	0	52	0	0	1	1	2	35	10	0	0	0	0	0	0	0	0	1	0	0	1	0	1	0	23	0	19	7	6	0	0	14	10	2	0	1	2	0	0	0	0	10	3	0	0	0	0	0	6	8	16	4	0	2	5	0	0	0	0	0	17	0	0	0	0	0	0	21	5	6	91	7	0	10	19	1	0	1	0	0	0	7	2	0	10	1	0	1	0	14	0	136	4	0	2	3	1	0	1	36	9	0	1	3	1	0	0	1	0	0	0	0	0	0	0	0	0	0	1	0	0	0	0	0	1	10	5	19	55	15	4	0	0	0	3	5	11	0	0	1	0	0	0	0	0	0	0	0	0	0	0	0	0	0	0	0	0	0	24	0	0	0	0	1	0	2	0	3	0	0	7	2	1	3	1	3	6	0	2	3	1	0	3	0	29	18	4	0	0	0	1	2	5	0	3	1	0	0	1	6	0	0	0	0	0	0	0	0	6	0	0	0	0	0	0	0	0	0	1	0	0	0	0	7	2	0	1	0	0	0	0	0	0	0	3	0	551	0	0	0	0	43	2	5	0	0	0	0	0	0	0	0	5	1	6	0	0	0	0	0	0	0	0	1	0	1	6	0	0	0	0	0	1	0	0	0	32	10	0	0	0	0	0	0	3	5	0	0	5	0	0	0	0	0	0	0	0	0	1	0	0	0	0	2	2	0	4	3	1	11	0	0	0	0	5	2	3	0	0	8	0	0	0	0	36	0	0	0	0	0	0	0	0	0	0	0	23	2	0	5	16	0	0	0	0	4	0	9	1	2	0	0	0	0	0	1	0	0	8	0	0	0	0	5	0	0	1	2	0	0	0	1	0	0	0	0	0	202	2	4	1	5	277	0	8	5	6	4	0	18	9	7	1	2	2	1	0	5	53	46	51	9	8	0	0	0	31	0	7	0	1	0	12	5	0	0	300	0	3	0	0	0	0	0	2	0	0	0	1	1	24	5	0	3	6	21	1	0	0	0	5	3	0	0	0	0	0	0	0	0	1	0	0	0	2	12	0	3	3	0	0	1	3	0	0	0	1	0	1	1	1	0	3	0	0	3	7	0	0	0	0	0	0	0	0	0	1	0	2	4	0	8	0	0	0	8	23	336	0	0	4	10	15	1	8	23	0	3	0	6	0	0	10	0	0	0	0	2	65	2	0	2	1	17	3	0	0	3	0	0	0	9	5	0	0	0	0	8	1	0	3	0	11	0	0	0	0	0	5	0	0	8	0	2	0	0	0	0	0	0	7	1	0	0	0	1	0	57	0	1	0	0	0	26	1	8	0	3	3	0	0	0	14	3	0	14	14	0	1	8	2	0	0	0	2	2	1	0	2	1	8	1	16	3	1	0	0	0	0	0	0	23	0	0	3	0	0	1	0	0	0	0	0	1	2	6	0	1	0	0	0	0	0	0	16	5	0	0	0	0	0	0	0	0	0	0	0	0	0	0	0	5	0	0	0	0	0	2	0	0	0	0	0	0	0	0	3	0	0	1	0	0	0	0	0	0	1	0	0	0	0	0	0	2	0	7	0	0	12	0	3	0	0	0	11	0	0	0	0	6	2	0	0	10	0	1	0	4	1	5	0	0	3	0	0	3	0	0	2	0	0	0	0	0	0	0	3	0	0	0	0	22	2	6	2	10	3	1	3	1	2	0	6	2	3	3	7	27	7	4	9	2	1	0	1	0	2	0	0	7	1	0	3	4	4	13	3	18	7	62	17	4	15	3	0	3	4	2	3	5	0	0	2	0	32	72	10	0	0	59	6	1	22	75	24	5	273	0	103	4	3	1	0	0	1	1	1	2	0	3	0	42	189	17	0	0	26	0	0	0	0	0	31	8	19	15	12	1	33	3	4	24	0	0	2	5	6	0	4	0	0	0	2	7	1	4	5	2	1	4	2	1	1	2	0	0	0	0	0	0	0	3	0	0	2	1	0	0	0	17	0	1	0	0	0	2	1	0	1	0	0	3	0	0	0	0	0	0	0	0	0	0	0	0	0	0	3	1	0	0	0	0	0	0	23	0	5	4	0	2	0	0	10	29	0	0	9	0	0	2	2	0	0	0	0	0	0	21	0	0	0	1	0	7	0	0	0	0	0	3	0	0	0	0	2	0	0	0	0	0	0	0	0	0	0	0	14	0	0	0	0	3	0	14	13	6	7	0	5	0	4	0	0	0	0	0	1	0	0	0	0	0	0	0	1	12	3	1	0	0	0	0	0	4	0	0	11	0	1	0	10	0	1	1	0	167	8	0	0	0	0	0	0	2	4	3	9	3	0	0	2	0	0	2	1	18	0	0	0	5	0	1	0	0	2	3	8	4	0	0	7	0	0	0	61	28	1	1	0	0	0	0	1	0	0	0	3	7	0	2	1	0	0	0	2	0	0	0	0	1	0	2	0	0	0	0	0	0	0	1	0	8	0	7	0	0	0	0	0	0	0	0	0	2	0	4	0	0	6	0	2	9	0	0	1	3	0	0	2	8	0	0	0	1	0	0	0	0	0	0	2	0	1	0	1	0	0	0	0	1	0	0	0	1	1	0	0	4	0	1	0	0	0	0	0	13	1	2	0	12	2	13	0	0	9	0	0	1	1	0	0	0	13	0	0	1	0	0	0	0	0	0	0	0	0	0	2	2	0	0	2	2	0	0	0	2	1	6	1	0	0	0	0	0	0	0	0	0	0	0	1	0	13	0	0	0	0	6	4	0	0	1	3	3	0	0	15	0	21	2	2	156	0	0	8	0	0	0	0	0	0	0	0	0	3	6	0	4	2	1	2	0	0	0	2	0	0	0	0	0	0	5	0	0	0	0	0	0	0	0	1	0	3	2	0	0	0	27	0	0	1	0	18	1	1	0	0	0	0	2	2	0	0	0	0	15	3	0	0	0	0	2	0	13294	0	0	0	0	0	0	0	0	0	0	0	0	0	0	0	0	1	0	0	0	1	5	4	1	10	0	4	3	3	0	0	0	0	0	0	3	0	1	10	0	7	6	0	0	0	4	1	2	0	0	0	0	1	0	15	52	13	3	1	9	8	16	0	0	2	0	6	0	0	87	2	15	2	0	0	0	63	3	6	0	5	7	12	1	2	0	0	0	0	7	0	2	0	0	4	6	0	13	1	0	0	3	4	0	0	6	8	0	0	0	2	0	0	0	0	0	0	0	14	11	20	8	5	0	2	1	0	3	16	4	23	5	1	1	3	1	13	4	0	0	3	5	0	7	0	1	0	55	79	18	3	1	0	3	0	0	5	4	2	1	0	3	0	0	0	0	0	0	0	0	0	3	1	4	2	0	0	13	0	0	0	1	0	0	0	0	4	4	22	0	1	6	7	3	2	0	0	20	0	0	0	1	0	0	9	10	2	0	15	0	0	0	7	1	0	0	0	0	0	0	0	0	0	0	0	0	0	1	7	0	0	0	6	3	1	0	0	1	1	0	0	1	2	0	0	0	3	0	0	0	11	31	0	1	1	0	4	19	0	2	13	0	1	1	0	0	1	0	0	0	0	0	0	0	0	0	0	0	0	0	0	0	24	0	0	0	0	0	0	3	0	0	0	0	0	0	0	0	0	0	0	0	0	0	0	0	0	0	0	0	0	0	6	0	4	0	0	0	0	5	0	12	0	0	0	0	0	1	0	18	0	0	0	22	3	2	8	9	0	0	1	2	5	0	0	0	0	4	0	17	0	0	0	0	0	0	0	0	0	19	1	0	0	0	3	1	0	0	0	0	5	26	0	0	0	0	0	0	1	1	5	5	2	0	7	0	39	6	1	435	3	0	0	3	19	11	4	0	106	0	0	30	3	58	0	1	0	0	0	0	0	0	2	0	0	24	1	11	0	0	0	1	5	0	0	0	0	0	0	1	0	0	0	3	0	1	0	1	0	1	0	0	47	0	0	0	0	0	3	5	0	0	0	0	0	0	0	8	10	2	1	10	11	9	6	0	0	39	6	1	46	0	0	1	0	1	0	0	1	0	0	0	0	1	0	0	0	0	0	0	2	0	0	0	0	0	10	0	4	38	0	0	0	6	0	0	3	0	0	0	0	0	20	0	2	0	0	0	0	3	3	0	0	0	1	0	0	0	0	1	0	0	0	0	0	3	0	0	470	0	0	0	0	0	0	0	47	0	40	0	0	0	0	0	0	0	0	0	0	0	0	0	0	0	0	0	2	1	1	20	0	2	0	0	2	1	4	0	0	0	0	0	0	0	0	0	0	0	0	0	0	0	1	0	0	0	0	0	0	0	0	0	0	0	0	0	0	10	0	0	0	40	0	0	0	0	1	42	0	0	0	5	1	1	3	0	0	0	1	0	0	8	2	3	7	45	4	21	123	0	0	2	0	0	1	2	4	0	0	0	0	0	0	0	42	0	0	1	0	48	0	0	0	0	0	45	0	2	0	0	0	2	0	0	0	2	0	0	0	0	0	0	0	0	0	0	14	11	0	0	0	0	0	0	0	1	2	0	0	0	0	0	2	4	5	0	0	0	0	2	0	0	0	5	2	0	1	1	0	0	0	0	1	0	2	1	4	122	1	0	7	0	0	7	0	0	1	0	1	2	17	0	2	30	1	3	110	0	0	1	0	0	1	0	3	1	2	0	0	0	0	8	1	1	0	2	0	0	0	0	8	0	0	4	9	30	1	8	0	0	12	38	0	0	0	0	0	1	0	0	5	1	0	9	0	0	2	0	0	0	0	1	0	0	0	0	24	4	0	0	0	1	0	0	0	0	1	1	1	10	0	1	11	1	3	0	0	0	0	2	1	0	3	450	14	7	0	0	19	0	9	20	35	0	0	0	0	0	0	4	0	0	47	0	0	2	3	13	2	0	5	4	0	1	1	11	1	0	14	5	0	3	0	0	1	0	0	5	26	3	0	0	0	0	11	0	0	2	0	0	0	0	0	0	0	0	0	0	0	0	0	0	0	0	0	0	0	0	0	0	0	0	0	0	0	0	0	0	6	0	0	2	0	0	0	0	0	0	0	0	0	0	0	0	1	0	0	0	3	1	5	1	0	0	432	0	1	0	3	0	2	0	0	0	0	12	106	8	1	1	1	10	2	0	3	0	7	0	1	0	0	0	0	0	0	0	0	13	0	3	0	0	6	5	0	0	1	0	0	5	7	0	3	0	1	0	0	0	0	12	8	9	4	3	1	7	3	0	4	3	1	1	0	0	1	0	0	1	3	2	0	5	1	8	1	1	0	1	0	2	0	0	0	0	0	0	0	0	0	0	14	0	0	0	0	0	0	0	0	0	0	2	1	2	0	18	1	7	5	0	5	1	0	18	5	8	0	0	0	0	0	0	0	0	3	440	9	11	3	0	0	0	0	0	0	0	0	0	0	0	0	0	0	1	0	3	28	32	0	0	10	4	2082	3	0	0	3	0	0	0	0	0	0	42	0	0	8	5	0	0	0	0	0	1	0	0	0	0	0	0	0	7	0	5	5	0	1	0	0	0	1	12	0	21	0	1	7	0	1	0	0	0	7	0	0	0	1	2	0	0	0	0	0	0	2	0	0	0	0	0	6	0	0	0	0	0	0	0	0	0	0	0	0	0	0	0	0	0	0	0	0	0	0	71	55	0	2	2	4	1	23	16	1	0	0	1	4	0	0	0	0	0	0	0	0	0	0	0	4	0	0	0	0	0	2	0	0	0	0	0	346	0	0	0	0	0	0	0	0	0	0	0	2	0	1	1	2	0	0	0	0	0	0	0	0	0	0	0	2	0	1	0	4	15	10	0	6	0	0	0	0	0	0	0	0	2	0	2	0	0	6	8	0	6	22	0	0	0	0	0	1	0	0	0	0	0	0	0	0	0	0	0	2	0	0	0	0	0	0	0	0	0	0	2	0	0	0	0	0	0	0	9	0	0	0	0	0	0	0	0	0	5	0	0	0	0	0	0	0	0	0	0	0	0	0	0	0	0	0	0	0	0	0	0	0	0	2	0	2	105	0	0	0	2	0	0	0	0	0	0	0	0	1	0	0	0	0	0	0	1	0	0	0	0	0	0	0	0	0	0	0	1	0	0	0	0	0	0	0	0	0	0	21	0	0	0	0	0	0	0	0	0	0	0	0	10	0	0	0	0	1	0	0	17	0	0	0	0	0	0	0	0	0	0	0	0	0	0	0	3	0	0	0	0	0	4	0	0	0	0	0	0	0	0	0	0	0	0	0	0	0	0	0	0	0	0	0	0	0	0	0	0	0	0	0	0	0	0	0	0	6	0	0	0	0	30	0	0	0	0	0	0	1	2	1	0	0	0	0	21	0	20	6	1	0	0	2	0	2	6	0	0	21	0	13	0	0	30	1	6	0	0	1	0	0	0	0	0	2	1	0	0	1	2	0	1	1	0	3	0	0	0	0	3	0	5	0	0	0	0	1	2	0	19	0	2	3	0	1	8	0	1	0	2	0	0	1	6	0	0	0	2	1	0	7	0	1	1	1	6	1	0	0	0	0	12	2	4	0	1	0	1	0	3	0	1	1	0	0	17	0	0	97	0	0	0	0	0	0	45	1	4	5	2	0	1	0	1	4	2	0	1	0	0	0	0	2	1	9	0	3	9	5	4	11	20	6	1	0	0	2	3	0	11	0	2	0	0	0	0	0	0	9	0	2	0	0	0	0	0	0	0	5	0	6	0	0	0	0	0	1	0	15	0	22	13	0	4	0	1	10	0	0	0	0	0	0	1	0	0	0	0	0	0	0	0	1	0	1	0	1	0	0	0	0	20	0	0	0	0	0	0	0	0	0	0	0	0	0	1	0	0	0	0	8	0	0	1	0	0	0	0	2	0	0	0	0	0	11	0	0	4	4	0	0	0	5	0	4	0	23	0	0	0	1	0	0	0	0	0	0	0	0	0	0	0	0	5	1	9	0	2	0	0	0	0	0	0	0	0	14	1	1	0	0	0	0	0	0	0	0	0	0	0	0	0	0	0	0	0	0	0	0	3	2	0	0	5	7	0	0	0	0	0	1	0	2	0	5	3	15	0	0	1	1	0	1	16	0	0	0	5	4	0	0	0	0	2	2	5	84	0	5	2	11	0	0	0	0	0	1	3	1	0	0	0	0	0	0	0	0	3	1	0	0	4	5	1	1	1	0	0	0	0	0	0	2	2	1	2	4	10	2	3	1	393	0	2	0	0	7	0	0	4	4	0	0	0	0	0	0	1	4	0	0	0	0	3	3	0	0	0	2	0	0	0	0	1	0	3	0	2	4	1	1	0	10	0	0	0	0	0	0	0	1	0	0	0	3	1	2	1	4	0	14	0	0	0	0	0	0	2	0	3	0	1	1	0	2	1	1	1	8	0	6	4	12	3	102	5	0	0	2	0	0	0	0	0	0	0	0	0	0	0	0	0	0	4	3	7	0	4	3	2	0	4	0	1	0	7	18	5	0	3	0	0	0	0	7	2	12	10	7	0	0	0	5	0	2	0	34	2	0	14	2	11	21	10	0	15	0	0	5	0	1	0	0	0	0	0	2	11	0	19	2	3	0	0	23	0	0	17	2	5	0	0	1	2	7	3	0	0	1	6	1	0	7	0	0	0	0	8	0	0	3	0	0	0	0	0	0	0	7	0	0	0	0	0	0	8	0	0	0	0	0	0	0	0	0	0	1	1	0	11	1	4	0	3	0	0	0	0	0	0	0	0	0	10	0	0	4	0	1	7	1	20	0	0	0	0	988	0	0	0	0	0	10	0	0	1	0	0	0	0	1	0	3	0	1	3	1	1	0	0	0	0	0	0	0	16	0	0	0	7	0	0	2	0	0	2	0	2	10	0	0	0	1	0	8	3	0	0	0	1	0	3	0	0	0	1	0	0	0	3	5	2	1	0	0	0	0	1	0	0	0	0	0	67	9	1	0	10	0	0	18	17	0	8	1	2	4	8	2	3	6	4	4	17	0	9	4	0	0	0	0	0	2	0	5	0	1	0	0	0	0	0	0	0	0	0	0	0	0	0	6	1	1	0	7	0	32	1	0	0	0	0	0	0	0	0	0	0	0	0	0	0	0	0	0	0	0	0	0	0	0	0	0	0	1	1	0	0	0	0	0	0	0	0	0	0	0	0	0	0	0	0	0	0	0	0	0	0	0	0	12	1	0	26	2	2	0	0	0	0	0	4	3	5	6	0	3	8	0	0	1	0	0	2	0	0	0	0	0	0	0	4	6	1	8	2	4	0	7	2	4	24	2	1	0	0	0	1	1	0	0	0	0	0	2	0	0	2	0	8	2	3	6	0	4	0	2	1	1	0	1	8	5	0	0	1	0	0	0	4	4	0	0	0	0	0	0	0	1	0	0	0	0	16	5	0	0	0	17	0	0	0	0	2	0	0	0	18	2	0	1	0	21	28	0	0	0	0	1	0	2	0	0	4	0	0	0	2	0	5	17	4	2	0	8	0	0	0	4	0	0	0	0	0	0	1	1	14	1	0	2	0	0	0	2	0	0	0	0	3	0	2	1	3	0	1	0	15	1	0	0	2	2	0	0	1	1	0	0	1	3	0	0	0	2	0	16	0	0	0	1	0	0	0	0	0	0	14	0	0	0	0	0	0	0	0	2	0	0	0	0	0	0	0	4	2	0	3	0	0	0	0	1	2	3	0	20	0	0	1	0	2	44	10	0	2	1	0	0	36	21	0	3	19	0	2	0	1	5	41	0	0	0	0	2	6	1	0	0	0	0	0	0	8	1	0	0	9	7	6	0	0	0	0	0	0	0	25	0	2	0	0	0	0	0	0	0	0	9	4	36	0	8	0	3	0	3	0	0	0	0	0	0	0	0	0	0	0	1	0	0	0	1	1134	0	0	6	0	61	4	0	0	0	2	11	4	76	11	6	27	3	57	0	4	10	0	0	0	0	0	0	5	0	132	20	4	0	0	0	1	0	0	3	0	0	0	1	0	0	0	4	37	0	0	1	109	7	15	8	2	2	0	2	1	0	0	13	0	0	4	0	0	0	0	0	0	0	0	0	5	0	0	1	0	0	0	0	0	0	0	0	0	0	0	0	14	0	0	1	0	30	2	1	0	3	0	0	0	0	0	0	0	0	0	4	0	8	0	3	2	0	0	1	1	0	2	2	0	0	10	2	1	1	2	8	21	3	2	1	28	1	18	24	2	0	0	0	0	0	0	0	0	0	0	0	1	0	0	0	4	0	0	0	2	1	0	1	0	0	0	0	0	2	0	29	0	0	0	0	5	0	0	2	2	0	2	0	7	0	5	0	2	0	0	0	0	0	0	0	0	0	0	0	0	0	11	0	0	0	0	0	0	0	0	1	0	0	0	0	0	1	1	3	0	13	0	80	16	0	112	0	0	2	0	0	0	0	6	1	1	0	0	0	0	0	3	8	0	0	0	6	0	8	3	2	0	89	0	28	69	0	0	1	0	0	0	0	0	0	19	76	2	5	1	1	21	1	0	2	1	0	0	0	1	2	0	0	1	9	1	0	0	0	0	1	0	0	0	4	0	0	0	1	13	0	0	0	0	0	0	0	0	0	0	0	0	0	0	1	0	0	0	0	1	0	0	0	0	0	0	1	1	0	4	2	0	5	0	4	6	10	3	0	0	0	1	0	0	0	0	0	162	0	0	22	1	0	0	0	1	0	4	0	6	1	0	0	0	0	0	1	0	0	0	9	0	0	0	0	0	0	0	46	0	4	0	23	23	0	5	1	3	2	0	0	606	7	0	0	1	46	2	0	5	1	0	2	1	0	0	0	7	1	0	2	1	0	0	0	0	0	0	0	1	0	43	0	1	0	1	0	0	0	5	0	1	0	0	0	0	0	0	3	0	0	3	3	0	0	0	0	0	0	0	0	0	0	0	0	0	14
LakWasMe98_LOW12_2_rpkm	0	0	0	0	0	1	0	0	0	0	0	3	3	4	0	0	0	0	0	0	0	0	0	2	0	0	0	0	0	0	0	0	0	2	0	2	0	0	0	0	0	0	0	1	4	1	2	9	0	1	0	2	0	0	0	0	0	0	7	29	2	0	0	0	0	0	0	0	0	3	0	0	0	0	0	0	1	0	0	0	0	6	2	0	0	0	0	0	0	0	0	1	0	0	6	0	0	0	0	0	0	0	0	0	0	1	0	0	0	0	1	0	0	0	1	0	0	0	0	0	0	0	0	0	0	0	4	0	0	0	3	17	10	0	0	0	0	0	0	0	0	0	0	1	1	0	0	0	3	0	0	2	0	0	8	0	0	0	6	0	2	0	0	1	0	0	0	1	0	7	1	0	0	0	0	0	0	0	0	0	0	0	0	0	0	29	0	0	0	0	0	2	1	1	0	0	1	7	1	16	0	0	0	0	0	0	0	0	0	0	2	0	2	2	2	0	0	0	0	12	0	0	0	1	0	0	5	0	13	0	0	2	0	0	0	0	0	0	2	0	0	0	3	0	6	0	0	0	0	0	0	0	14	0	113	2	0	0	0	0	0	0	0	1	0	0	123	0	0	21	60	0	4	0	0	1	0	0	0	0	0	6	0	9	5	0	0	0	1	0	0	0	0	0	0	0	0	11	0	0	0	8	2	0	0	0	1	8	10	0	0	0	7	1	0	0	0	0	0	0	0	0	0	0	4	0	0	0	0	0	0	1	0	0	0	0	0	5	0	0	0	1	4	0	0	0	2	0	11	0	0	0	0	0	0	0	0	0	0	16	0	0	0	0	0	3	0	7	0	0	0	12	0	14	19	0	0	1	0	1	2	0	0	0	3	0	2	1	0	0	0	0	24	0	0	3	0	0	0	0	1	1	0	1	2	0	0	0	0	0	0	3	0	16	0	5	0	1	1	5	0	0	2	0	0	0	0	0	0	0	0	0	0	0	0	7	0	1	3	0	9	0	0	0	0	23	0	0	0	0	0	12	0	50	0	0	8	0	0	0	0	0	0	1	0	2	6	0	0	0	1	17	5	0	0	0	7	1	3	0	4	1	14	697	1	0	0	16	6	0	0	0	7	26	0	0	4	0	0	0	0	0	3	0	0	2	0	0	0	0	0	0	0	0	1	0	0	0	0	9	0	0	0	0	0	0	0	0	0	0	0	0	17	2	0	0	0	6	0	1	0	0	0	2	1	0	0	0	0	11	0	0	1	3	0	0	0	2	0	0	0	0	0	0	1	0	0	0	1	0	0	0	0	1	0	0	1	21	3	0	0	7	4	0	4	0	0	3	24	0	0	0	5	0	87	2	1	0	3	0	2	0	0	0	1	1	0	4	0	41	1	52	41	55	0	0	8	0	24	0	0	0	0	1	0	5	0	1	0	1	0	0	0	0	2	0	0	0	5	2	2	31	0	0	0	1	2	1	0	1	0	0	1	13	2	0	0	0	1	0	0	6	0	0	0	0	0	0	0	0	0	1	9	0	0	0	0	1	0	0	0	0	1	0	0	0	0	0	0	5	0	0	1	0	0	0	0	0	0	0	0	7	0	5	2	0	4	0	0	0	0	1	0	1	0	3	0	0	3	8	0	0	0	5	0	0	0	0	1	0	0	0	0	0	0	0	0	0	0	0	0	0	1	0	2	2	0	0	0	3	0	0	4	0	0	0	0	0	1	6	0	0	0	2	0	0	0	0	0	0	0	0	0	0	5	7	0	0	0	0	0	0	3	0	0	0	0	0	0	0	0	3	0	0	0	0	0	3	0	1	0	0	0	0	0	0	24	0	0	0	0	0	0	0	0	0	0	0	0	0	0	0	0	0	2	0	0	0	23	3	1	0	0	0	0	0	0	4	11	0	0	0	0	0	0	0	0	0	1	6	0	0	2	0	0	0	0	0	0	0	3	0	0	1	0	0	0	0	3	0	0	0	0	0	0	0	0	0	1	0	0	0	0	0	0	0	1	0	0	0	0	0	0	0	0	0	0	0	0	0	0	0	3	35	0	0	0	0	0	0	0	0	0	0	1	0	0	0	0	0	0	2	0	0	0	0	0	0	0	0	0	0	0	0	0	0	0	0	0	0	0	0	0	0	1	0	0	0	0	0	0	0	0	0	0	0	0	0	0	0	0	0	0	0	0	0	0	0	0	0	0	0	1	7	0	14	0	0	0	0	3	3	0	0	53	0	0	0	0	0	0	0	0	0	0	0	0	0	0	0	0	0	0	0	0	0	0	0	0	2	0	0	0	0	0	0	0	8	0	0	0	4	0	0	0	1	0	0	7	0	4	0	0	0	0	0	3	0	1	0	0	0	0	0	0	0	0	0	0	0	0	0	0	0	0	0	0	0	0	0	0	0	0	3	0	0	0	0	0	0	0	0	0	0	0	0	0	0	2	0	0	0	0	0	0	0	0	0	0	2	0	0	1	0	0	0	0	0	0	0	0	0	0	0	0	1	12	0	0	67	0	92	0	0	0	0	0	18	0	0	5	0	0	0	0	0	0	0	18	0	0	0	0	0	0	0	0	0	0	0	0	0	0	0	0	0	0	0	0	0	0	3	0	0	0	0	0	0	0	0	0	0	0	0	0	0	0	0	0	0	3	0	0	0	61	0	1	1	1	0	0	0	0	0	0	0	0	2	0	0	0	0	8	4	0	10	0	0	0	7	1	0	0	0	0	1	1	0	0	0	0	0	0	0	0	0	0	0	0	0	0	0	0	0	0	0	0	0	0	0	0	0	0	0	0	0	0	0	0	0	6	0	2	0	0	0	27	0	0	0	3	0	0	3	5	0	0	0	0	0	0	0	0	7	0	8	0	0	0	0	0	0	1	14	0	11	5	0	0	1	0	0	0	0	0	39	9	5	15	0	0	0	0	0	0	1	0	0	0	0	0	0	0	0	0	0	0	0	0	1	0	0	0	0	0	0	0	0	0	1	0	0	0	0	0	0	0	0	0	0	0	0	0	1	9	0	3	5	5	0	0	0	2	6	0	0	2	0	0	1	0	0	1	0	0	0	2	2	0	0	0	0	0	0	5	0	0	0	2	1	0	0	0	5	0	0	1	0	0	0	0	0	0	0	0	0	2	4	4	6	0	0	10	0	0	1	0	1	0	0	0	0	0	0	0	0	2	0	0	9	2	0	11	3	2	0	10	0	0	0	0	0	0	0	0	0	0	3	0	0	0	4	5	0	2	0	1	1	0	0	0	0	0	6	0	0	0	0	1	0	0	0	0	2	2	15	43	0	0	0	0	0	0	0	0	13	11	0	0	6	0	0	0	0	60	57	0	7	0	0	2	7	0	0	2	0	0	0	0	0	9	0	3	3	24	0	0	0	0	8	0	0	0	0	0	0	0	3	0	0	0	2	0	2	0	0	0	0	0	9	0	0	0	0	0	0	1	0	0	0	0	0	0	2	0	6	0	0	0	0	0	0	0	0	0	0	0	0	0	15	0	0	2	0	0	0	0	0	0	0	0	0	0	1	1	0	0	0	0	0	0	0	0	0	0	0	0	0	0	0	0	0	0	0	0	0	0	1	0	0	0	0	0	1	0	3	0	3	30	0	0	1	0	1	0	0	0	0	0	0	3	1	0	0	0	0	0	0	6	0	0	0	0	0	0	0	3	0	0	4	0	0	0	0	0	0	0	10	0	10	1	0	0	0	4	0	0	0	0	0	0	0	0	0	0	0	0	0	0	0	0	0	4	4	0	0	0	5	0	0	0	0	0	0	1	0	0	0	0	0	0	0	0	0	0	0	0	0	12	0	175	4	26	12	0	6	0	0	0	0	0	0	0	0	0	0	6	0	0	0	0	1	0	0	0	15	5	0	7	0	0	24	0	1	0	3	3	0	0	0	0	0	0	0	0	0	0	4	0	1	0	1	0	0	0	0	0	0	0	0	0	0	0	0	0	0	5	25	0	12	0	1	0	1	0	2	0	0	0	0	0	0	0	0	1	0	0	2	0	0	0	1	1	0	0	0	0	0	0	0	0	0	0	0	0	0	0	2	9	0	0	0	0	0	0	0	0	0	7	0	5	5	2	0	0	0	0	0	0	0	0	3	0	0	0	1	0	0	0	4	0	0	0	0	0	5	0	145	0	4	0	0	0	0	0	0	0	0	0	0	6	0	0	12	4	17	32	0	0	0	0	0	0	0	12	0	0	4	0	0	0	0	31	1	12	0	0	4	8	0	3	0	15	0	2	0	0	0	3	0	0	2	0	0	0	0	0	0	0	0	0	0	0	0	0	0	0	2	0	26	0	0	35	0	0	0	0	0	0	0	0	0	0	0	0	0	11	0	0	0	0	1	0	1	0	0	0	0	0	2	5	0	3	11	1	0	0	0	0	0	0	0	0	0	0	0	0	0	0	2	0	0	2	142	1	0	0	0	0	0	0	0	26	0	9	8	12	2	0	0	17	0	0	14	26	1	0	0	0	0	0	0	0	0	0	0	0	0	1	0	0	0	0	0	0	0	0	0	0	0	0	0	0	5	0	0	2	0	0	3	18	0	2	0	96	1	2	0	0	0	0	0	0	0	0	0	0	0	0	0	3	0	0	0	8	0	3	0	0	0	0	3	0	0	0	0	0	0	0	0	0	0	0	0	0	0	0	0	0	0	0	0	2	4	0	9	0	0	2	0	0	1	0	0	0	0	3	0	38	0	0	2	1	0	3	98	0	0	0	0	0	0	1	0	0	0	0	14	0	0	0	0	0	8	0	0	0	2	0	5	58	8	1	0	0	0	0	0	0	0	1	0	0	0	0	0	0	0	0	0	0	0	1	0	0	0	0	0	1	0	0	0	0	0	0	0	0	0	0	0	0	0	0	16	0	0	0	2	0	13	2	0	0	0	0	0	70	0	0	0	0	0	0	0	0	0	7	1	10	7	0	0	0	1	0	2	5	5	0	0	0	0	5	0	0	0	0	0	0	0	8	0	0	0	0	0	0	0	0	0	18	20	4	0	0	0	0	4	0	5	0	0	2	0	37	0	0	0	0	4	0	0	0	0	0	0	1	0	0	3	0	0	0	0	1	0	0	1	0	0	0	0	0	4	0	0	5	0	0	0	0	0	0	0	0	0	0	0	0	0	0	0	0	0	0	0	0	0	0	0	24	0	0	0	0	0	0	0	0	0	2	0	0	0	0	1	0	0	0	0	0	0	0	0	7	0	0	3	0	0	0	0	0	2	0	0	1	1	0	0	3	0	0	0	0	0	0	0	0	0	0	0	0	0	271	3	1	0	3	0	0	9	0	1	0	0	0	1	0	2	0	0	0	0	3	3	1	24	2	9	2	0	18	0	0	8	0	0	0	0	0	0	0	0	0	0	1	23	0	0	0	0	0	0	0	0	0	0	0	0	0	0	0	0	0	0	0	0	2	0	5	0	16	1	1	0	16	0	0	0	0	0	12	1	0	0	0	0	0	0	0	0	0	0	0	0	0	0	0	10	0	3	0	0	0	0	0	0	0	0	0	0	1	3	0	0	0	0	27	0	0	0	0	0	0	0	0	3	0	0	0	0	2	3	0	4	0	0	0	0	0	1	0	0	0	0	0	0	0	0	0	1	0	19	3	0	0	6	0	0	0	0	0	0	0	0	0	0	0	0	0	0	2	0	0	0	0	0	0	0	7	0	3	0	0	0	1	2	0	2	1	1	0	1	0	7	0	0	0	0	0	0	2	0	0	0	0	0	0	0	0	0	0	0	0	0	1	0	0	0	0	0	0	0	0	2	0	0	6	0	0	0	0	0	0	0	0	0	0	0	0	10	0	45	0	0	0	5	0	0	1	0	0	1	0	0	0	0	0	0	0	0	1	0	0	0	0	0	3	0	0	12	1	1	0	0	0	12	1	0	4	1	0	0	0	0	0	1	0	10	0	1	0	0	0	0	0	0	0	4	0	0	0	0	0	0	0	0	0	7	0	0	0	0	0	0	0	0	0	0	1	0	0	0	0	3	4	9	19	8	0	0	0	0	0	0	0	0	0	0	1	0	0	0	0	0	0	0	2	6	2	7	0	0	0	1	0	0	1	0	1	7	0	0	0	0	0	0	0	0	0	4	0	0	0	0	0	0	3	0	4	0	0	0	0	0	0	0	7	1	0	8	1	0	0	0	0	0	0	0	7	0	0	0	0	0	0	0	0	0	0	0	4	1	0	0	2	0	0	0	1	0	0	0	0	0	0	0	0	0	0	0	0	0	6	0	0	0	0	6	0	0	0	0	0	1	0	0	0	0	0	0	0	0	0	0	54	0	0	13	0	13	0	7	3	0	0	0	0	2	0	0	0	0	0	0	0	0	0	0	0	0	0	0	1	0	0	0	24	0	0	0	13	0	0	0	0	0	0	0	0	0	0	75	0	0	0	0	0	0	2	0	0	5	0	0	0	0	0	0	0	1	0	0	0	10	2	0	6	2	5	4	1	0	10	1	1	0	0	0	0	0	5	0	1	2	0	1	0	0	10	5	0	0	0	0	0	3	31	1	0	0	0	17	1	0	0	0	0	0	0	0	0	0	0	0	0	0	0	0	0	14	0	0	2	0	4	0	0	0	0	0	0	0	0	0	0	5	0	0	48	14	4	0	18	0	3	0	0	0	2	0	1	0	0	0	0	0	0	0	0	0	0	0	0	6	0	17	0	0	15	0	0	6	0	0	0	0	0	23	12	0	0	0	2	1	0	0	0	0	4	0	1	2	0	4	5	0	0	0	29	0	0	0	0	0	0	0	97	0	1	1	0	0	0	0	0	0	0	10	0	0	0	2	0	0	17	29	7	0	0	0	0	0	0	0	40	0	0	0	0	0	11	0	0	0	0	0	0	0	0	0	0	0	0	0	0	0	109	66	0	1	0	0	0	0	5	0	0	0	0	0	0	0	0	1	0	5	0	0	1	0	0	814	5	11	0	0	0	0	0	0	0	0	0	1	0	0	0	0	0	0	0	0	0	99	0	0	0	0	0	0	0	0	0	0	0	0	0	0	0	0	0	0	0	0	0	0	0	0	0	0	0	0	0	0	0	0	0	0	0	0	0	0	0	1	0	4	0	0	0	0	1	0	0	0	0	0	0	0	0	1	0	0	0	0	0	0	0	1	0	0	255	0	0	0	0	0	1	33	0	0	0	0	0	0	0	30	2	0	0	0	0	3	45	0	4	0	0	0	0	2	0	0	0	0	0	0	5	0	0	0	0	0	0	0	0	0	0	0	0	0	0	0	0	0	0	0	0	0	0	0	8	0	11	0	0	0	0	0	0	0	0	0	0	0	0	3	0	0	1	0	4	0	0	1	0	0	0	5	0	0	0	0	1	0	0	3	0	18	0	2	0	0	0	0	0	0	0	0	0	0	0	0	3	0	30	1	3	6	0	0	0	0	0	0	0	0	2	0	0	1	0	0	0	0	0	0	122	3	0	0	0	0	0	0	0	170	2	2	0	0	0	0	0	0	8	2	0	0	0	0	0	0	0	0	0	0	0	0	5	5	38	0	0	0	0	3	0	0	0	0	0	0	0	0	6	30	1	6	0	0	0	0	0	0	0	36	0	0	0	0	0	0	0	0	0	0	1	0	1	0	0	5	0	0	0	0	12	0	11	0	0	0	9	0	0	0	0	0	7	0	0	0	0	0	0	0	0	0	1	0	2	0	0	0	0	0	0	32	0	0	0	0	0	0	0	13	0	0	0	0	0	2	0	0	0	0	0	0	0	0	0	0	0	0	0	0	0	0	0	0	0	0	0	0	0	0	0	0	0	0	0	0	0	0	2	0	13	0	0	0	0	0	0	0	0	0	0	0	0	0	0	0	0	0	0	0	0	0	0	3	0	0	0	0	0	0	0	0	0	2	0	0	0	0	0	0	0	0	0	0	0	0	0	0	4	0	0	0	0	0	0	0	0	0	0	0	0	0	0	0	0	0	0	0	0	0	0	0	0	0	3	4	4	0	0	0	5	0	0	0	0	0	1	0	0	0	0	0	0	15	0	3	0	0	0	0	0	0	0	0	0	19	0	0	0	0	0	0	0	0	0	0	0	0	0	0	0	0	0	0	0	0	0	0	0	0	0	0	0	0	0	0	0	0	0	0	0	0	0	0	0	0	0	0	0	0	0	0	0	0	2	0	0	1	0	0	0	0	0	1	0	0	0	1	0	0	0	0	0	0	0	17	0	0	0	1	0	0	0	0	0	0	0	0	0	0	0	0	0	0	0	0	0	0	0	0	0	0	0	0	0	0	0	0	0	1	0	0	0	0	0	1	0	0	0	1	0	0	0	0	0	0	1	0	1	0	0	0	0	0	0	0	0	0	0	0	0	0	0	0	0	0	0	0	0	0	0	2	0	0	2	0	0	3	0	0	0	0	0	0	0	0	0	0	14	1	0	18	0	0	0	0	0	5	0	0	2	1	1	53	0	0	0	1	0	0	0	0	0	1	0	0	1	0	0	0	0	3	0	0	0	0	0	11	0	1	0	0	0	0	0	0	2	0	0	0	0	0	0	0	1	0	0	0	0	0	0	0	0	1	0	0	0	6	1	0	0	0	0	0	0	0	0	0	0	0	0	2	0	1	0	0	0	0	0	0	0	0	0	0	0	0	0	0	0	0	0	0	0	0	0	0	0	0	0	0	0	0	0	0	0	0	6	0	0	10	0	0	0	0	0	0	0	0	0	0	0	0	0	6	1	0	0	3	0	0	0	0	0	0	0	0	0	0	0	2	0	0	0	0	0	0	0	22	0	0	0	0	0	0	0	0	0	0	0	1	0	0	0	0	0	0	0	0	0	0	0	0	0	0	0	0	0	15	0	0	0	0	0	0	0	0	0	0	0	0	0	0	0	0	0	0	0	0	0	1	0	0	32	0	0	0	0	0	0	0	2	6	0	1	0	0	0	0	0	0	0	0	0	0	5	0	0	0	0	0	0	0	0	0	5	0	0	0	0	0	0	0	0	0	0	0	0	0	3	0	0	0	0	0	0	0	0	0	0	0	0	0	0	0	0	0	1	0	0	0	0	1	0	0	0	0	0	3	2	0	0	6	0	7	0	0	0	0	0	0	0	0	0	0	30	0	1	0	0	0	0	0	0	0	10	0	0	1	0	0	0	1	0	0	0	0	1	0	0	0	0	0	0	0	0	0	0	0	2	0	0	0	0	0	6	0	0	0	0	0	0	0	0	0	0	0	1	0	0	0	0	0	0	0	0	1	0	0	1	0	0	0	0	0	0	0	0	16	4	3	22	97	0	0	0	0	2	0	0	0	0	0	0	0	5	0	0	2	0	0	15	0	49	0	0	0	260	0	0	0	0	0	0	0	0	0	0	0	2	14	33	0	0	0	0	0	0	1	0	0	0	0	0	0	0	0	0	0	0	0	0	0	0	0	0	3	0	0	0	0	0	0	0	0	0	0	0	0	0	0	0	0	0	35	0	0	0	0	0	0	0	61	1	0	0	0	0	0	0	0	4	0	0	0	9	37	0	0	0	0	0	0	0	0	0	0	0	0	0	0	0	2	1	0	0	0	0	0	0	0	0	0	0	0	0	0	0	0	0	0	0	0	1	0	1	0	3	0	0	0	0	0	0	6	0	0	0	0	0	0	3	0	0	0	0	2	0	2	0	0	2	0	0	16	0	0	0	0	0	0	0	29	0	0	0	30	27	4	0	1	0	0	1	0	0	6	1	1	1	28	1	0	1	0	0	0	0	1	3	0	0	0	3	0	8	0	0	0	0	0	0	1	0	0	0	48	0	4	0	0	0	0	0	0	0	0	0	0	1	0	0	2	3	0	0	0	0	1	2	0	0	0	0	0	0	34	17	0	0	0	0	0	0	38	1	0	0	0	0	0	0	20	0	3	0	4	0	0	0	0	0	0	14	11	0	8	13	1	0	0	0	0	0	0	1	0	0	0	0	0	0	0	0	0	0	0	0	0	4	2	0	0	0	1	0	0	0	12	1	0	0	0	0	3	6	0	4	0	3	0	0	0	0	0	0	11	0	2	8	0	0	0	0	0	0	0	0	0	0	0	0	0	0	0	20	0	0	0	3	0	0	0	4	0	1	0	1	4	15	9	14	0	1	0	0	1	0	0	2	0	0	0	0	0	0	0	0	0	0	0	0	0	0	0	0	0	0	0	0	0	0	0	3	0	0	0	2	0	0	0	0	0	0	0	7	0	0	1	0	12	6	2	0	0	0	0	0	4	0	25	0	0	1	0	16	0	0	0	1	0	0	0	0	0	0	0	0	0	0	0	0	0	0	11	0	0	0	0	1	0	0	1	3	0	1	0	0	0	0	0	0	0	0	2	0	0	0	0	0	0	0	0	0	0	0	0	0	0	0	0	1	0	0	7	0	0	3	0	0	0	1	9	0	6	5	1	1	0	1	0	0	0	0	0	0	0	0	8	0	0	0	0	0	0	0	0	0	0	0	16	14	0	1	0	0	2	6	0	0	0	0	0	7	0	0	3	0	25	0	0	0	0	6	0	22	4	0	0	0	0	0	0	0	0	1	0	0	0	0	1	0	0	0	0	17	0	0	0	0	5	0	0	2	0	0	0	1	0	0	0	2	0	0	1	0	0	0	0	0	0	0	0	1	0	0	0	0	0	0	0	0	0	0	1	6	0	0	0	2	0	4	0	0	10	0	1	0	0	0	0	0	0	0	0	0	0	0	0	8	1	0	0	0	0	0	0	0	0	2	6	4	0	2	3	0	0	0	0	0	0	7	0	0	3	1	0	0	9	0	0	0	4	0	1	1	0	1	3	4	6	0	0	0	0	1	0	3	0	0	0	0	0	0	0	0	0	0	0	0	0	0	0	0	0	0	0	0	0	0	0	0	22	1	0	0	0	0	15	0	4	0	0	0	0	0	0	5	0	0	0	0	0	0	0	1	19	0	0	10	1	0	0	2	0	1	5	0	0	0	0	0	0	0	0	0	3	0	0	0	0	0	75	0	1	0	1	0	0	0	11	0	0	0	0	0	0	7	0	0	0	0	2	0	0	0	0	0	2	0	0	0	0	0	1	0	19	3	0	4	0	2	0	0	0	0	37	0	0	1	0	5	0	0	0	0	12	0	0	0	0	1	0	0	0	0	0	0	0	0	0	41	32	2	1	0	0	41	0	0	0	0	0	1	0	0	1	7	0	8	0	0	0	0	0	0	0	0	0	0	0	0	0	0	0	0	8	0	0	0	0	0	0	0	0	0	0	0	3	0	0	0	0	2	0	28	22	0	0	0	0	0	0	0	0	0	0	0	0	0	0	0	0	0	0	0	10	0	0	0	0	0	0	0	0	0	0	0	0	0	0	0	0	0	0	0	0	9	0	0	0	0	0	0	0	0	0	0	0	1	0	4	0	0	0	1	0	0	0	2	0	0	0	0	0	0	0	0	0	0	0	0	0	0	0	0	0	0	2	0	0	0	0	0	0	0	0	0	0	4	0	0	0	0	2	0	0	0	0	0	0	0	0	0	0	0	0	0	0	0	0	0	1	0	0	0	0	0	0	0	0	0	0	0	0	0	0	0	0	0	0	0	0	0	0	0	0	0	2	0	0	1	0	0	0	0	0	0	8	6	0	0	0	0	0	0	0	0	6	0	0	0	0	0	0	0	0	0	0	0	0	0	3	0	0	0	0	0	0	0	0	3	0	0	1	0	0	0	0	0	0	0	0	0	0	0	0	0	0	0	0	0	0	0	0	0	0	0	0	0	0	0	0	0	0	9	0	0	0	0	0	5	0	0	0	0	0	0	0	0	1	0	0	43	0	0	0	0	1	0	0	1	1	0	0	0	0	0	0	0	0	0	0	0	0	0	0	0	0	44	0	8	0	12	0	0	0	0	0	9	0	0	0	0	2	4	4	0	0	0	3	0	1	0	0	0	4	4	0	4	7	0	0	0	0	0	0	0	10	4	0	2	0	6	0	0	0	0	0	1	2	0	0	0	0	0	2	0	0	0	0	0	0	0	0	0	0	0	0	2	0	0	0	0	4	1	0	0	0	0	1	5	0	6	6	0	3	0	2	0	0	137	0	0	0	0	0	0	2	0	2	0	0	0	0	2	3	1	0	0	0	0	3	28	5	18	0	0	46	10	1	0	0	0	0	0	0	0	0	0	0	0	0	1	0	1	0	0	8	0	2	0	0	3	2	1	0	0	0	0	0	0	0	0	0	0	0	0	0	0	0	0	0	0	0	0	1	0	0	5	0	0	0	2	0	0	0	0	2	0	22	0	0	0	0	0	0	0	0	0	1	2	0	0	0	0	1	0	0	0	5	0	0	50	0	0	0	0	0	0	0	0	0	0	0	0	139	0	0	76	20	0	8	0	7	0	2	0	2	3	0	12	12	1	0	0	0	0	0	0	0	0	0	0	0	0	0	0	0	0	7	0	0	2	0	0	3	0	0	0	0	0	0	0	2	0	0	0	2	4	0	0	0	0	0	0	0	0	0	4	0	6	1	0	2	0	0	0	0	10	0	0	1	0	0	0	0	0	0	0	0	0	0	0	0	9	0	3	0	0	1	0	0	0	0	2	0	0	2	0	0	3	14	5	0	1	0	0	0	0	4	0	0	0	0	0	3	0	0	0	0	0	0	0	3	0	0	0	0	0	4	5	0	0	0	0	2	1	0	0	0	3	0	0	0	0	0	0	0	0	1	7	10	0	0	3	0	4	0	5	0	7	0	0	0	4	0	0	0	0	0	0	0	0	0	2	0	0	0	0	0	0	0	1	127	3	0	22	1	0	0	2	26	1	0	0	0	0	0	0	0	0	0	0	0	0	0	2	2	0	0	0	6	21	0	1	0	0	0	0	3	0	0	0	0	0	0	0	3	0	0	0	8	1	0	0	0	0	0	22	17	1	0	0	0	0	0	0	0	0	1	0	0	0	5	0	0	0	38	0	0	0	8	2	32	13	0	0	0	0	0	0	0	0	0	0	0	0	0	1	0	17	0	12	4	2	0	0	5	16	3	0	0	1	0	0	0	0	11	0	0	0	0	0	0	3	8	0	5	0	0	1	0	0	0	0	0	18	0	0	0	0	0	0	35	7	4	110	10	0	24	12	0	0	0	0	0	0	2	3	0	6	0	1	0	0	40	0	129	1	3	2	1	2	0	0	27	1	0	6	2	0	0	2	1	0	0	0	0	0	0	0	0	0	0	9	0	0	0	0	0	0	0	0	22	36	11	0	0	2	0	10	5	10	0	0	2	0	0	0	0	0	0	0	0	0	0	0	0	0	0	0	0	0	0	28	0	0	0	0	1	0	1	0	1	0	0	3	0	0	1	2	0	16	2	0	1	1	0	5	0	31	18	0	0	0	0	0	0	15	0	0	0	0	0	0	6	0	0	0	0	0	0	0	0	11	0	0	0	0	0	0	0	0	0	0	0	0	0	0	0	1	0	0	2	0	0	0	0	0	0	26	0	87	0	1	0	0	31	0	5	0	0	0	0	0	0	0	0	6	0	5	0	0	0	0	0	0	0	0	1	0	1	14	0	0	0	0	0	0	0	0	0	0	0	0	0	0	0	0	0	3	6	0	0	7	0	0	0	0	0	0	0	1	0	1	0	0	0	0	0	2	0	0	0	1	0	0	0	0	0	6	3	3	0	0	10	0	0	0	0	47	0	0	0	0	0	0	0	0	0	0	0	58	0	0	7	0	0	0	0	0	3	0	0	2	1	0	0	0	0	0	1	0	0	1	0	0	0	0	20	0	0	1	4	0	0	0	0	0	0	0	0	0	134	0	7	1	5	4	0	0	3	0	5	2	31	23	18	1	9	5	2	0	0	2	0	1	0	0	0	5	0	221	1	9	0	1	0	14	0	0	0	0	4	5	0	0	0	0	0	0	0	0	0	3	0	16	3	0	3	10	31	2	0	0	0	5	0	0	4	0	0	0	0	0	0	1	0	0	0	3	13	0	1	4	3	0	0	1	0	0	0	0	0	0	0	0	0	0	0	0	5	0	0	0	0	0	0	0	0	2	0	0	0	3	0	0	12	0	0	0	0	10	524	0	0	0	0	5	0	5	15	0	1	0	3	0	0	0	0	0	2	1	2	83	0	0	0	0	27	0	0	0	4	0	0	0	8	3	1	0	0	0	14	0	0	1	0	9	0	1	1	0	0	2	0	0	16	0	4	0	0	0	0	0	0	10	2	0	0	0	0	0	0	0	1	0	0	0	18	3	0	0	6	4	0	0	0	0	5	0	10	5	0	0	7	3	0	0	0	0	0	0	0	0	0	0	3	14	16	6	0	0	0	0	0	0	28	0	0	0	0	0	0	0	0	0	0	0	1	6	0	0	1	0	0	0	0	0	0	19	6	0	0	0	0	0	0	0	0	0	0	0	0	0	0	0	4	0	0	3	0	0	0	0	0	0	1	2	0	0	0	4	6	0	1	0	0	0	0	0	1	1	0	1	0	0	0	0	0	0	8	0	1	14	0	2	0	0	0	11	0	0	0	0	8	2	0	0	0	0	1	0	4	0	22	0	0	8	0	0	0	0	1	0	5	0	0	0	0	0	0	18	0	0	0	0	9	0	6	0	8	0	0	3	0	4	0	3	0	0	0	9	2	3	0	2	2	2	0	0	0	4	0	0	8	0	0	1	0	3	0	2	6	0	49	0	6	0	0	2	0	4	1	0	2	0	0	0	0	3	0	9	2	2	53	2	0	21	0	4	11	87	0	1	4	2	0	0	0	1	0	1	0	0	0	0	1	1	30	1	0	25	0	0	0	0	0	7	9	1	16	0	0	0	0	8	34	0	0	10	2	2	0	3	0	1	1	6	3	0	11	0	2	0	8	0	0	2	0	0	0	0	4	0	0	0	7	0	0	3	0	0	0	0	18	0	0	0	0	0	1	0	0	0	0	0	2	0	0	0	2	0	0	0	0	0	0	0	0	0	0	4	0	0	0	0	0	0	0	25	0	3	4	0	6	4	2	8	4	0	0	11	0	0	8	1	0	0	0	0	0	0	27	0	0	0	0	0	0	0	2	0	0	0	4	0	0	0	0	1	0	0	0	0	0	0	0	0	0	0	0	17	0	1	0	0	0	0	15	15	5	9	0	12	0	3	0	0	0	0	0	0	0	0	0	0	0	0	0	2	11	1	0	0	0	0	0	0	3	0	0	12	1	0	0	1	0	1	1	0	130	8	0	0	0	1	0	0	3	0	5	0	4	0	0	0	0	0	6	1	8	0	0	0	4	1	0	0	1	3	1	11	0	0	0	9	0	0	0	54	10	0	0	0	0	0	0	2	0	0	0	0	6	0	2	1	0	0	0	2	0	0	0	0	0	0	0	4	0	0	0	0	0	0	2	0	8	0	7	1	0	0	2	0	0	0	0	0	10	1	1	0	0	1	0	0	9	0	0	0	0	0	0	0	10	0	0	0	0	0	0	0	0	0	0	1	0	1	0	1	0	0	0	0	0	0	0	0	1	0	0	0	6	0	0	0	0	0	0	1	16	0	0	0	18	2	14	0	0	11	0	1	0	0	0	0	0	18	0	0	0	0	0	0	0	0	0	0	0	0	0	0	3	0	0	2	1	0	0	0	0	3	7	1	2	0	0	0	0	0	0	0	0	1	0	1	0	6	0	0	0	0	1	0	0	0	7	0	1	0	1	18	0	23	0	0	6	0	0	9	0	0	0	0	0	0	0	0	0	1	0	0	2	0	1	0	0	0	0	4	0	0	0	0	0	1	6	0	0	0	0	0	0	0	0	1	0	9	3	0	0	0	28	0	0	0	0	15	4	0	0	0	0	0	1	0	0	0	0	0	1	6	0	0	0	0	29	0	8014	0	0	0	0	0	2	0	0	0	0	0	0	0	0	0	0	2	0	0	0	0	0	0	0	1	1	0	5	0	0	0	0	0	0	0	4	0	3	7	0	0	0	0	0	0	3	6	0	0	0	0	0	1	0	7	58	9	1	0	0	0	8	0	0	0	0	0	0	0	128	3	14	3	0	0	0	28	3	7	0	0	15	0	0	0	0	0	0	0	0	0	1	0	0	5	0	0	2	0	0	0	0	4	0	0	2	0	0	0	0	1	0	0	0	0	0	0	0	16	0	0	1	0	0	3	11	0	44	0	0	29	2	0	0	9	0	27	18	0	0	0	0	0	5	0	0	0	42	83	22	2	14	0	3	0	0	14	5	0	0	0	2	0	0	0	0	0	0	0	0	0	2	0	7	2	1	0	14	0	0	0	7	0	0	0	0	4	1	10	0	0	5	9	1	1	3	0	0	0	1	0	0	0	0	6	12	2	0	13	0	0	0	0	1	0	0	0	0	0	0	0	0	0	0	0	0	0	0	6	0	0	0	5	4	2	0	0	1	3	0	0	1	0	0	1	0	0	0	0	0	9	34	0	0	0	1	6	14	0	1	13	0	0	1	0	0	0	0	0	0	0	0	0	0	0	0	0	0	0	0	0	0	16	1	0	0	0	0	0	4	0	0	0	0	1	0	0	0	0	0	0	0	0	0	0	0	0	0	0	0	0	0	4	0	2	0	0	0	0	4	0	7	0	0	0	1	2	1	0	30	0	0	0	0	5	5	8	7	0	0	0	0	4	0	0	0	0	4	0	16	0	0	0	0	0	0	0	0	0	97	0	0	0	0	0	0	0	0	0	0	80	298	0	0	0	0	0	0	0	1	0	6	0	1	0	0	42	5	0	4	2	0	0	1	20	9	3	0	136	0	0	15	3	65	0	1	0	0	0	1	0	0	10	0	0	8	2	8	0	0	0	2	0	0	1	0	0	0	0	2	0	0	0	2	0	0	1	0	0	0	0	0	44	0	0	0	0	0	0	2	0	0	0	0	0	0	0	6	21	4	3	14	12	11	45	0	0	31	5	4	57	0	0	0	0	3	0	0	0	0	0	0	0	3	0	0	0	0	0	0	0	0	1	0	0	0	8	0	0	51	3	0	0	2	0	0	3	0	1	0	0	0	10	0	6	0	0	0	0	0	2	0	0	0	0	0	0	0	0	0	0	0	0	0	2	8	0	0	0	0	0	0	0	0	0	0	40	0	39	1	0	0	1	0	0	0	0	0	0	0	0	0	0	0	0	0	0	0	0	0	0	2	0	5	7	2	4	0	0	0	0	0	0	0	0	0	0	0	0	0	0	0	0	0	5	0	0	0	0	0	0	0	0	0	0	0	0	10	0	0	0	31	0	0	0	0	0	47	0	0	1	1	2	0	0	0	0	4	5	3	0	25	1	4	0	1	0	0	0	0	0	3	0	0	0	0	7	4	0	0	0	0	0	0	4	0	0	0	0	25	0	0	0	0	0	1	0	0	0	0	0	0	0	0	0	3	0	0	0	0	0	1	0	0	0	0	31	1	0	0	0	0	0	0	0	0	2	0	0	0	0	0	1	8	0	0	0	0	0	2	0	0	0	0	0	0	1	0	0	0	0	0	0	0	2	0	1	93	0	0	6	0	0	40	0	0	1	0	1	2	17	0	0	10	0	0	161	0	4	8	1	0	4	0	9	3	9	0	0	0	0	2	0	0	0	2	0	0	0	0	1	0	0	3	0	14	0	0	0	0	0	7	0	0	0	0	0	2	0	0	5	0	0	0	0	0	3	0	0	0	1	3	0	0	0	0	23	3	0	0	0	0	0	0	0	0	0	0	0	4	0	0	0	0	8	0	0	0	0	0	0	1	1	423	3	0	0	0	9	1	12	14	42	0	0	0	0	0	0	1	0	0	3	0	0	0	30	30	2	2	0	16	0	0	2	10	0	0	1	3	0	3	0	0	0	0	0	2	6	2	0	0	0	0	8	0	0	3	0	0	0	0	0	0	0	0	0	0	0	0	0	0	0	0	0	0	0	0	0	0	0	0	0	0	0	0	0	0	6	0	0	1	0	0	0	0	0	0	0	0	0	0	0	0	0	0	0	0	4	0	5	0	0	0	311	0	0	0	6	0	0	0	0	0	0	9	1	7	3	0	0	2	1	0	0	0	2	2	0	0	0	0	0	0	1	0	0	11	0	5	1	0	0	4	0	0	0	0	0	8	1	0	0	0	0	0	0	0	0	10	3	10	1	1	0	12	0	0	7	0	0	2	0	0	0	0	4	15	12	0	0	2	0	9	2	4	0	2	0	2	0	2	0	0	0	0	0	0	0	0	17	0	0	0	0	0	0	1	0	0	4	0	2	0	0	16	0	2	0	1	6	0	0	20	0	3	0	0	0	0	0	0	0	0	2	311	8	1	0	0	0	1	0	0	0	0	0	0	0	0	0	0	0	0	0	0	35	1	0	1	3	4	9	0	0	0	2	0	0	0	0	0	0	34	0	0	10	4	0	0	0	0	0	5	0	0	0	0	0	0	1	0	0	5	6	0	0	0	0	0	1	26	0	20	0	3	0	0	3	0	3	0	0	0	0	0	0	0	0	0	0	0	0	0	0	0	0	0	0	0	0	0	0	0	0	0	0	0	0	0	0	0	0	0	0	0	0	0	0	0	0	2	1	30	1	0	4	2	3	3	24	8	0	0	1	0	0	0	0	0	1	0	0	0	0	0	0	0	5	0	0	0	0	0	0	0	0	0	1	0	261	0	0	0	0	0	0	0	0	0	0	0	0	0	0	3	0	0	0	0	0	0	0	0	0	0	0	0	2	0	0	0	0	3	1	0	8	0	0	0	0	0	0	0	0	0	0	5	0	0	10	11	0	6	18	0	0	0	0	0	0	0	0	0	0	0	0	0	0	0	0	0	1	0	0	0	0	0	0	0	0	0	0	3	0	0	0	0	0	0	0	39	0	0	0	0	0	0	0	0	0	2	0	0	0	0	0	0	0	0	0	0	0	0	0	0	0	0	0	0	0	0	0	0	0	0	3	0	3	4	0	0	0	1	0	0	2	0	0	0	0	0	0	0	0	0	1	0	0	4	0	0	0	0	0	0	0	0	0	0	0	0	0	0	0	0	0	0	0	0	0	0	16	0	0	0	0	0	0	0	0	0	0	0	0	0	0	0	0	0	3	0	0	13	0	0	0	0	0	0	0	0	0	0	0	0	2	0	0	4	0	0	0	0	0	0	0	0	0	0	0	0	0	0	0	0	0	0	3	0	0	0	0	0	0	0	0	0	1	0	0	0	0	0	0	0	0	0	0	1	3	0	0	0	0	5	0	0	0	0	0	0	0	0	0	0	0	0	0	0	0	0	0	0	0	0	0	0	0	6	0	0	0	0	12	0	0	1	0	4	0	0	0	0	0	0	0	0	0	0	0	0	0	1	0	0	0	0	3	0	0	0	0	0	1	0	0	0	0	0	0	0	2	0	3	0	0	0	0	7	0	0	0	0	0	0	0	8	0	0	0	0	0	0	0	0	0	0	0	0	1	0	0	0	0	0	0	0	0	0	0	0	0	0	0	0	0	0	0	1	0	0	0	0	0	0	0	0	0	0	0	0	0	0	0	0	0	0	0	0	0	0	0	0	0	0	8	0	4	0	0	0	0	0	0	4	0	1	0	0	0	9	0	6	0	2	0	0	0	0	0	0	9	0	2	0	0	0	0	0	0	0	42	2	2	0	0	0	0	0	3	0	17	0	16	13	0	5	0	1	6	0	0	0	0	0	0	0	0	0	0	0	0	1	0	0	0	0	1	0	0	0	0	0	0	18	0	0	0	0	0	0	0	0	0	0	0	0	0	1	0	0	0	0	10	0	0	0	0	0	0	0	0	0	0	0	0	0	0	0	0	3	5	0	0	0	13	0	5	0	11	0	0	0	1	0	0	0	0	0	0	0	0	0	0	0	0	0	0	16	0	0	0	0	0	0	0	0	0	0	11	0	0	0	0	0	0	0	0	0	0	0	0	0	0	0	0	0	0	0	0	0	0	3	1	0	0	4	8	0	0	0	0	0	0	0	0	0	0	0	0	0	0	0	0	0	0	20	0	0	0	0	5	0	0	0	0	0	0	0	1	0	5	1	14	0	0	0	0	0	2	3	0	0	0	0	0	0	0	0	0	0	0	1	0	0	9	1	0	1	0	0	0	0	0	0	0	0	2	1	4	8	1	7	5	41	0	3	0	0	6	0	0	6	2	0	1	0	0	0	1	3	5	0	0	0	0	10	0	0	0	0	5	0	0	0	0	0	0	1	0	0	0	0	10	0	4	1	0	0	0	0	0	0	0	0	0	0	0	3	0	2	0	0	15	0	0	0	0	0	0	1	0	4	0	0	0	2	0	0	0	1	11	0	0	1	7	0	56	1	0	0	3	0	0	0	0	0	0	0	0	0	0	1	0	0	0	11	0	2	0	4	2	3	2	8	0	0	0	7	22	0	1	4	0	0	0	0	12	2	14	6	4	2	0	0	5	0	0	0	35	5	0	12	1	8	0	5	0	14	0	0	2	0	2	1	0	0	0	0	3	0	0	1	0	3	1	0	0	0	0	18	2	7	0	1	0	6	2	0	0	1	7	0	2	0	10	1	0	0	0	0	0	0	5	0	0	0	0	0	0	1	7	1	1	0	0	0	0	8	0	0	0	0	0	0	0	0	0	0	1	0	1	9	0	9	0	3	0	0	0	0	0	0	0	1	0	9	0	0	4	0	0	8	0	3	0	0	0	1	555	0	0	0	0	0	8	0	0	1	0	0	0	0	2	2	0	0	1	4	3	0	0	0	0	0	0	0	0	11	0	0	0	4	2	0	7	0	4	0	0	0	8	0	0	0	0	0	7	0	0	0	0	0	0	0	0	0	0	1	0	0	0	12	0	1	0	0	0	0	0	0	0	0	0	0	1	65	0	0	0	10	0	0	25	1	1	0	16	0	0	32	2	1	16	45	8	24	0	0	0	0	0	0	0	0	0	0	5	0	1	0	0	1	0	0	0	0	0	0	0	0	0	0	7	1	2	0	6	0	28	0	0	0	0	0	0	0	0	0	0	0	0	0	0	0	0	0	0	0	0	0	0	0	0	0	0	0	1	2	0	0	0	0	0	0	0	0	0	0	0	0	0	0	0	0	0	0	0	0	0	0	0	0	15	4	0	26	1	5	1	1	0	0	0	0	0	4	0	0	0	3	0	0	0	0	0	1	0	0	0	0	0	0	0	0	0	0	6	1	4	0	7	3	4	20	1	0	0	2	0	0	0	0	0	0	0	0	0	0	0	1	3	7	0	2	2	0	4	0	4	2	5	0	2	2	8	0	0	0	0	0	0	3	3	0	0	0	0	0	0	0	0	1	2	0	0	7	5	0	0	0	0	0	0	0	0	0	0	0	0	0	0	0	0	0	25	13	0	0	0	0	3	0	0	0	0	0	0	0	0	1	0	0	17	10	4	1	0	0	0	0	2	0	0	0	0	0	0	0	0	10	1	0	0	0	0	0	0	1	0	0	1	3	0	4	0	6	0	1	0	13	0	1	0	0	1	0	0	1	4	0	0	0	3	1	0	0	0	0	16	0	0	0	0	0	0	0	0	0	0	6	0	0	0	0	0	0	0	0	1	0	0	0	0	0	0	0	3	2	0	0	0	0	0	0	5	2	0	0	19	3	0	0	0	1	0	36	3	6	2	0	1	3	1	0	0	22	0	8	0	0	0	40	0	0	1	0	1	4	0	0	0	0	0	0	0	8	0	0	0	6	4	8	0	0	0	0	0	0	0	1	0	1	0	0	0	0	0	0	0	0	11	6	34	0	4	1	0	0	4	0	1	0	0	0	0	0	0	0	0	0	0	0	2	0	0	1404	0	0	6	0	20	0	0	0	0	0	11	0	46	21	4	21	0	26	0	2	0	0	0	0	0	0	0	6	3	121	14	0	0	0	0	0	0	0	1	0	0	0	0	0	0	0	1	15	0	0	0	128	2	0	0	0	0	4	5	6	0	1	0	0	0	0	0	1	0	0	0	0	0	0	0	0	2	0	0	1	0	0	0	0	0	0	0	0	0	0	0	22	0	0	0	0	37	0	0	0	2	0	1	0	0	0	0	0	0	2	0	2	0	0	2	0	0	0	3	0	0	0	0	0	0	1	0	0	2	0	0	17	3	0	0	1	1	10	7	3	0	0	0	0	0	0	0	1	0	0	0	7	0	0	0	3	0	0	0	1	0	0	1	1	0	2	0	0	3	0	24	0	0	0	0	9	0	0	2	0	0	0	3	17	1	1	0	5	0	0	0	0	0	0	0	0	0	0	0	0	0	15	0	0	0	0	0	0	0	0	4	0	0	0	0	0	1	2	2	0	12	0	88	20	0	68	0	0	0	1	0	0	0	5	0	2	0	0	0	0	0	6	13	2	0	0	0	0	0	4	0	0	0	0	1	2	0	0	0	0	1	0	1	0	0	0	24	4	4	0	0	8	3	2	0	2	0	0	0	3	2	0	0	0	0	1	0	0	1	0	0	1	0	0	3	0	0	0	1	4	0	0	0	0	0	0	0	0	0	0	0	0	0	0	1	0	0	0	0	0	0	0	0	0	0	0	0	0	0	4	0	0	2	0	9	20	0	10	0	0	0	1	0	0	0	0	0	15	0	0	22	2	1	0	0	0	0	1	0	3	4	3	0	0	0	0	0	0	0	0	9	0	0	0	0	0	1	2	40	0	8	0	19	18	0	6	0	3	0	0	0	405	0	0	0	1	32	2	0	6	0	0	0	4	0	0	0	4	1	0	0	2	0	0	0	0	0	1	0	0	0	1	3	0	0	1	0	2	0	7	0	0	0	0	0	0	0	0	1	0	0	1	4	0	0	0	0	0	0	0	0	0	0	0	0	0	14
LakWasM104_HOW12_2_rpkm	0	0	0	0	0	41	1	3	0	0	0	15	0	0	0	1	0	0	2	0	2	0	1	66	0	0	0	0	0	25	0	0	0	68	0	26	1	0	0	0	0	0	0	13	54	85	90	32	0	115	0	28	0	0	0	0	0	2	218	29	72	0	1	0	0	0	0	0	4	99	0	2	0	0	0	0	0	0	0	0	0	10	0	0	0	0	0	1	0	0	0	0	13	0	45	0	0	0	0	0	0	0	0	0	0	0	0	0	0	1	0	0	228	2	91	0	0	0	0	0	0	0	13	0	0	0	2	0	0	0	85	314	4	0	0	0	0	0	3	0	0	0	0	6	0	0	0	0	175	2	0	233	2	3	561	0	1	3	58	0	28	3	0	2	5	0	0	2	0	4	0	0	0	0	0	0	0	0	0	0	0	0	0	0	0	3	0	0	0	3	13	11	25	83	1	0	0	83	63	198	3	0	8	0	0	0	5	0	1	2	77	24	46	103	32	0	30	32	0	1	0	0	3	0	1	4	0	0	40	0	0	0	3	0	0	0	58	4	75	1	0	0	62	4	115	117	0	0	3	0	2	28	36	0	2660	111	0	1	0	0	0	0	0	93	4	0	0	0	1	351	7	0	0	0	0	1	0	1	8	8	3	92	6	144	72	0	0	0	38	11	0	0	0	0	0	0	0	0	1	0	0	8	141	0	4	0	6	261	17	1	5	0	282	100	0	0	0	1	0	0	0	0	0	1	7	45	2	0	2	0	1	0	0	2	0	0	0	0	0	0	0	0	35	2	28	0	36	9	0	0	3	0	0	0	0	0	0	0	0	23	4	0	3	0	0	78	4	108	3	1	0	132	0	0	9	1	0	111	0	3	0	0	31	0	0	0	53	0	0	0	1	0	781	0	0	12	9	1	0	199	0	51	0	5	49	0	1	0	0	0	0	1	7	1228	0	64	47	3	2	0	0	0	0	0	0	0	0	0	1	0	0	1	0	1	0	3	0	0	33	0	82	4	0	0	1	345	2	0	0	0	1	222	2	802	0	32	125	1	0	4	0	0	0	52	0	93	71	0	0	0	39	4	20	2	0	0	45	0	0	0	6	0	2	0	0	3	0	17	18	1	0	3	143	92	3	0	0	0	0	0	0	0	42	0	0	0	0	0	0	0	0	0	0	0	0	0	1	0	0	17	1	0	0	0	0	0	0	0	0	0	0	0	449	133	4	0	33	0	0	50	0	2	3	49	47	1	0	0	0	0	0	0	0	1	0	2	0	13	0	0	0	0	0	0	84	0	4	0	150	0	0	0	0	4	5	4	7	508	2	8	13	24	15	3	172	0	1	2	19	0	0	0	36	3	16	45	0	0	1	0	88	0	0	27	16	26	0	59	0	1	1	594	30	132	1	0	489	0	487	2	20	14	197	28	0	24	0	15	0	14	0	4	0	0	0	0	0	0	0	2	0	326	0	0	0	0	0	35	9	0	7	0	24	23	0	0	0	0	0	0	0	19	0	3	0	0	0	0	6	6	12	47	0	143	1	0	0	0	0	1	2	1	1	1	0	0	0	0	0	26	0	0	5	1	0	0	0	2	0	1	0	2	0	9	0	1	1	0	1	0	0	43	0	0	3	2	0	0	7	0	0	0	3	1	0	0	19	1	49	0	0	0	0	0	0	0	0	0	0	0	0	63	6	0	2	194	1	0	0	34	1	0	0	0	0	2	0	0	20	0	0	3	0	140	0	0	12	0	0	0	0	0	0	0	0	134	0	0	0	0	0	0	4	0	0	0	0	0	0	0	4	1	1	0	0	0	20	0	0	1	0	0	0	0	23	43	250	0	0	0	0	0	1	0	29	0	7	0	0	0	0	0	0	0	41	2	0	3	0	24	12	0	0	0	0	0	0	80	34	0	0	0	0	4	0	0	0	2	37	209	0	0	1	0	0	0	1	0	0	4	79	0	0	1	0	1	0	0	0	0	0	0	0	0	0	0	0	0	11	1	0	1	0	3	0	2	86	0	0	0	0	0	0	0	5	0	0	0	0	0	0	0	12	0	1	0	0	0	0	0	0	0	0	8	5	3	8	13	5	2	0	0	0	0	0	2	0	0	0	0	0	0	0	0	0	0	0	0	0	5	0	0	0	35	34	0	0	20	0	0	0	0	0	0	0	0	0	0	0	0	0	0	4	1	1	5	0	0	0	0	0	15	35	516	1	17	0	95	0	0	59	64	1	0	4	0	0	45	0	0	0	0	1	0	0	1	0	12	0	0	0	0	0	0	0	0	1	0	0	0	0	0	0	0	0	0	0	451	4	0	0	101	3	0	0	5	0	0	10	0	39	0	0	0	0	0	0	0	1	12	0	0	0	0	0	0	0	1	1	0	0	0	0	0	1	6	0	0	0	0	0	3	0	89	0	0	0	0	6	5	15	0	11	0	1	0	4	3	1	4	0	0	0	0	0	0	0	0	0	79	0	0	0	0	4	0	0	0	0	0	0	0	1	0	0	19	6	0	7	10	0	0	0	0	12	0	0	55	0	0	3	5	0	0	0	0	4	12	154	0	0	3	0	0	0	1	2	0	0	0	0	0	0	0	0	0	0	0	0	0	0	1	0	0	1	0	1	0	0	2	0	0	0	0	1	0	0	0	0	0	103	1	0	0	0	0	13	0	1	0	0	0	17	1	0	0	0	1	0	1	2	2	32	19	990	509	0	0	0	127	1	0	0	1	0	4	0	0	0	0	0	0	1	0	0	0	0	20	0	1	0	0	44	0	0	0	0	0	11	1	0	0	0	0	0	0	0	1	0	0	2	0	136	7	0	0	2	0	0	0	25	0	0	207	282	0	0	1	2	0	8	0	0	63	0	0	0	0	0	0	0	0	5	58	1	2	59	57	0	150	1	0	1	1	0	23	0	0	54	0	0	2	2	0	0	50	0	0	11	0	0	0	0	0	0	1	4	0	0	4	0	0	0	1	0	0	0	0	0	1	0	0	6	0	0	4	0	0	0	0	0	0	0	3	1	0	183	10	200	2	0	9	63	0	0	0	0	0	0	28	0	0	3	0	0	0	51	27	0	0	0	0	0	1	74	0	23	0	0	2	0	1	2	77	0	1	29	1	0	0	0	0	0	0	63	0	48	142	34	75	29	0	34	0	0	34	2	27	0	0	0	14	0	42	7	0	59	1	2	0	0	2	13	22	13	0	63	0	0	0	0	0	0	1	1	0	0	0	0	0	6	110	1	1	4	0	22	9	0	1	0	0	3	0	0	1	0	1	0	0	0	2	0	54	44	397	79	0	0	0	0	0	0	0	1	217	1	1	0	23	0	0	0	2	233	1172	2	128	0	0	18	330	0	0	0	0	1	0	0	0	679	11	265	14	373	11	0	3	3	32	0	0	0	0	0	0	24	212	0	0	0	29	0	107	1	0	0	2	0	38	0	2	0	0	0	0	30	0	0	0	0	0	0	0	2	1	0	0	0	0	0	3	0	2	0	1	0	0	31	0	0	0	18	0	0	0	0	0	0	1	0	0	0	29	0	0	0	0	0	0	0	0	0	0	1	0	0	0	0	1	0	0	0	0	0	0	0	41	0	0	10	0	0	6	0	163	0	89	298	0	0	10	0	98	22	5	0	0	1	0	155	7	84	0	0	0	0	2	1	0	0	1	11	0	0	0	2	0	0	0	0	0	0	0	0	0	0	2	3	125	2	4	0	0	84	3	0	0	0	3	1	0	0	0	3	0	0	2	1	0	0	0	1	74	26	0	2	85	0	0	0	2	0	25	2	20	0	0	5	0	0	0	0	0	0	0	1	0	155	8	15	432	395	185	448	318	0	0	0	3	5	8	0	0	2	1	184	0	0	0	2	6	1	0	1	93	121	0	300	3	0	39	0	2	2	2	1	0	7	2	0	0	0	0	0	3	1	200	0	13	8	4	0	0	3	0	1	77	1	0	4	2	1	0	0	14	76	237	26	368	0	2	0	23	0	19	0	1	0	0	0	0	15	0	0	0	0	0	0	6	3	53	5	30	0	0	0	1	0	1	0	0	0	0	0	0	1	0	1	0	0	0	4	0	0	33	0	1	37	73	0	41	1	0	2	0	0	0	0	0	0	71	1	0	0	8	1	0	0	7	0	0	0	0	0	0	0	0	0	73	0	0	0	0	0	3	5	0	0	1	1	0	4	1	0	0	90	0	0	0	0	31	0	0	67	0	0	74	1	0	0	0	429	20	39	6	0	69	262	0	62	0	121	3	73	2	7	0	6	2	0	52	0	0	0	0	1	0	0	0	0	0	0	0	0	0	2	31	1	8	0	3	92	0	0	0	0	0	0	0	0	0	0	0	0	0	14	0	0	0	9	16	8	55	0	0	0	0	0	0	34	0	0	36	0	0	0	0	0	0	0	0	0	0	0	0	0	0	0	49	0	0	1	0	0	0	0	0	0	0	0	0	179	1	4	52	0	1	1	0	62	0	4	58	1069	10	0	0	0	7	1	0	0	0	0	3	2	0	5	0	0	0	0	1	9	0	0	0	0	0	0	0	1	1	1	2	38	4	0	59	12	0	49	0	53	66	59	0	0	0	0	0	0	0	1	0	0	0	0	0	100	0	0	0	0	0	0	0	1	0	1	0	0	6	0	0	0	0	1	3	0	0	3	9	3	0	0	0	0	0	0	0	10	0	0	124	2	0	19	0	1	4	0	0	4	0	3	0	1308	0	0	570	0	0	1	768	0	0	0	0	0	0	0	0	1	0	0	1	13	11	15	0	0	94	0	0	2	19	0	37	43	35	1	0	0	0	0	0	15	0	46	4	0	0	0	0	0	2	0	3	0	0	0	0	0	0	0	0	25	0	0	0	0	0	0	0	0	5	0	0	0	0	5	296	0	0	0	106	0	0	0	0	0	0	0	2	0	0	0	0	3	0	0	0	0	0	0	0	0	181	1	0	0	16	0	14	0	2	0	1	0	20	67	1	1	0	0	0	0	1	233	1	0	1	0	0	0	0	0	20	43	50	34	0	0	0	1	2	0	0	0	1	3	0	0	0	0	0	0	66	0	0	0	0	1	1	1	0	10	0	0	1	0	0	60	3	0	22	1	0	0	0	0	9	0	0	1	0	0	0	0	0	29	0	0	0	0	3	31	1	0	0	0	0	0	0	0	0	1	2	0	0	0	0	0	0	0	0	2	0	0	0	0	0	0	0	0	0	0	0	1	0	0	0	0	0	0	1	0	0	8	0	3	1	0	0	34	0	0	0	5	0	0	0	0	37	49	0	0	0	0	0	58	683	117	27	46	15	37	33	9	440	23	323	30	35	13	21	10	30	39	5	16	2	42	50	207	268	71	153	30	7	43	9	12	57	0	0	0	0	0	0	0	0	0	0	23	102	0	0	1	0	0	0	0	0	0	0	0	0	0	0	0	6	0	0	0	0	33	0	122	0	2	13	1	0	0	0	0	0	0	0	2	13	0	0	0	0	0	0	3	0	0	91	0	0	0	0	0	60	0	28	2	1	8	15	0	0	0	3	0	0	2	1	1	0	0	0	29	0	0	4	2	0	0	0	0	0	0	0	0	0	15	12	0	10	0	0	0	0	0	0	0	0	0	0	39	0	0	0	0	0	1	194	0	0	27	62	0	0	0	0	0	0	1	0	0	0	1	0	0	2	45	7	0	0	0	5	0	0	98	61	95	0	0	90	55	43	8	8	1	489	38	27	0	0	0	0	0	0	0	0	1	0	7	3	0	0	0	0	0	0	0	0	2	0	0	0	0	0	0	0	0	0	0	27	0	0	1	5	0	0	0	0	0	1	1	0	0	1	0	9	0	423	9	1	0	28	0	0	0	0	0	56	0	0	0	0	38	0	3	0	5	2	0	0	0	0	9	0	1	20	34	0	2	6	0	184	0	3	0	0	0	0	0	0	0	2	0	19	1	1	0	0	0	0	0	0	0	0	1	0	0	0	0	0	0	0	0	0	0	0	0	0	0	0	13	0	0	1	47	0	0	0	0	6	0	1	626	87	6	0	28	0	0	0	0	0	0	0	0	0	0	0	0	0	0	0	196	12	30	21	0	0	0	24	0	0	0	0	168	94	1	0	0	0	12	0	0	0	0	0	0	0	3	0	0	0	0	0	109	3	0	0	0	0	0	0	0	0	0	64	64	3	20	0	0	4	0	1	92	6	0	0	0	0	0	0	0	0	0	0	48	0	1	0	62	0	0	0	0	0	0	0	0	0	0	1	0	1	0	0	0	1	0	0	0	0	0	3	0	0	0	0	0	30	0	0	0	0	0	0	0	0	2	0	46	0	0	39	0	0	0	1	3	0	17	0	0	61	0	38	1	0	0	0	0	0	0	0	0	3	0	0	0	0	0	0	351	0	0	3	129	5	0	4	3	6	0	1	0	7	0	5	0	2	0	2	0	4	15	4	0	2	0	4	0	1	0	0	0	36	0	34	0	98	136	88	148	127	87	79	87	0	87	77	73	0	4	0	0	0	13	1	0	76	0	57	1	0	75	43	0	0	0	2	0	0	6	0	0	0	0	1	57	0	0	0	0	10	0	0	0	0	0	0	0	0	13	0	0	27	0	3	18	0	15	0	0	6	1	0	0	0	0	0	0	24	0	0	12	35	4	1	52	0	3	1	1	0	115	0	0	0	0	1	0	0	7	0	0	2	0	0	0	0	22	316	0	0	126	3	0	6	0	21	0	0	0	234	79	0	0	0	0	31	0	0	0	0	7	0	13	25	0	0	27	0	0	0	111	4	0	1	2	0	0	0	3377	74	47	7	0	0	0	0	0	1	0	198	0	6	0	45	0	0	16061	356	242	0	0	0	241	0	4	0	882	3	8	0	0	0	0	0	0	1	0	0	0	0	0	0	0	0	0	0	0	0	116	617	0	1	1	0	0	1	0	4	1	0	0	1	0	0	66	21	0	1	0	0	34	4	0	43799	257	258	0	0	0	1	0	0	17	0	0	99	1	1	0	1	0	0	0	0	0	2658	2	0	1	0	2	0	0	1	0	0	0	0	0	0	1	7	4	46	0	0	0	0	0	0	0	0	1	0	0	0	3	0	0	3	0	0	0	0	0	0	1	10	0	0	7	0	65	0	0	0	0	0	19	0	1	6	0	0	0	10	0	0	0	5	0	0	143	0	0	0	0	0	0	708	12	0	7	0	0	3	5	47	0	0	7	0	0	52	35	0	68	1	0	2	0	0	1	0	0	0	0	0	4	6	1	0	0	0	1	0	0	0	0	0	0	0	4	0	0	0	0	0	0	0	0	0	16	0	0	0	0	0	1	0	0	1	0	0	0	0	0	73	0	0	58	3	77	13	0	28	0	0	0	0	0	0	0	8	16	0	0	1	0	39	0	64	0	0	0	0	0	0	0	91	2	0	0	5	42	1	0	1	0	13	0	0	7	3	1	0	0	0	0	2	0	17	0	2	5	0	2	0	33	4	0	0	0	0	0	0	0	22	26	72	30	0	0	0	0	0	78	320	0	45	0	1	0	1	0	0	0	0	0	0	0	0	0	0	10	0	12	2	0	0	0	0	0	0	0	0	120	0	49	0	0	2	0	0	0	0	0	0	0	0	0	0	37	1	0	0	1	0	15	0	18	0	0	116	0	0	0	0	110	0	0	0	40	0	0	0	0	0	0	0	96	0	0	0	0	11	0	0	0	1	0	0	0	0	0	0	0	0	0	111	0	0	0	0	0	0	0	373	0	0	0	84	0	0	0	0	0	0	0	0	0	0	0	1	0	0	0	0	0	15	0	0	0	0	0	0	0	0	0	1	3	0	0	0	4	0	1	0	1	0	0	8	0	1	2	3	0	0	0	0	0	0	0	0	0	0	0	0	0	0	0	0	0	0	0	0	0	0	0	0	0	0	0	0	0	0	0	0	0	0	0	3	29	0	0	0	65	0	0	1	1	0	3	0	0	0	0	0	0	0	0	0	0	0	0	2	0	0	10	0	0	0	0	0	0	1	0	0	2	0	1	1	1	0	16	0	0	0	0	1	0	1	0	3	0	0	0	0	0	0	1	0	0	17	2	0	0	2	1	0	0	0	0	0	0	0	0	0	0	0	2	0	0	8	0	0	0	0	0	0	0	0	0	0	0	0	0	1	0	1	0	0	0	0	0	0	4	0	1	0	0	0	0	0	0	20	3	3	0	0	0	15	0	12	0	1	0	0	0	0	0	0	0	68	0	0	0	0	0	0	0	0	0	0	0	0	0	0	0	0	0	1	0	0	1	1	1	0	0	0	0	0	140	0	0	0	0	28	0	0	0	0	0	9	0	0	0	11	0	0	0	0	0	0	0	0	115	0	0	0	0	0	0	0	1	0	0	0	0	0	0	1	0	0	0	42	0	0	0	0	0	0	0	0	79	9	0	0	0	2	0	0	0	0	0	0	215	0	0	30	48	0	1	0	0	21	0	0	25	0	0	313	0	1	0	2	3	0	1	0	0	2	0	1	209	33	0	20	0	1185	0	23	1	0	0	119	0	0	0	0	0	0	4	0	0	0	0	1	1	0	0	2	0	0	0	26	0	0	0	0	0	0	2	0	0	1	0	0	0	0	0	0	0	0	0	0	0	0	0	127	0	78	0	0	1	0	0	0	0	0	0	0	12	0	0	0	0	0	0	0	0	0	0	0	0	0	0	1	0	0	2	0	0	0	0	0	0	60	0	0	0	0	0	191	0	0	0	0	0	0	0	0	0	0	16	0	0	0	0	0	0	0	0	0	0	0	250	0	0	1	13	0	5	0	0	137	0	2	0	0	0	0	0	0	0	0	0	0	3	0	0	1	0	1	1	0	0	0	7	0	0	0	0	0	0	141	2	0	0	1	0	0	0	0	0	13	0	0	0	0	0	0	0	0	0	0	0	0	0	0	0	0	57	0	0	0	0	0	0	265	0	1	0	0	0	0	0	0	1	0	0	0	0	1	3	1	14	1	13	0	0	0	321	0	0	0	0	0	0	1	0	0	0	0	1	3	2	0	4	0	0	0	0	0	0	0	0	0	3	6	0	0	0	0	0	0	7	0	145	13	0	0	0	0	0	0	0	0	0	115	69	0	0	0	0	7	0	0	0	10	11	28	4	0	17	0	0	0	0	0	2	0	135	0	0	0	0	1	0	1	0	3	0	0	28	1	0	1	0	0	0	0	0	0	0	0	13	0	2	0	0	0	50	0	0	0	0	0	2	0	0	0	0	0	0	1	0	1	5	0	2	0	0	23	0	0	0	1	1	0	0	71	2	2	0	196	53	33	941	1706	0	0	3	0	53	0	53	11	3	0	0	0	4	45	0	258	0	1	68	0	69	0	2	0	0	2	0	0	4	2	1	2	0	0	4	0	1	15	97	0	0	16	1	3	0	2	0	0	0	2	0	1	0	0	0	0	0	10	2	0	0	0	0	109	115	0	1	0	4	0	0	0	0	0	0	0	1	0	0	0	0	0	0	1	1	18	0	0	0	59	0	10	0	0	0	0	0	0	29	0	0	0	11	167	2	0	4	0	0	0	0	1	0	0	0	0	0	0	0	43	13	0	2	0	0	0	0	1	1	0	0	0	0	0	3	0	0	0	0	4	1	0	0	2	0	2	0	0	0	1	0	17	0	0	0	0	0	0	17	0	0	11	0	34	2	0	104	0	23	0	4	172	0	0	1	0	0	0	0	3	0	0	0	586	691	519	0	2	34	32	35	0	33	186	36	9	43	321	49	1	59	20	50	19	32	1	245	21	443	0	53	0	2	0	1	0	0	1	0	0	0	0	0	1	0	0	0	0	2	0	0	0	1	0	0	0	13	0	0	0	0	0	0	4	0	1	29	0	0	0	2	0	0	216	0	0	0	0	1	0	0	169	26	0	0	1	2	1	0	0	1	16	0	4	0	1	0	0	0	0	5	184	0	168	188	1	0	0	0	0	0	0	1	0	0	0	0	0	0	0	0	6	0	1	0	0	31	0	0	0	0	81	0	0	3	0	2	0	2	0	0	0	187	3	0	39	7	0	0	0	0	0	9	1	0	3	0	1	1	0	0	0	0	0	0	0	0	0	0	0	0	0	342	2	0	0	0	0	0	0	24	0	13	0	0	5	585	19	0	0	31	0	0	65	0	81	26	0	1	0	1	0	0	0	0	1	0	0	1	0	0	0	0	0	0	0	0	0	0	1	102	0	0	15	34	0	0	0	0	0	0	1	55	0	0	24	0	1	5	1	0	5	1	0	0	116	0	33	0	0	4	0	61	1	0	0	0	1	0	0	0	0	0	0	0	0	0	8	0	0	0	101	0	0	0	0	32	0	0	3	18	2	0	0	0	0	0	0	0	0	10	68	0	3	2	0	2	0	8	2	0	0	0	0	0	7	1	1	11	7	0	87	0	0	1	1	3	0	1	77	1	16	1	3	11	0	36	0	0	0	0	0	0	3	0	25	0	0	0	0	0	0	0	1	3	0	0	0	37	7	20	0	0	51	2	0	30	0	2	0	0	0	0	0	0	8	0	0	0	0	0	0	1	0	0	0	0	0	0	0	0	1	5	0	0	0	0	19	0	0	0	0	291	3	3	0	0	0	0	0	65	0	0	0	0	0	0	0	64	2	0	0	9	45	0	4	0	0	0	0	66	0	0	0	0	0	1	0	0	0	0	0	0	0	0	31	28	0	1	0	0	182	7	40	3	0	0	0	0	0	0	0	0	0	0	0	100	2	0	1	0	0	0	1	0	1	53	0	89	4	41	83	2	2	0	0	0	0	71	0	3	3	16	0	0	0	0	0	0	96	0	40	44	0	26	34	40	133	0	0	0	0	85	0	3	0	8	0	0	0	0	0	0	0	0	0	0	0	0	0	10	0	0	0	0	0	0	0	0	106	60	0	0	1	0	14	1	75	0	6	0	0	0	0	40	0	1	0	0	0	1	28	1	44	3	0	63	47	0	0	46	1	1	0	0	0	0	0	0	0	0	0	0	34	0	0	1	0	0	60	1	0	5	0	0	0	0	53	7	0	0	2	0	0	19	0	1	0	0	27	0	0	0	0	0	1	0	0	0	0	0	5	0	0	117	1	2	2	1	0	0	5	0	561	0	1	59	0	90	0	7	0	27	1	0	1	0	0	0	0	0	0	0	0	0	0	0	2	1	403	0	30	0	0	906	0	3	0	3	0	21	10	0	23	0	1	1	183	0	0	13	0	0	0	0	0	21	0	0	2	0	0	0	32	2	0	0	0	0	0	0	25	7	0	0	22	0	0	0	2	1	0	0	0	0	0	3	0	0	3	0	0	0	0	0	0	0	0	0	0	0	1	0	0	0	0	0	0	0	0	0	0	0	0	0	0	0	0	0	0	0	0	0	0	19	0	0	0	0	0	0	0	0	3	0	0	4	0	0	0	0	0	0	0	0	1	22	0	0	0	0	0	0	2	1	0	0	0	0	0	0	0	0	0	0	17	0	0	0	0	0	2	0	1	0	0	0	0	0	0	0	34	0	0	1	0	0	0	0	1	0	1	12	0	0	9	0	0	0	0	0	0	0	0	26	0	10	0	0	24	0	0	0	0	0	0	0	24	0	0	0	0	1	0	0	0	0	0	0	3	19	0	0	0	0	30	73	0	0	0	0	0	1	0	1	0	0	0	32	0	0	0	0	0	0	0	0	1	17	271	0	0	1	0	0	0	0	0	48	0	0	40	1	0	0	0	0	0	0	1	0	0	0	2	4	0	0	0	0	0	0	0	0	0	9	1	1	0	1	0	1	0	154	0	0	0	0	4	62	7	0	0	0	0	0	5	0	1	1	0	0	0	0	3	0	82	0	3	0	0	0	0	0	0	0	0	0	0	0	0	0	0	0	0	0	0	234	8	74	4	0	1	0	0	0	0	4	1	0	0	0	216	67	122	13	0	4	85	0	150	0	0	1	12	196	0	9	0	0	0	0	0	0	0	0	229	10	0	1	34	295	0	0	0	8	3	5	0	0	0	0	0	0	32	0	5	0	0	0	0	8	0	0	2	0	1	56	0	1	0	0	0	81	0	13	1	4	1	22	0	133	6	1	33	0	5	3	0	102	0	0	0	0	0	0	1	0	2	0	0	0	0	0	59	2	2	0	0	0	87	107	1	1	3	1	567	1	0	0	0	1	0	2	0	0	0	0	0	0	0	28	0	0	0	0	12	0	21	2	23	9	0	0	0	0	1	0	0	0	0	0	0	0	0	0	2	0	0	0	0	37	0	0	0	1	1	1	0	0	0	0	0	0	2	13	0	0	1	0	0	0	0	0	0	0	0	0	23	26	2	1	0	0	0	0	1	6	178	5	1	0	0	0	0	0	0	0	0	0	2	55	0	0	0	0	0	12	3	2	0	3	0	1	0	0	2	0	0	0	3	5	0	2	0	0	0	0	1	0	0	0	0	0	0	0	0	1	0	0	0	4	0	0	60	2	0	0	0	0	0	0	5	2	5	0	19	308	5	0	0	0	0	42	0	0	0	49	1	46	48	1	3	0	0	0	1	0	21	0	1	0	504	0	0	0	42	0	0	0	0	0	0	39	18	127	1	0	62	0	0	0	1	85	0	0	16	1	0	82	8	203	4	71	1	0	0	0	33	0	0	2	0	0	12	0	0	0	0	0	0	0	40	0	0	0	0	0	2	0	3	1	0	0	132	0	37	4	0	178	3	0	0	0	9	0	152	3	37	29	118	2	0	93	2	91	1	47	3	0	0	0	0	69	0	0	2	0	7	0	0	0	0	0	0	4	10	2	1	3	3	31	7	11	0	126	0	1	0	45	2	0	0	0	0	0	0	0	0	0	0	0	2	0	0	48	34	0	0	0	1	2	0	83	0	0	1	0	14	1	0	0	0	0	2	0	0	0	1	0	81	0	0	4	0	37	0	1510	1000	88	56	0	0	5	0	0	0	69	7	0	1	0	0	1	0	0	8	0	0	0	196	9	6	5	1	0	8	0	0	2	1	0	10	0	4	0	1	0	0	0	0	210	162	72	0	0	19	0	2	0	1	2	0	1	0	0	31	4	0	0	1	1	0	77	290	8	3	5	2	206	0	0	0	0	0	0	8	0	0	0	0	0	61	34	1	0	1	0	636	1	0	0	0	1	0	0	4	61	6	1	2	0	3	0	695	0	61	63	75	30	53	30	0	0	315	72	0	99	0	0	0	31	20	3	0	0	0	1	0	0	0	0	0	205	1	0	0	0	0	3	17	4	326	309	1	6	1	109	0	301	188	146	0	0	146	0	0	0	0	0	0	0	0	0	0	0	0	0	0	0	0	0	1	9	1	0	0	0	0	0	16	1	83	0	3	167	2	13	1	45	6	258	80	3	2	0	0	0	0	1111	109	5	0	0	0	3	3	110	1	1	17	0	0	1	29	0	0	1	0	0	0	0	43	93	0	0	1	0	0	0	0	0	18	2	0	0	0	0	9	2	8	8	82	4	1	0	0	0	0	885	0	5438	0	57	0	12	33	18	7	0	0	0	0	0	0	0	0	78	6	34	0	0	1	0	0	0	2	2	1	0	0	926	0	0	13	1	0	4	2	0	0	0	3590	0	0	0	0	0	0	0	0	0	25	0	0	0	0	0	0	0	0	0	0	0	0	0	0	0	8	2	0	122	1	0	4	0	0	0	0	1	97	0	0	0	1	0	0	0	0	153	0	1	0	1	0	0	0	0	0	1	0	781	0	0	111	21	0	0	1	0	2	0	6	47	36	1	0	0	0	0	15	0	1	9	0	0	0	0	143	1	0	0	0	2	0	0	2	0	0	0	0	0	1473	1	24	1	1	792	1	4	280	17	366	79	869	1037	726	2	791	425	575	0	1	118	16	19	46	12	2	1074	1	1314	2	2	3	0	0	77	3	0	0	20	31	20	0	1	2	2	1	119	1	0	0	99	20	89	35	46	2	71	2	59	0	1	0	100	1	25	87	0	0	1	0	0	0	0	0	0	0	80	0	0	1	0	57	1	3	26	0	0	0	0	1	50	0	0	0	14	0	0	65	2	0	0	0	0	0	1	0	68	0	1	0	54	5	0	100	2	0	0	7	142	1187	1	12	1	3	13	1	4	10	0	5	0	188	1	0	8	0	0	64	1	34	204	0	0	34	0	106	4	0	0	46	0	0	0	38	1	41	0	0	0	166	0	0	1	1	0	0	50	37	0	0	6	0	0	0	1	0	0	0	0	0	0	0	0	61	0	0	3	3	0	62	77	47	0	0	1	0	0	7	0	0	38	0	0	0	23	142	0	97	78	0	1	18	1	0	0	0	2	2	0	1	3	5	3	75	454	219	284	0	0	0	0	1	0	0	1	0	7	0	8	1	0	0	0	0	0	5	164	8	0	2	0	0	0	0	0	0	29	0	1	0	0	0	0	0	0	9	0	0	0	0	0	0	0	0	0	0	50	0	0	0	0	0	0	54	16	0	2	0	34	103	0	0	0	0	0	0	0	35	0	0	39	0	0	0	0	13	1	0	4	25	14	1	0	0	0	0	0	0	0	0	0	1	77	0	0	3	0	0	1	29	4	174	0	0	3	1	0	12	0	38	2	79	33	0	0	1	0	0	644	8	0	0	0	3	388	426	34	142	3	1	168	1	233	0	211	2	2	9	352	343	206	17	62	40	88	150	90	0	91	1	5	83	67	55	3	5	335	1	255	225	2	236	2	175	5	4	202	4	100	60	4	158	0	0	1	0	226	11	0	151	83	130	130	2	2	19	558	866	3139	0	15	102	0	0	0	0	7	1	0	36	1	2	1	28	122	336	18	0	14	0	0	0	0	0	3	17	2	7	4	13	7	13	146	247	0	136	161	190	4	0	0	1	1	71	109	0	3	131	6	2	2	125	3	1	67	5	0	0	0	33	0	2	0	84	0	0	0	0	0	0	0	116	3	0	0	0	0	44	2	0	2	0	0	0	0	0	0	72	0	0	0	0	0	0	0	0	1	5	0	1	1	0	0	0	0	0	18	1	0	0	2	228	424	522	501	8	0	0	0	0	1	0	1	0	0	0	0	0	0	0	0	0	0	1	0	8	0	1	0	0	0	42	0	0	0	0	0	0	0	0	0	0	0	0	0	0	0	0	75	0	0	0	0	7	0	202	65	67	310	0	130	0	191	0	0	0	0	0	2	0	0	0	0	0	0	0	43	3	45	2	1	0	0	0	0	0	0	0	2	18	0	0	13	0	8	0	0	226	192	0	0	0	39	0	0	81	12	120	4	33	0	0	2	0	0	62	0	607	0	0	0	3	71	1	0	11	46	2	67	11	0	1	48	8	0	2	139	112	24	1	1	0	0	25	111	2	5	0	2	0	0	0	0	1	0	1	0	0	0	0	0	40	40	1	60	1	0	0	0	0	0	8	1	0	0	75	0	0	0	0	0	0	0	0	1	216	20	1	0	0	3	0	2	0	0	0	3	2	0	0	10	1	0	0	1	0	0	0	0	0	0	0	91	2	74	1	0	1	0	0	0	0	0	0	0	27	3	0	0	49	0	0	0	0	0	4	0	1	4	2	1	66	61	38	0	0	4	0	1	1	0	0	0	0	0	0	0	0	1	3	1	0	0	12	0	1	0	1	4	103	77	0	0	0	0	1	0	2	22	6	17	27	1	0	0	0	0	1	0	4	1	2	0	1	2	0	0	1	0	126	7	0	0	84	6	2	0	1	131	0	54	3	2	244	0	0	38	0	1	0	0	0	0	0	0	0	65	2	0	94	3	45	0	0	0	0	163	0	0	0	0	0	911	0	0	0	0	0	0	0	0	0	0	0	0	0	0	0	0	0	4	0	4	0	0	63	28	0	0	0	0	47	2	1	0	0	0	179	65	0	0	0	0	268	0	100994	0	0	0	0	0	86	0	1	0	0	0	0	0	0	0	0	65	0	0	0	0	4	2	100	10	0	5	60	2	0	0	0	0	0	0	5	0	51	114	0	14	4	0	0	0	0	0	1	0	0	0	0	4	0	1	38	29	121	92	9	15	81	0	17	1	0	3	0	1	149	123	114	623	0	1	0	0	1	5	0	39	134	13	1	344	0	0	0	0	15	0	0	1	0	110	4	0	16	1	0	0	130	146	0	0	310	8	0	0	0	0	0	0	0	0	0	0	0	60	273	7	481	539	0	38	436	0	998	15	11	964	16	37	218	219	2	788	177	0	8	56	5	0	45	1	0	0	276	394	402	470	343	18	40	0	0	192	120	3	15	2	0	0	0	0	0	0	0	0	0	0	0	0	41	0	35	0	24	0	0	0	44	0	1	0	0	44	54	66	22	0	0	1	1	0	44	39	0	0	42	0	1	1	1	6	47	41	0	15	0	0	0	3	89	0	1	0	1	0	0	0	0	0	0	0	0	0	1	16	0	3	0	3	83	46	0	0	1	11	0	0	0	1	2	135	0	19	0	0	0	101	13	0	3	1	0	358	2	0	30	1	0	0	1	0	0	1	0	0	2	0	0	0	0	0	0	0	0	0	0	0	2	0	18	0	0	0	0	0	9	0	0	1	1	4	0	0	0	0	0	0	0	0	0	0	0	0	0	0	0	0	1	101	0	1	1	0	0	0	0	2	0	0	0	3	22	73	77	0	298	15	0	2	20	115	145	18	63	0	0	0	4	60	0	0	2	0	26	1	20	13	0	0	0	0	0	0	0	0	175	0	92	0	29	5	2	0	0	1	0	18242	56409	0	22	1	0	0	0	0	133	4	116	4	0	5	0	48	44	1	49	0	2	0	87	59	2	90	1	855	0	0	14	2	1148	0	0	3	0	2	3	1	0	103	0	4	189	71	66	0	0	0	236	8	12	0	0	0	0	0	0	0	0	2	0	0	3	35	1	0	1	0	1	1	0	2	2	2	2	3	3	9	1	0	0	0	1	0	78	236	73	58	65	42	105	343	13	0	14	18	82	50	0	1	9	0	10	0	0	1	0	0	0	0	92	0	1	2	0	0	0	1	0	33	2	20	0	2	0	6	64	16	0	0	19	0	0	0	0	1	0	1	0	107	0	83	0	2	0	0	1	0	0	0	0	0	0	0	0	2	0	0	0	0	0	25	167	0	1	0	0	1	1	9	0	0	1	2	0	1	0	0	0	0	0	0	1	0	0	0	0	0	0	0	0	0	0	0	1	0	11	0	37	142	401	1195	262	289	0	0	0	0	0	0	0	0	0	1	0	0	0	0	0	0	0	105	0	0	0	0	0	46	0	0	0	0	0	0	0	27	0	0	73	0	0	1	43	0	46	0	0	39	0	3	4	4	3	2	107	161	124	0	342	3	9	14	58	3	7	48	0	0	70	0	0	3	5	322	121	3	0	0	0	0	0	7	0	0	1	0	499	0	0	0	0	1	16	0	1	3	0	0	1	3	0	0	1	0	0	0	7	3	0	0	0	0	1	305	8	0	0	0	1	0	0	0	0	59	0	0	0	0	0	0	78	5	0	0	0	0	26	0	0	0	104	2	0	141	7	0	0	0	0	0	1	36	2	39	2	0	0	0	0	0	73	0	5	0	1	9	1	0	0	28	198	51	6	2131	0	91	204	41	0	147	0	984	99	184	23	0	0	0	41	0	18	0	18	0	270	1	0	5	0	6	0	11	88	2	2	1	1	12	692	0	6	0	1	0	86	55	0	0	0	0	3	0	0	21	0	0	1	26	32	0	1	0	0	41	0	25	0	0	2	0	0	0	0	21	0	2	4	0	1	12	13	0	0	0	1	0	2	3	35	93	55	116	5	2	49	60	48	50	54	97	0	1	0	0	0	0	0	0	0	415	0	0	1	221	234	110	52	6	526	0	4	49	1	1	0	5	5	0	1	0	0	1	0	0	69	814	100	1	0	0	0	2	0	0	0	0	0	0	0	2	1	0	0	0	0	0	0	1	0	3	0	0	0	0	0	0	0	0	0	0	0	0	0	0	0	0	0	1	10	1	0	0	0	0	0	0	1	0	0	0	0	0	0	0	0	66	3	31	1	0	1	2	0	1	0	0	0	1	0	0	0	0	27	36	40	212	19	1	4	2	16	1	0	59	33	1	1	0	0	54	0	19	0	0	28	0	26	72	0	7	29	0	1	4	5	85	303	9	0	2	0	0	0	0	0	1	117	4	50	3	71	1	104	9	0	174	0	1	21	18	0	3	0	34	176	88	2	0	94	54	121	0	58	1	42	0	0	0	0	0	1	2	0	0	0	1	0	41	0	6	82	0	0	1	35	2	26	49	3	39	6	0	63	2	125	4	66	98	4	6	175	6	94	0	0	0	0	0	0	0	0	0	183	3	44	27	0	0	41	0	0	0	0	0	0	0	0	0	0	0	0	0	2	66	37	0	60	72	225	886	3	0	33	0	0	0	0	0	0	1	1	0	0	1	59	0	1	0	0	0	19	0	0	0	0	0	4	26	29	1	51	263	0	1	1	0	0	0	228	3	23	0	24	104	0	0	0	84	0	7	0	0	0	0	0	0	0	0	0	0	29	2	0	0	0	0	0	1	0	0	0	0	0	0	0	0	0	0	3	0	1	0	0	0	0	0	0	0	36	1	50	18	0	121	126	71	91	73	33	50	0	25	0	2	0	0	0	0	0	0	0	0	0	0	0	31	0	1	0	0	3	0	0	0	3	8	0	34	0	0	0	0	33	3	0	0	0	0	0	5	0	0	52	2	0	0	0	0	0	0	0	0	0	0	0	0	0	1	0	5	8	7	1	131	0	0	0	0	0	0	0	0	4	0	99	0	6	1	32	0	30	1082	0	0	0	0	0	0	0	0	0	2	0	0	0	0	0	0	0	0	0	1	0	0	0	0	0	0	0	14	0	0	1	0	0	27	0	0	422	0	0	0	0	0	0	0	0	0	0	0	2	0	135	30	0	0	0	0	0	0	0	0	0	0	0	0	0	0	0	0	1	0	0	74	0	1	26	0	0	6	85	0	0	18	0	0	0	0	0	0	2	0	0	0	0	0	0	0	0	5	0	0	0	0	0	0	0	0	0	1	0	0	0	0	1	0	0	0	0	0	0	0	0	4	0	2	0	0	0	0	0	0	6	0	0	0	0	96	0	0	0	0	0	0	0	0	0	0	2	0	5	0	0	36	0	0	0	0	0	0	0	0	1	0	0	0	0	0	0	0	0	0	0	0	0	81	0	0	0	0	0	0	0	0	0	0	0	0	0	0	0	0	0	0	0	0	29	0	0	0	0	0	100	0	0	1	0	1	0	1	2	0	1	0	0	1	17	0	1	2	0	0	0	2	0	3	0	0	4	5	1	2	1	0	93	4	396	0	0	0	0	0	0	2	2	1	1	0	0	1	4	0	2	2	0	1	0	0	3	0	3	113	2	0	1	0	29	1	1	0	1	0	2	1	0	0	2	0	0	0	3	3	5	1	2	1	0	0	2	1	0	12	3	0	1	0	5	8	2	0	0	0	8	0	7	2	1	0	2	1	8	6	1	1	0	2	25	0	0	8	0	1	8	2	1	0	6	0	4	9	0	0	2	0	1	4	2	1	0	1	2	0	3	135	0	5	1	5	13	13	5	18	124	9	4	0	0	2	104	0	2	0	0	0	2	0	0	0	0	66	0	3	0	0	0	21	0	0	0	681	17	5	0	0	1	0	2	187	0	119	0	28	12	0	0	0	46	0	0	0	0	0	0	0	0	0	0	0	6	0	39	0	0	0	0	0	0	2	0	0	1	0	1	0	2	3	0	0	0	0	1	0	0	0	0	0	1	0	0	0	0	74	0	5	0	1	2	0	0	8	0	0	0	0	0	1	0	0	0	0	0	0	0	428	0	13	0	31	0	0	0	0	0	0	0	0	0	0	3	1	0	0	0	0	11	0	251	0	0	0	0	1	1	0	0	0	0	371	0	3	0	0	1	0	0	1	0	0	0	0	0	1	0	0	0	0	0	0	0	0	99	28	1	130	25	0	0	0	0	0	7	0	0	1243	0	4	1	61	0	0	0	0	6	4	3	0	0	2	2	0	0	0	1	0	33	34	1	116	0	26	1	114	0	0	0	0	0	0	0	2	0	0	0	0	1	0	0	0	0	4	3	0	3	71	0	1	19	0	0	0	0	0	0	55	3	92	40	83	138	1	104	196	1	1	179	5	1	138	0	0	0	5	0	0	0	0	1	0	75	28	0	0	0	2	233	5	0	0	0	221	0	0	0	0	0	0	0	0	19	0	8	189	0	192	1	0	0	0	0	0	0	1	23	0	25	0	61	18	12	6	0	160	0	27	0	0	0	0	25	0	59	0	1	0	13	7	1	1	3	1	0	13	2	6	2	34	78	9	0	0	0	0	1	0	0	34	1	0	0	0	14	0	0	6	70	4	0	36	1	1	127	62	90	1	2	0	0	51	6	34	128	0	0	0	0	37	0	27	130	5	67	1	0	0	0	0	0	0	0	0	0	0	266	7	146	0	3	0	0	2	1	74	50	0	0	0	2	7	19	5	13	12	58	20	1	17	0	7	2	4	14	1	28	46	149	113	0	1	55	144	22	0	0	0	2	0	0	0	12	0	0	261	0	1	0	0	0	0	27	252	24	33	0	0	0	0	0	0	0	0	0	0	0	2	0	4	0	46	28	15	155	0	36	0	0	0	0	0	46	2	28	0	32	0	0	0	29	0	0	96	3	1	9	0	0	0	31	225	0	0	0	2	0	2	0	0	13	0	0	0	0	1	92	3	0	33	0	46	0	0	3	0	0	8	0	0	16	0	0	0	62	0	0	479	0	65	2	0	19	0	0	0	0	0	0	85	5	0	0	1	1	1	1	1	0	2	0	0	0	0	183	7	33	0	1	0	0	1	1	0	0	0	0	7	29	1	0	0	753	3	1	528	9	377	53	328	13	49	1043	309	0	602	3150	181	556	5	8	8	0	0	0	2	0	2	0	0	6	0	1	0	26	0	0	0	0	1	0	0	1	0	0	0	0	32	4	0	0	2	0	0	0	1	0	0	0	0	0	0	0	0	0	0	0	0	0	0	0	0	1	0	0	0	0	0	2	16	13	0	0	0	0	0	1	0	0	0	0	0	0	0	0	0	0	0	1	0	0	0	0	0	0	163	37	1	516	5	0	0	40	0	0	0	126	122	184	5	0	4	265	2	0	6	0	1	0	0	0	0	0	0	0	0	10	9	2	4	135	125	0	0	0	41	5	63	1	7	0	0	5	0	0	0	0	0	0	5	0	0	0	0	0	24	1	79	2	32	0	14	14	57	0	62	2	94	0	0	0	1	0	1	81	156	0	0	0	0	0	0	0	2	5	2	0	0	23	10	5	79	0	3	0	0	0	0	54	0	0	0	327	0	1	1	0	1	383	0	0	0	2	72	0	6	0	0	4	0	0	0	15	0	2	25	137	0	29	31	0	14	0	68	0	0	0	0	0	0	16	22	0	27	0	0	0	1	0	71	9	0	1	59	28	25	112	0	47	1	32	4	0	34	0	0	6	1	7	1	0	89	0	0	1	1	43	0	23	1	0	0	0	0	0	0	0	0	0	0	0	0	0	0	0	0	0	0	0	0	0	1	0	0	0	0	0	1	1	0	0	0	5	0	1	0	0	0	30	2	0	18	46	0	4	0	14	23	325	79	154	43	0	19	272	274	0	14	146	0	52	0	4	3	0	0	0	51	0	92	132	6	0	0	1	0	0	2	91	9	0	0	38	42	281	2	0	0	0	0	0	0	14	0	0	0	1	1	0	1	1	0	0	0	0	693	6	201	92	19	0	86	1	20	0	0	0	0	0	7	0	0	0	9	0	102	0	9	4	4	0	24	2	1143	12	1	0	0	4	6	1	74	44	17	2	4	33	0	12	15	4	0	0	0	0	7	1	54	611	102	6	0	6	0	1	0	0	37	0	0	0	3	1	52	0	675	26	0	0	0	1231	16	6	8	4	28	230	199	94	10	0	4	0	0	2	5	68	0	2	11	0	0	0	0	2	1	0	1	0	0	0	0	0	0	0	0	0	0	0	0	471	0	0	0	0	320	7	10	0	0	0	13	0	2	0	0	0	25	89	3	145	6	0	58	1	0	1	13	1	0	1	0	0	0	8	0	2	75	54	5	4	110	3	0	37	20	16	14	0	0	0	0	0	0	0	0	29	0	0	0	86	0	0	0	0	0	0	0	131	0	0	0	101	1	42	0	0	40	0	41	0	0	21	0	6	0	0	5	17	26	25	146	129	32	88	0	461	0	0	0	0	0	0	0	0	0	0	1	6	0	0	0	0	0	0	13	1	0	0	53	0	0	1	0	23	1	1	0	0	199	0	506	0	0	410	1	1	2	0	0	0	0	0	10	130	0	0	0	0	1	1	6	3	2	0	3	1	13	0	1	0	4	1	6	13	1	2	1	0	32	0	1	0	55	6	4518	112	100	105	56	113	90	50	87	135	43	31	0	97	51	1	0	1	5	0	0	0	1	0	0	0	1	0	0	0	1	1	4	2	0	0	0	0	0	0	0	0	0	0	3	0	0	0	0	0	0	0	0	0	0	0	0	0	0	0	0	1	0	79	4	0	226	0	366	325	5	181	0	0	0	23	0	0	1	0	0	89	0	0	106	218	0	0	0	15	2	38	0	69	93	66	0	0	0	0	0	0	0	0	0	0	0	0	0	0	45	33	48	0	127	1	41	27	50	0	0	1	1	0	0	86	4	0	0	0	108	42	0	78	0	0	1	22	0	91	0	68	3	0	0	0	0	0	0	0	0	10	0	15	0	3	46	0	0	0	0	61	0	1	0	0	0	0	0	1	0	0	0	12	0	29	79	0	1	0	1	0	6	0	0	0	0	1	2	0	0
LakWasM105_HOW12_2_rpkm	0	0	0	0	0	33	0	0	5	0	1	52	0	0	0	1	0	1	0	0	0	0	1	73	0	0	0	0	0	12	0	1	0	27	0	11	0	0	0	0	0	0	0	6	147	115	79	25	0	59	0	117	0	0	0	0	0	1	115	38	4	3	1	1	0	0	0	0	4	85	3	0	53	0	78	0	0	0	0	0	0	46	1	0	3	0	1	0	0	0	0	2	10	0	72	0	1	0	7	0	0	3	0	0	0	0	0	0	0	2	0	0	295	0	150	1	0	14	0	0	0	0	1	4	0	0	3	1	0	1	87	438	3	0	0	1	0	0	0	0	0	0	0	5	0	1	0	0	61	0	20	138	0	0	331	5	8	4	231	0	13	0	0	1	0	1	0	11	1	20	1	0	0	0	1	0	1	0	0	1	0	0	0	0	0	46	1	0	0	1	17	18	26	29	44	0	3	17	222	195	0	0	0	0	0	1	2	0	1	0	283	12	50	87	32	0	1	9	0	0	1	1	0	2	0	1	0	1	56	0	0	15	8	0	0	0	70	0	58	0	0	1	35	1	58	0	0	0	0	1	0	15	33	0	1931	2	0	0	0	0	3	1	1	59	1	0	5	1	6	452	3	0	13	0	0	0	0	4	2	1	2	69	1	92	44	0	3	0	17	8	0	0	1	1	5	0	0	8	8	0	0	52	73	5	0	2	18	86	3	1	0	0	489	76	0	0	1	0	1	1	0	0	0	1	6	19	0	0	0	0	0	1	23	0	0	0	54	0	0	0	1	4	42	1	104	0	18	6	3	10	0	6	1	3	2	1	0	0	0	51	0	0	3	0	0	97	0	50	1	9	0	293	0	0	16	0	0	69	3	42	1	0	11	1	2	0	128	1	0	0	0	0	1022	0	0	11	14	0	0	40	0	26	0	18	32	0	1	0	2	4	1	12	6	1008	0	15	109	3	24	0	0	0	0	0	0	0	0	1	0	2	4	4	1	1	0	1	0	0	7	0	69	0	0	0	0	59	0	0	0	0	0	274	0	630	1	0	202	0	0	1	0	0	2	29	2	59	45	0	0	0	29	20	52	0	0	0	22	0	2	0	0	0	6	0	0	1	0	3	3	0	0	2	150	120	0	0	0	0	0	0	0	1	68	1	0	1	0	0	0	1	0	0	0	0	3	0	2	0	1	18	2	0	0	0	1	0	0	0	0	0	0	0	64	27	28	0	36	0	0	81	0	0	0	46	38	0	0	0	0	0	0	0	3	0	0	0	0	5	0	0	0	0	0	0	51	0	1	0	189	1	0	1	3	12	0	0	0	87	1	0	1	25	4	1	518	0	1	3	36	0	0	0	34	2	47	12	0	0	0	0	91	0	9	33	28	14	0	46	0	2	0	1555	8	1516	3	0	456	4	706	5	10	0	273	31	0	15	0	12	0	7	0	4	0	0	0	0	0	0	0	8	2	560	0	0	0	3	1	21	1	3	30	0	13	10	1	0	2	1	3	7	1	17	4	0	1	1	2	2	0	0	0	37	1	1	3	0	1	0	0	0	0	0	6	1	0	0	12	0	0	44	0	0	38	0	0	0	0	6	0	2	0	1	1	10	1	3	1	0	153	0	0	1	0	0	7	2	2	0	48	3	0	2	2	4	2	0	0	164	78	0	0	1	0	0	0	0	0	0	0	7	0	72	18	0	1	215	0	0	0	1	0	0	31	0	0	0	4	0	50	0	0	0	0	29	0	0	13	0	0	0	0	0	0	1	0	364	0	0	0	0	0	1	6	0	0	8	0	0	0	0	1	7	0	2	0	0	19	0	0	4	0	0	1	0	0	4	269	0	0	0	1	0	0	0	76	0	0	0	0	0	0	3	0	0	168	1	0	2	2	6	38	0	0	0	0	1	1	189	70	0	0	0	0	0	0	0	0	0	117	331	0	0	1	0	0	0	0	2	0	0	51	2	0	0	0	1	0	1	8	0	0	0	0	0	0	0	4	0	4	0	0	1	0	0	1	208	594	0	0	0	0	0	0	0	1	0	1	22	0	0	0	0	4	0	0	0	0	1	0	0	0	0	0	0	3	2	0	5	2	1	0	0	0	0	0	0	0	0	0	0	0	1	1	1	0	0	0	0	0	1	0	1	0	38	21	0	0	33	0	0	0	0	0	0	3	1	1	0	3	0	0	0	1	2	1	0	0	0	0	61	0	0	21	706	2	47	0	98	0	0	205	26	7	0	1	0	0	0	0	0	0	1	0	0	0	0	0	0	0	0	0	0	2	1	0	0	0	0	3	0	0	1	1	0	0	0	0	698	3	0	0	93	0	0	0	24	0	0	7	2	61	0	0	0	0	1	0	8	3	8	0	1	0	0	0	1	0	0	2	0	5	0	0	1	0	0	1	0	0	2	0	0	0	368	11	0	0	0	0	0	6	0	0	10	1	2	0	0	0	239	1	0	0	0	0	1	0	0	1	83	1	0	0	0	0	0	0	2	0	1	0	0	0	0	0	0	3	0	2	0	0	2	0	0	5	0	0	53	0	0	2	0	1	0	0	0	0	1	50	0	1	1	1	0	0	1	0	1	0	0	0	0	0	33	0	0	0	0	0	0	0	0	0	0	0	0	0	0	0	13	0	0	0	1	0	0	0	1	0	0	87	1	0	0	0	0	25	2	8	0	0	0	26	0	0	0	0	4	0	0	0	6	33	42	540	328	2	0	0	226	4	0	0	0	0	12	1	0	0	0	0	0	0	4	0	0	4	3	1	0	0	0	21	0	1	0	2	0	5	0	0	0	1	3	1	0	0	0	5	0	8	0	201	0	3	2	3	0	24	0	141	0	3	210	995	2	0	2	12	0	0	0	0	65	0	1	0	0	0	1	0	0	3	112	0	86	77	2212	0	116	0	2	0	4	0	78	2	0	36	0	0	0	0	0	0	16	0	1	0	1	1	0	0	0	2	36	6	4	0	9	1	0	0	0	0	0	1	0	0	3	0	0	4	0	0	0	0	0	2	0	0	0	0	0	2	0	67	1	55	0	0	0	39	1	0	0	1	0	1	17	1	0	2	0	0	0	33	10	0	0	0	0	0	0	9	0	15	0	0	2	0	1	28	50	0	0	15	0	0	0	0	0	0	0	260	1	58	138	29	50	79	5	45	0	0	51	3	28	0	1	1	5	0	37	16	0	14	0	3	0	1	0	15	20	54	0	62	0	0	0	0	0	1	20	0	0	0	0	1	1	2	107	1	2	1	0	18	23	0	0	0	4	0	3	0	0	0	19	0	0	0	0	1	4579	78	598	141	4	96	0	0	1	0	0	0	49	10	4	7	21	0	0	0	2	559	772	54	165	10	2	102	470	1	0	0	0	1	0	0	0	159	0	141	6	251	0	0	190	3	55	0	0	1	1	0	0	0	410	0	0	0	12	0	39	0	1	0	1	0	27	0	4	0	1	0	2	101	0	0	0	0	0	0	5	2	0	0	0	0	0	0	0	0	0	0	0	0	0	0	2	0	0	24	1	0	0	0	0	0	3	0	0	0	13	1	0	0	0	0	0	0	0	0	1	0	0	0	0	0	0	0	0	0	0	0	0	0	1	0	0	0	0	1	2	1	239	0	123	953	0	0	87	0	4	12	20	0	0	1	0	119	1	45	0	0	16	0	3	0	0	0	1	106	0	0	0	20	0	2	0	0	0	0	0	0	8	1	4	0	61	0	0	0	0	20	7	0	0	0	4	2	0	0	2	1	11	0	0	0	0	0	2	1	63	25	0	0	32	0	0	0	1	0	26	1	23	0	0	0	0	0	0	0	1	0	0	0	0	82	20	155	91	245	60	53	105	0	0	0	3	0	17	0	0	0	0	123	0	0	0	0	0	3	0	0	48	116	5	143	0	0	80	0	25	0	8	3	0	87	0	0	0	0	0	0	1	0	228	1	14	0	3	0	0	5	0	2	1096	7	0	0	0	0	0	0	8	21	164	1	404	0	0	2	89	0	5	0	0	0	0	0	0	10	0	0	3	0	5	1	0	0	25	0	27	0	1	0	0	0	3	0	0	0	0	0	0	2	1	1	0	0	0	0	0	1	0	0	1	46	3	0	12	0	0	1	0	2	0	2	0	3	12	2	0	0	23	0	0	0	35	3	0	1	1	0	0	0	0	0	163	3	2	0	0	5	0	27	0	0	0	0	0	0	9	0	1	17	0	0	0	0	0	0	0	44	1	2	445	0	0	0	1	258	3	73	25	0	39	320	0	24	1	256	91	35	0	2	0	1	2	4	28	0	0	0	0	1	1	0	0	0	0	3	1	0	0	183	24	5	41	0	4	110	1	0	0	0	0	17	0	0	0	0	0	0	0	16	30	0	0	0	18	0	131	2	1	0	0	1	0	235	0	1	57	7	0	0	0	4	0	0	0	0	0	0	0	0	0	0	15	0	0	0	0	0	3	0	0	0	0	0	0	296	0	18	9	6	3	5	0	21	1	2	84	1438	12	4	0	0	0	0	0	0	0	0	0	0	1	0	0	0	0	0	0	2	0	0	1	2	1	1	0	0	1	0	0	47	0	0	125	19	0	3	0	185	408	128	0	1	0	0	0	0	0	0	0	0	0	4	0	2	0	4	0	4	0	0	0	0	0	0	0	0	1	0	0	0	0	2	0	0	1	0	1	0	0	0	0	0	0	0	1	4	0	0	136	0	0	2	0	1	5	0	0	14	0	1	0	159	0	0	795	4	0	0	113	0	0	0	0	0	0	0	0	0	0	0	5	0	0	0	0	0	71	0	0	1	28	1	25	32	32	0	0	0	0	0	0	6	0	177	0	0	1	0	0	4	0	0	1	0	0	1	0	1	0	0	0	16	0	0	0	0	1	0	0	0	7	0	0	0	0	0	253	0	0	0	824	0	0	3	0	0	0	0	0	1	0	0	0	0	0	0	0	0	0	3	0	0	4	2	0	0	28	0	8	7	7	3	19	0	8	20	0	0	0	0	0	0	0	114	6	9	3	2	0	0	1	3	1	40	234	45	0	0	0	2	0	0	1	1	1	0	0	0	12	0	0	0	2	1	0	0	0	5	0	11	0	10	3	0	2	3	0	67	0	0	14	0	1	0	0	0	0	1	0	0	0	1	0	0	1	13	1	8	1	1	6	13	1	0	0	0	0	1	3	0	5	8	7	0	0	0	0	0	1	0	0	0	0	2	0	1	0	0	0	0	0	2	0	1	0	0	1	4	0	1	0	0	0	30	0	1	0	4	0	18	0	0	1	20	0	0	0	0	23	36	2	0	0	0	0	5	184	61	445	69	28	173	9	29	353	9	429	4	26	3	2	4	7	21	0	16	1	38	42	226	487	130	129	4	5	7	16	15	1285	0	3	0	0	0	0	2	0	0	0	0	298	0	0	0	0	0	0	0	0	0	0	0	0	0	0	0	0	0	1	0	0	21	1	52	1	794	26	3	0	2	2	0	2	0	0	5	14	0	6	0	0	0	0	0	1	0	107	0	0	0	0	0	78	14	19	1	0	5	7	0	0	0	1	0	0	17	1	0	0	0	0	1	1	0	0	2	0	0	0	0	21	2	0	1	0	62	30	1	11	1	0	0	1	0	0	0	1	0	0	9	0	0	1	0	5	8	434	0	0	30	27	0	0	0	0	0	0	1	0	1	0	0	0	0	0	107	0	0	0	0	0	0	0	182	64	114	0	1	59	35	42	7	24	0	4	74	99	4	1	0	0	0	1	0	0	8	0	0	2	0	0	0	0	0	0	0	0	4	0	1	0	0	0	2	0	0	0	1	5	0	0	1	18	0	0	0	1	13	6	5	0	0	4	0	117	0	2220	2	0	0	70	0	0	1	0	0	1	2	0	0	1	11	0	6	0	2	1	1	0	2	0	212	0	0	169	16	0	0	0	0	171	0	0	0	0	0	0	0	0	0	0	0	18	0	4	0	1	0	2	0	0	0	0	6	1	0	0	0	0	5	0	0	0	1	1	1	0	3	0	4	0	0	0	32	0	0	1	0	1	0	0	139	44	0	0	42	0	0	1	0	1	0	0	0	0	0	1	0	0	0	0	249	3	39	75	0	0	1	48	0	0	0	1	18	87	3	0	1	2	1	0	0	1	0	0	0	0	0	0	0	0	0	0	99	0	0	1	1	0	0	0	0	1	0	38	31	1	8	0	9	0	0	3	52	0	0	0	0	0	0	0	0	0	6	1	1	3	1	0	102	3	1	0	0	0	0	0	3	0	1	0	1	0	3	0	3	0	1	0	3	0	0	2	0	0	1	0	0	17	0	0	0	0	0	0	1	3	3	0	227	0	0	18	0	3	3	0	9	0	1	0	2	53	2	39	0	0	0	1	0	0	0	0	1	0	0	0	7	0	0	0	383	1	0	5	51	5	1	2	6	32	1	0	1	3	2	1	0	2	0	2	0	3	8	1	1	0	2	0	0	8	0	0	0	117	0	14	1	14	57	12	33	46	39	29	26	0	49	39	52	1	2	2	0	0	19	2	0	31	0	3	0	16	179	14	0	0	0	0	0	0	1	0	0	0	0	3	17	0	0	0	0	10	0	0	0	0	0	0	0	0	1	0	0	15	0	2	12	0	21	0	0	84	0	0	0	1	0	1	0	23	0	2	17	66	89	1	55	2	1	0	0	2	46	0	0	0	0	0	0	0	0	0	2	0	0	0	0	1	4	133	0	0	114	22	0	45	0	8	2	0	0	75	36	1	0	0	10	0	1	2	0	0	4	0	11	4	0	3	2	1	0	0	230	2	2	0	0	0	0	0	9690	12	2	4	0	0	0	0	0	1	0	154	0	1424	0	1	0	0	1682	1363	269	0	1	0	85	0	1	0	156	0	0	0	0	1	0	0	0	0	0	0	2	0	0	0	0	0	0	0	0	0	100	1864	0	3	0	0	0	0	1	0	0	0	0	0	0	0	4	1	0	2	1	0	2	1	0	37996	40	501	1	0	1	0	0	0	22	2	0	31	0	0	0	3	0	0	0	0	0	1848	0	3	4	0	3	0	0	0	0	0	0	0	0	0	0	0	0	36	0	0	0	0	0	2	0	1	0	0	0	0	3	0	1	0	0	0	0	0	0	0	0	1	1	0	0	1	25	0	0	0	0	0	0	0	0	8	0	1	1	25	0	0	0	0	0	0	126	0	3	0	1	0	1	246	1	0	2	0	1	0	4	184	3	0	0	1	0	58	0	0	178	0	0	1	5	0	0	0	0	0	0	0	3	0	2	0	0	0	0	0	0	0	0	0	0	2	0	3	0	0	0	0	0	0	5	0	0	0	2	0	0	1	2	0	0	9	0	0	0	0	2	22	0	1	3	3	43	13	0	14	0	0	0	0	0	2	1	22	11	0	0	0	0	19	0	48	0	0	0	0	0	0	0	22	1	0	0	1	13	0	0	0	0	7	0	0	0	7	2	0	0	0	0	0	1	4	0	0	0	0	1	1	199	0	0	0	0	0	0	0	0	7	11	96	0	0	0	0	0	0	198	262	0	0	0	0	0	1	0	0	0	0	0	1	0	1	0	0	6	1	0	0	0	0	0	0	0	0	0	0	208	18	44	2	0	3	1	0	1	7	3	3	0	0	0	0	78	8	0	0	2	0	49	2	105	0	0	244	0	0	0	6	162	1	0	0	157	6	6	0	0	0	1	0	2	0	0	11	4	0	1	0	0	0	0	0	2	0	2	0	0	4	0	202	1	0	0	0	0	0	0	216	0	0	0	71	0	1	0	0	0	0	0	0	40	0	0	0	1	0	0	3	0	9	0	0	3	0	0	0	0	0	0	0	1	0	0	0	6	4	1	0	10	0	0	318	0	0	0	0	0	0	0	0	0	0	0	0	0	0	1	0	0	0	0	0	5	0	1	0	0	0	0	0	0	0	1	0	0	0	0	0	0	0	0	15	49	0	0	0	90	1	2	690	85	0	0	0	1	0	0	0	0	2	0	0	0	0	0	5	4	0	6	0	0	0	0	1	0	12	0	0	0	0	38	1	10	0	17	0	0	5	1	0	0	0	0	7	0	0	0	0	0	0	1	0	0	79	3	0	0	4	1	1	0	0	0	0	0	0	0	0	0	0	0	0	0	1	0	0	0	0	3	0	0	1	16	0	0	0	0	99	0	0	0	0	0	1	0	0	1	0	10	1	0	0	7	0	0	0	19	7	0	0	0	2	0	304	1	0	0	1	0	1	1	0	0	119	0	0	0	0	0	0	0	0	0	2	0	0	1	1	0	0	0	0	0	0	6	1	109	1	0	0	0	0	0	0	1	0	1	16	0	0	2	0	0	54	0	0	0	37	0	0	0	1	0	0	3	0	4	12	0	0	0	0	0	0	1	0	0	0	0	0	2	0	0	0	0	3	0	2	0	0	0	0	0	0	0	53	0	0	0	0	0	0	0	0	0	0	83	0	0	18	25	19	5	0	0	29	0	0	9	0	1	504	0	0	0	4	20	1	3	0	0	11	0	8	51	20	0	3	11	835	0	13	9	0	1	93	1	2	2	0	0	0	0	0	2	0	0	0	1	0	0	0	1	1	0	28	0	0	0	0	0	0	0	0	0	0	0	0	1	0	0	0	4	0	0	0	1	1	0	226	1	91	11	0	0	0	0	0	0	0	0	0	2725	2	0	0	0	0	1	2	0	0	0	0	0	0	0	1	7	0	0	0	0	12	0	2	0	139	0	0	0	0	0	581	0	0	0	0	0	1	0	6	0	0	12	0	0	1	0	1	0	0	0	0	2	0	820	0	0	0	8	4	11	0	0	1059	0	4	0	0	0	1	0	0	0	0	2	0	10	3	1	2	0	0	1	0	0	0	0	0	0	0	0	0	0	143	0	0	0	0	0	1	0	0	0	0	0	0	0	6	1	0	0	2	0	0	0	2	0	0	1	0	87	0	0	0	0	0	0	13	2	3	0	0	0	0	0	0	0	0	0	0	1	0	0	0	0	0	1	0	0	0	10	0	1	0	0	0	0	0	0	0	0	0	0	54	33	0	2	0	0	0	0	0	1	0	1	0	37	4	0	0	0	2	0	0	9	0	1136	0	0	0	1	0	0	0	0	1	0	90	0	0	0	0	0	5	0	0	0	12	3	236	21	0	71	0	0	0	0	0	2	0	38	0	0	10	7	0	1	0	0	1	0	1	35	0	1	0	0	1	0	0	0	0	1	0	26	0	0	0	0	1	28	1	1	0	0	0	3	0	0	0	0	0	2	1	0	0	2	0	0	6	0	10	0	0	0	10	0	0	0	26	0	0	0	168	268	53	1707	2674	0	0	0	0	16	0	44	4	4	0	0	0	7	5	0	74	1	2	76	0	44	0	0	0	0	5	0	0	3	7	2	3	0	0	6	0	1	3	77	0	0	20	0	30	1	1	0	0	0	0	3	0	0	0	0	0	0	2	0	0	0	0	0	116	12	0	0	0	4	0	0	0	1	0	0	0	0	0	5	0	0	13	5	0	73	165	1	1	0	1	12	10	2	0	2	0	0	0	0	0	0	0	0	196	0	0	0	2	0	0	2	0	0	0	0	0	0	0	0	22	31	0	6	4	1	0	0	0	0	1	1	1	0	0	7	0	0	0	2	10	18	0	1	1	2	0	1	1	0	1	0	41	0	0	0	0	0	0	59	0	0	13	1	94	0	4	1	0	2	0	0	41	0	0	0	1	0	0	0	8	0	0	0	238	230	487	5	2	30	5	81	37	15	13	18	18	7	873	8	0	6	8	10	10	4	5	214	16	637	14	86	0	1582	0	0	0	0	2	0	65	1	0	0	0	0	1	1	0	0	2	0	0	2	1	0	6	28	0	4	1	1	0	2	1	0	2	64	0	0	0	0	0	1	280	0	36	0	0	0	0	0	117	23	0	0	0	0	3	0	4	4	9	0	11	0	0	0	0	1	0	39	567	0	44	175	70	0	0	0	4	0	0	0	0	0	0	1	0	0	0	1	3	0	0	0	0	2	0	0	0	0	130	1	0	0	0	6	3	0	0	0	11	13	0	1	22	5	0	0	0	0	0	13	1	1	4	1	2	8	0	0	0	1	2	0	0	0	2	0	0	0	0	544	1	0	1	1	0	0	0	2	0	6	0	0	0	1045	173	0	0	18	0	1	58	1	3	41	2	2	2	0	0	0	0	0	0	0	0	0	0	0	0	0	0	0	0	0	0	0	0	393	0	2	0	25	0	0	0	0	0	0	0	246	0	0	21	0	10	13	2	8	16	0	0	1	79	0	70	0	0	4	0	47	0	0	0	10	14	0	0	0	11	0	0	0	0	0	2	0	0	0	172	0	0	1	0	3	0	0	0	30	0	3	0	3	0	0	0	0	0	0	113	0	0	0	0	0	0	1	0	1	0	0	0	1	4	1	1	13	29	0	123	0	0	1	0	0	0	2	137	1	0	1	0	4	0	5	0	0	0	0	0	0	0	0	47	0	0	0	0	0	0	0	0	4	0	0	1	42	1	20	5	0	169	0	0	65	0	2	1	0	0	0	0	0	4	0	0	0	0	0	1	0	1	0	0	0	0	0	0	0	5	53	0	0	0	0	3	0	0	1	0	45	0	42	0	5	0	0	0	969	0	0	0	6	0	0	0	42	3	0	0	0	66	0	0	1	0	1	0	9	0	0	0	0	0	0	0	0	1	0	1	0	1	0	0	19	0	0	0	0	146	1	54	1	0	0	0	0	0	1	0	0	2	0	0	170	0	1	0	0	1	1	1	0	0	188	0	192	1	24	127	0	0	0	0	0	0	32	8	2	0	29	2	0	0	0	1	1	64	0	43	11	9	82	20	42	147	0	0	0	1	43	0	15	0	5	0	1	0	0	1	1	0	0	0	0	0	2	0	1	2	1	0	0	0	0	0	0	208	70	0	0	2	0	49	8	73	0	0	0	1	0	0	24	0	5	0	0	0	4	8	5	608	0	0	2	0	0	0	21	0	12	1	0	0	0	0	0	3	0	0	0	200	0	0	8	0	0	12	0	0	12	0	0	0	0	6	0	0	0	2	0	0	12	0	4	0	0	54	1	0	0	0	1	2	0	1	0	0	2	3	0	0	45	0	23	5	3	2	1	6	3	245	1	1	21	0	82	0	18	0	0	4	0	0	0	4	0	0	6	0	0	0	0	0	0	0	1	141	0	26	0	1	790	1	0	0	0	0	9	45	0	15	0	1	0	778	3	6	131	0	0	1	0	1	4	0	1	4	0	0	0	13	1	0	0	0	0	0	0	11	7	0	0	10	0	0	0	24	1	0	11	2	2	0	0	0	0	5	0	7	0	0	0	0	0	0	0	0	0	1	0	0	0	0	0	0	0	0	0	0	0	0	0	0	0	0	0	0	0	0	0	0	436	0	0	1	0	0	1	313	0	1	0	0	18	0	0	1	1	0	1	0	0	0	16	0	0	0	0	0	0	0	0	0	0	1	0	0	1	0	0	7	0	2	0	1	1	0	1	3	0	1	0	0	2	1	0	0	0	127	0	0	1	0	0	0	0	0	0	1	2	0	7	0	0	0	0	0	0	2	0	0	12	0	0	0	0	0	0	24	0	0	0	0	0	3	0	0	0	0	0	0	0	0	0	1	4	0	64	0	0	0	0	36	499	0	0	0	0	0	0	0	0	0	0	0	20	0	1	0	0	1	0	0	0	0	1	3	0	0	0	0	0	0	0	0	80	0	2	17	0	0	0	0	0	0	0	1	0	0	0	7	0	3	4	0	0	0	0	0	0	1	49	0	0	0	0	0	0	0	16	1	0	7	0	1	264	64	0	0	0	0	0	1	2	1	0	0	3	0	0	0	0	31	0	1	0	1	0	0	0	0	0	0	0	11	0	5	1	1	0	0	0	0	123	1	36	0	6	0	0	1	0	1	17	5	3	0	4	243	47	50	5	0	0	37	0	127	0	1	2	15	393	0	1	26	0	0	1	5	0	0	0	351	5	5	2	94	664	0	0	0	54	2	22	0	1	2	2	0	0	46	0	5	0	0	2	0	0	0	0	77	0	0	20	4	0	0	1	0	115	2	933	0	5	0	90	2	102	0	2	66	0	4	0	0	37	10	0	0	2	4	0	5	0	0	1	0	0	10	0	28	1	1	0	0	2	54	49	0	3	3	11	703	16	0	0	0	0	0	0	1	0	0	0	1	0	0	29	0	0	0	0	16	0	39	0	3	11	0	2	0	0	0	0	0	5	0	1	0	2	1	0	2	0	0	1	0	0	0	2	0	0	3	0	0	0	0	1	0	9	0	7	0	0	0	0	0	4	1	3	1	0	7	0	13	11	1	0	2	0	6	0	0	2	179	0	0	1	2	3	1	0	0	0	0	0	12	15	0	0	40	0	0	143	10	9	2	20	4	18	2	0	10	2	0	0	10	0	0	0	0	1	3	0	0	0	1	0	0	0	0	0	0	0	10	0	0	3	0	0	90	2	0	0	0	0	0	0	0	8	0	9	2	346	19	0	0	1	0	63	0	0	0	14	0	28	24	2	1	0	0	0	1	2	1	2	1	0	1932	0	0	13	74	17	222	0	25	3	0	141	3	73	0	0	62	0	0	0	1	29	0	0	21	1	0	62	4	139	1	47	0	1	0	2	40	0	0	0	0	0	0	1	0	0	1	0	1	0	21	0	2	0	0	1	1	0	5	0	0	0	151	3	11	0	0	91	7	2	0	11	9	0	330	2	7	83	44	1	7	41	3	39	0	66	0	0	0	0	3	10	0	0	0	0	2	4	3	0	0	0	0	0	12	1	2	1	0	12	19	214	0	1198	294	0	0	28	3	1	0	0	0	0	1	1	0	0	0	0	0	0	0	25	14	19	0	0	6	2	0	24	0	2	2	1	1	0	0	0	0	0	0	0	0	0	1	0	94	1	23	2	0	5	0	260	289	50	24	0	0	1	1	0	0	35	1	0	0	1	0	0	0	5	0	0	1	0	139	21	36	94	0	0	0	0	0	4	0	0	11	0	3	1	0	1	1	0	0	56	78	43	4	1	5	1	5	2	2	4	0	0	0	0	45	0	0	2	2	5	0	131	243	9	8	515	0	104	0	0	0	2	0	0	14	0	0	0	0	0	385	194	0	0	1	0	39	6	0	0	0	0	0	0	21	36	10	0	2	0	0	0	1867	1	71	84	160	30	98	73	0	1	689	23	0	95	4	1	0	17	17	0	4	0	0	0	0	0	0	0	0	65	0	0	0	1	0	0	5	5	739	1324	3	1	1	98	0	649	381	146	0	0	188	1	0	0	1	0	0	0	0	1	0	0	0	0	0	0	0	2	0	2	0	0	2	0	0	0	9	0	18	0	0	149	0	28	0	34	0	143	27	1	0	0	2	0	0	586	106	2	0	21	3	0	0	87	0	0	9	0	0	0	44	0	1	0	0	2	0	0	35	91	0	0	0	0	0	0	1	1	5	0	0	0	0	0	0	0	6	0	269	0	1	0	0	0	0	14357	9	11020	0	100	0	25	19	1	21	0	0	0	0	0	0	0	6	120	0	44	1	0	0	0	0	0	22	182	1	0	0	239	0	0	39	0	0	3	0	0	0	1	3860	0	0	1	0	0	0	0	0	0	17	0	2	2	0	0	0	0	2	0	0	0	0	0	0	1	9	4	0	85	0	0	1	0	0	7	1	0	191	1	0	0	0	0	0	0	0	246	1	0	38	4	0	4	0	0	0	0	0	1248	1	0	22	7	0	0	0	0	2	0	5	24	24	0	0	0	0	2	9	0	0	1	0	0	0	1	197	0	0	1	2	1	1	0	2	1	1	1	0	4	24360	0	97	5	0	33	0	0	1239	0	553	108	6138	3272	2331	211	225	145	302	0	0	350	1	0	3	0	1	9	3	9949	4	6	6	2	0	294	0	0	0	3	136	71	3	1	0	9	0	146	0	0	0	46	14	62	7	43	28	60	0	19	0	1	0	58	0	15	78	6	4	0	0	0	0	0	0	0	2	53	1	0	0	0	157	0	0	601	0	0	0	7	0	102	0	0	0	1	0	0	169	0	0	0	1	0	3	0	0	89	0	3	0	103	1	0	140	0	2	0	0	401	1849	0	142	0	11	165	0	10	4	0	3	0	349	0	0	2	0	0	13	0	41	116	1	0	38	1	220	0	0	0	24	4	3	0	46	0	30	1	1	12	252	1	0	2	0	1	1	38	33	0	1	3	0	0	0	0	0	0	0	0	0	0	0	0	372	3	2	13	3	1	26	115	41	0	0	1	0	0	2	0	1	53	0	0	3	3	116	0	44	120	1	0	76	0	3	4	1	0	0	0	0	0	17	0	56	155	141	78	0	0	0	0	0	0	0	0	0	1	2	3	0	0	0	0	0	0	102	64	3	0	6	0	1	1	0	0	0	18	3	0	1	0	0	2	0	2	3	4	0	0	0	0	0	0	1	0	0	33	0	0	1	0	0	0	75	11	0	0	2	17	13	0	0	0	0	0	0	0	34	0	0	23	0	0	0	0	0	0	0	0	10	8	0	1	0	0	0	0	1	0	0	0	11	140	0	1	0	0	0	1	72	1	60	0	0	0	0	0	0	0	45	0	29	11	3	0	0	0	0	392	0	0	0	0	0	1263	1469	110	362	0	217	504	1	584	0	522	0	0	0	1790	1955	1214	624	504	215	297	298	191	1	378	0	1	69	111	41	3	1	817	0	506	1505	0	263	0	1878	11	0	308	2	248	401	3	572	0	0	0	4	1076	0	0	226	381	521	274	0	0	0	895	1490	8777	0	19	167	0	0	0	0	0	15	0	47	0	5	0	46	2	228	5	0	5	3	0	0	0	1	14	6	5	5	1	3	5	2	159	424	0	20	313	167	0	12	1	1	1	160	152	0	1	168	0	7	0	152	0	0	42	2	0	0	0	126	0	1	1	170	0	1	0	0	0	0	0	138	0	0	0	0	0	32	0	2	6	0	0	8	0	2	7	54	0	2	0	0	0	0	0	0	2	1	2	0	0	0	0	1	4	0	1	0	10	2	2	22	119	71	129	0	0	0	2	2	0	0	0	0	0	0	0	1	0	0	0	0	0	0	0	0	1	2	2	0	0	79	1	0	0	1	2	0	0	0	0	0	0	3	0	10	0	1	88	0	0	0	0	0	0	601	1	55	128	0	167	1	242	0	0	0	0	1	1	0	0	0	1	1	0	1	36	1	16	0	1	0	4	1	0	1	0	0	0	16	0	2	5	0	0	1	0	208	129	0	1	0	41	2	1	36	1	149	6	47	1	0	0	0	0	81	1	144	0	0	0	0	35	0	0	25	40	0	23	3	0	0	107	0	0	4	198	113	16	0	3	1	0	9	89	6	7	0	0	5	1	0	0	0	1	4	1	0	0	3	1	50	46	4	27	2	0	0	0	0	0	3	3	1	0	141	10	0	0	3	0	0	0	0	0	129	14	1	0	1	0	1	0	2	0	0	0	0	0	0	0	0	0	0	0	2	0	0	0	0	1	0	51	1	36	0	1	25	2	1	0	1	0	1	0	20	0	1	0	84	1	16	0	0	0	0	1	0	18	0	4	152	157	34	0	0	2	0	2	0	0	2	0	0	0	0	6	3	3	0	0	0	0	1	0	0	0	0	0	123	17	0	5	0	0	0	10	2	16	0	23	22	0	0	1	0	1	6	3	1	3	3	1	0	1	0	0	5	0	62	1	0	0	80	1	0	0	0	53	0	34	0	0	2	0	0	30	0	0	0	0	0	0	0	1	11	65	0	1	61	0	20	0	2	0	0	341	0	0	0	0	0	1079	0	0	0	0	1	0	0	1	3	5	1	0	2	2	3	0	0	1	0	0	0	3	48	23	0	0	1	0	96	0	2	0	0	1	56	58	0	2	2	0	5407	3	159519	0	0	1	0	0	13	0	1	0	0	0	0	0	0	2	0	29	0	1	0	0	0	0	143	0	2	0	22	1	0	1	2	0	0	0	2	0	32	127	2	7	2	0	1	0	0	1	1	0	23	0	0	6	0	6	37	28	137	94	0	1	50	0	22	0	0	0	0	1	106	21	77	128	0	0	0	3	4	20	0	0	623	1	0	957	0	0	0	0	1	0	86	20	4	104	0	2	297	82	1	0	59	204	3	0	122	0	1	0	2	2	0	1	0	3	0	5	0	132	459	2	205	365	0	7	210	2	326	80	19	400	313	676	139	91	90	226	501	0	41	326	9	321	259	0	0	4	133	261	142	444	378	4	42	1	0	382	84	1	36	0	0	0	0	0	0	4	0	1	0	0	0	0	10	0	10	1	11	0	0	0	60	0	13	2	0	23	67	31	15	0	0	0	0	0	8	1	0	0	6	0	0	0	0	0	78	55	0	13	1	0	0	22	143	0	1	0	3	1	0	0	1	13	0	0	0	0	0	0	1	30	0	4	3	30	44	1	1	12	7	0	42	0	0	114	0	74	1	0	9	105	6	0	4	20	0	201	8	1	30	7	1	2	2	1	0	0	0	0	2	0	1	5	0	1	0	0	0	0	0	0	1	0	8	0	6	0	0	1	1	3	0	1	1	0	0	2	0	0	0	0	0	0	0	0	0	0	0	0	0	0	3	32	0	0	6	0	0	0	2	0	0	0	4	3	21	41	56	74	143	15	1	12	14	98	96	41	161	0	1	0	0	154	0	0	1	0	58	1	18	7	0	0	0	0	0	0	0	0	97	3	101	2	22	3	4	0	0	0	0	2307	57490	0	0	0	0	0	2	1	104	0	105	0	4	9	0	36	33	1	51	0	0	0	83	39	0	76	0	2354	0	0	6	1	1489	0	0	0	0	0	0	0	0	304	0	3	354	93	165	0	2	0	159	0	0	5	1	8	0	3	3	0	0	2	0	0	2	39	0	0	1	0	0	0	6	0	7	11	5	1	3	3	0	1	0	0	0	1	146	540	114	56	127	49	103	545	0	0	10	45	50	33	1	0	0	0	10	0	0	0	5	0	1	2	63	3	1	3	2	1	0	1	0	7	0	27	0	0	0	0	15	2	0	2	16	0	0	1	0	0	0	1	1	159	2	176	0	4	0	0	2	4	0	27	0	0	0	1	1	12	0	8	0	1	0	2	127	0	0	0	0	1	0	18	1	1	6	5	12	14	1	0	0	1	0	0	0	0	0	0	0	1	0	1	0	0	0	0	0	0	3	0	23	38	491	528	36	70	0	0	0	0	0	0	0	0	0	1	0	1	0	0	0	0	1	438	1	0	0	0	0	78	0	0	0	0	0	0	0	35	0	4	124	0	1	2	20	0	83	1	0	129	2	2	2	12	46	5	23	37	59	0	139	7	0	137	65	4	3	41	0	0	55	1	1	1	5	71	28	8	0	0	0	0	0	672	0	10	0	0	532	0	45	0	0	6	2	5	1	4	1	0	0	2	0	0	0	0	0	0	0	2	2	0	0	1	3	320	0	0	0	0	4	0	0	0	0	121	2	1	0	0	0	1	112	1	1	0	0	0	4	0	2	0	92	1	0	87	0	24	0	0	0	0	0	60	1	49	1	2	0	0	0	0	3844	0	1	1	0	10	6	0	0	107	399	35	0	4379	0	22	180	25	0	65	0	407	135	121	10	38	1	0	9	1	8	0	0	0	31	0	0	0	0	79	0	1	57	0	1	0	3	0	1201	0	2	0	0	0	73	76	3	0	1	0	1	0	0	19	1	0	0	11	9	3	2	0	0	99	5	15	0	0	0	0	0	0	0	0	1	0	0	0	0	3	0	0	0	0	0	0	0	1	23	38	14	56	6	0	37	75	48	65	54	95	0	0	0	17	0	0	0	0	0	817	0	0	0	274	128	77	17	0	683	0	0	58	10	0	7	1	4	0	0	1	0	0	0	0	6	417	90	1	0	0	0	2	1	1	0	0	0	89	2	5	4	0	0	0	0	0	0	1	0	1	0	0	0	1	2	0	0	0	0	0	0	4	0	0	0	0	0	2	1	1	0	0	0	0	2	0	0	0	0	0	2	7	0	2	0	30	0	7	0	0	4	1	4	1	0	0	5	0	0	3	0	1	20	8	40	98	14	0	1	0	1	0	3	22	25	1	0	0	0	38	0	29	0	1	20	0	1	30	0	2	59	0	3	20	133	6	133	1	0	1	0	3	0	0	0	0	93	2	33	1	29	0	141	3	0	309	1	5	47	5	0	0	0	22	296	276	470	0	329	75	58	0	33	0	18	0	1	45	0	0	2	1	3	0	0	0	0	14	0	297	38	0	0	0	98	6	31	38	0	35	1	0	15	1	56	0	22	132	3	16	186	0	146	0	1	0	1	0	6	0	0	2	293	0	46	4	0	0	49	2	0	1	0	0	0	1	0	0	0	2	2	0	0	69	20	17	126	29	171	1109	9	1	5	0	0	0	0	0	43	5	7	0	0	4	91	0	1	1	8	6	10	0	1	2	0	0	7	40	44	1	18	101	0	0	0	0	1	1	52	0	21	0	6	620	0	1	0	25	1	1	0	0	0	0	0	0	0	0	0	0	14	5	0	0	0	0	0	0	1	2	0	0	0	0	1	0	0	1	4	1	1	0	0	1	0	0	1	1	208	6	171	33	0	50	111	26	94	26	16	45	0	1	0	0	0	0	0	0	0	0	0	0	1	0	0	28	0	0	0	0	33	0	0	0	0	3	0	30	0	0	0	0	41	13	0	0	0	0	0	0	0	0	20	2	0	1	0	0	0	0	0	0	2	0	2	3	0	8	1	2	21	2	1	125	0	0	0	0	0	1	0	3	35	0	186	0	0	1	22	0	34	145	0	0	1	0	0	4	0	0	0	2	0	0	0	1	0	0	0	32	0	8	0	0	0	0	0	4	1	147	1	1	1	0	0	2	1	0	421	0	0	0	1	0	1	0	0	0	0	0	0	0	177	31	0	1	0	2	0	0	0	0	0	0	0	0	1	0	0	0	3	1	0	112	0	0	0	0	0	0	37	0	0	184	0	1	0	0	0	1	0	0	0	0	0	1	2	1	1	7	0	0	3	0	1	1	0	1	0	0	0	1	0	0	0	0	0	0	0	1	0	0	0	1	0	0	0	0	0	0	0	0	0	0	0	0	0	28	0	0	3	0	0	0	0	11	0	0	0	0	0	1	0	24	0	0	1	0	0	0	1	0	0	0	0	0	0	0	0	0	0	0	0	0	0	37	0	0	0	0	0	0	0	0	0	0	0	0	0	0	1	0	0	0	0	0	1	0	0	0	2	0	2	0	0	0	0	0	0	0	1	0	0	0	0	0	1	0	1	0	0	0	0	0	0	0	0	0	1	0	0	0	0	0	6	0	2	0	0	0	0	1	0	10	1	0	0	0	0	1	0	0	0	1	0	0	0	0	2	0	0	13	1	0	0	0	0	0	0	0	0	0	0	26	0	1	0	0	2	1	0	1	0	0	0	0	0	0	0	0	0	0	0	4	0	0	0	1	4	0	0	0	0	0	0	0	0	1	82	0	0	0	0	0	1	3	0	0	0	2	0	0	0	0	0	0	0	0	1	0	1	0	0	1	0	0	1	0	0	1	1	0	0	46	6	0	0	5	1	2	0	4	176	0	1	0	0	0	80	0	0	0	6	0	0	0	0	0	0	30	0	429	0	0	0	62	0	0	0	959	29	0	0	0	1	0	0	226	1	826	0	429	47	0	1	0	55	0	1	0	0	0	0	0	0	0	0	2	14	0	33	0	15	5	0	0	0	1	0	0	0	0	3	1	1	0	0	0	0	0	0	1	1	0	0	0	0	0	0	1	1	56	0	0	0	0	2	0	4	22	0	0	0	0	0	0	2	0	0	1	0	0	0	68	1	2	4	129	0	0	0	0	0	0	0	0	2	1	0	0	0	0	0	0	0	0	810	0	0	0	0	0	0	0	1	0	0	2105	0	6	1	0	0	0	2	0	0	0	0	0	0	0	0	0	0	1	0	0	0	0	125	66	0	286	233	0	2	0	0	2	2	55	0	44286	0	0	0	1	0	0	0	0	70	27	5	0	0	0	0	8	2	1	0	0	46	0	0	8	0	15	17	100	0	1	0	1	0	0	3	1	6	0	0	2	0	0	0	0	1	0	0	2	0	65	0	1	3	1	0	0	0	0	0	13	2	56	57	76	67	0	66	94	1	0	66	1	1	52	1	0	5	0	0	0	0	0	0	2	24	14	0	0	0	0	185	0	1	0	0	175	0	0	3	0	1	6	1	0	17	2	1	57	0	116	0	0	0	0	0	0	1	4	11	0	12	0	25	3	10	0	0	11	0	26	0	0	0	0	69	0	57	0	1	2	76	90	2	1	1	0	1	0	0	8	0	8	35	0	0	0	0	0	0	2	0	0	0	1	1	0	19	3	0	25	175	0	0	32	0	2	87	49	34	0	0	0	2	50	0	39	151	0	0	1	0	15	4	13	75	2	26	8	0	0	6	0	0	0	1	2	10	1	266	3	114	2	0	0	0	2	0	38	22	0	0	0	0	1	2	2	0	0	17	13	0	1	0	0	0	2	13	0	25	48	78	98	1	0	31	118	18	0	0	0	2	0	1	3	1	1	0	205	0	30	3	2	10	8	10	161	31	14	0	0	0	0	0	0	0	0	1	1	0	2	0	0	0	85	35	56	429	0	53	0	1	0	2	0	37	0	21	0	33	1	0	0	28	0	5	41	1	13	0	0	1	0	54	1025	0	0	0	2	0	7	0	0	4	0	0	0	1	31	126	2	0	14	1	97	0	4	3	0	0	0	1	0	40	0	0	0	126	0	1	1103	0	38	2	0	35	0	0	0	0	3	0	85	0	0	0	1	0	0	5	0	0	2	62	8	0	1	134	2	31	0	0	0	0	0	8	1	0	0	0	41	74	0	186	0	211	20	2	248	89	72	242	284	2	76	306	352	0	223	398	234	281	7	61	22	0	0	3	15	0	0	0	1	4	0	0	0	12	1	0	0	10	0	0	1	1	0	0	1	1	123	0	6	5	4	1	0	0	0	0	0	0	0	0	0	0	0	0	0	0	1	0	0	0	0	0	0	0	0	0	0	0	19	68	0	0	0	0	0	0	0	0	0	0	0	0	0	0	0	0	0	0	0	0	0	0	17	0	112	45	1	476	11	0	1	14	1	0	0	184	77	86	0	5	1	392	0	0	0	3	6	6	0	0	0	0	0	0	0	42	2	11	5	125	135	0	2	1	17	2	53	1	42	0	0	0	0	2	1	0	0	11	4	0	2	0	0	0	38	1	161	11	14	0	31	30	26	0	47	1	2	0	0	30	0	0	0	85	84	0	2	0	0	0	0	0	19	8	18	0	0	31	231	7	53	7	12	0	0	0	0	0	6	3	4	8834	25	0	0	0	0	252	0	0	0	0	40	1	2	1	1	1	0	0	0	18	0	0	23	106	7	13	14	0	9	1	76	0	3	0	0	0	0	17	18	0	48	0	0	2	0	0	84	8	0	0	177	38	16	49	1	33	0	32	16	0	17	3	12	2	0	2	0	0	48	1	1	1	3	40	0	32	0	0	2	0	0	0	0	0	5	0	1	0	1	1	0	6	3	0	7	0	0	2	0	0	0	0	0	0	0	3	0	6	0	0	0	1	0	0	0	52	2	0	14	87	0	3	0	3	10	350	149	129	168	0	15	1087	483	0	3	280	0	57	0	21	0	9	0	0	48	0	50	52	0	2	1	2	2	4	14	244	6	0	0	52	24	1302	0	0	0	0	0	0	0	0	0	0	0	0	100	0	0	0	0	0	7	0	407	0	99	42	52	0	52	0	9	0	0	0	0	0	3	0	0	0	13	0	168	0	2	4	107	0	59	9	1194	3	11	0	0	1	14	0	14	33	9	14	0	16	0	10	22	4	0	0	0	1	1	3	6	1193	90	13	0	3	0	1	0	0	55	0	0	1	0	0	2	0	159	3	0	0	0	171	15	0	0	0	12	355	76	154	1	4	1	0	0	9	0	34	0	7	1	0	0	1	3	0	4	0	3	0	0	1	0	1	0	0	0	0	0	0	0	484	0	0	1	0	506	2	81	0	0	0	9	5	21	0	1	1	80	39	1	2	4	0	42	0	0	0	11	1	0	0	0	0	0	1	5	2	173	49	12	22	119	2	0	64	25	12	3	1	0	0	0	3	0	0	0	20	0	2	2	205	0	0	0	0	0	0	0	43	0	1	2	19	0	20	1	4	32	1	44	0	0	8	0	9	0	0	16	4	32	26	97	292	29	204	0	463	2	0	0	0	0	4	0	0	0	1	11	6	0	1	0	0	0	1	31	1	0	0	38	0	2	1	8	15	7	4	2	0	381	1	916	0	0	915	0	0	1	0	0	0	0	0	8	147	0	0	0	4	0	1	11	5	3	0	85	0	104	0	0	0	11	0	1	0	0	2	117	0	7	0	0	0	142	9	10754	153	257	243	44	227	111	118	70	231	142	50	0	42	80	0	0	0	2	0	3	0	2	0	2	4	3	1	0	0	0	3	0	0	0	0	0	0	0	0	0	0	0	1	0	0	0	0	0	0	0	1	0	0	0	0	0	0	2	0	0	0	0	54	1	0	183	0	1860	216	1	153	0	0	0	10	0	0	3	1	1	188	0	0	202	24	1	0	0	97	0	19	0	66	59	87	0	0	0	0	2	0	0	2	0	0	0	0	0	0	8	9	82	0	114	1	15	14	8	1	0	0	0	0	1	46	0	7	0	16	18	228	0	35	0	2	0	39	0	0	0	48	5	0	0	0	0	0	0	0	0	26	1	0	0	2	17	0	1	0	2	20	1	4	0	0	0	0	0	1	0	2	3	0	3	13	62	0	0	1	1	1	0	0	0	0	0	0	4	4	2
LakWasM106_HOW12_2_rpkm	0	0	0	0	2	4	0	1	0	0	0	35	0	2	1	0	0	0	0	0	1	0	0	38	0	0	0	0	0	11	0	0	0	22	1	17	0	1	1	0	0	0	0	4	25	65	57	26	0	29	1	19	0	0	0	1	0	2	85	18	18	0	1	2	0	0	0	0	0	39	4	2	2	0	4	1	0	0	0	0	1	8	3	0	0	0	0	0	0	0	1	3	14	0	38	0	0	0	2	0	0	1	1	1	0	0	0	0	0	0	0	1	106	3	42	1	2	0	0	0	0	0	3	5	0	0	0	0	0	0	28	169	0	3	0	0	0	2	4	0	0	0	0	6	0	1	0	0	43	0	3	36	0	0	182	0	6	12	60	0	16	2	1	1	5	0	0	5	1	13	0	0	0	0	0	0	0	0	0	0	2	1	0	0	0	5	0	0	0	3	3	1	23	35	4	1	2	30	26	81	4	0	1	0	0	0	5	0	0	1	35	7	23	39	15	0	14	12	0	0	0	0	1	6	0	0	0	0	40	0	0	1	15	2	3	0	42	0	21	1	0	0	38	0	53	27	0	0	0	2	0	28	16	5	1815	39	0	1	0	0	4	0	3	38	0	0	5	0	9	110	3	0	11	0	0	1	1	1	5	1	3	37	0	42	43	1	0	0	15	9	0	0	0	1	0	3	0	0	4	0	0	25	39	2	0	1	5	102	6	2	5	0	147	60	0	0	0	0	939	0	1	0	0	3	4	21	4	0	5	0	0	1	1	0	0	0	4	0	0	0	0	0	14	4	21	0	11	2	0	2	1	2	2	0	0	0	1	0	0	15	2	0	1	0	2	49	2	33	0	10	0	71	0	0	24	0	0	52	0	19	0	1	15	3	4	0	8	0	1	0	0	0	363	0	0	22	0	0	0	72	0	16	0	12	31	5	0	0	0	4	1	12	5	480	0	25	12	12	3	0	0	0	0	0	0	0	0	0	0	1	2	1	0	0	0	1	0	0	9	0	39	9	0	1	0	128	1	0	0	0	1	110	1	3791	0	15	105	0	0	0	0	0	0	17	1	60	23	0	0	0	48	11	17	0	0	0	27	0	1	0	4	0	3	0	0	0	0	13	13	0	2	4	59	70	12	0	1	0	0	7	0	5	14	0	1	2	0	3	0	1	0	0	0	0	1	0	1	0	0	9	1	0	0	0	1	0	0	0	1	0	0	0	152	51	4	0	13	2	0	19	0	2	1	29	14	2	0	0	0	0	0	0	1	0	0	1	1	2	0	0	0	22	0	1	29	0	25	1	61	0	0	0	0	27	2	10	2	250	0	6	13	81	1	0	71	0	0	0	25	2	0	0	10322	1	9	23	0	0	0	1	46	2	0	8	9	14	0	41	0	0	0	954	33	122	0	0	156	0	211	4	17	12	101	22	0	13	0	10	1	2	2	3	0	0	1	0	0	0	0	2	2	153	0	0	0	12	0	20	4	2	3	0	19	7	0	0	0	0	3	2	0	18	0	2	1	0	2	0	3	0	4	12	0	22	0	2	1	1	1	0	0	0	10	1	0	0	1	0	0	26	0	0	15	2	0	0	0	5	0	1	0	0	0	5	3	6	1	0	470	0	0	9	0	0	0	10	1	0	14	3	2	0	1	3	1	1	5	20	18	0	0	0	0	0	0	0	0	0	0	1	0	41	16	0	0	79	0	0	0	5	0	0	0	0	0	0	2	0	5	0	0	0	0	75	0	0	5	0	0	1	0	0	1	0	0	82	0	0	0	0	0	0	3	0	0	1	0	0	0	0	1	2	0	0	0	0	8	0	0	6	0	0	0	0	6	21	93	0	0	0	0	0	1	0	14	0	0	0	0	0	0	0	0	0	56	1	0	0	1	6	23	0	0	0	0	0	0	60	54	0	0	0	0	1	0	0	1	0	61	83	0	0	2	0	0	0	0	0	0	3	27	2	2	1	0	7	0	0	4	0	0	0	0	0	0	0	0	0	21	1	0	2	0	0	0	5	65	2	0	0	0	0	0	0	0	0	0	12	0	0	0	0	5	2	0	0	1	0	0	0	0	0	0	1	4	4	6	81	2	0	0	1	0	1	0	0	0	0	0	0	0	0	1	0	0	0	0	0	0	0	0	0	0	21	12	0	0	7	0	0	0	0	0	0	1	0	2	0	7	0	0	0	3	0	0	1	0	0	0	2	1	3	27	173	1	29	0	41	0	0	19	26	5	0	8	0	0	15	0	0	0	1	0	0	0	0	0	0	0	0	0	0	0	3	0	0	0	0	0	0	0	2	0	0	1	0	0	192	0	0	0	35	0	0	1	1	0	0	62	1	6	0	0	0	0	0	0	0	0	5	0	0	0	0	0	0	0	1	0	0	1	0	1	5	0	3	0	0	0	3	0	1	0	27701	0	0	0	0	0	0	11	0	3	1	0	3	5	1	6	20	0	0	1	0	0	0	0	0	1	38	1	0	0	0	0	0	2	0	0	0	0	0	0	0	5	0	4	0	3	5	0	1	0	0	2	0	0	26	0	0	4	1	3	0	0	0	1	2	23	0	0	1	1	0	0	1	2	0	0	0	0	0	0	0	1	0	0	0	0	0	0	0	0	1	0	0	0	0	0	9	0	0	0	0	0	0	0	0	0	0	49	2	0	0	0	0	3	9	6	0	0	0	7	0	0	0	3	5	0	0	0	22	3	13	184	110	0	0	0	77	5	0	0	4	0	6	10	0	0	0	0	0	0	1	0	0	4	4	0	0	0	0	15	0	0	0	1	0	5	1	0	0	0	1	1	0	0	0	2	0	10	2	152	2	1	0	2	387	26	0	18	0	0	77	110	0	0	0	3	0	2	0	0	45	0	1	0	0	1	0	1	5	4	34	0	6	21	256	4	66	0	0	0	7	0	6	0	0	19	0	0	1	0	2	0	42	0	0	9	0	1	0	1	0	0	1	4	6	0	12	0	4	0	2	0	0	1	0	1	3	0	0	9	1	0	0	9	0	1	0	1	0	0	2	5	0	59	1	70	1	0	4	32	0	1	0	1	0	1	14	0	1	1	0	0	0	33	8	0	0	0	0	1	2	29	0	16	0	1	7	0	4	2	39	0	3	13	0	7	0	0	0	0	0	20	0	21	99	23	33	41	11	17	2	0	15	3	17	0	2	1	11	0	23	4	0	20	0	3	0	0	2	4	21	4	0	34	0	0	0	0	0	0	2	1	0	0	0	0	2	4	41	0	3	2	0	15	14	0	0	4	3	0	9	0	1	4	2	0	0	0	0	7	350	16	139	41	3	0	3	0	0	0	0	0	49	8	14	0	12	0	0	1	7	211	524	8	208	0	0	2	150	5	0	0	0	0	0	0	0	291	2	111	7	165	4	0	46	12	16	0	0	0	0	0	0	10	58	0	0	0	2	0	51	0	2	0	2	0	7	0	7	0	0	1	3	8	0	0	0	0	0	0	0	1	7	0	0	0	0	0	0	0	1	0	0	0	0	7	2	0	0	9	3	0	0	0	0	0	12	0	1	0	28	0	0	0	0	0	0	0	0	0	0	0	0	0	0	0	0	0	0	0	0	0	0	0	7	0	0	7	0	0	3	0	79	0	28	153	0	34	5	0	36	7	7	0	0	2	0	50	2	61	0	0	0	0	0	0	0	0	0	79	0	1	0	17	0	8	0	0	0	0	0	0	0	0	10	1	119	1	0	0	0	39	1	0	0	0	2	3	0	0	0	2	3	1	1	7	0	0	0	1	29	24	0	2	48	0	0	1	0	0	14	0	7	0	0	2	0	0	0	0	0	0	0	0	0	60	18	22	130	212	77	213	169	0	0	0	1	4	12	0	0	0	0	104	0	0	0	0	3	0	0	0	14	34	0	80	5	2	19	0	4	0	2	7	0	16	3	0	0	1	0	0	1	1	84	1	5	0	5	0	0	22	0	1	98	3	0	2	0	2	1	0	3	22	61	2	137	0	0	3	3	0	9	0	0	0	1	0	0	19	3	0	0	0	1	0	3	0	13	10	32	0	0	0	0	0	0	0	0	0	0	0	0	5	316	95	0	1	0	3	0	1	8	0	3	2	8	0	38	1	0	5	0	0	0	0	0	0	30	1	5	0	52	0	1	0	5	1	0	0	0	0	0	0	2	0	42	1	1	0	0	0	2	23	0	0	0	0	0	0	3	0	0	26	0	1	0	0	6	0	0	33	0	0	83	1	0	0	1	171	86	28	18	1	32	177	0	21	0	125	37	25	1	3	0	2	13	1	13	0	0	0	0	0	3	0	0	0	0	0	3	0	0	9	4	0	18	0	2	52	0	0	0	0	0	2	1	1	0	0	0	0	0	6	0	0	0	2	6	3	41	0	1	2	0	3	0	30	0	1	48	7	0	0	0	8	0	0	0	2	0	0	0	1	0	0	21	0	0	0	4	0	0	0	0	0	0	0	0	102	0	5	18	2	3	11	0	10	3	3	42	156	4	0	0	0	3	1	0	2	0	1	0	0	0	1	0	0	1	0	1	2	0	0	0	0	2	1	0	1	0	0	0	31	2	0	22	10	0	18	0	31	30	26	0	0	0	0	0	0	0	0	0	0	1	0	0	20	0	9	0	0	0	0	0	0	0	0	0	0	2	0	0	0	0	2	2	0	2	0	9	0	0	1	0	1	0	0	3	2	0	0	26	0	0	4	0	3	4	0	0	0	0	1	0	322	0	0	203	4	0	1	232	0	0	0	0	0	0	0	0	2	0	0	2	0	3	2	0	0	40	0	0	6	13	0	23	22	27	0	0	0	0	0	0	3	0	187	4	0	0	0	0	0	0	0	1	0	0	0	0	0	0	0	0	9	0	0	2	0	0	0	0	0	3	0	0	8	0	2	109	0	0	0	39	0	0	0	0	0	0	0	0	0	0	0	0	3	2	0	0	0	0	4	2	0	52	0	0	0	38	0	22	21	38	2	5	0	22	30	0	0	0	0	0	0	0	188	3	3	22	0	0	0	0	0	10	18	10	31	0	0	0	4	11	0	0	5	0	0	0	0	0	0	0	0	17	0	1	1	0	0	2	3	0	2	3	0	1	4	0	54	0	0	10	2	0	3	0	2	1	0	0	0	0	23	0	0	0	13	2	1	2	0	2	21	2	0	0	0	0	0	3	0	6	4	6	0	0	0	0	0	0	0	0	1	0	0	2	1	0	0	0	0	0	1	0	3	0	0	0	0	1	0	0	0	0	8	3	3	0	2	0	22	7	0	4	2	0	0	0	0	10	17	0	0	0	0	4	53	209	37	71	46	27	11	112	0	238	14	155	12	34	0	16	3	19	38	0	25	0	55	27	35	231	118	32	17	2	14	17	21	30	0	1	0	0	0	0	2	0	1	0	5	54	3	0	1	0	0	0	0	0	0	1	0	0	0	0	0	6	1	1	0	0	12	1	64	0	38	19	0	0	0	0	2	0	0	0	3	7	0	27	1	0	1	0	1	0	0	48	2	0	0	0	0	29	5	32	1	1	6	10	0	0	0	1	0	0	8	1	1	0	0	0	14	0	0	9	3	0	0	0	0	0	0	0	0	1	16	6	0	4	2	0	0	0	0	0	0	0	0	0	7	1	0	0	1	1	1	208	4	0	24	23	0	0	0	0	0	0	0	0	1	1	0	0	0	3	28	1	0	0	0	2	0	0	78	26	48	0	0	42	24	16	6	62	0	111	21	13	0	0	0	0	0	0	0	0	8	0	2	3	1	0	0	0	0	0	0	1	0	0	1	0	0	0	1	0	0	0	0	6	0	0	1	0	0	0	0	0	3	4	1	0	0	4	0	8	0	280	14	0	0	4	6	0	0	0	0	0	0	0	0	0	8	0	1	0	2	5	0	1	0	0	13	0	0	33	16	0	1	1	0	96	2	0	23	0	0	0	0	0	2	2	0	8	0	0	0	2	0	0	2	0	0	0	0	0	0	0	0	0	0	0	0	0	3	0	0	0	7	0	0	0	0	0	25	0	0	0	0	4	0	4	252	34	2	0	9	0	0	0	0	0	0	0	0	0	0	0	0	0	0	0	79	5	19	28	2	1	0	24	0	0	0	0	51	35	2	1	0	0	5	1	0	32	0	0	0	0	0	0	1	0	0	0	59	1	0	1	0	0	1	0	6	1	0	14	35	0	15	1	0	0	0	6	51	5	0	0	0	0	0	0	0	0	19	0	20	0	1	0	47	0	0	0	0	0	3	0	0	0	3	2	1	0	5	0	1	0	1	3	0	0	0	1	0	0	1	0	0	10	0	0	0	0	0	0	0	1	5	0	71	0	0	27	0	7	1	1	5	0	6	0	0	27	0	19	0	0	0	0	0	0	0	4	0	3	0	0	0	2	0	0	155	0	0	0	41	3	0	0	3	0	0	4	1	2	0	4	8	2	0	0	0	4	4	0	1	3	0	8	0	2	0	0	0	86	0	13	1	36	81	26	58	47	46	134	35	0	54	38	41	0	2	11	0	0	10	18	1	25	0	21	1	10	56	10	0	0	0	1	1	0	1	0	0	0	0	5	11	0	0	0	0	8	0	0	0	0	0	0	0	0	3	0	0	30	1	3	21	0	4	0	1	8	0	0	0	2	0	1	0	44	0	0	50	64	54	0	32	0	1	0	0	0	73	0	0	0	0	2	0	0	4	0	0	7	0	0	1	0	6	62	0	0	64	5	1	131	0	10	0	0	0	73	37	0	1	23	13	18	0	0	2	1	4	1	8	4	0	3	9	3	0	1	48	0	1	0	0	1	0	0	1878	85	11	7	0	0	0	2	0	3	0	84	0	83	0	15	1	0	5482	251	94	2	0	0	129	0	1	0	267	1	6	0	0	0	0	0	0	1	0	0	0	0	0	0	0	0	0	0	0	0	84	424	1	2	0	0	1	0	0	3	3	0	0	1	0	0	20	8	0	1	0	0	6	3	0	16710	106	86	0	0	0	2	0	0	15	0	0	70	1	0	0	1	0	1	0	0	1	1045	1	2	0	0	3	0	0	1	0	0	0	0	0	0	1	3	1	15	0	0	0	0	0	0	0	0	0	0	0	0	3	0	0	0	0	0	0	6	0	0	0	0	0	0	3	2	22	0	0	0	0	0	4	0	0	2	0	0	0	8	0	0	0	4	0	0	72	0	0	0	0	0	0	219	13	1	6	0	4	1	1	290	9	0	0	0	0	30	4	0	66	0	0	1	3	0	0	0	0	0	0	0	1	1	0	0	0	0	0	0	0	0	0	0	0	2	3	0	0	0	0	0	0	0	0	0	2	1	0	1	0	0	0	0	0	0	0	0	0	1	1	33	0	0	19	2	27	4	1	19	0	0	0	0	0	0	0	7	10	1	0	2	0	19	0	12	0	0	0	0	0	0	1	25	0	0	0	0	16	0	0	4	0	15	0	0	5	2	0	0	0	0	0	0	0	1	0	1	0	0	0	0	37	2	0	0	0	0	0	1	0	2	5	19	3	0	0	0	0	0	35	131	0	14	0	1	0	0	2	0	0	0	0	0	0	2	0	0	16	3	3	7	0	0	0	0	1	0	0	0	70	1	17	8	0	3	3	0	0	2	0	4	0	0	0	0	54	1	0	0	1	0	7	2	8	0	0	79	0	0	0	3	98	0	0	0	17	2	2	0	0	0	0	0	39	0	0	1	0	0	2	0	0	0	1	0	1	1	0	0	0	2	0	126	0	0	0	0	0	0	0	417	0	0	0	7	0	0	0	0	0	0	0	1	4	0	1	5	0	0	0	0	1	10	0	0	0	0	0	0	0	0	0	0	2	0	0	0	10	10	4	1	4	0	0	21	0	2	0	0	1	0	0	0	0	0	0	0	0	1	0	0	0	0	0	0	1	0	0	0	0	0	1	0	0	0	0	0	0	0	0	0	0	0	0	7	17	0	1	0	51	5	0	11	6	0	2	0	0	0	0	0	0	0	0	0	0	0	0	0	0	0	3	0	0	0	0	0	0	37	0	20	1	0	20	1	0	0	5	0	0	6	0	0	3	1	0	13	0	0	0	0	2	0	0	0	0	28	12	0	2	0	1	0	0	0	0	0	0	0	0	0	0	0	0	0	0	0	0	0	0	0	0	0	0	4	6	0	0	0	0	19	0	0	0	0	0	0	0	0	9	0	30	0	0	0	0	0	0	8	15	5	0	5	0	0	0	7	0	0	0	0	0	0	0	0	0	24	0	0	0	0	0	1	0	0	0	0	0	0	0	0	0	0	0	1	0	0	0	0	0	0	0	0	0	0	46	0	2	0	3	5	0	0	2	4	0	9	2	5	0	4	0	0	1	0	0	0	0	0	33	0	0	0	3	0	0	0	0	0	0	0	0	0	0	0	0	0	0	15	0	0	0	1	0	0	0	0	17	1	0	0	0	0	0	0	0	0	0	4	65	0	0	55	8	4	5	0	1	14	0	0	15	0	0	74	0	0	0	15	0	0	2	1	1	0	0	65	113	19	1	6	3	235	0	2	0	0	0	66	0	2	0	0	0	4	1	0	0	1	0	10	0	0	0	0	0	0	0	9	1	0	0	0	0	4	3	0	0	0	0	0	0	0	0	0	3	0	0	0	0	0	0	39	0	59	0	0	0	0	0	0	0	0	0	0	123	0	0	0	0	0	5	0	1	0	0	0	0	0	0	0	0	0	0	0	0	3	0	0	0	14	0	0	0	2	0	49	0	1	0	0	1	0	0	0	2	0	7	0	0	0	0	0	0	0	0	0	0	0	103	0	0	0	5	1	14	0	3	195	0	1	0	0	0	1	0	0	7	0	0	0	1	0	3	0	0	0	0	0	1	0	6	0	1	0	0	0	0	36	0	0	0	0	0	0	0	0	0	5	0	0	0	0	0	0	0	0	0	0	0	2	0	0	0	0	36	0	0	0	0	0	0	100	1	1	0	0	0	0	0	0	3	0	0	0	0	0	0	2	8	0	5	0	1	0	114	0	0	0	1	0	0	1	0	0	0	0	4	2	9	0	94	0	0	0	0	0	1	0	2	0	68	3	0	0	0	0	0	0	11	0	85	2	0	0	0	0	0	0	0	1	0	67	8	0	0	0	0	2	0	0	0	4	5	60	3	0	8	0	0	0	0	3	6	0	46	0	0	9	1	2	0	3	0	0	0	0	9	0	0	5	0	0	0	0	0	0	2	1	11	0	2	0	0	1	15	0	4	0	0	0	8	0	0	0	0	0	0	2	0	0	10	0	0	0	0	11	0	0	0	1	0	0	0	34	0	0	3	63	38	13	267	761	0	0	0	0	47	0	21	10	1	0	0	0	4	102	0	76	2	0	24	0	36	0	0	0	0	0	0	0	2	2	0	8	0	2	2	1	8	2	64	0	0	15	0	8	0	1	0	0	2	0	0	1	0	0	0	0	0	5	7	0	0	0	1	33	12	0	0	0	4	0	0	1	0	0	0	0	1	0	0	0	8	15	0	0	14	32	0	0	0	36	5	11	0	0	1	0	0	0	7	0	0	0	16	45	0	3	0	0	0	0	0	0	1	0	0	1	0	0	0	26	9	0	1	0	0	1	0	0	0	1	0	0	0	0	2	0	0	0	0	0	5	0	1	3	0	1	2	3	0	0	0	6	1	1	0	0	0	0	40	0	0	4	0	47	0	0	23	0	10	0	0	81	0	0	0	0	0	0	3	8	0	0	1	199	170	237	0	2	28	10	51	0	2	34	13	8	9	169	30	0	18	4	9	37	9	0	87	0	187	1	43	0	50	0	0	0	0	4	0	77	1	0	0	0	0	4	0	0	0	0	0	0	22	3	0	3	8	2	5	0	2	0	1	0	0	1	30	3	0	0	0	0	0	176	0	1	0	0	1	0	0	92	14	0	1	0	0	0	0	4	0	11	1	83	0	0	0	0	5	0	5	86	0	72	59	9	0	0	0	2	0	0	0	0	0	0	0	0	0	0	2	4	0	0	0	0	9	0	0	1	0	24	0	0	1	0	0	0	0	0	0	0	162	0	9	12	0	0	1	0	0	0	14	11	3	7	9	0	2	0	0	0	1	0	0	0	0	2	0	2	0	0	161	0	0	0	0	0	0	0	6	0	11	0	0	3	270	14	0	0	16	0	1	26	0	27	11	0	1	0	134	0	0	0	0	0	0	0	0	0	0	0	0	2	0	0	10	0	0	0	40	0	0	4	15	0	0	0	0	0	0	5	42	0	0	9	2	13	4	3	5	16	1	0	0	48	0	15	0	0	5	0	28	1	0	0	0	15	0	0	0	0	0	0	0	0	1	4	0	0	0	63	0	0	0	0	17	0	0	1	7	0	0	0	2	0	0	0	0	0	5	39	2	4	1	0	0	0	0	1	1	0	0	0	0	3	0	2	23	20	0	19	0	0	1	0	0	0	1	20	0	0	0	1	5	0	10	0	0	0	0	0	0	1	0	16	0	0	0	0	0	1	0	1	17	0	0	1	24	3	0	0	0	30	0	0	17	0	5	2	0	0	0	0	0	5	0	0	0	0	0	5	0	1	0	0	0	0	0	0	0	1	22	0	0	0	0	5	0	2	0	0	112	0	9	0	0	0	0	0	37	0	0	0	2	0	0	0	13	1	0	0	0	8	0	0	2	0	0	0	25	0	0	0	0	0	1	0	0	0	0	1	1	0	0	5	16	0	0	0	0	202	1	24	0	0	0	3	0	0	0	0	1	0	0	0	53	2	0	1	0	0	0	1	0	0	39	0	126	30	14	57	2	3	0	1	0	0	21	1	1	1	13	6	0	0	0	0	0	38	0	31	13	3	7	19	38	70	0	0	0	0	47	0	2	0	1	3	0	0	0	0	0	0	0	0	0	0	9	0	4	5	4	0	0	0	0	0	0	88	78	0	0	0	0	8	6	39	0	4	0	0	0	0	12	1	0	0	0	0	6	25	1	38	0	0	9	28	0	0	26	0	3	0	0	0	0	0	0	0	0	0	19	15	0	0	3	0	0	12	0	0	9	0	0	0	0	21	4	0	0	5	0	1	9	0	1	0	2	118	0	0	0	2	0	0	0	0	0	0	0	3	0	0	35	0	4	0	3	1	0	3	0	304	0	6	13	0	30	0	7	0	5	0	0	1	0	0	1	1	0	0	0	0	0	0	3	4	0	460	0	23	0	0	418	0	5	0	0	0	7	42	0	4	0	0	0	69	0	22	22	0	0	2	0	0	8	0	31	1	0	0	0	2	2	3	2	2	0	0	0	36	0	0	0	0	0	7	0	6	0	0	5	0	0	0	0	0	0	6	0	0	0	0	0	0	0	0	0	1	0	5	0	0	1	1	0	0	0	0	0	0	0	0	0	0	0	0	0	0	2	0	0	0	70	0	0	0	0	0	0	13	0	3	0	0	4	2	0	1	0	0	0	0	0	0	10	1	0	0	0	2	0	0	1	0	0	18	1	0	2	0	0	0	0	10	0	0	0	1	0	2	0	0	0	1	0	3	0	0	0	534	2	0	3	0	0	0	0	0	0	0	8	0	1	0	0	0	0	0	0	3	0	0	10	0	7	1	0	9	0	0	2	0	0	0	0	25	0	0	0	0	0	0	0	0	0	0	0	0	0	0	0	0	0	22	40	0	0	1	0	0	0	0	0	0	0	0	4	0	0	0	0	0	0	0	0	0	5	96	0	0	0	0	0	0	0	0	6	5	0	16	1	0	0	0	0	0	0	0	0	0	0	15	0	0	0	0	0	0	0	0	0	0	15	0	0	1	0	0	0	0	28	0	1	1	0	0	36	4	0	0	0	0	1	10	0	3	16	0	0	0	0	4	0	39	1	0	0	0	0	0	0	0	0	0	0	0	6	0	0	3	0	0	0	0	105	5	25	0	2	1	1	0	0	1	28	3	0	0	5	204	22	43	8	0	1	31	0	94	0	1	2	26	70	0	5	3	0	1	1	7	0	0	0	151	12	2	19	74	103	0	0	0	52	8	0	0	0	0	4	0	0	17	0	1	0	0	0	0	2	0	0	2	0	0	17	0	0	5	1	0	27	1	17	0	3	0	16	2	70	21	0	16	0	0	0	0	49	0	0	1	0	1	0	1	3	2	1	0	0	2	1	23	2	0	0	0	4	43	52	0	0	12	4	319	10	0	0	1	0	0	1	0	0	0	0	0	2	1	11	0	1	0	0	8	0	8	1	28	5	0	6	0	0	0	0	0	1	0	1	0	6	0	0	2	0	0	0	0	5	0	1	0	0	1	0	0	0	1	0	0	0	0	5	0	0	0	0	2	3	3	2	0	0	3	0	13	0	1	2	2	0	2	0	0	1	61	0	0	9	1	3	2	1	0	0	0	0	9	28	0	0	1	0	0	21	4	5	4	9	5	21	1	1	10	2	1	0	8	7	0	0	0	0	2	3	1	0	0	0	0	0	0	0	0	2	9	0	0	7	1	0	30	0	0	0	0	0	0	0	5	1	1	3	10	182	5	2	0	0	0	71	0	0	0	18	5	17	34	0	2	0	0	0	0	0	12	0	0	0	158	0	0	0	19	2	5	0	0	0	3	15	12	74	0	0	65	1	0	0	1	27	0	0	35	2	0	49	2	67	0	31	0	0	0	2	28	0	0	0	0	1	3	1	0	0	1	0	0	0	4	0	1	0	0	0	13	3	2	5	0	2	38	0	10	1	0	76	3	3	0	1	11	0	77	0	21	13	51	2	2	36	2	33	5	63	0	0	0	1	0	24	0	0	4	0	4	1	1	0	0	0	0	1	7	4	3	0	0	17	7	69	0	55	3	0	0	16	0	1	0	0	0	0	0	0	0	0	0	0	1	0	0	28	12	3	0	1	1	1	5	22	0	1	0	0	7	0	0	0	0	0	6	0	0	2	0	0	56	0	3	0	0	41	0	597	383	41	8	0	1	4	4	0	0	85	5	0	1	2	2	0	0	0	313	0	0	0	97	28	30	37	0	0	2	0	0	3	0	0	31	0	0	0	0	1	3	0	0	91	88	21	1	2	10	4	2	4	5	3	0	0	0	0	26	2	0	2	1	11	0	33	113	3	7	15	0	69	1	0	0	1	0	2	9	0	0	0	1	0	49	32	1	1	3	0	236	2	0	0	0	0	0	0	46	27	4	3	12	0	0	0	318	0	21	32	62	18	43	33	0	3	191	22	0	46	1	0	0	9	12	0	0	3	0	0	0	2	0	1	1	48	0	0	0	0	0	1	8	2	207	122	1	7	5	23	0	103	69	74	0	0	75	0	0	0	1	1	1	0	0	0	0	0	0	0	0	0	0	1	0	11	1	0	1	0	0	0	16	0	43	0	2	104	0	6	2	23	1	120	28	4	3	0	0	1	0	251	92	6	0	1	1	3	1	42	0	0	16	0	0	2	23	1	0	0	0	0	0	0	39	50	0	1	0	0	0	0	1	2	10	0	1	0	0	0	0	1	2	5	287	2	0	0	0	0	0	4001	0	1862	0	21	0	4	20	626	9	0	0	0	0	0	0	0	0	37	3	18	1	0	0	0	0	1	6	16	4	0	0	302	0	0	10	0	0	5	0	0	0	0	983	0	0	0	0	0	0	1	0	0	18	2	0	2	0	0	0	0	4	0	2	0	0	0	0	0	4	3	0	36	0	0	1	0	4	1	0	0	38	2	3	1	2	0	0	0	4	69	0	0	6	2	0	3	0	2	0	4	1	518	8	0	45	38	1	1	1	1	7	0	17	16	10	0	1	0	0	0	2	0	0	4	0	0	0	1	136	0	5	3	0	8	3	0	1	0	0	0	0	2	915	0	20	3	1	230	0	0	139	0	132	49	691	687	338	9	295	139	229	1	0	208	14	1	9	10	0	333	12	2187	3	5	5	8	0	62	3	0	0	15	30	32	7	1	1	3	0	41	0	0	0	37	8	27	13	27	11	39	3	30	0	0	0	38	0	19	38	0	0	1	0	1	0	0	0	0	1	26	0	0	0	0	42	0	0	54	0	1	0	0	0	20	6	1	0	4	0	0	72	0	0	0	0	0	1	0	0	30	0	4	1	25	10	0	41	1	5	0	2	50	529	0	10	1	0	57	0	1	4	0	9	0	70	3	0	1	0	0	22	6	11	174	4	0	7	7	45	5	0	0	10	2	0	0	11	0	19	0	1	1	173	1	0	1	0	0	0	15	16	0	0	12	0	2	1	1	0	0	0	2	0	2	0	0	37	0	0	2	3	0	48	2	14	1	0	2	0	0	1	1	0	23	0	0	0	9	36	2	88	54	0	2	17	6	7	36	1	0	0	0	0	2	1	1	30	134	44	75	0	0	0	0	0	0	0	0	0	0	1	2	0	0	0	0	0	0	6	67	4	0	8	0	0	0	0	0	0	19	0	3	3	0	0	0	0	0	9	1	1	0	0	0	0	0	0	0	0	29	0	0	0	0	0	0	48	8	0	0	0	13	316	0	0	0	0	1	0	0	13	3	0	11	0	0	0	0	2	0	0	2	19	8	0	2	0	0	0	0	1	0	0	0	21	25	0	1	0	0	0	1	15	0	89	0	0	0	0	0	1	0	21	0	49	21	0	1	2	0	0	195	5	0	0	0	0	197	287	16	47	0	166	102	1	211	0	100	2	2	0	197	669	142	65	92	30	63	112	55	0	66	3	0	61	23	32	0	2	442	2	122	157	1	66	1	168	4	6	85	2	43	75	0	179	0	0	0	0	105	3	0	71	41	79	148	0	0	10	265	327	2248	0	9	91	5	0	3	0	1	14	2	15	0	1	0	57	47	117	5	0	11	3	0	2	0	0	26	8	5	24	0	10	16	8	88	141	0	40	69	77	2	2	1	0	6	49	49	1	0	66	2	10	0	127	0	2	23	0	0	0	3	16	1	2	0	40	0	0	1	1	1	0	4	64	0	0	0	0	1	17	1	3	1	0	0	38	0	3	0	51	0	0	0	2	0	0	0	0	0	0	0	0	1	0	0	2	3	0	7	1	3	1	2	69	209	157	156	7	34	0	22	1	0	0	1	0	0	0	0	0	3	0	0	0	0	0	0	1	0	0	0	0	1	15	2	2	0	0	4	0	0	0	0	0	0	1	0	0	0	1	25	0	1	0	0	3	0	63	28	23	150	0	129	1	116	0	0	0	0	0	0	0	0	1	0	1	1	0	25	1	27	0	2	0	1	0	0	1	0	0	0	16	0	2	7	2	1	1	0	118	69	0	0	0	19	0	0	41	10	79	1	19	0	0	1	0	0	36	0	223	0	0	0	3	36	3	0	7	29	0	26	5	0	0	27	4	0	3	57	35	26	1	9	0	0	6	47	5	6	0	0	0	2	0	0	6	1	4	0	0	0	0	1	17	11	1	19	1	0	0	0	0	0	8	8	7	0	25	2	0	0	2	0	0	0	0	0	86	10	21	0	0	6	1	0	6	3	2	0	1	0	0	3	0	1	0	0	3	0	0	1	0	3	0	45	0	41	1	3	0	1	1	0	1	0	2	0	4	3	2	0	27	0	0	0	0	2	0	0	0	12	0	6	139	45	23	0	0	7	0	1	3	0	1	0	0	0	0	2	3	3	1	0	0	0	0	1	11	0	0	0	42	26	0	0	0	0	0	0	2	11	3	11	17	2	1	0	1	7	0	0	4	7	0	0	0	6	0	0	0	0	17	3	0	1	46	2	3	0	0	51	0	24	0	3	73	0	0	22	0	0	2	0	0	0	3	0	1	52	1	0	56	0	48	0	3	0	0	113	1	0	0	0	1	332	0	0	0	0	0	0	0	1	5	3	2	5	0	0	0	0	0	3	0	4	0	3	30	38	0	0	1	0	37	3	0	0	0	0	91	36	0	5	1	0	170	0	164860	0	0	1	0	0	27	0	0	0	0	0	0	1	0	3	0	35	0	1	0	0	0	29	42	5	1	2	18	3	0	1	0	0	0	0	0	0	37	33	2	9	0	0	1	0	0	5	1	2	6	0	0	2	0	2	19	16	28	169	0	0	21	0	20	0	0	0	5	0	61	123	93	280	0	0	0	3	3	20	0	7	1303	21	1	200	0	0	0	0	5	0	4	3	6	67	5	0	360	39	0	0	53	74	2	0	118	1	1	1	1	0	0	0	0	2	0	2	0	36	93	6	242	303	3	24	137	0	524	7	11	426	96	12	75	49	10	257	77	4	25	34	0	0	7	0	0	0	199	132	167	220	122	8	12	0	2	80	56	3	7	3	0	0	0	0	0	0	0	0	0	1	0	1	21	2	9	0	7	0	0	0	57	0	0	0	0	14	20	37	13	0	0	0	0	0	15	16	0	0	16	0	0	0	0	0	57	25	0	9	1	0	0	4	64	0	0	0	5	3	0	0	0	0	0	0	0	0	1	4	0	10	1	6	28	93	0	0	0	7	0	0	2	0	1	30	1	13	1	0	0	78	8	0	1	25	1	113	6	0	23	14	2	1	2	0	0	3	0	0	1	0	0	0	0	0	1	0	1	1	0	0	4	0	8	1	0	0	0	5	1	0	0	0	0	1	0	1	0	0	0	0	3	0	2	0	1	0	2	0	0	1	0	37	0	1	3	0	0	0	0	0	0	0	0	1	10	21	31	1	103	5	0	7	28	55	55	20	35	0	0	0	0	28	0	0	3	0	15	0	9	11	1	0	0	0	0	0	0	0	96	13	32	0	11	4	15	0	0	0	0	8915	18189	2	2	4	0	0	0	0	48	1	58	2	0	18	0	23	33	2	12995	2	0	0	129	42	1	33	0	417	0	1	6	1	434	1	2	0	0	1	0	0	0	192	0	0	124	52	32	0	0	0	58	4	2	2	0	2	0	0	4	0	0	2	1	0	2	18	5	0	2	0	4	0	2	0	1	4	3	0	6	1	0	0	0	0	0	1	46	75	20	34	47	54	27	169	7	2	21	20	44	22	0	0	2	0	24	0	3	2	2	0	0	6	26	2	3	1	0	0	0	1	0	16	1	29	2	14	0	11	41	6	0	0	7	0	0	0	0	5	1	0	2	66	0	36	0	1	0	0	1	4	0	0	4	3	0	0	0	0	0	1	0	0	0	4	75	0	0	9245	0	1	0	16	0	0	0	2	2	3	0	0	0	0	0	0	0	0	1	0	0	0	0	1	0	0	0	0	0	0	28	0	18	52	114	399	81	99	0	0	0	0	0	0	0	0	0	0	0	1	0	0	1	0	0	72	0	0	0	0	0	22	0	0	0	0	0	0	0	7	0	0	106	0	1	3	33	1	42	0	0	30	1	5	0	21	4	0	31	49	62	0	111	11	5	38	484	6	5	99	0	0	30	1	0	4	2	105	34	6	1	0	0	0	0	112	0	0	0	0	343	0	3	0	0	7	4	5	11	3	0	0	0	2	0	0	7	0	0	0	7	0	2	0	0	0	1	134	3	0	0	0	2	1	0	0	1	30	0	0	0	1	0	0	49	7	0	0	0	0	11	3	0	0	28	0	0	44	6	8	0	6	0	0	2	24	0	14	0	4	1	1	0	0	212	4	2	0	0	15	35	0	1	41	104	16	10	1315	1	28	62	14	0	47	0	384	34	82	6	1	6	0	17	1	16	0	10	0	108	0	0	2	0	19	1	7	125	2	5	4	2	6	377	1	0	0	0	0	31	22	1	0	0	0	194	0	0	23	1	1	0	14	22	0	1	1	0	42	4	10	0	0	3	1	1	0	0	4	4	0	2	0	0	2	4	0	0	0	0	0	7	0	18	33	25	47	10	0	20	57	15	44	53	143	0	0	0	0	2	0	0	0	0	230	1	0	1	69	74	37	16	0	168	0	0	35	9	0	0	2	3	0	0	1	0	0	0	0	24	266	43	2	0	0	1	0	0	0	0	4	0	4	2	2	310	0	0	0	0	0	0	0	0	2	1	0	0	0	0	0	0	0	0	1	0	0	0	0	0	0	0	1	2	0	0	0	0	0	0	0	2	0	0	0	0	3	0	0	0	24	1	15	0	0	4	1	2	0	1	1	4	0	0	0	0	0	16	2542	16	75	9	1	3	1	7	0	2	23	25	0	0	0	0	20	3	8	0	0	18	0	6	136	0	7	23	1	18	6	6	22	103	3	0	1	0	0	0	0	0	0	76	2	23	7	27	4	57	4	0	64	0	1	18	4	0	2	0	13	44	69	89	0	52	31	34	0	25	1	11	0	2	5	0	0	3	1	0	0	0	0	0	10	0	6	32	0	0	0	13	0	8	14	0	6	0	0	26	0	66	0	28	64	1	9	77	1	105	0	0	0	0	0	40	0	0	1	288	1	30	4	2	0	37	0	0	2	0	0	0	0	0	0	0	12	3	0	0	25	16	7	218	19	81	273	3	0	45	0	0	0	0	0	10	0	10	0	0	4	20	1	0	1	10	0	10	0	0	0	0	0	2	9	46	0	22	99	0	0	0	0	0	0	77	1	105	0	13	312	0	0	0	37	0	10	0	1	0	1	0	0	0	0	0	0	8	2	0	1	0	0	0	0	0	0	0	2	0	1	0	0	0	3	1	0	10	0	0	0	0	2	3	1	35	4	25	29	0	42	39	36	80	28	29	38	0	8	4	3	0	0	0	0	0	0	0	0	0	0	0	8	1	0	0	2	6	1	0	0	5	0	0	103	1	0	0	0	16	1	0	0	0	0	0	3	0	0	42	1	0	0	0	0	0	0	0	0	0	0	0	3	2	10	2	1	7	5	2	49	4	0	0	0	0	0	0	0	2	0	30	1	2	2	11	0	25	672	0	0	1	0	1	0	0	0	0	0	0	0	0	0	0	0	0	0	1	6	0	0	0	0	0	0	0	5	1	0	0	0	0	6	1	0	166	0	0	2	0	0	1	0	0	0	5	0	0	0	20	11	0	1	0	0	0	0	0	0	0	2	0	0	0	0	0	0	0	0	1	28	0	0	8	0	0	0	31	0	0	7	0	0	0	0	0	2	0	0	0	3	0	0	1	0	2	2	0	0	0	0	5	0	0	0	1	0	0	0	0	0	1	0	0	0	0	0	0	0	0	3	0	0	0	0	0	0	0	0	2	0	0	0	0	28	0	0	0	0	0	0	0	0	0	0	0	0	2	0	0	28	0	0	3	0	0	0	0	0	0	0	0	0	0	0	0	0	0	0	0	0	0	78	0	0	1	0	0	0	0	0	0	0	0	0	0	0	0	0	0	0	0	0	10	0	0	1	0	0	35	0	0	0	1	0	0	0	0	0	1	0	0	0	4	0	2	10	2	0	0	0	1	0	0	0	7	9	0	0	0	0	37	0	247	0	0	0	0	0	0	1	1	1	0	3	0	0	1	0	1	1	0	0	0	0	1	0	0	31	0	0	0	0	8	0	1	0	0	0	0	0	0	0	1	0	0	3714	1	0	0	0	3	0	0	3	0	0	0	9	2	1	0	0	0	0	1	0	0	0	6	0	6	0	0	0	16	1	0	9	1	0	0	0	5	0	0	2	0	0	2	0	0	0	4	0	0	6	0	0	0	1	0	2	5	0	0	0	0	0	1	69	1	1	4	5	1	2	1	5	83	4	3	1	1	0	86	0	1	0	3	0	3	0	0	0	0	24	0	341	0	0	0	11	0	0	0	448	10	0	0	0	7	0	0	315	2	47	0	216	16	0	1	0	38	0	2	0	0	0	0	0	0	0	1	3	3	3	17	0	3	3	1	0	0	0	0	0	1	0	0	0	8	0	3	0	0	1	0	0	0	0	0	1	5	0	0	0	0	25	0	0	0	0	4	0	2	16	9	0	0	0	0	0	0	0	0	0	1	0	0	186	4	11	1	6	1	0	0	0	2	0	0	0	2	1	0	1	0	0	0	1	5	0	418	0	0	0	0	0	1	0	0	0	0	306	0	6	1	1	0	0	0	0	0	0	0	1	0	0	0	0	0	2	0	0	0	0	48	28	2	47	32	0	1	1	0	0	3	4	0	1153	0	0	0	16	0	0	1	0	31	15	8	0	0	0	0	0	1	0	0	0	33	12	3	44	0	16	18	37	0	1	0	0	0	0	4	1	1	0	0	0	0	0	0	0	1	2	1	2	4	31	2	1	18	0	0	0	0	0	0	25	3	29	11	44	36	0	43	77	8450	2	91	1	0	109	2	1	7	1	0	1	0	0	0	0	36	13	0	0	0	1	112	2	0	1	0	96	0	0	1	0	0	49	13	0	15	0	4	76	0	72	0	0	0	0	0	0	7	4	2	3	12	1	14	1	10	0	1	37	0	9	0	0	2	0	14	0	29	0	3	0	9	20	3	13	5	0	0	4	0	5	0	13	38	2	0	0	0	0	0	0	0	3	0	0	0	1	14	0	0	7	51	0	0	8	0	10	52	20	25	0	0	1	1	20	3	30	131	0	2	0	1	14	6	8	53	3	22	4	0	1	0	1	0	0	0	1	16	0	105	3	68	2	6	0	0	1	1	25	28	0	0	0	0	5	5	0	5	2	18	10	2	5	0	0	4	0	7	3	10	18	34	46	0	0	38	194	12	4	0	0	0	0	0	0	3	0	0	103	0	4	4	1	1	2	9	138	14	43	0	0	0	0	0	0	0	0	0	2	0	0	0	1	0	13	24	12	98	0	13	0	1	0	5	0	4	2	6	0	14	0	0	0	5	3	5	54	5	23	12	0	0	0	28	120	0	0	0	1	3	2	0	1	9	0	0	0	0	2	32	0	0	13	1	23	0	0	1	0	0	3	1	0	7	0	1	0	47	0	0	102	0	31	15	1	10	0	0	1	0	2	0	28	10	0	1	0	0	1	0	0	0	10	12	13	0	0	50	15	10	0	0	1	0	0	1	0	0	0	0	7	17	0	15	0	289	8	2	129	2	120	220	121	2	11	298	116	0	236	1198	62	148	8	5	9	0	0	1	5	3	3	0	1	9	0	2	1	33	1	0	19	0	0	0	0	0	0	0	0	0	14	2	4	7	4	52	0	0	0	0	0	0	0	0	0	0	0	1	0	0	0	1	0	0	0	1	0	0	0	0	0	0	11	11	0	0	0	0	0	0	0	0	0	0	0	0	0	0	0	0	0	0	0	0	0	0	3	0	139	29	0	163	7	0	0	19	0	0	0	51	27	49	4	0	4	69	0	0	0	3	0	4	0	0	0	0	0	0	1	15	10	0	4	117	78	0	0	0	19	4	20	3	8	0	0	1	0	0	0	0	0	3	2	0	2	1	0	0	22	3	59	3	11	0	26	27	55	0	22	7	24	0	0	0	0	0	0	125	108	0	1	0	0	0	0	0	4	13	5	0	0	14	84	2	35	0	28	0	0	0	0	25	5	1	0	274	0	1	0	0	0	254	0	0	2	0	29	1	0	1	0	0	1	0	1	8	0	4	8	50	9	4	16	0	2	0	34	0	4	2	27	0	0	9	6	0	18	0	0	0	0	0	44	7	0	4	19	7	13	53	11	42	0	16	6	0	8	0	2	1	2	0	0	0	50	0	5	1	0	19	0	16	0	1	1	0	0	0	1	0	1	0	0	1	0	1	0	0	0	0	0	0	0	1	1	0	0	0	0	0	0	0	0	4	0	3	0	1	0	0	0	17	1	1	3	20	1	13	0	5	107	111	65	47	29	0	4	79	82	0	2	80	2	27	0	10	0	7	0	0	22	2	57	36	2	1	2	1	0	0	0	135	6	0	0	17	12	180	0	0	0	0	0	0	0	2	0	0	0	2	0	0	0	0	0	0	1	0	245	1	56	25	8	0	27	2	10	0	0	0	0	0	0	0	0	0	0	0	61	1	0	4	3	0	20	5	424	0	1	0	0	7	32	0	40	20	56	12	22	24	0	4	8	0	0	0	2	0	2	3	22	393	43	27	0	11	0	0	0	0	29	0	0	0	1	2	26	0	337	324	0	0	0	465	17	3	6	0	11	58	77	65	3	3	2	0	1	1	1	21	1	5	3	0	0	1	1	2	1	0	0	0	4	0	0	0	0	0	1	0	0	0	0	180	1	1	2	0	171	5	19	1	0	1	7	4	2	0	0	0	20	30	0	42	10	0	19	0	0	1	6	2	0	0	0	0	0	2	0	3	35	43	4	3	25	0	0	66	13	19	5	0	0	0	1	1	0	0	0	16	0	4	1	51	0	0	0	0	0	1	0	46	0	0	1	30	3	27	5	1	18	1	22	0	0	12	0	3	0	0	0	1	5	28	53	43	32	70	0	118	0	0	0	0	0	5	0	0	0	0	0	4	0	0	0	0	0	0	11	1	0	0	20	0	0	3	0	8	1	3	1	0	232	0	275	0	0	182	0	1	1	0	0	0	0	0	6	59	0	0	0	0	1	2	1	1	2	0	42	0	13	1	0	0	2	0	4	642	1	1	1	1	11	0	0	0	25	5	1281	53	52	27	8	111	22	20	32	66	14	16	0	34	28	0	0	0	186	0	0	0	0	0	0	0	2	1	1	0	0	0	1	2	0	0	0	0	0	1	0	0	1	0	0	0	0	0	0	0	0	0	0	0	0	0	2	0	4	0	0	0	0	32	2	0	124	0	191	135	17	58	0	0	0	5	0	0	4	0	0	30	0	0	45	78	6	0	1	32	2	25	0	29	42	57	0	0	0	0	6	0	0	1	2	0	1	0	0	0	7	6	13	0	75	0	9	18	6	0	0	0	0	0	0	48	2	1	0	2	49	30	0	139	0	0	1	25	0	19	0	27	1	1	0	0	0	0	0	0	11	5	0	2	0	65	18	1	0	3	6	44	1	3	1	0	7	0	0	0	0	2	10	4	4	14	31	0	2	2	0	0	2	1	0	1	0	0	4	2	2
LakWasM109_LOW13_2_rpkm	0	0	0	0	0	4	5	0	0	0	0	3	6	6	0	0	0	0	2	0	0	2	0	6	0	0	0	0	0	0	0	0	0	0	1	1	1	0	0	0	0	0	0	0	7	6	8	10	0	0	1	0	0	0	0	3	0	4	13	27	133	0	0	0	0	0	0	0	1	10	0	0	0	0	0	0	3	0	0	0	0	8	2	0	0	0	0	0	0	0	0	0	0	0	1	0	0	0	0	1	0	0	0	0	0	1	0	0	0	0	3	0	11	0	6	0	0	0	0	0	0	0	0	0	0	0	4	0	0	0	0	7	21	1	0	0	0	0	4	0	1	0	0	0	1	0	0	0	0	1	0	3	1	0	8	0	3	1	5	0	2	0	0	0	7	0	0	1	0	12	1	0	0	0	0	0	0	0	0	0	0	0	0	0	1	42	0	0	0	6	0	1	0	0	0	0	2	7	0	19	4	0	9	0	0	0	7	0	11	0	3	0	35	1	1	0	10	0	0	13	0	0	9	1	1	11	2	0	11	0	0	3	0	0	0	0	1	11	2	2	0	0	4	2	5	8	0	0	5	2	4	0	19	0	153	65	0	0	0	0	0	0	0	1	4	0	241	0	0	10	68	0	12	0	0	0	0	0	11	12	0	1	9	0	1	0	0	0	0	0	0	0	0	0	0	0	0	13	0	0	0	6	16	0	2	0	5	3	14	1	9	0	3	0	0	0	0	0	0	0	0	0	0	0	4	2	1	0	0	0	0	1	0	0	0	0	0	6	0	0	0	1	4	6	0	0	1	0	17	0	1	0	0	0	0	0	0	0	0	43	3	0	0	0	0	2	1	1	14	0	0	7	0	10	18	2	0	0	0	3	1	0	1	0	1	0	26	2	0	0	0	0	23	1	0	4	39	0	0	5	2	3	0	1	0	0	0	0	0	0	0	2	7	0	0	4	5	2	1	7	0	0	2	0	0	0	0	0	0	0	0	0	0	0	0	8	0	2	2	0	10	26	0	0	8	4	0	0	0	0	0	22	11	7	0	14	3	0	0	4	0	0	0	0	0	4	0	0	0	7	2	25	3	0	0	0	12	1	305	0	9	4	15	991	2	0	1	62	13	1	0	0	15	26	0	0	9	0	0	0	0	0	0	0	0	2	0	0	0	0	0	0	0	0	1	0	0	0	0	10	0	0	0	0	0	0	0	0	0	0	0	0	0	0	1	0	0	2	0	0	0	5	0	2	4	0	0	0	0	14	0	0	1	2	0	7	0	3	1	0	0	0	0	0	3	0	5	0	6	0	0	0	0	0	3	14	20	23	6	6	33	31	21	14	1	0	10	5	63	0	0	0	3	0	66	1	1	0	5	0	2	0	0	0	1	3	0	12	0	42	1	31	141	60	0	0	8	0	94	0	59	13	1	1	0	4	0	3	0	0	0	4	0	0	4	0	0	0	8	2	1	19	0	1	0	3	4	2	0	3	31	0	2	18	5	0	1	0	2	0	2	44	0	108	0	0	0	0	0	6	13	2	9	0	0	0	1	1	0	0	0	0	4	0	0	0	0	0	0	4	0	0	3	0	0	0	0	1	0	2	0	9	0	3	3	0	4	0	1	0	0	0	0	0	1	5	0	0	4	4	0	0	0	6	0	0	0	0	1	0	0	0	0	0	0	0	0	0	0	4	0	5	2	0	6	5	3	0	0	14	0	0	5	0	0	2	0	0	33	6	0	5	0	5	0	5	0	0	0	0	0	0	0	0	5	5	0	0	0	0	0	0	0	0	0	0	1	0	0	1	0	3	0	0	0	0	0	8	0	9	0	0	0	0	84	0	3	0	0	0	0	0	0	0	0	0	4	0	0	0	0	0	0	18	1	0	0	2	31	0	0	0	0	0	0	0	0	18	28	0	0	0	0	0	0	0	0	7	9	14	0	0	1	0	0	0	2	0	0	5	7	0	0	1	0	0	0	0	5	1	0	0	0	0	0	0	0	16	0	37	0	0	0	0	0	0	3	0	0	0	0	0	0	0	0	0	0	0	0	0	0	39	4	32	0	0	0	0	0	0	0	0	0	0	6	3	15	3	4	0	0	3	0	0	0	0	0	0	0	0	29	0	0	0	0	0	0	0	0	24	0	0	0	1	1	0	20	0	0	0	0	0	0	0	0	0	0	0	0	0	0	0	0	0	0	1	0	0	0	0	0	8	2	121	0	14	0	0	0	0	1	1	4	0	86	0	0	0	0	0	0	0	0	0	0	0	0	5	10	0	0	0	0	0	0	0	0	0	0	3	0	0	0	0	0	0	0	23	0	0	0	16	2	0	0	0	0	0	12	0	2	0	0	0	0	0	1	0	133	0	0	0	0	0	0	0	0	3	0	0	0	0	0	0	2	0	0	0	0	0	9	6	0	4	0	0	0	0	18	0	11	0	0	0	0	0	3	1	3	0	0	1	0	0	0	0	0	0	0	1	0	0	1	0	0	0	0	0	0	0	0	0	0	0	0	0	27	0	6	85	0	63	0	0	2	0	0	28	0	0	6	0	0	0	0	0	1	5	18	0	6	0	0	0	0	0	0	0	0	0	0	0	0	0	0	0	0	0	0	0	0	6	0	0	8	0	0	0	0	0	0	0	0	0	0	0	0	0	0	0	6	3	0	0	78	0	0	0	0	0	0	0	0	0	0	0	0	3	0	0	0	2	1	13	29	40	0	0	0	4	1	0	0	1	0	1	2	0	0	0	0	0	2	0	0	0	0	1	0	0	0	0	1	0	0	0	0	0	27	0	0	0	0	0	0	0	0	2	0	0	8	0	0	2	0	0	29	0	0	0	1	0	0	7	3	0	0	0	0	0	10	0	0	7	0	7	0	0	0	0	0	1	4	22	2	45	0	0	0	2	0	1	1	3	0	41	4	3	11	0	0	0	0	0	0	1	0	0	1	0	0	0	0	0	0	0	0	0	0	1	0	0	0	0	0	0	0	0	0	1	0	0	14	0	0	0	0	0	0	0	0	0	0	1	8	0	2	20	3	7	0	0	1	9	0	0	4	1	0	1	0	1	0	0	0	0	6	4	0	1	0	0	5	0	7	0	0	2	3	8	0	0	9	0	2	1	2	1	0	0	0	0	4	0	8	0	1	2	4	13	0	3	29	0	0	0	1	3	0	0	0	0	3	1	0	0	0	0	1	11	1	5	17	1	1	0	11	0	0	0	0	0	0	0	6	0	0	7	3	0	4	5	5	4	7	0	1	0	0	0	0	1	0	10	3	8	0	0	1	0	0	0	4	10	17	7	53	0	0	0	0	0	0	0	0	31	14	0	3	11	0	0	0	0	66	13	15	15	0	0	1	65	0	0	1	0	2	0	0	0	19	2	1	15	17	7	0	0	20	10	0	0	0	0	0	0	45	0	0	0	0	2	0	2	0	0	0	0	0	9	0	0	0	0	0	0	0	0	0	0	0	0	0	3	2	14	0	0	0	0	0	0	0	0	0	0	0	0	1	22	0	0	4	0	0	0	0	0	0	0	0	0	0	0	0	0	0	0	0	0	0	0	0	0	0	0	0	0	0	0	0	0	0	0	0	0	0	220	0	0	37	0	0	0	0	24	0	6	29	0	0	2	0	0	4	0	1	0	0	0	3	0	47	0	0	0	0	0	5	0	0	3	1	0	0	0	4	1	0	5	0	0	0	0	0	0	0	15	0	21	6	3	0	0	0	10	0	0	0	1	0	0	0	0	0	0	0	0	1	0	2	0	7	7	2	0	0	2	0	0	0	2	0	2	2	0	6	0	6	0	0	0	0	0	0	0	3	0	1	2	300	11	6	6	0	1	0	0	0	0	0	13	0	0	0	3	14	0	0	0	11	1	3	0	0	17	4	0	6	2	0	31	0	2	2	3	4	0	1	0	0	0	0	0	0	0	0	36	0	0	9	2	0	0	0	4	0	1	1	0	3	0	0	0	0	1	13	119	1	19	0	23	0	1	4	3	0	0	4	0	0	1	141	0	1	0	0	3	0	0	3	0	2	1	0	0	0	0	0	0	0	6	0	0	0	0	0	3	14	0	0	0	29	0	239	0	0	4	89	0	10	5509	4	0	2	0	0	0	0	0	0	0	0	0	0	0	0	0	0	3	0	0	0	0	0	9	0	70	0	1	0	0	0	0	0	5	0	0	0	0	10	0	1	15	3	19	20	0	1	0	0	0	0	0	10	0	0	4	9	0	0	0	9	86	6	5	0	7	19	0	8	3	51	0	3	5	8	2	30	8	0	5	0	0	0	0	0	0	0	0	0	0	0	0	0	0	1	0	0	16	0	5	35	0	0	0	0	0	0	0	1	0	0	0	0	0	0	0	0	0	0	2	15	0	0	0	0	0	0	2	4	0	4	0	1	0	1	0	0	0	0	0	0	0	0	0	0	0	0	0	0	0	3	153	3	0	0	0	0	0	0	0	23	0	12	3	18	2	0	0	19	0	23	29	5	1	0	0	0	0	0	0	0	0	0	1	0	0	19	0	0	0	0	1	0	0	0	0	0	0	0	0	4	60	5	2	5	8	0	10	23	0	0	0	62	1	18	4	0	0	0	0	0	1	0	0	0	0	2	0	0	0	0	2	6	0	3	0	0	0	0	4	1	0	2	0	0	0	0	0	0	0	0	197	6	0	0	0	0	0	0	0	5	2	0	4	0	0	0	0	1	1	0	0	0	0	3	0	1	0	0	0	1	0	5	123	0	0	0	0	1	0	2	0	0	0	0	1	0	0	0	0	0	10	0	0	5	1	0	10	130	21	4	0	3	0	0	0	12	0	12	0	0	0	0	0	1	5	0	6	0	0	2	0	0	0	0	0	0	0	2	0	0	0	0	0	0	0	0	0	0	0	2	16	0	0	0	0	0	12	3	0	0	0	0	0	45	0	0	0	2	0	0	0	0	7	7	2	12	7	1	0	0	260	0	0	38	76	15	0	2	0	7	3	0	0	1	0	0	2	10	0	0	0	0	2	0	0	0	0	30	15	1	0	0	0	1	13	0	8	0	0	12	0	57	0	0	0	0	1	0	0	0	0	0	0	0	0	0	3	0	0	0	1	16	4	0	1	2	0	0	0	5	4	0	0	7	0	0	0	0	0	0	0	0	0	0	0	16	0	0	0	0	0	0	0	0	0	0	0	21	0	0	0	0	1	0	0	0	0	2	0	0	0	0	1	0	0	0	0	0	0	0	0	8	0	0	6	0	0	0	0	0	2	5	0	0	2	0	1	0	0	1	0	0	0	0	0	0	0	0	0	21	36	194	45	15	16	43	24	0	25	18	61	26	25	3	16	9	34	36	6	2	0	55	45	34	26	14	7	33	23	44	1	14	2	0	1	0	0	0	0	0	0	0	0	33	18	0	0	0	0	0	0	0	0	0	0	0	0	0	0	0	2	0	0	0	0	4	0	1	0	15	0	1	0	14	0	21	0	0	0	23	0	0	0	0	0	0	0	0	0	0	1	0	0	0	0	1	10	0	0	0	0	0	0	0	0	0	2	0	0	2	4	0	0	0	0	63	0	0	6	0	0	0	0	0	2	0	0	0	0	0	2	0	2	0	0	0	0	0	0	0	1	0	0	0	0	0	0	0	1	0	17	5	0	2	4	0	0	0	0	0	0	0	0	0	0	1	0	0	19	0	0	0	0	0	0	0	0	5	0	0	0	0	0	1	0	0	0	0	5	0	2	0	15	0	0	0	0	0	0	0	0	0	13	0	0	0	0	0	1	0	0	0	0	2	0	1	0	0	0	0	0	0	0	0	0	3	0	0	0	0	0	0	0	0	0	0	0	0	10	0	10	0	0	0	0	0	4	2	0	0	0	0	0	0	0	0	0	1	0	2	2	0	0	0	0	7	0	0	18	1	1	0	1	0	17	3	0	7	2	0	0	0	0	0	1	0	13	0	1	0	0	0	0	0	0	1	4	0	0	0	0	0	0	0	0	0	12	0	0	0	0	0	0	0	0	0	0	6	0	0	0	0	8	2	11	11	73	1	0	0	0	0	0	0	0	0	0	0	0	0	0	0	0	0	0	2	6	2	3	0	0	0	1	0	0	3	0	2	2	0	0	0	0	261	0	0	0	0	2	0	0	0	0	0	0	6	0	9	9	0	0	0	0	0	0	19	1	0	0	2	8	0	1	0	0	0	0	6	5	0	0	0	0	0	1	0	0	0	0	0	1	0	0	3	0	1	0	1	0	0	0	0	0	0	0	0	0	0	0	0	0	8	0	0	0	0	6	0	0	0	0	0	0	0	0	0	0	0	0	0	1	0	0	40	0	0	19	0	33	0	7	2	0	0	0	0	3	0	4	3	0	0	0	0	0	0	0	0	11	0	0	3	0	0	0	6	0	10	10	17	0	0	8	10	1	0	9	0	5	0	103	0	6	0	4	1	2	4	1	0	9	0	0	0	2	0	0	0	3	0	0	0	4	3	0	5	1	0	2	0	0	3	0	0	0	10	0	0	0	2	1	0	2	0	0	0	0	17	7	0	0	0	0	0	7	33	1	0	0	0	15	0	0	0	0	0	73	0	0	0	0	0	0	0	0	0	0	0	16	0	0	0	2	4	0	0	0	0	0	0	0	0	0	0	28	1	0	57	21	6	0	23	0	5	1	0	0	28	0	1	0	0	0	1	1	23	0	0	3	0	0	0	3	0	2	0	0	3	0	0	71	0	4	0	0	0	25	23	0	0	0	1	1	0	0	0	0	8	0	0	0	0	5	12	0	0	0	39	10	0	0	1	0	0	0	25	280	156	1	0	0	0	2	0	1	2	4	0	0	0	0	0	0	0	50	4	0	0	0	0	0	0	0	72	0	0	1	0	0	20	0	0	2	0	0	0	0	0	0	0	0	0	0	0	0	234	63	0	1	0	0	0	0	5	32	0	0	0	0	0	0	8	0	0	9	0	0	0	0	0	98	0	0	0	0	0	4	0	0	0	0	0	2	0	1	0	0	0	0	0	0	0	780	0	0	0	0	1	0	0	0	0	0	0	0	0	0	0	5	0	0	0	0	0	0	0	0	0	0	0	0	0	0	0	0	0	0	0	0	0	0	0	1	0	11	2	0	0	0	0	0	0	0	0	0	0	0	0	0	0	0	0	7	0	0	0	0	0	0	307	0	0	0	0	0	2	8	0	0	0	0	0	11	0	26	4	0	5	0	0	6	60	0	1	1	0	2	0	2	0	0	0	0	0	0	9	0	0	0	0	0	0	0	0	0	0	0	0	1	0	0	0	0	0	0	0	0	0	0	2	0	12	0	0	0	0	0	0	0	0	0	0	0	0	1	0	0	0	10	2	2	0	0	0	0	0	6	0	0	0	0	1	0	0	3	0	19	0	0	0	0	0	0	0	0	0	1	0	0	0	18	2	8	49	8	4	6	0	0	0	0	3	0	0	0	2	0	0	4	0	7	9	0	0	0	166	28	0	0	0	0	0	0	0	170	0	7	0	0	0	0	0	0	3	15	0	1	0	0	0	1	0	0	0	0	0	0	7	4	49	0	0	6	20	6	0	0	0	0	0	0	0	0	7	30	2	6	0	0	0	0	0	0	0	43	0	0	0	0	0	0	0	0	0	0	0	0	0	1	1	5	1	0	0	0	14	0	7	0	1	0	8	1	0	0	0	0	24	0	0	0	0	0	0	0	0	0	2	0	4	0	0	0	0	0	0	32	0	0	0	0	0	0	0	15	0	0	0	0	0	2	0	0	0	0	0	0	0	0	2	0	0	0	0	0	0	0	0	0	0	0	0	0	0	0	0	0	0	0	0	0	0	0	1	0	13	0	0	0	0	0	0	0	0	0	0	0	0	0	0	0	0	0	0	0	0	0	0	4	0	1	0	0	0	0	0	0	0	5	0	1	0	0	0	0	0	0	0	0	0	0	0	0	4	0	0	0	0	0	0	0	0	0	0	0	0	0	0	0	0	0	0	0	0	0	0	0	0	0	3	6	2	1	0	0	2	0	59	0	0	0	1	0	0	0	0	0	0	10	0	4	0	0	0	1	0	0	0	0	0	25	0	0	0	0	6	0	0	0	0	0	0	0	0	0	0	0	2	0	0	59	0	0	0	0	0	0	0	0	0	0	0	0	0	0	0	1	0	0	0	0	0	0	0	0	0	0	0	0	3	0	0	9	0	5	0	1	0	0	0	0	0	6	0	0	0	0	0	0	0	2	0	0	0	3	0	0	0	0	0	0	0	0	0	0	0	0	0	0	0	0	0	0	0	0	0	0	0	0	0	0	0	0	0	0	0	0	0	0	0	0	0	0	0	0	0	0	0	1	0	0	1	0	0	0	0	0	0	0	0	0	0	0	0	0	0	0	0	0	0	0	0	0	0	0	0	3	0	0	3	0	0	2	0	0	0	0	0	0	0	0	0	0	1	0	0	8	0	4	0	0	0	2	0	0	3	0	2	8	0	0	0	0	0	0	0	0	0	0	0	99	1	0	0	7	0	219	0	0	0	0	0	0	0	0	0	0	0	0	0	0	3	0	0	0	0	0	0	0	7	0	0	0	0	0	0	0	0	2	0	0	0	8	1	0	0	0	0	0	0	0	0	0	0	0	0	71	0	3	3	0	1	0	0	0	0	0	0	0	0	0	0	0	0	0	0	0	0	0	0	0	0	0	0	0	0	0	0	0	0	0	9	0	0	1	0	0	0	0	9	2	0	0	0	0	0	0	0	7	2	0	0	2	0	0	0	0	0	0	0	0	0	0	4	0	0	0	0	0	0	0	0	0	0	0	0	0	0	0	0	0	0	0	0	1	0	0	0	0	0	0	1	0	0	1	0	0	0	0	0	0	0	11	0	0	0	0	0	0	0	0	0	0	0	0	0	0	0	0	0	1	0	0	0	1	0	0	99	0	1	0	0	0	0	0	5	0	1	1	0	0	0	0	0	0	0	0	0	0	2	0	0	0	0	0	0	0	1	0	0	0	0	0	0	0	0	0	0	0	0	0	0	16	2	0	0	0	0	0	0	0	0	0	0	0	0	0	0	0	0	0	3	0	31	0	0	1	8	0	0	0	0	2	3	0	0	12	0	15	0	0	0	0	0	0	0	0	0	5	23	0	1	0	0	0	0	5	0	0	6	0	0	1	0	0	0	1	0	0	0	0	0	0	0	0	0	0	0	0	0	0	0	0	0	0	0	0	0	0	1	0	0	0	0	0	8	0	0	0	0	0	1	0	0	0	3	6	0	0	0	0	0	0	2	0	0	0	0	1	2	5	0	1	8	0	15	63	0	0	3	0	163	0	3	11	1	0	0	0	30	102	0	10	0	8	3	0	264	0	0	0	289	0	0	0	1	8	0	4	0	0	3	0	12	28	39	0	0	1	0	1	0	7	0	0	6	1	0	0	0	0	0	0	0	3	8	0	0	0	0	1	0	0	20	0	0	0	0	0	0	0	0	0	0	11	0	0	1	35	0	0	0	3	1	0	0	79	2	0	0	0	0	0	0	0	7	0	0	0	55	337	0	0	0	0	0	0	0	4	2	0	0	0	0	0	0	7	0	0	0	0	0	0	0	22	0	0	0	0	0	0	1	0	0	0	2	3	1	0	1	0	5	6	0	0	0	0	1	7	0	0	1	0	0	0	5	0	0	0	0	8	3	0	0	0	1	0	1	2	2	0	8	0	0	0	0	30	1	0	0	18	0	35	0	4	3	0	70	0	41	7	2	2	49	58	18	0	312	23	34	5	14	1	33	2	44	0	1	0	8	0	0	0	0	0	0	1	0	0	0	47	0	7	0	0	0	0	0	0	5	0	0	4	0	1	0	3	1	0	0	0	0	2	1	0	0	0	0	0	0	9	18	0	0	1	0	0	0	48	2	0	0	0	5	0	0	25	0	1	0	8	0	0	0	0	0	0	20	25	2	0	0	15	0	0	0	0	0	0	0	0	0	0	0	0	0	0	0	3	0	0	0	0	3	2	0	0	0	7	0	0	5	19	2	0	0	0	0	5	1	5	5	0	1	0	0	0	0	0	0	25	1	3	6	0	0	0	0	0	0	0	0	0	0	0	0	78	0	0	31	0	0	1	2	0	0	0	14	0	1	0	0	0	0	0	14	0	2	0	0	0	0	0	1	0	0	0	2	0	0	0	0	0	0	0	0	0	0	0	0	0	0	0	0	0	0	14	0	0	0	0	0	0	0	0	0	0	0	0	23	0	0	0	0	14	5	5	0	0	0	0	0	17	28	79	0	0	1	0	22	0	0	0	0	0	0	0	0	0	0	0	0	0	0	37	4	5	0	13	0	0	0	0	0	0	0	2	5	0	1	0	0	0	0	0	0	0	0	2	0	4	0	0	0	0	1	0	0	1	0	0	0	1	6	0	0	0	0	5	0	0	5	0	18	0	3	3	0	4	5	0	39	0	8	0	0	0	0	0	0	10	0	8	0	0	1	0	0	0	0	0	0	0	0	17	14	0	1	0	0	2	18	0	0	0	0	0	15	0	0	2	0	37	0	0	0	0	5	0	39	6	0	0	0	0	0	0	0	0	2	0	1	0	2	0	0	0	0	0	19	0	0	0	0	5	0	0	0	1	0	0	2	0	0	0	0	0	0	0	1	0	0	0	0	0	1	0	0	0	0	0	0	0	0	0	0	0	0	1	4	0	0	1	0	0	4	0	0	9	24	0	6	0	0	0	0	0	0	0	0	0	0	0	20	1	0	0	0	0	0	9	0	3	0	12	2	2	4	4	1	0	0	0	0	0	4	0	0	2	0	0	0	11	0	0	0	0	0	3	1	0	1	0	2	0	0	0	0	0	42	0	1	0	0	0	0	1	0	0	0	0	0	0	0	0	0	0	0	0	0	0	0	0	0	0	0	20	2	1	0	0	0	11	0	0	0	0	0	0	0	0	0	0	0	1	0	0	0	10	0	9	0	0	0	0	0	0	1	0	0	6	0	0	0	0	0	0	0	0	0	9	0	1	0	0	0	79	0	1	0	1	0	0	0	15	1	0	0	1	0	0	10	0	0	0	0	4	0	0	0	10	0	2	0	0	0	0	0	2	0	43	7	1	2	0	2	0	0	0	0	30	0	0	0	0	0	0	1	0	0	15	0	0	0	0	0	0	0	1	0	0	0	0	1	1	18	35	0	0	0	1	86	0	0	0	0	1	3	0	0	0	12	0	5	0	0	2	1	0	0	0	0	0	0	0	0	0	0	0	0	5	0	0	1	0	0	0	0	27	0	0	0	0	0	0	0	2	0	0	15	22	0	0	0	0	0	0	0	0	0	0	0	0	0	1	0	0	0	0	0	14	0	0	0	0	0	0	0	0	0	0	0	0	0	0	0	0	0	0	0	0	5	0	0	0	0	0	0	1	0	0	0	0	1	0	3	0	0	0	0	0	0	0	0	0	0	0	0	0	0	0	0	0	0	0	0	0	0	0	0	1	0	39	0	0	0	0	0	4	0	4	0	0	4	0	0	1	2	6	1	0	0	0	0	0	0	5	0	4	27	0	0	17	0	0	0	0	0	0	0	0	0	0	14	0	0	0	0	0	0	0	0	0	0	15	0	0	0	0	0	0	0	0	0	0	0	0	0	0	3	2	0	9	9	0	0	0	0	0	0	0	0	7	0	0	0	0	0	0	0	2	0	0	0	0	31	0	0	0	3	2	0	0	0	0	2	0	0	1	0	0	0	0	0	0	0	0	0	0	0	26	0	2	0	0	0	0	0	0	0	0	0	0	0	0	0	0	0	2	1	0	0	0	0	0	9	1	0	0	0	0	0	3	0	2	2	1	102	0	0	3	0	2	0	1	1	0	0	0	0	0	0	0	0	3	1	0	0	0	0	0	0	0	78	4	5	4	12	0	0	0	0	0	13	0	1	0	0	2	3	3	12	0	9	7	0	5	0	0	0	14	0	0	10	14	0	0	0	0	0	0	0	22	12	0	5	0	178	0	0	0	0	2	2	2	1	0	0	1	0	5	1	8	0	0	0	0	0	0	0	1	0	0	1	0	0	0	0	3	26	0	3	0	0	2	48	5	8	9	0	5	0	7	0	3	117	0	0	0	0	0	0	4	0	1	1	0	0	0	3	3	1	2	0	0	0	5	20	7	40	3	0	32	9	1	0	2	0	0	1	0	0	0	0	0	0	0	0	0	0	0	0	9	0	2	0	57	4	1	3	0	0	2	0	0	0	0	0	0	0	0	0	0	0	0	0	0	0	0	0	1	0	0	4	0	0	0	2	0	0	0	0	2	0	22	0	0	0	0	0	0	2	0	0	1	0	0	0	0	1	1	0	4	0	9	10	0	43	0	0	0	0	0	2	0	0	0	53	0	0	164	0	0	55	7	0	11	1	12	1	2	0	1	2	0	17	15	3	0	0	0	0	0	0	6	0	0	0	0	0	0	0	0	8	7	0	0	18	0	0	6	4	0	0	0	0	0	0	10	0	0	0	13	5	0	0	0	0	0	0	0	0	0	5	2	9	1	0	12	0	0	0	7	9	79	0	1	0	285	0	1	0	1	0	2	0	0	0	0	12	1	4	3	0	4	0	0	0	0	3	0	0	0	0	0	3	31	2	0	4	1	0	0	0	3	0	1	0	0	0	5	0	0	0	0	0	0	0	1	0	0	0	0	0	7	3	0	0	0	0	7	1	2	2	0	1	4	0	0	0	12	0	1	2	3	0	14	0	0	7	3	3	6	3	17	14	0	0	0	7	0	0	10	0	0	0	0	0	0	5	0	0	0	0	4	2	0	9	126	33	0	10	3	6	0	0	16	0	0	0	0	0	0	0	0	0	0	0	0	0	0	3	9	1	0	1	8	26	0	0	0	0	0	0	114	0	0	0	0	0	0	6	4	0	0	0	5	2	0	0	0	6	0	10	4	1	2	1	0	15	0	0	0	5	15	0	0	0	11	1	0	0	35	0	0	0	0	3	35	15	0	0	0	0	0	0	0	0	0	0	0	3	0	1	0	18	0	19	13	11	0	0	58	10	6	0	0	2	0	0	0	0	13	11	0	0	0	0	0	19	13	38	5	0	2	8	0	0	0	0	0	16	0	0	0	0	0	0	6	5	7	125	13	0	15	19	0	0	1	0	0	0	2	3	0	8	2	1	7	0	13	0	139	5	2	6	4	1	0	3	73	36	0	4	2	0	1	0	1	3	0	2	0	0	0	0	0	0	0	0	0	1	0	0	0	1	36	2	40	174	21	12	0	0	0	1	6	11	0	0	3	0	0	0	0	0	0	0	0	0	0	0	0	0	0	0	0	0	0	24	0	0	0	0	1	0	0	1	4	0	1	11	3	3	6	1	6	5	2	4	1	1	0	6	0	31	12	10	0	0	0	3	1	5	0	5	1	0	0	2	9	1	0	0	0	0	0	0	5	8	0	0	0	0	0	3	0	0	0	0	0	0	0	0	14	1	0	1	16	1	0	0	0	0	0	2	0	1254	0	0	0	1	67	3	4	0	0	0	0	0	0	0	0	6	0	9	0	0	0	0	0	0	0	0	1	0	0	10	0	0	0	0	0	0	0	0	0	24	19	0	0	1	0	0	0	4	6	0	0	5	0	0	0	0	0	0	0	1	0	2	0	0	0	0	2	2	0	2	5	1	32	0	0	1	0	8	9	3	0	0	12	0	0	0	1	61	0	0	0	0	0	0	0	0	0	0	0	31	8	0	7	25	0	3	1	0	11	0	36	0	3	1	0	0	0	0	1	0	0	23	0	0	0	1	2	0	0	0	4	2	0	0	1	0	0	0	0	0	420	13	5	0	8	498	0	12	6	20	8	0	18	4	6	0	5	5	2	0	8	45	46	73	15	17	0	0	0	70	0	7	0	1	0	19	6	0	0	689	0	4	0	0	0	0	0	1	0	0	0	1	1	40	9	2	4	9	26	0	0	0	0	6	6	0	3	0	0	0	0	0	0	1	0	0	0	1	14	0	8	2	1	0	2	13	0	0	0	5	0	2	2	2	0	5	0	0	5	22	0	0	0	0	0	0	0	0	0	2	0	2	7	0	11	3	0	0	16	72	197	0	0	10	24	18	2	13	27	0	9	0	4	1	0	42	0	0	0	1	3	78	4	0	6	3	30	8	0	0	7	4	0	0	15	7	1	0	0	0	12	1	0	3	0	17	0	1	1	0	0	7	0	0	14	0	2	0	0	0	0	0	0	7	3	0	0	0	0	0	57	1	0	0	0	0	26	3	13	0	9	6	0	0	0	49	2	0	29	62	0	3	6	3	0	0	0	0	1	1	1	3	0	13	3	14	2	1	0	0	0	0	0	0	23	0	0	0	0	0	0	0	0	0	0	0	2	2	5	0	1	0	0	0	0	0	0	19	6	0	0	0	0	0	0	0	1	0	0	0	0	0	0	0	7	0	0	0	0	0	4	0	0	0	0	1	0	0	0	5	0	0	1	0	0	0	0	0	0	1	0	0	0	0	0	0	0	0	9	0	0	19	0	4	0	0	0	15	0	0	0	0	8	3	0	0	8	1	0	1	4	5	5	0	0	2	0	0	23	0	0	3	15	3	0	0	0	0	1	5	0	0	0	0	34	3	16	5	13	10	3	9	1	2	0	14	4	35	9	6	11	15	6	11	5	1	0	3	0	4	0	0	13	1	1	10	9	6	29	4	27	11	89	38	5	24	5	0	11	7	5	4	8	0	0	1	0	120	216	15	1	1	62	11	0	29	241	90	6	396	0	153	3	9	1	0	0	1	3	1	5	0	18	0	145	624	23	0	1	36	0	0	0	0	0	52	11	38	28	33	1	136	3	3	26	0	2	2	11	14	0	3	0	1	0	2	7	3	2	12	4	2	3	2	2	1	6	0	0	1	0	0	0	0	2	0	0	4	0	0	0	0	23	0	0	0	0	0	3	2	0	0	0	0	2	0	0	0	0	0	0	0	0	0	0	0	0	0	0	5	0	0	0	0	0	0	0	23	0	5	9	0	3	0	0	8	60	0	0	12	0	0	5	3	0	0	0	0	0	0	30	0	0	0	0	0	23	0	2	0	0	0	1	0	0	0	0	2	0	0	0	0	0	0	0	0	0	0	0	13	0	0	0	0	5	0	17	14	5	17	0	11	0	8	0	0	0	0	0	3	0	0	0	0	0	0	0	0	11	3	2	0	0	0	0	0	8	0	0	17	3	4	0	12	0	4	1	0	148	10	0	0	0	2	0	0	5	11	10	26	3	0	0	7	0	0	2	4	17	0	0	0	6	1	3	0	0	1	5	11	7	0	2	15	0	0	0	55	74	3	2	0	0	0	0	0	0	0	0	5	10	0	2	1	0	0	0	3	0	0	0	0	0	0	1	4	1	0	0	0	0	0	1	0	9	0	13	0	0	0	1	0	0	0	0	0	1	1	4	0	0	12	0	3	13	0	0	5	7	0	0	3	14	0	0	2	0	0	0	0	0	0	0	0	1	3	0	1	0	1	0	0	1	0	0	0	1	4	0	0	4	0	0	0	0	0	0	1	23	3	7	0	18	7	14	0	0	17	0	2	2	1	0	0	0	19	0	0	1	0	0	0	0	0	0	0	0	0	0	3	2	1	0	2	3	0	0	0	1	0	9	0	0	0	0	1	0	0	0	0	0	0	0	0	1	19	0	2	1	0	6	11	0	0	0	11	4	0	1	15	0	23	2	3	310	0	0	16	0	0	0	0	0	0	0	0	0	3	30	0	6	1	2	2	0	0	0	2	0	0	0	0	0	0	4	0	0	0	0	0	0	0	0	0	0	3	3	0	0	0	36	1	0	2	0	24	4	4	0	0	0	0	3	5	0	0	0	0	21	5	0	0	0	0	0	0	12965	0	0	0	0	0	0	0	0	0	0	0	0	0	0	0	0	1	0	0	0	0	11	3	2	23	2	4	3	5	0	0	0	0	0	0	5	0	1	12	0	19	13	0	0	0	4	2	6	0	0	0	0	1	0	40	65	13	4	2	24	14	13	0	3	0	0	15	0	0	121	5	26	2	0	0	0	83	3	11	0	2	2	26	4	2	1	0	0	0	5	0	2	0	0	6	10	0	11	0	0	0	5	4	0	0	5	4	0	4	0	1	0	0	0	0	0	0	0	26	24	44	8	4	0	1	2	0	0	13	0	29	7	2	1	2	0	10	4	0	0	4	4	0	0	0	1	0	58	83	23	3	1	0	2	0	0	5	3	4	2	4	4	0	0	0	0	0	0	0	0	0	4	1	7	2	1	1	17	1	0	4	4	0	0	0	0	5	7	32	0	2	8	17	3	1	1	0	39	0	0	0	2	1	0	16	8	13	0	9	0	0	0	14	4	0	0	0	0	0	0	0	0	0	0	0	0	0	1	13	0	0	0	7	3	1	0	0	0	0	0	0	1	7	0	0	0	6	0	0	0	10	48	0	0	1	0	4	37	0	2	17	0	0	1	0	0	1	0	0	0	0	0	0	0	0	0	0	0	0	0	0	0	24	0	0	0	0	0	0	3	0	0	0	0	0	0	0	0	0	0	0	0	0	0	0	0	0	1	0	0	0	0	12	0	2	0	0	0	0	4	0	17	0	0	0	0	1	2	0	20	0	0	0	62	4	1	10	7	0	0	1	7	7	0	0	1	1	11	0	22	0	0	0	0	0	0	0	0	0	2	0	0	0	0	7	3	0	0	0	0	7	10	0	0	0	0	0	0	2	1	6	6	2	0	30	0	76	11	2	7	13	0	0	6	16	16	5	1	127	0	0	49	8	72	0	1	0	0	0	0	0	0	1	0	0	37	2	8	0	0	0	1	4	0	0	0	0	0	0	4	0	0	0	2	0	8	0	2	0	5	0	1	67	0	0	1	0	0	6	7	0	0	0	0	0	0	0	9	19	3	0	12	10	16	2	0	0	44	7	1	77	0	2	0	0	0	0	2	3	0	0	0	0	0	0	2	1	0	0	0	4	0	0	1	0	0	12	0	5	45	0	0	0	7	0	0	3	0	0	0	0	0	80	0	1	0	0	0	1	8	2	0	1	0	0	0	0	0	0	0	0	0	0	0	0	4	0	0	0	0	0	2	1	0	0	1	36	0	49	1	0	0	0	0	0	0	1	0	0	0	0	0	0	1	1	0	0	0	1	51	0	3	0	0	6	1	6	0	0	0	0	0	0	0	0	0	0	0	0	0	0	0	0	0	0	0	1	0	0	0	0	0	0	0	0	0	0	13	0	0	0	72	0	0	0	0	1	68	4	0	0	8	3	0	1	0	1	2	5	0	0	6	4	8	10	36	1	22	153	0	0	3	1	0	0	4	4	0	0	0	0	0	0	0	68	0	0	1	0	89	0	0	0	0	0	186	0	1	1	0	0	4	0	0	0	3	0	0	0	0	0	2	0	0	0	0	11	15	0	0	0	0	0	0	0	1	1	0	0	0	0	0	1	8	7	0	0	0	0	1	0	0	0	8	0	0	3	2	1	0	0	0	1	0	2	6	7	99	1	0	6	0	0	3	0	0	1	0	4	9	18	0	19	68	0	5	94	0	0	0	0	0	0	0	3	1	0	0	0	0	1	18	0	6	0	5	0	0	0	0	8	0	0	2	45	73	1	20	0	0	7	38	0	0	0	0	0	1	0	0	8	2	0	2	0	0	2	0	0	0	0	1	0	0	0	0	29	4	0	0	0	3	0	0	0	0	0	3	3	13	0	2	30	2	6	0	0	0	0	3	5	0	3	660	19	22	0	0	33	0	10	20	44	0	0	0	0	0	0	4	0	0	49	0	0	0	1	9	3	0	4	0	0	0	0	12	3	0	28	4	0	2	0	0	4	0	0	4	23	12	0	0	0	0	13	0	0	3	0	0	0	0	0	0	0	0	0	0	0	0	0	0	0	0	0	0	0	0	0	0	0	0	0	0	0	0	0	0	8	0	0	5	0	0	0	0	0	0	0	0	0	0	0	0	1	0	0	0	3	1	6	2	0	0	340	0	1	0	7	0	6	0	0	0	0	5	0	7	3	1	0	5	1	0	10	0	3	0	0	0	0	0	0	1	0	0	0	23	0	3	0	0	4	8	0	0	1	0	0	5	10	0	5	0	1	0	0	0	0	8	12	13	6	6	1	7	8	0	8	2	0	0	0	0	0	0	2	0	7	3	0	6	0	10	1	0	0	0	0	2	0	1	0	0	0	1	0	0	0	0	25	0	0	0	0	0	0	2	0	0	1	4	1	3	0	13	0	10	11	0	3	3	0	27	33	15	0	0	0	0	0	1	0	1	2	380	10	13	19	0	0	0	0	0	0	0	0	0	0	0	0	0	0	1	0	10	39	49	0	1	22	3	4423	9	0	0	4	0	0	0	0	1	0	39	0	0	7	5	0	0	0	0	0	1	0	0	0	0	0	0	1	14	0	10	7	0	1	0	0	0	1	12	0	21	0	0	1	0	2	0	1	0	13	0	0	0	3	3	0	0	0	0	0	0	5	0	0	0	0	0	1	0	0	0	0	0	0	0	0	0	0	0	0	0	1	0	0	0	0	0	0	0	0	206	214	0	0	2	4	0	23	16	1	0	1	0	7	0	0	0	1	0	0	0	0	0	0	0	3	0	0	0	0	0	7	0	0	0	0	0	150	0	0	0	0	1	0	0	0	0	0	0	2	0	0	1	3	0	0	0	0	0	0	0	0	0	0	0	2	0	1	0	8	17	19	0	12	0	0	0	0	0	0	0	0	1	0	0	0	0	8	8	0	7	6	0	0	0	0	0	0	1	0	0	0	0	0	0	0	0	0	0	1	0	0	0	0	0	0	0	0	0	0	8	0	0	0	0	0	0	0	9	0	0	0	0	0	0	0	0	0	5	0	0	0	0	1	0	0	0	1	0	0	0	1	0	0	0	0	0	0	0	0	0	0	0	7	0	3	68	0	0	0	1	0	0	1	0	0	0	0	0	1	0	0	0	0	0	0	3	0	0	1	0	0	0	0	0	0	0	0	1	0	0	0	0	0	0	0	0	0	0	23	0	0	0	0	0	1	0	0	0	0	0	0	15	0	0	0	0	2	0	0	23	0	0	0	0	0	0	0	0	0	0	0	0	1	0	0	5	0	0	0	0	0	2	0	0	0	0	0	0	0	0	0	0	0	0	0	0	0	0	0	0	0	0	0	0	0	0	0	0	0	0	0	0	0	0	0	0	5	0	0	0	0	90	0	0	0	0	0	0	0	7	0	0	0	0	0	50	0	61	7	0	0	0	2	0	4	3	0	3	137	0	9	0	0	51	1	2	0	0	1	0	1	0	1	0	1	6	0	0	2	6	0	1	3	0	5	0	0	1	2	3	0	6	0	0	0	0	2	8	0	27	5	1	5	0	1	9	0	3	0	6	1	0	3	15	0	0	1	8	1	1	21	1	0	2	1	11	8	0	0	0	0	26	17	7	2	2	0	6	0	0	1	1	4	0	2	22	0	0	206	0	0	1	0	1	0	109	1	17	10	2	0	2	0	2	9	3	2	1	0	0	1	0	6	1	17	0	5	11	7	5	51	19	20	4	0	0	3	8	0	10	0	2	0	0	0	0	0	0	7	0	1	0	0	0	0	0	1	0	0	4	9	0	0	0	0	0	2	0	27	0	34	13	1	6	0	2	20	0	0	0	0	0	0	8	0	0	0	0	0	1	0	0	2	0	1	0	1	0	0	0	0	14	0	0	0	0	0	0	0	0	0	0	0	0	1	1	0	0	0	0	9	0	0	1	0	0	0	0	3	0	0	0	0	0	27	0	0	3	7	0	0	0	2	0	13	0	25	0	0	0	1	0	0	0	0	0	1	0	0	0	0	0	0	11	3	23	0	3	0	0	1	0	0	0	0	0	20	1	1	0	0	0	0	0	0	0	0	0	0	0	0	0	0	0	0	0	0	0	0	7	3	0	3	3	10	0	0	0	0	0	1	0	9	0	8	7	45	0	0	1	0	0	2	29	0	0	0	10	5	0	0	1	0	2	1	19	209	0	10	4	14	0	0	0	0	0	1	5	0	0	0	0	0	1	0	0	0	8	0	0	0	2	13	0	0	1	0	0	0	0	0	0	0	4	1	2	8	10	2	3	1	44	0	4	1	0	9	0	0	9	11	1	2	0	0	0	0	1	4	0	0	0	0	12	4	0	0	0	1	0	0	0	0	0	0	1	0	8	4	1	0	0	19	1	0	0	0	0	0	0	1	0	0	1	4	1	4	0	3	0	30	0	0	0	0	0	0	2	0	5	0	10	0	0	1	0	1	5	12	0	12	7	10	5	248	6	0	0	2	0	0	0	0	0	0	1	0	0	0	0	0	0	0	1	22	2	0	5	5	1	1	6	0	2	1	8	14	3	0	6	0	0	0	0	6	2	16	14	10	0	0	0	8	0	9	0	22	7	0	11	1	22	41	7	0	22	0	0	6	4	1	1	0	0	0	0	1	8	0	23	0	5	1	0	19	0	0	21	6	8	0	0	3	1	15	3	0	0	10	14	0	0	7	0	0	0	0	13	0	0	5	0	0	0	0	0	0	0	15	1	1	0	0	0	0	10	0	0	0	0	0	0	0	0	0	0	1	0	0	30	1	2	0	4	0	0	0	3	0	0	0	0	0	14	0	0	5	0	3	4	2	51	0	0	0	1	796	1	0	1	0	0	24	0	0	1	0	0	0	0	2	0	6	0	0	4	1	4	0	0	0	1	0	0	0	34	0	0	0	8	0	0	2	0	0	5	0	2	29	0	0	0	0	0	16	10	0	0	1	1	0	3	0	0	0	0	0	0	0	2	6	3	2	0	0	0	0	1	0	0	0	0	0	71	16	2	0	17	0	0	17	15	1	9	0	4	3	2	2	2	8	1	8	23	1	6	6	0	2	0	1	0	5	0	7	0	1	0	0	1	0	0	0	0	0	0	0	0	0	0	6	0	3	0	6	0	35	0	0	0	0	0	0	0	0	0	0	0	0	0	0	0	0	0	0	0	0	0	0	0	0	0	0	1	4	1	0	0	0	0	0	0	0	0	0	0	0	0	0	0	0	0	0	0	0	0	0	0	0	0	11	1	0	41	1	6	1	0	0	0	0	4	1	4	4	0	2	7	0	0	0	0	0	5	0	0	0	0	0	0	0	1	10	1	22	1	5	0	12	3	9	25	1	0	0	0	0	0	0	0	0	0	1	0	4	1	1	3	6	8	3	5	14	1	4	0	5	2	2	0	0	12	5	0	0	0	0	0	0	3	7	0	0	0	0	0	0	0	0	0	1	0	0	39	2	0	0	0	26	0	0	0	0	0	0	0	0	35	0	0	1	0	47	42	0	0	0	2	5	0	5	0	0	5	0	0	0	3	0	14	20	2	4	2	16	0	0	0	6	0	0	0	0	0	1	2	0	15	1	0	2	0	2	0	1	0	0	0	1	6	0	3	0	4	1	0	0	22	1	0	1	5	1	0	0	0	1	0	0	2	4	0	0	0	3	0	19	0	0	0	1	0	0	0	0	0	0	10	0	0	0	0	0	0	0	0	1	0	0	0	0	0	0	1	5	1	0	13	0	0	0	0	0	2	10	1	26	0	0	5	0	0	56	6	6	2	4	0	0	82	33	0	9	36	0	0	0	4	21	49	0	0	1	0	5	12	2	0	0	0	0	0	1	6	3	0	0	8	7	3	4	0	0	0	0	0	0	47	0	3	0	0	0	0	0	0	0	0	17	5	46	2	7	1	3	0	13	0	0	0	0	0	0	0	0	0	0	0	6	0	3	0	3	1944	0	0	11	0	251	38	1	0	0	4	25	14	67	22	6	27	7	113	0	11	25	0	0	0	0	0	0	7	0	203	25	1	0	0	0	0	0	0	2	0	0	0	3	0	0	0	5	51	0	0	0	89	9	5	4	1	3	1	0	2	0	1	32	0	0	6	0	0	0	0	0	0	0	0	0	11	1	0	0	0	0	0	0	0	0	0	0	0	0	0	0	18	0	0	0	0	30	10	1	0	4	1	0	0	0	0	0	0	2	1	5	0	16	0	6	2	0	0	0	3	0	6	9	0	0	18	7	2	4	7	44	37	3	8	2	46	2	27	32	4	0	0	0	0	0	0	0	1	0	0	0	0	0	0	0	4	0	0	0	2	0	0	2	1	0	3	0	0	3	0	19	0	0	0	0	10	0	0	2	0	0	1	1	5	0	1	0	0	0	0	0	0	0	0	0	0	0	0	0	0	0	14	0	0	0	0	0	0	0	0	0	0	0	0	0	0	0	3	3	0	10	0	50	24	0	111	0	0	3	0	0	0	0	6	1	0	0	0	0	0	0	3	15	2	0	0	18	3	17	5	4	0	170	0	66	84	0	0	0	0	0	0	0	0	1	113	191	7	5	1	1	29	0	1	4	1	0	0	0	2	7	0	0	2	8	1	1	0	1	0	0	0	0	0	4	0	0	0	2	16	0	0	0	0	1	0	0	0	0	0	0	0	0	0	1	0	0	0	0	0	0	0	0	0	0	0	1	4	0	7	2	0	7	0	6	5	19	9	0	0	0	0	0	0	0	0	0	111	0	0	42	1	0	0	0	0	0	8	0	1	0	3	0	0	0	0	1	0	0	0	6	0	0	0	0	0	1	0	68	0	5	0	25	23	0	3	0	4	2	0	0	870	10	0	0	3	54	2	0	7	0	0	4	1	0	1	0	9	3	0	1	2	0	0	0	0	0	0	0	1	0	122	0	0	0	1	0	2	0	7	0	3	0	0	0	0	0	0	2	1	0	9	7	0	0	0	0	0	0	0	0	0	0	1	0	0	12
LakWasM110_LOW13_2_rpkm	0	0	0	0	0	0	0	0	0	0	0	3	3	5	0	0	0	0	0	0	0	0	0	0	0	0	0	0	0	1	0	0	0	0	0	0	0	0	0	0	0	0	0	0	0	1	0	10	0	0	0	1	0	0	0	1	0	0	4	16	1	0	0	0	0	0	0	0	0	0	0	0	0	0	0	0	1	0	0	0	0	6	1	0	0	0	0	0	0	0	0	1	0	0	2	0	0	0	0	0	0	0	0	0	0	1	0	0	0	0	1	0	0	0	0	0	0	0	0	0	0	0	0	0	0	0	3	0	0	0	0	5	20	0	0	0	0	0	0	0	0	0	0	1	0	0	0	0	0	0	0	0	0	0	7	0	0	0	3	0	0	0	1	0	0	0	0	2	0	9	1	0	0	0	0	0	0	0	0	0	0	0	0	0	0	27	0	0	0	0	0	1	0	0	0	0	1	5	0	0	0	0	0	0	0	0	0	0	0	0	1	0	0	1	0	0	0	0	0	12	0	0	0	1	0	0	2	0	10	0	0	2	0	0	0	0	1	1	1	1	0	0	1	0	2	0	0	0	1	0	0	0	18	0	17	9	0	0	0	0	0	0	0	1	1	0	122	0	0	5	47	0	2	0	0	0	0	0	0	1	0	2	1	1	1	0	0	0	0	0	0	0	0	0	0	0	0	10	1	0	0	6	0	0	0	0	0	3	10	0	0	0	1	0	0	0	0	0	76	0	0	0	0	0	6	0	1	0	0	0	0	1	0	0	0	0	0	1	0	0	0	0	2	1	0	0	0	0	13	0	0	0	0	0	0	0	0	0	0	11	0	0	0	0	0	0	0	0	1	0	1	6	0	12	12	0	0	0	0	3	1	0	0	0	4	0	3	0	0	0	0	0	14	0	0	2	0	0	0	0	3	0	0	1	0	0	0	0	0	0	0	0	0	2	0	0	0	1	0	5	0	0	2	0	0	0	0	0	0	0	0	0	0	0	0	4	0	1	1	0	3	1	0	0	0	3	0	0	0	0	0	6	0	295	0	0	1	0	0	0	0	0	0	1	0	3	1	0	0	0	1	16	2	0	0	0	7	0	3	2	6	1	11	838	1	0	0	13	10	0	0	0	7	25	2	0	5	0	0	0	0	0	1	0	0	1	0	0	0	0	0	0	0	0	0	0	0	0	0	6	0	0	0	0	0	0	0	0	0	0	0	0	4	0	0	0	0	3	0	0	0	0	0	1	0	0	0	1	0	10	0	0	2	2	0	0	0	3	0	0	0	2	0	0	0	0	0	0	0	0	0	0	0	0	0	0	3	7	3	0	0	25	4	1	3	0	0	2	16	0	0	0	1066	0	56	2	0	0	4	0	1	0	0	1	0	1	0	1	0	51	1	8	35	27	0	0	5	0	4	0	1	1	0	0	0	4	0	0	0	0	0	0	0	0	3	0	0	0	6	1	0	11	0	0	0	0	2	0	1	1	1	1	0	12	4	0	0	0	1	0	0	4	0	1	0	0	0	0	0	0	0	0	6	0	0	0	0	2	0	0	0	0	3	0	0	0	0	0	0	5	0	0	1	0	0	0	0	0	0	0	0	5	0	2	2	0	3	0	0	0	0	0	0	0	1	5	0	0	3	5	0	0	0	3	0	0	0	0	0	0	0	0	0	0	0	0	1	0	0	0	0	1	0	0	1	0	0	0	0	0	0	0	3	0	0	0	0	0	3	3	0	0	0	3	0	0	0	0	0	0	0	0	0	0	4	1	0	0	0	0	0	0	0	0	0	0	0	0	0	0	0	3	0	0	0	0	0	7	0	3	0	0	0	0	1	0	2	0	0	0	0	0	0	0	0	0	0	0	0	0	0	0	0	0	1	0	0	0	26	1	0	0	0	0	0	0	0	6	8	0	0	0	0	0	0	0	0	0	1	5	0	0	1	0	0	0	0	0	0	0	0	0	0	0	0	0	0	0	4	0	0	0	0	0	0	0	0	0	1	0	0	0	0	0	0	0	2	0	0	0	0	0	0	0	0	0	0	0	0	0	0	4	3	27	0	0	0	0	0	0	0	0	0	0	0	0	0	7	0	0	0	2	0	0	0	0	0	0	0	0	0	0	0	0	0	0	0	0	0	3	0	0	0	0	0	0	0	0	0	0	0	0	0	0	0	0	0	0	0	0	0	0	0	0	0	0	0	0	0	0	0	0	0	5	0	7	0	0	0	0	1	0	0	0	40	0	0	0	0	0	0	0	0	0	0	0	0	0	0	0	0	0	1	0	0	0	0	0	0	1	0	0	1	0	0	0	0	1	0	0	0	1	1	0	0	0	0	0	11	0	1	0	0	0	0	0	2	0	3	0	0	0	0	0	0	0	0	0	0	0	0	0	0	0	0	0	0	0	0	0	0	0	0	2549	0	0	0	0	0	1	0	0	0	0	1	0	0	2	1	0	0	0	0	0	0	0	0	0	0	0	0	0	1	0	0	0	0	0	0	0	0	0	0	0	0	4	12	0	1	58	0	63	0	0	0	0	0	13	0	0	1	1	0	0	0	0	0	1	15	0	0	0	0	0	0	0	0	0	0	0	0	0	0	0	0	0	0	0	0	0	0	2	0	0	0	0	0	0	0	0	0	0	0	0	0	0	0	0	0	0	0	0	0	0	56	0	1	0	2	0	0	0	0	0	0	0	0	2	0	0	0	1	2	4	0	4	0	0	0	1	0	0	0	0	0	1	0	0	0	0	0	0	0	0	0	1	0	0	0	0	0	0	0	0	0	0	0	0	1	0	0	0	0	0	0	0	0	0	0	0	6	0	0	0	0	0	27	0	0	0	1	0	0	0	2	0	0	0	1	0	1	0	0	2	0	6	0	0	0	0	0	0	3	18	0	5	0	0	0	0	0	0	0	0	0	35	4	2	11	1	0	0	0	0	0	0	0	0	1	0	0	0	0	0	0	0	0	0	0	0	0	0	0	0	0	0	0	0	0	1	0	0	0	0	0	0	1	0	0	0	0	0	0	0	8	0	1	5	1	0	0	0	0	9	0	0	2	0	1	0	0	0	1	0	0	0	1	0	0	0	0	0	0	0	1	0	0	0	1	1	0	0	0	1	0	0	1	0	0	0	0	0	0	0	1	0	0	0	6	4	0	2	5	0	0	0	0	0	0	0	0	0	0	0	1	0	0	0	0	6	0	0	9	0	1	0	8	0	0	0	0	0	0	0	0	0	0	3	0	0	0	0	5	0	1	0	0	0	0	0	0	0	0	5	0	0	0	0	0	0	0	0	3	7	0	12	25	0	0	0	0	0	0	0	2	6	5	0	0	5	0	1	0	0	51	18	2	9	0	0	0	4	0	0	2	0	0	0	0	0	6	0	0	3	5	2	0	1	0	9	0	0	0	0	0	0	1	0	0	0	0	0	0	0	0	0	0	0	0	5	0	0	0	0	0	0	0	0	0	0	0	0	0	1	0	6	0	0	0	0	0	0	0	0	0	0	0	0	0	15	0	0	2	0	0	0	0	0	0	0	0	0	0	0	0	0	0	0	0	0	0	0	0	0	0	0	0	0	0	0	0	0	0	0	0	1	0	2	0	0	0	0	3	0	0	4	0	2	20	0	0	2	0	0	0	1	1	0	0	0	2	0	0	0	0	0	0	0	7	0	0	0	0	0	0	0	3	0	0	3	0	0	0	0	0	0	0	10	0	5	1	2	0	1	0	0	0	0	0	0	0	0	0	0	0	0	0	0	0	0	2	0	3	3	0	0	0	1	0	0	0	0	0	0	0	0	0	0	0	0	0	0	0	0	0	0	0	0	1	2	185	3	6	1	2	0	0	0	0	0	0	0	0	0	0	0	1	0	0	0	0	1	0	0	0	10	2	0	1	0	0	27	0	0	0	2	4	0	0	0	0	0	0	0	0	0	0	0	0	0	1	2	0	0	0	0	0	1	0	0	0	0	0	0	0	1	0	4	1	13	0	0	0	1	0	4	0	0	0	0	0	0	0	0	0	0	0	1	0	0	0	0	0	0	0	0	0	0	0	0	0	0	0	0	0	0	0	2	18	0	0	0	0	0	2	0	0	0	4	0	7	28	2	0	0	0	0	0	0	0	0	0	0	1	0	0	0	0	0	2	0	0	0	0	0	7	2	67	0	1	0	0	0	0	0	0	0	0	0	0	6	0	0	10	3	17	24	0	0	0	0	0	0	0	8	0	0	0	0	0	0	0	13	2	5	0	0	0	8	0	0	0	12	0	0	0	0	0	2	0	0	2	0	0	0	0	0	0	0	0	0	0	0	0	0	0	1	0	0	16	0	0	26	0	0	0	0	0	0	0	0	0	0	0	0	0	1	0	0	0	0	0	1	0	0	0	0	0	0	2	3	0	3	1	1	0	0	0	0	0	0	0	0	0	0	0	0	0	0	0	0	0	2	212	1	0	0	0	0	0	0	0	20	0	10	3	15	2	0	0	11	0	1	10	8	1	0	0	0	0	0	0	0	0	0	1	0	0	1	1	0	0	0	1	0	0	0	0	0	0	0	0	0	2	0	1	0	0	0	0	21	0	0	0	50	1	1	0	0	0	0	0	0	0	0	0	0	0	0	0	0	0	0	0	5	0	3	0	0	0	0	3	0	0	0	0	0	0	0	0	0	1	1	1	0	0	0	0	0	0	0	0	1	2	0	3	0	0	0	0	0	0	0	0	0	0	4	0	1	0	0	0	1	0	3	86	0	0	0	0	0	0	1	0	0	0	0	2	0	0	0	0	0	8	0	0	0	1	0	1	78	3	0	0	1	0	0	0	1	0	0	0	0	0	0	0	0	0	0	0	0	0	2	0	0	0	0	0	0	0	1	0	0	0	0	0	2	0	0	0	1	0	0	2	0	0	0	1	0	11	4	0	0	0	0	0	55	0	0	0	0	0	0	0	0	1	4	1	5	2	0	0	0	9	0	0	2	6	0	0	0	0	1	0	0	0	1	0	0	0	4	0	0	1	0	0	0	0	0	0	23	29	0	0	0	0	1	3	0	5	3	0	1	0	21	0	0	0	0	0	0	0	0	0	0	0	2	0	0	3	0	0	0	0	0	0	0	0	0	0	0	0	0	2	0	0	2	0	3	0	0	0	0	0	0	0	0	0	1	0	0	0	0	0	0	0	0	0	0	0	19	0	0	0	0	0	0	0	0	0	2	0	0	0	0	1	0	0	0	0	0	0	0	0	7	0	0	2	0	0	0	0	0	1	0	0	0	1	0	0	1	0	1	0	0	0	0	0	0	0	0	0	1	7	125	2	2	1	3	1	0	7	1	3	1	1	0	0	0	2	6	0	1	0	5	8	0	4	0	2	3	0	12	0	2	2	0	1	0	0	0	0	0	0	0	0	2	6	0	0	0	0	0	0	0	0	0	0	0	0	0	0	0	0	0	0	1	0	0	0	2	0	18	0	0	0	4	0	2	0	0	0	22	2	0	0	0	0	0	0	0	0	0	0	0	0	0	0	0	6	1	0	0	0	1	0	0	0	0	0	0	0	2	4	0	0	1	0	21	0	0	1	0	0	0	0	0	1	1	0	0	0	0	3	0	4	0	0	0	0	0	0	0	1	0	0	0	0	0	0	0	0	0	13	5	0	0	2	0	0	0	0	0	0	0	0	0	0	0	0	0	0	0	0	0	0	0	0	0	0	4	0	0	0	0	0	0	0	0	0	0	4	0	1	0	6	0	0	0	0	0	0	1	0	1	0	0	0	0	0	0	0	0	0	0	0	1	0	0	0	0	0	1	0	0	0	0	0	7	0	0	0	0	0	0	0	0	0	0	0	0	8	0	3	1	0	0	0	0	0	1	0	0	0	0	0	0	0	0	0	0	0	3	0	0	0	0	0	4	0	0	15	0	1	0	1	0	10	2	0	9	0	0	0	0	0	0	1	0	8	0	0	0	0	0	0	1	0	0	4	0	0	0	0	0	0	0	0	0	8	0	0	0	0	0	0	0	0	0	0	0	0	0	0	0	3	0	9	4	5	0	0	0	0	0	0	0	0	0	0	0	0	0	0	0	0	0	0	1	5	0	2	0	0	0	1	0	0	0	0	0	0	0	0	0	0	3	0	0	0	0	4	0	0	0	0	0	0	1	0	0	0	0	0	0	0	0	0	8	1	0	1	0	0	0	0	0	0	0	0	2	0	0	0	0	0	0	0	0	0	0	0	0	2	0	0	0	0	0	0	0	0	0	0	0	0	0	0	0	0	0	1	0	0	8	0	0	0	0	4	0	0	0	0	0	1	0	0	0	0	0	0	0	0	0	0	40	0	0	10	0	18	0	7	4	0	0	0	0	1	0	0	0	0	0	0	0	0	0	0	0	0	0	0	1	0	0	0	3	0	0	0	3	0	0	0	0	2	0	1	0	0	0	74	0	0	0	0	0	0	0	1	0	3	0	0	0	0	0	0	0	0	0	1	0	4	1	1	3	2	0	0	0	0	5	0	0	0	0	0	0	0	4	0	0	1	0	0	0	0	10	3	0	0	0	0	0	2	27	1	0	0	0	14	2	0	0	0	0	3	0	0	0	0	0	0	0	0	0	0	0	10	0	1	0	0	3	0	0	0	0	0	0	0	0	0	0	7	0	0	53	22	9	0	11	0	1	0	0	0	1	0	0	0	0	0	0	0	0	0	0	0	0	0	0	1	0	2	0	0	0	0	0	11	0	0	0	0	0	16	3	0	0	0	2	0	0	0	0	0	5	0	0	0	0	6	4	0	0	0	20	0	0	0	0	0	0	0	19	8	2	3	0	0	0	0	0	0	0	3	0	0	0	0	0	0	1	20	0	0	0	0	0	0	0	0	40	0	2	0	0	0	18	0	0	0	0	0	0	0	0	0	0	0	0	0	0	0	118	37	0	1	0	0	0	0	4	1	0	0	0	0	0	0	0	1	0	6	0	0	0	0	0	57	2	1	0	0	3	0	0	0	0	0	0	0	0	0	0	0	0	0	0	0	0	62	0	0	0	0	1	0	0	0	0	0	0	0	0	0	0	0	0	0	0	0	0	0	0	0	0	0	0	0	0	0	0	0	0	0	0	0	0	0	0	0	0	6	0	0	0	1	0	0	0	0	0	0	0	0	0	0	0	0	0	0	0	0	0	0	0	0	225	0	0	0	0	0	1	9	0	0	0	0	0	0	0	45	3	0	0	0	0	0	48	0	2	0	0	0	0	2	0	0	1	0	0	0	9	1	0	0	0	0	0	0	0	0	0	1	0	0	0	0	0	0	0	0	0	0	0	0	1	0	8	0	0	0	0	0	0	0	0	0	0	0	0	0	0	0	0	0	1	1	0	0	0	0	0	1	0	0	0	0	0	0	0	3	0	16	0	0	0	0	0	0	0	0	0	0	0	0	0	0	0	0	37	1	2	5	0	0	0	0	0	0	0	0	1	0	0	0	0	1	0	0	2	0	128	2	0	0	0	0	0	0	0	112	0	1	0	0	0	0	0	0	4	1	0	1	0	0	0	0	0	0	0	0	0	0	6	4	41	0	0	0	2	4	0	0	0	0	0	0	0	0	1	20	0	5	0	0	0	0	0	0	2	51	0	0	0	0	0	0	0	0	0	0	1	0	0	0	0	2	0	0	0	0	15	0	5	0	0	0	8	0	0	0	0	0	4	0	0	0	0	0	0	0	0	0	2	0	2	0	0	0	0	0	0	25	0	0	0	0	0	0	0	9	0	0	0	0	0	2	0	0	0	0	0	0	0	0	0	1	0	0	0	0	0	1	0	0	0	0	0	0	0	0	0	0	0	0	0	0	1	0	0	0	15	0	0	0	0	0	0	0	0	0	0	0	0	0	0	0	0	0	0	0	0	0	0	2	0	0	0	0	0	0	1	0	0	5	1	0	0	0	0	0	0	0	0	0	0	1	0	0	2	0	0	1	0	0	0	0	0	0	0	0	0	0	0	0	0	0	0	0	0	0	0	1	0	0	1	4	2	0	0	3	1	0	3	0	0	0	0	0	0	0	0	0	0	11	0	7	0	0	0	0	2	0	0	0	1	17	1	0	0	0	0	0	0	0	0	0	0	0	0	0	0	0	0	0	0	1	0	0	0	0	0	0	0	0	0	0	0	0	0	0	0	0	0	0	1	0	0	0	0	0	0	0	0	0	4	0	0	1	0	1	0	1	0	0	0	0	0	4	0	0	0	0	0	0	0	2	0	0	0	4	0	0	0	0	0	0	0	0	0	0	0	0	0	0	0	0	0	1	0	0	0	0	0	0	0	0	0	0	0	0	0	0	0	0	0	0	0	0	0	0	0	0	0	1	0	0	0	0	0	0	0	0	0	0	0	0	0	0	0	0	0	0	0	0	0	0	0	1	0	0	0	3	0	0	4	0	0	1	0	0	0	0	0	0	0	0	0	0	3	0	0	7	0	1	0	0	0	3	0	0	1	0	2	7	0	0	0	0	0	0	0	0	0	0	0	0	1	0	0	0	0	3	0	0	0	0	0	0	1	0	0	0	0	1	0	0	1	0	0	0	0	0	0	0	3	0	0	0	0	0	0	0	0	1	0	0	0	4	1	0	0	0	0	0	0	0	0	0	0	0	0	1	0	0	0	0	0	0	0	0	0	0	0	0	4	0	0	0	0	0	0	0	0	0	0	1	0	0	0	0	0	0	0	0	1	0	8	0	0	2	0	0	0	0	1	0	0	0	0	0	0	0	0	12	2	0	0	2	0	0	0	0	0	0	0	0	0	0	0	1	0	0	0	0	0	0	0	6	0	0	1	0	0	0	0	0	0	0	0	2	0	0	0	0	1	1	0	0	0	0	0	0	0	0	0	1	0	4	0	0	0	0	0	0	0	0	0	0	0	0	1	0	0	0	1	0	0	0	0	1	0	0	29	0	0	0	0	0	0	0	3	0	0	0	0	0	0	0	0	1	0	0	0	0	1	0	0	0	0	0	0	0	0	0	1	0	0	0	0	0	0	0	0	0	0	0	0	0	1	0	7	0	0	0	0	0	0	0	0	0	0	0	0	0	0	0	3	0	0	0	0	1	0	0	0	0	0	1	1	0	0	2	0	10	0	0	0	0	0	0	0	0	0	0	21	0	0	0	1	0	0	0	0	0	2	0	0	1	0	1	0	1	0	0	0	0	0	0	0	0	0	0	0	0	0	0	0	0	0	0	0	0	0	0	1	0	0	0	0	0	0	0	0	0	0	0	0	0	0	0	0	0	1	0	0	0	0	0	2	0	0	0	0	0	0	0	0	1	5	0	6	20	0	0	0	0	3	0	0	0	1	0	1	0	6	3	0	0	0	0	0	0	39	0	0	0	338	0	0	0	0	0	0	0	0	0	0	0	2	13	15	0	0	0	0	0	0	0	0	0	0	0	0	0	0	0	0	0	0	1	0	0	0	0	0	1	0	0	0	0	0	0	0	0	0	0	0	0	0	0	0	0	0	42	0	0	0	2	0	0	0	58	1	1	0	0	0	0	0	0	4	0	0	0	10	28	0	0	1	0	0	0	0	0	0	0	0	0	0	0	0	1	2	0	0	0	0	0	0	1	1	0	0	0	0	0	2	0	0	0	0	0	0	0	1	0	5	0	0	0	0	0	0	4	0	1	4	0	0	0	1	0	0	0	0	0	0	1	0	0	0	0	0	2	0	0	0	0	0	0	0	32	0	0	0	6	5	10	0	0	1	0	3	0	1	7	0	0	2	4	3	0	4	0	1	0	0	1	4	1	1	0	0	0	1	0	0	0	0	0	0	0	0	0	0	33	0	5	0	0	0	0	0	0	0	0	0	0	0	1	0	3	0	0	0	0	0	1	2	0	0	0	0	0	0	9	14	0	0	0	0	0	0	34	1	0	0	0	3	0	0	19	0	2	0	3	0	1	0	0	0	0	8	4	0	1	0	3	0	0	0	0	0	0	2	0	0	0	0	0	0	0	0	1	0	0	0	0	1	1	0	0	0	0	0	0	0	13	2	0	1	0	0	2	1	2	3	0	7	0	0	0	0	0	0	10	1	1	7	0	0	0	0	0	0	0	0	0	0	0	0	0	0	0	18	0	0	1	2	0	0	0	3	1	0	0	0	2	1	1	12	0	3	0	0	0	0	0	1	0	0	0	0	0	0	0	0	0	0	0	0	0	0	0	0	0	0	0	0	0	0	0	0	0	0	0	1	0	0	0	0	0	0	0	7	0	0	0	0	9	2	3	0	0	0	0	0	5	0	19	0	0	0	0	12	0	0	0	0	1	0	0	0	0	0	0	0	0	0	0	0	0	0	8	0	0	0	0	0	0	0	3	0	0	2	0	0	0	0	0	1	0	0	1	0	0	1	0	0	0	1	1	1	1	0	0	0	0	0	0	0	0	0	3	0	0	2	0	0	0	2	4	0	3	3	0	1	0	0	0	0	0	0	0	0	0	0	7	0	0	0	0	0	0	0	0	0	0	0	12	12	0	1	0	0	2	4	0	0	0	0	0	7	0	0	1	0	22	0	0	0	0	4	0	26	4	0	0	0	0	0	0	0	0	1	0	0	0	0	0	0	0	0	0	13	0	0	0	0	4	0	0	2	2	0	0	1	0	0	0	1	0	0	1	0	0	0	0	0	0	0	0	0	0	0	0	0	0	0	0	0	0	0	1	6	0	0	1	0	0	2	0	0	0	0	0	0	0	0	0	0	0	0	0	0	0	0	0	1	0	0	0	0	0	0	0	0	0	0	7	0	2	0	2	0	0	0	0	0	0	2	0	0	4	0	0	0	7	0	0	0	0	0	0	1	0	0	0	3	1	0	0	0	0	1	0	1	0	0	0	0	0	0	0	0	1	0	0	0	0	0	0	0	1	0	0	0	0	0	0	0	16	0	0	0	0	0	7	0	1	0	0	0	0	0	0	0	0	0	0	0	0	0	1	1	7	0	0	2	1	0	0	1	0	0	3	0	0	0	0	0	0	0	0	1	2	0	2	0	0	0	46	0	1	0	0	0	0	0	8	0	0	0	0	0	0	3	0	0	0	0	3	0	0	0	1	0	3	0	0	0	0	0	7	0	8	0	0	2	1	2	0	0	0	0	29	0	0	1	0	0	0	1	0	0	11	0	0	0	0	0	0	0	0	0	0	1	0	0	0	27	29	1	0	0	1	29	0	0	0	0	0	2	0	0	0	10	0	4	0	0	0	1	0	0	0	0	0	0	0	0	1	0	0	0	2	0	0	1	0	0	0	0	1	0	0	0	0	0	0	0	0	1	0	11	114	0	0	0	0	0	0	0	0	0	0	0	0	0	0	0	0	0	0	0	8	0	0	0	0	0	0	0	0	0	0	0	0	0	0	0	0	0	0	0	0	3	0	0	0	0	0	0	0	0	0	0	0	1	0	3	0	0	0	0	0	0	0	0	0	0	0	0	0	0	0	0	0	0	1	0	0	0	0	0	1	0	0	0	0	0	0	0	0	0	0	0	0	6	0	0	0	0	61	0	0	0	0	0	0	0	1	0	0	0	0	0	0	0	0	0	0	0	0	0	0	0	0	1	0	0	0	2	0	0	0	0	0	0	1	0	0	0	0	0	0	0	0	0	0	0	0	0	0	0	0	0	4	3	0	0	0	0	0	0	0	0	5	0	0	0	0	0	0	0	0	0	0	0	0	0	0	0	1	0	1	0	0	0	0	1	0	0	3	0	0	0	0	0	0	0	0	0	0	0	0	0	4	4	0	0	0	0	0	0	0	0	0	0	0	0	2	0	0	1	0	0	0	0	0	4	0	0	0	0	0	0	0	0	0	1	1	97	0	0	0	0	0	0	0	0	0	0	0	0	0	0	0	0	0	0	0	0	0	0	0	0	0	28	1	4	0	9	0	0	0	0	0	10	0	0	0	0	1	2	2	1	0	0	1	0	2	0	0	0	6	0	0	5	7	0	0	0	0	0	0	0	3	5	0	5	1	8	0	0	0	0	0	1	3	0	0	0	0	0	1	0	0	0	0	0	0	0	0	0	0	0	0	0	0	0	0	0	1	0	0	1	0	0	2	3	0	2	2	0	1	0	4	0	0	105	0	0	0	0	0	0	2	0	0	1	0	0	0	2	1	2	1	0	0	0	1	11	5	41	4	0	28	10	1	0	0	0	0	0	0	0	0	0	0	0	0	0	0	0	0	0	6	0	1	0	1	4	2	1	0	0	0	0	0	0	0	0	0	0	0	0	0	0	0	0	0	0	0	0	1	0	0	0	0	0	0	2	0	0	0	0	2	0	15	0	0	0	0	0	0	0	0	0	0	0	0	0	0	0	0	0	0	0	1	1	0	32	0	0	0	0	0	0	0	0	0	2	0	0	118	0	0	52	5	0	7	1	6	2	1	0	3	2	0	16	8	0	0	0	0	0	0	0	0	0	0	0	0	0	0	0	0	0	6	0	0	3	0	0	1	0	0	0	0	0	0	0	2	0	0	0	2	3	0	0	0	0	0	2	0	0	0	3	0	4	0	0	2	0	0	0	0	8	2	0	1	0	2	0	0	0	0	0	0	0	0	0	0	3	0	0	0	0	0	0	0	0	1	0	0	0	0	0	0	1	19	2	0	0	0	0	0	0	3	0	0	0	0	0	5	0	0	0	0	0	0	0	0	0	0	0	0	0	7	3	0	0	0	0	1	2	0	0	0	0	0	0	0	0	0	0	0	0	2	1	7	0	0	2	0	2	0	3	0	10	0	0	0	4	0	0	0	0	0	0	0	0	0	1	0	0	0	0	0	0	0	1	66	1	0	10	1	0	0	0	13	0	0	0	0	0	0	0	0	0	0	0	0	0	0	1	2	0	0	0	2	14	0	0	0	0	0	0	1	0	0	0	0	0	0	0	3	0	0	0	3	1	0	0	0	0	0	3	7	2	3	1	0	1	0	0	0	0	1	0	0	0	5	0	0	0	56	0	0	1	2	4	25	12	0	0	0	0	0	0	0	0	0	0	0	0	0	1	0	22	0	2	0	0	0	0	4	14	3	0	0	1	0	0	0	0	6	0	0	0	0	0	0	0	3	1	2	0	0	0	0	0	0	0	0	18	0	0	0	0	0	0	13	5	4	146	11	0	18	11	0	0	0	0	0	0	1	1	0	5	0	0	0	0	8	0	97	0	0	2	0	0	0	0	3	0	0	1	1	0	0	0	1	0	0	0	0	0	0	0	0	0	0	1	0	0	0	0	0	1	3	0	8	14	13	0	0	0	0	1	7	7	0	0	2	0	0	0	0	0	0	0	0	0	0	0	0	0	0	0	0	0	0	24	0	0	0	0	1	0	0	0	1	0	0	0	0	1	3	0	1	4	0	1	0	1	0	6	0	22	12	0	0	0	0	0	0	1	0	0	0	0	0	0	2	0	0	0	0	0	0	0	0	4	0	0	0	0	0	0	0	0	0	0	0	0	0	0	3	2	0	0	0	0	0	0	0	0	0	0	0	80	0	0	0	1	20	1	4	0	0	0	0	0	0	0	0	0	0	8	0	0	0	0	0	0	0	0	0	0	1	6	0	0	0	0	0	0	0	0	0	0	1	0	0	0	0	0	0	4	5	0	1	2	0	0	0	0	0	0	0	0	0	4	0	0	0	0	2	1	0	0	0	0	0	0	0	0	0	4	0	3	0	0	10	0	0	0	0	50	0	0	0	1	0	0	0	0	0	0	0	8	0	0	2	1	0	0	1	0	3	0	1	1	1	0	0	0	0	0	0	0	0	0	0	0	0	0	1	0	0	0	5	0	0	0	0	0	0	0	0	0	23	0	4	0	3	13	0	0	0	0	3	0	2	4	6	0	3	0	3	0	0	2	1	1	1	0	1	0	2	29	1	8	0	1	0	5	0	0	0	5	0	3	0	0	0	0	0	0	0	0	0	1	0	3	5	1	1	8	19	1	0	1	0	3	0	0	1	0	0	0	0	0	0	1	0	0	0	1	11	0	1	2	0	0	0	0	0	0	0	0	0	1	0	0	0	1	0	0	3	0	0	0	0	0	0	0	0	0	0	0	0	0	1	0	3	0	0	0	0	7	108	0	0	0	0	3	0	4	13	0	0	0	1	0	0	1	0	0	0	0	3	64	0	0	0	0	21	0	0	0	3	0	0	0	6	3	0	0	0	0	4	1	0	1	0	9	0	0	0	0	0	1	0	0	14	0	1	0	0	0	0	0	0	3	1	0	0	0	0	0	2	0	0	0	0	0	17	1	0	0	8	3	0	0	0	0	0	0	2	3	0	0	3	2	0	0	0	0	0	0	0	0	0	0	0	2	0	1	0	0	0	0	0	0	17	1	0	0	0	0	2	0	0	0	0	0	2	1	0	0	1	0	0	0	0	0	0	10	4	1	0	0	0	0	0	0	0	0	0	0	0	0	0	0	3	0	0	0	0	0	0	0	0	0	1	1	0	0	0	3	1	0	2	0	0	0	0	0	0	2	0	1	0	0	0	0	0	0	5	0	0	12	0	2	0	0	0	12	0	0	0	0	5	2	0	0	0	0	1	0	2	0	3	0	0	5	0	0	0	0	1	0	0	0	0	0	0	0	0	4	0	0	0	0	9	1	3	1	6	1	0	0	0	0	0	0	0	0	0	3	33	4	1	1	1	0	0	1	0	3	0	0	9	0	1	0	2	1	0	2	3	0	35	0	5	1	0	0	0	0	0	0	1	0	0	0	0	4	2	5	0	0	29	2	0	18	2	6	2	54	0	2	2	2	0	0	0	0	0	0	0	0	0	0	6	6	4	1	0	26	0	0	0	0	0	7	8	2	17	0	1	2	0	3	20	0	0	2	0	3	0	2	0	1	0	2	3	0	2	0	2	0	5	1	0	0	1	0	0	0	0	0	0	0	0	0	0	4	0	0	0	0	16	0	0	0	0	0	0	0	0	0	0	0	5	0	0	0	0	0	0	0	0	0	0	0	0	0	0	4	0	0	0	0	0	0	0	14	0	2	3	0	3	1	0	9	1	0	0	6	0	0	4	2	0	0	0	0	0	0	14	0	0	0	0	0	0	0	0	0	0	0	1	0	0	0	0	1	0	0	0	0	0	0	0	0	0	0	0	14	0	1	0	0	0	0	5	16	4	2	0	2	0	0	0	0	0	0	0	1	0	0	0	0	0	0	0	0	8	0	0	0	0	0	0	0	2	0	0	13	0	0	0	1	0	2	1	0	109	1	1	0	0	0	0	0	1	0	0	0	2	0	0	0	0	0	0	1	8	0	0	0	3	0	0	0	0	2	0	10	0	0	0	10	1	0	0	51	5	0	0	1	0	0	0	1	0	0	0	0	5	0	3	2	0	0	0	2	0	0	0	0	0	0	2	3	0	0	0	0	0	0	0	0	6	0	3	0	0	0	2	0	0	0	0	0	1	0	3	0	0	0	0	0	7	0	0	0	0	0	0	3	10	0	0	0	0	0	0	0	0	0	0	0	0	0	0	1	0	1	0	0	0	1	0	0	0	0	0	0	5	0	0	0	0	0	0	0	21	3	0	0	6	0	11	0	0	9	0	0	0	0	0	0	0	10	0	0	0	0	0	0	0	0	0	0	2	0	0	0	1	1	0	3	3	0	0	1	0	0	7	0	0	0	0	0	0	0	0	0	0	1	0	0	0	9	0	1	0	0	1	0	0	0	1	0	1	0	1	12	0	13	0	0	12	0	0	4	0	0	0	0	0	0	0	0	0	1	1	0	0	0	6	0	0	0	0	2	0	0	0	0	0	0	4	0	0	0	0	0	0	0	0	1	0	2	2	0	0	0	16	0	0	0	0	15	1	0	0	0	0	0	1	0	0	0	0	0	0	3	0	0	0	0	1	0	19444	0	0	0	0	0	0	0	0	0	0	0	0	0	0	0	0	1	0	0	0	0	0	2	0	0	1	0	3	0	0	0	0	0	0	0	2	0	1	0	0	0	0	0	0	0	7	3	0	0	0	0	0	0	0	5	51	7	2	0	0	3	7	0	0	0	0	0	0	0	118	1	15	0	0	0	0	13	2	8	0	2	1	1	0	1	1	0	0	0	0	0	2	0	0	3	0	0	12	0	0	0	0	1	0	0	2	0	0	0	0	3	0	0	0	0	0	0	0	11	3	3	1	0	0	3	3	0	2	2	0	3	7	2	0	1	1	5	7	0	0	1	0	0	4	0	0	0	48	79	2	1	1	0	2	0	0	4	0	0	1	0	4	0	0	0	0	0	0	0	0	0	1	0	3	1	0	0	13	0	0	0	0	0	0	0	0	3	2	11	0	0	4	9	2	1	0	0	0	0	0	0	0	0	0	8	9	1	0	12	0	0	0	1	0	0	0	0	0	0	0	0	0	0	0	0	0	0	0	7	1	0	0	4	0	0	0	0	2	0	0	0	1	0	0	0	0	0	0	0	0	2	25	0	2	1	1	3	11	0	1	13	0	0	1	0	0	0	0	0	0	0	0	0	0	0	0	0	0	0	0	0	0	20	0	0	0	0	0	0	4	0	0	0	0	1	0	0	0	0	0	0	0	0	0	0	0	0	0	0	0	0	0	0	0	2	0	0	0	0	1	0	10	0	0	0	0	0	0	0	27	0	0	0	2	2	1	9	5	0	0	0	1	3	0	0	1	0	2	0	17	0	0	0	0	0	0	0	0	0	9	0	0	0	1	0	2	0	0	0	0	16	57	0	0	0	0	0	0	0	0	0	2	0	1	0	0	40	5	0	1668	4	0	0	3	10	8	0	0	82	0	0	12	4	34	0	1	0	0	0	0	0	0	1	0	0	3	1	4	0	0	0	2	0	0	0	0	0	0	0	2	0	0	0	1	0	0	2	0	0	0	0	0	35	0	0	0	1	0	0	2	0	0	0	0	0	3	0	3	4	3	0	16	6	8	9	0	0	37	5	1	82	0	0	0	0	0	0	1	0	0	0	0	0	0	0	0	0	0	0	0	0	0	0	0	0	0	4	0	0	51	0	0	0	1	0	0	2	0	0	0	0	0	5	0	2	0	0	0	0	0	1	0	0	0	0	0	0	0	0	0	0	0	0	0	0	4	0	0	1237	0	0	0	0	0	0	0	28	0	39	1	0	0	0	0	0	0	0	0	0	0	0	0	0	0	0	0	0	1	0	1	0	0	0	1	3	0	3	0	0	0	0	0	0	0	0	0	0	1	0	0	0	0	0	0	0	0	1	0	0	0	0	0	0	0	0	0	0	10	0	0	0	18	0	0	0	0	0	45	0	0	0	1	2	0	0	0	0	1	3	0	0	3	1	6	0	2	2	0	1	0	0	1	0	0	0	0	3	1	0	0	0	0	0	0	3	0	0	0	0	5	0	0	0	0	0	0	0	1	1	0	0	0	0	0	0	2	0	0	0	0	0	1	0	0	0	1	4	1	0	0	0	0	0	0	0	0	1	0	0	0	0	0	1	1	0	0	0	0	0	3	0	0	0	0	0	0	1	0	0	0	0	0	0	0	0	0	1	53	0	0	4	0	0	4	0	0	0	0	0	2	17	0	0	13	1	0	67	0	0	1	0	0	0	0	3	0	1	0	0	0	0	1	0	0	0	1	0	0	0	0	1	0	0	1	0	1	0	0	0	0	1	4	0	0	0	0	0	0	0	0	5	0	0	13	0	0	3	0	0	0	0	2	0	0	0	0	17	3	0	0	0	0	0	0	0	0	1	0	1	3	0	0	0	0	10	0	0	0	0	0	0	0	0	1008	0	0	0	0	11	0	11	16	25	0	0	0	0	0	0	2	0	0	7	0	0	0	2	7	1	0	0	1	0	0	0	13	0	0	0	1	1	0	0	0	0	0	0	1	9	2	0	0	0	0	8	0	0	2	0	1	0	0	0	0	0	0	0	0	0	0	0	0	1	0	0	0	0	0	0	0	0	0	0	0	0	0	0	0	11	0	0	2	0	0	0	0	0	0	0	0	0	0	0	0	0	0	0	0	2	0	4	1	0	0	341	0	0	0	3	0	0	0	0	0	0	3	315	6	1	0	0	3	0	0	0	0	1	1	0	0	0	0	0	1	0	0	0	16	0	5	0	0	0	7	0	0	0	0	0	4	0	0	0	0	1	0	0	0	0	6	1	5	2	0	0	7	0	0	1	0	0	0	0	0	0	0	0	2	1	1	0	0	0	4	1	1	0	0	0	3	0	1	0	0	0	0	0	0	0	0	17	0	0	0	0	0	0	0	0	0	3	0	1	0	0	9	0	3	0	0	1	1	0	9	0	1	0	0	0	0	0	0	0	0	2	264	7	0	0	0	0	0	0	0	0	0	0	0	0	0	0	0	0	0	0	0	30	2	0	1	2	1	21	0	0	2	2	0	0	0	0	0	0	27	0	0	8	0	0	0	0	0	0	1	0	0	1	0	0	0	0	1	0	6	2	0	0	0	0	0	0	9	0	29	0	0	0	0	1	0	0	0	1	0	0	0	0	0	0	0	0	0	0	0	0	0	0	0	0	0	0	0	0	0	0	0	0	0	0	0	0	0	0	0	0	0	0	0	0	0	0	0	0	3	3	0	0	2	3	0	22	7	1	0	0	0	0	0	0	0	0	0	0	0	0	0	0	0	3	0	0	0	0	0	0	0	0	0	0	0	127	0	0	0	0	0	0	0	0	0	0	0	0	0	0	0	0	0	0	0	0	0	0	0	0	0	0	0	3	0	0	0	2	4	1	0	2	0	0	0	0	0	0	0	0	0	0	2	0	0	12	8	0	4	31	0	0	0	0	0	0	0	0	0	0	0	0	0	0	0	0	0	1	0	0	0	0	0	0	0	0	0	0	3	0	0	0	0	0	0	0	10	0	0	0	0	0	0	0	0	0	1	0	0	0	0	0	0	0	0	2	0	0	0	0	0	0	0	0	0	0	0	0	0	0	0	0	0	5	4	0	0	0	0	0	0	0	0	0	0	0	0	0	0	0	0	3	0	0	3	0	0	0	0	0	0	0	0	0	0	0	0	0	0	0	0	0	0	0	0	0	0	19	0	0	0	0	0	1	0	0	0	0	0	0	0	0	0	0	0	2	0	0	17	0	0	0	0	0	0	0	0	0	0	0	0	0	0	0	2	0	0	0	0	0	0	0	0	0	0	0	0	0	0	0	0	0	0	0	0	0	0	0	0	0	0	0	0	0	0	0	0	0	0	0	0	0	0	0	0	4	0	0	0	0	0	0	0	0	0	0	0	0	0	0	0	0	0	0	3	0	1	0	0	0	0	0	0	0	3	0	0	0	0	11	0	0	1	0	7	0	0	0	0	0	0	0	0	0	0	0	0	0	0	0	0	0	0	2	0	0	0	0	0	0	0	0	1	0	2	0	0	0	0	3	0	0	0	0	6	1	0	0	0	0	0	0	4	0	0	0	0	0	0	0	0	0	0	0	0	2	0	0	0	0	0	0	0	0	0	0	0	0	0	0	0	1	0	0	1	0	0	1	0	0	0	0	0	0	1	0	0	1	0	0	0	0	0	1	0	0	0	0	0	0	0	0	0	5	0	0	0	0	0	1	6	3	2	0	0	0	2	0	3	0	2	0	2	0	0	0	0	9	0	2	0	0	0	1	0	0	0	4	0	2	0	0	0	0	0	0	0	15	0	19	11	0	5	0	0	6	0	0	0	0	0	0	0	0	0	0	0	0	0	0	0	0	0	2	0	0	0	0	0	0	5	0	0	0	0	0	0	0	0	0	0	1	0	0	2	0	0	0	0	5	0	0	0	0	0	0	0	1	1	0	0	0	0	0	0	0	1	7	0	0	0	2	0	5	0	9	0	0	0	0	0	0	0	0	0	0	0	0	0	0	0	0	0	0	16	0	0	0	0	0	0	0	0	0	0	5	0	0	0	0	0	0	0	0	0	0	0	0	0	0	0	0	0	0	0	0	0	0	0	0	0	0	2	8	0	0	0	0	0	0	0	2	0	1	1	1	0	0	0	0	1	1	24	0	0	0	0	6	0	0	0	0	0	1	0	1	0	21	1	6	0	0	0	0	0	2	2	0	0	0	0	0	1	0	0	0	0	0	0	0	0	2	0	1	0	0	0	0	0	0	0	1	0	0	0	1	6	0	1	0	906	0	1	0	0	2	0	0	5	3	0	1	0	0	0	1	0	2	0	0	0	0	1	2	0	0	0	1	0	0	0	0	1	0	2	0	1	0	0	0	0	0	1	0	0	0	0	0	0	0	2	0	0	0	0	1	1	0	0	9	0	1	0	0	0	0	1	0	3	0	1	0	0	1	1	1	0	6	0	0	1	4	0	45	0	0	0	1	0	0	0	0	0	0	1	0	0	0	0	0	0	1	0	0	1	1	2	4	1	1	4	0	0	0	6	6	1	0	2	0	0	0	0	9	2	18	1	4	0	0	0	5	0	0	0	17	3	1	5	1	2	1	5	0	10	0	0	2	0	0	0	0	0	0	0	2	0	0	1	0	1	0	0	1	0	0	19	1	8	0	0	0	0	0	0	0	0	1	0	0	0	6	0	0	0	0	1	0	0	1	0	0	0	0	0	0	0	2	0	0	0	0	0	0	5	0	0	1	0	0	0	0	0	0	0	0	3	0	5	0	1	0	4	0	0	0	0	0	0	0	0	0	10	0	0	3	1	1	0	0	3	1	0	0	0	535	0	0	0	0	0	6	0	0	1	0	0	0	0	1	1	0	0	0	7	1	0	0	0	0	0	0	0	0	8	0	1	0	0	1	0	2	0	0	0	0	0	8	0	0	0	0	0	3	0	0	0	0	0	0	0	0	0	0	1	0	0	0	0	1	0	0	0	0	0	0	0	0	0	0	0	1	37	1	1	0	2	0	0	2	2	4	2	4	1	0	5	1	1	6	7	3	15	4	0	3	0	0	0	1	0	0	0	6	0	0	0	0	0	0	0	0	0	0	0	0	0	0	0	5	1	1	0	5	0	24	3	0	0	0	0	0	0	0	0	0	0	0	0	0	0	0	0	0	0	0	0	0	0	0	0	0	0	0	1	0	0	0	0	0	0	0	0	0	0	0	0	0	0	0	0	0	0	0	0	0	0	0	0	12	0	0	29	0	4	1	2	0	0	0	1	1	4	1	0	0	1	0	0	0	0	0	2	0	0	0	0	0	0	0	1	0	1	4	1	2	0	7	3	1	14	0	0	0	0	0	1	0	0	0	0	0	0	0	0	0	1	3	6	0	2	0	0	5	0	4	1	3	0	0	1	3	0	0	0	0	0	0	3	0	0	0	0	0	0	0	0	0	0	0	0	0	3	4	0	0	0	1	0	0	0	0	1	0	0	0	2	0	0	0	0	28	3	0	0	0	0	6	0	0	0	0	0	0	1	0	3	0	0	18	0	4	0	2	0	0	0	1	0	0	0	3	0	0	1	0	8	1	0	0	0	1	0	0	0	0	0	1	3	0	0	0	4	0	2	1	16	0	0	0	0	1	0	0	0	0	0	0	0	2	1	0	0	0	0	18	0	0	0	0	0	0	0	0	0	0	9	0	0	0	0	0	0	0	0	1	0	0	0	0	0	0	0	4	1	0	0	0	0	0	0	1	1	0	0	19	0	0	0	0	0	0	8	1	1	0	0	0	5	1	0	2	15	0	1	0	0	0	30	0	0	0	0	0	3	0	0	0	0	0	0	0	5	1	0	0	8	2	0	0	0	0	0	0	0	0	0	0	2	0	1	0	0	0	0	0	0	16	4	17	0	2	0	0	0	0	0	0	0	0	0	0	0	0	0	1	0	0	0	1	0	0	2123	0	0	4	1	17	0	0	0	0	1	12	0	34	17	9	16	2	25	0	1	1	0	0	0	0	0	0	5	0	156	10	4	0	0	0	0	0	0	0	0	0	0	0	0	0	0	2	13	0	0	0	62	3	0	0	0	0	0	2	0	0	1	0	0	0	0	0	0	0	0	0	0	0	0	0	0	1	0	0	0	0	0	0	1	0	0	0	0	0	0	0	3	0	0	0	0	19	0	1	0	2	0	0	0	0	0	0	0	0	0	0	0	0	0	0	0	0	0	1	0	0	0	0	0	0	0	0	1	0	0	2	19	1	0	0	8	0	12	6	3	0	0	0	0	0	0	0	0	0	0	0	0	0	0	0	3	0	0	0	0	0	0	1	0	0	1	0	0	1	0	28	0	0	0	0	9	0	0	2	1	0	0	1	5	0	2	0	1	0	0	0	0	0	0	0	0	0	0	0	0	0	11	0	0	0	0	0	0	0	0	0	0	0	0	0	2	0	2	4	0	5	0	27	21	0	51	0	0	0	1	0	0	0	2	0	1	0	0	1	0	0	4	14	0	1	0	0	0	0	4	0	0	2	0	2	67	0	0	0	0	0	0	0	0	4	1	10	2	1	4	0	3	1	0	0	0	1	2	0	3	0	0	0	0	0	1	0	0	1	0	0	1	0	0	3	0	0	0	1	5	0	0	0	0	0	0	0	0	0	0	0	0	0	0	1	0	0	0	0	1	0	0	0	0	0	0	0	0	0	4	0	0	1	0	2	5	0	0	0	0	0	0	0	0	0	0	1	7	1	0	18	2	0	0	0	1	0	0	0	0	0	1	0	0	0	0	0	0	0	0	3	0	0	0	0	0	0	0	50	0	5	0	26	18	0	3	0	2	1	0	0	877	0	0	0	2	34	0	0	2	0	0	0	1	0	0	0	3	1	0	0	2	1	0	0	0	1	0	0	0	0	2	0	0	0	1	1	0	0	4	0	1	0	0	0	0	0	0	1	3	0	0	2	0	0	1	0	0	0	1	0	0	0	0	0	0	8
LakWasM111_LOW13_2_rpkm	0	0	0	0	1	12	20	0	0	0	1	1	1	3	0	0	0	1	3	0	0	0	1	16	0	2	0	0	0	4	0	0	0	4	1	5	2	0	0	0	0	0	0	0	21	16	25	30	0	6	2	12	1	0	0	1	0	2	65	12	129	0	0	3	0	0	0	0	0	31	0	0	0	1	0	0	0	0	0	0	0	11	0	0	0	0	1	0	1	0	0	1	9	1	24	4	1	0	1	0	0	0	1	0	0	0	0	1	0	0	1	3	71	0	16	0	1	5176	0	0	0	0	1	1	0	0	1	0	0	0	23	54	5	0	0	0	0	0	5	0	2	0	0	1	3	2	0	0	23	2	2	27	2	1	69	0	0	1	18	1	8	4	0	10	12	0	0	6	0	11	0	0	0	1	0	0	0	0	0	1	0	1	0	1	9	7	0	0	0	11	1	1	2	9	0	0	0	10	13	38	1	1	12	0	0	0	13	0	6	1	16	2	19	12	8	0	6	6	0	2	4	1	0	2	0	7	0	2	8	0	3	0	0	0	0	0	13	6	22	2	0	0	12	1	18	6	0	1	4	1	5	3	23	0	693	312	0	0	0	0	2	0	0	4	5	0	5	0	0	24	16	2	2	0	0	0	0	1	18	22	3	18	6	26	12	0	0	0	15	2	1	0	0	0	2	0	0	3	5	0	0	25	34	1	4	0	6	18	11	1	7	0	19	13	0	0	0	0	0	0	1	0	0	2	13	89	0	1	2	0	0	1	0	0	0	0	1	0	0	0	0	0	9	9	7	2	6	4	0	1	0	3	1	0	9	0	0	0	0	13	22	0	2	0	0	12	0	15	6	3	2	27	0	0	4	1	0	4	0	3	0	1	7	2	3	0	33	0	0	0	0	0	85	1	1	8	53	0	0	36	0	11	0	3	15	0	0	1	0	0	1	2	1	303	0	16	20	3	2	0	0	0	0	1	0	0	0	0	0	1	0	1	0	1	0	1	0	0	3	0	14	9	0	0	11	62	0	0	0	1	0	51	13	101	0	21	27	1	0	7	4	3	0	8	1	13	14	0	0	1	7	4	4	1	0	0	11	0	204	0	2	1	7	0	0	0	0	45	5	3	0	5	33	354	4	0	1	0	1	0	0	1	6	1	0	0	0	0	0	1	0	0	0	1	0	0	1	0	1	9	0	0	0	0	0	0	0	0	0	0	0	0	36	6	3	0	4	4	0	10	0	7	1	18	5	0	0	0	0	0	0	0	2	0	0	8	0	2	0	0	1	0	0	0	6	4	8	0	22	1	0	0	0	3	9	25	34	73	3	31	53	46	34	27	19	0	9	1	12	1	0	0	7	2	13	16	3	0	0	0	9	0	0	7	7	9	0	22	0	2	0	166	52	147	0	0	56	1	112	2	71	18	43	6	0	9	0	4	0	2	2	4	0	0	1	1	0	0	0	4	1	98	1	1	0	1	0	7	1	0	20	1	0	9	1	0	0	1	0	2	2	41	0	9	0	0	1	0	3	3	1	16	1	0	1	0	4	0	1	0	0	0	1	0	0	0	1	0	1	4	3	0	84	1	0	0	0	2	0	8	0	1	1	2	1	0	5	0	18	1	2	3	1	0	10	4	2	0	7	0	1	2	2	5	1	0	11	0	17	0	4	0	1	1	0	0	0	0	0	2	0	17	15	0	6	22	3	0	0	10	0	0	0	0	1	2	0	0	47	0	0	1	0	5	0	0	3	0	0	0	0	0	0	0	0	26	0	0	0	0	0	0	3	0	1	2	0	0	0	2	3	2	0	0	0	2	5	0	0	13	1	0	0	0	93	6	106	1	0	5	0	0	2	0	1	0	1	0	0	0	0	0	0	19	13	0	0	14	1	0	6	0	0	0	0	0	0	25	31	0	0	0	0	0	0	0	0	2	15	25	0	0	1	0	0	1	2	4	0	5	9	1	0	2	0	0	0	0	4	2	0	0	0	0	0	0	2	0	3	15	0	1	0	0	1	3	1250	0	0	0	0	0	0	0	0	1	0	0	0	0	0	0	0	2	0	0	0	0	0	0	0	0	0	0	16	7	15	4	3	0	0	0	0	1	0	0	0	0	0	1	0	1	0	0	0	0	0	0	1	3	0	0	0	17	2	0	6	6	0	0	0	0	0	0	0	0	0	0	2	1	1	0	1	0	0	4	0	0	1	2	0	7	13	170	1	15	0	14	0	0	15	15	5	0	5	0	0	0	1	0	0	1	0	0	1	0	0	4	4	0	1	0	0	0	0	0	0	0	0	0	0	1	1	0	0	0	0	79	0	0	0	27	2	0	1	1	0	0	1	0	5	0	0	0	0	0	2	1	210	1	0	2	0	0	0	0	1	3	0	0	2	0	0	2	3	0	0	0	0	2	1	2	5	22	0	0	0	0	37	0	6	0	0	6	2	1	5	1	4	6	0	0	0	0	0	0	0	0	1	15	0	0	0	0	1	0	0	0	0	1	0	0	0	0	0	0	17	0	3	11	0	0	0	0	4	0	0	8	0	0	0	7	0	0	0	0	19	65	21	0	3	0	0	0	0	4	1	0	0	0	0	0	0	1	0	0	0	0	0	0	0	0	0	0	4	0	0	0	1	0	0	1	0	0	0	0	0	0	0	0	18	2	0	0	4	0	7	3	2	0	0	0	3	0	0	0	1	6	0	0	0	2	25	9	32	20	0	0	0	27	3	1	0	1	0	0	2	0	0	0	1	0	2	2	1	0	2	14	0	0	0	2	15	0	1	0	0	0	12	1	0	0	0	1	0	0	0	1	2	0	10	1	45	3	0	3	1	0	0	36	8	0	2	29	43	0	1	1	2	1	24	0	0	14	0	2	0	0	0	0	0	0	3	12	1	12	17	5	0	35	0	1	0	2	0	8	0	0	6	0	0	0	0	0	0	3	0	0	19	1	2	0	9	0	0	0	0	6	0	4	0	2	0	0	0	0	0	0	0	1	1	0	32	1	0	0	1	0	1	0	0	0	0	6	4	0	23	10	14	5	0	1	7	0	0	0	0	2	0	8	0	0	5	1	0	0	18	13	0	0	0	0	12	0	15	0	4	1	1	4	0	0	5	9	2	2	4	1	7	0	0	0	1	0	27	0	4	22	3	71	6	0	24	0	0	5	4	8	0	0	1	3	2	6	4	0	8	0	0	1	2	5	12	26	4	0	11	0	1	0	0	0	0	8	3	0	0	0	1	1	0	41	0	3	5	0	3	5	2	2	0	3	0	34	1	8	0	0	0	0	1	1	4	280	18	53	19	0	0	2	0	1	0	0	1	43	2	2	1	17	1	0	0	8	64	171	5	29	0	0	27	85	0	0	0	0	1	0	0	0	84	18	39	24	82	21	0	13	21	6	0	0	0	0	0	0	23	7	0	0	0	8	0	12	2	1	0	0	0	5	0	0	0	0	0	0	19	0	0	0	0	0	0	8	3	8	0	0	0	0	0	0	1	16	0	0	0	0	4	2	0	0	2	0	0	1	0	0	1	1	2	2	1	6	0	0	0	0	0	0	0	0	0	0	0	0	0	0	0	0	0	0	0	0	0	0	1	90	0	1	33	0	2	1	0	40	1	17	61	1	3	31	0	0	3	2	2	0	1	0	23	6	9	3	0	0	0	0	0	0	0	2	16	0	1	0	5	1	1	1	2	0	0	0	0	0	0	4	0	30	6	43	0	0	6	11	0	0	0	3	0	0	0	0	2	4	0	0	2	1	52	3	2	18	7	0	2	11	0	0	1	12	0	6	2	12	5	0	7	0	0	0	1	0	0	1	1	0	15	12	27	81	141	32	22	43	0	0	1	2	1	13	0	0	0	5	24	0	5	0	4	0	1	0	0	16	15	0	36	9	0	4	0	4	3	3	3	0	32	1	1	0	0	0	0	3	0	82	4	4	9	6	0	0	7	4	3	151	1	0	4	1	0	1	0	8	15	270	5	43	0	16	2	9	7	5	1	0	5	0	0	0	56	1	0	0	1	6	0	1	4	2	4	7	0	0	1	0	0	0	0	5	0	0	3	0	1	2	0	0	0	0	4	0	388	0	0	8	274	0	0	8108	2	0	2	0	0	0	0	0	2	6	0	0	1	8	0	1	0	11	0	1	0	2	0	0	0	1	0	19	0	28	0	0	0	5	0	0	0	0	6	0	7	5	0	0	2	1	0	1	0	0	0	0	20	0	0	9	7	0	1	0	78	55	9	4	2	14	67	0	19	2	47	0	17	26	9	5	18	7	0	23	11	0	0	1	3	0	0	0	0	0	0	0	0	0	6	7	0	6	0	5	13	0	0	1	0	0	1	1	1	0	0	0	1	0	5	0	0	1	6	4	27	9	1	1	0	0	0	0	25	0	0	62	2	0	2	0	0	0	0	0	0	1	1	0	0	0	0	40	0	0	1	11	0	1	0	0	0	0	0	0	47	0	2	6	1	2	15	0	15	0	6	25	144	3	0	0	1	0	0	0	0	0	0	10	1	0	10	0	1	0	0	3	1	0	0	0	0	8	1	1	4	0	5	2	10	16	0	10	2	0	3	0	14	22	21	0	1	0	0	0	0	1	1	0	0	0	4	0	9	0	0	1	2	0	0	1	1	0	0	0	0	1	1	3	1	0	0	0	0	0	1	66	164	0	0	0	1	0	0	1	3	1	0	13	0	0	12	0	0	2	0	0	3	1	153	2	7	0	0	12	1	0	0	55	0	0	1	2	0	0	0	0	1	0	0	133	3	0	0	0	0	32	0	0	1	12	0	116	9	14	1	0	1	0	0	0	15	0	19	1	0	0	0	0	0	2	0	5	0	0	0	0	0	1	0	0	4	1	0	1	1	0	0	1	0	8	0	0	0	0	7	31	0	1	0	11	0	0	4	0	0	1	0	0	2	0	0	0	1	0	0	0	0	4	3	0	0	8	2	0	0	226	0	60	25	61	20	8	0	0	11	1	3	0	0	0	0	1	61	1	1	0	12	0	0	0	0	0	4	51	13	1	1	1	1	5	0	0	12	0	6	0	0	4	0	0	1	5	0	0	0	1	2	4	1	0	4	2	0	0	0	0	23	9	0	5	0	0	0	0	4	3	0	0	2	1	0	0	0	0	2	1	0	4	0	3	29	1	0	0	0	0	0	35	1	8	0	0	1	1	0	1	0	1	0	0	0	2	0	0	0	0	0	0	0	1	0	0	0	0	0	0	0	1	0	19	1	1	0	1	3	1	5	0	6	0	42	2	0	0	0	0	0	3	6	2	0	0	0	0	76	107	38	78	158	38	61	90	10	124	42	161	116	62	11	47	53	122	179	68	20	2	187	179	150	120	164	129	84	35	64	31	58	35	1	3	0	0	0	0	0	0	0	0	19	85	0	0	1	0	0	0	0	0	0	3	0	0	2	0	0	2	0	0	0	13	7	0	16	0	6	5	0	0	3	0	7	0	1	0	0	5	0	0	3	0	0	0	1	0	0	14	0	0	0	0	1	12	3	12	1	0	1	1	0	0	0	4	0	1	2	2	0	0	0	0	95	0	0	4	0	3	0	0	0	1	0	0	0	0	5	6	0	6	0	0	0	0	71	0	0	2	0	2	2	0	0	1	0	2	0	67	1	0	2	15	0	0	0	0	0	1	0	3	0	0	0	0	0	7	30	2	1	0	0	0	0	0	28	10	27	0	0	13	11	9	1	4	0	15	7	5	0	0	1	0	0	0	0	0	33	0	0	17	2	0	0	0	0	3	0	0	1	0	0	0	68	0	0	0	0	0	0	13	0	0	1	0	0	1	1	0	9	0	0	0	0	11	1	21	0	76	9	2	1	2	4	0	1	0	0	9	0	0	0	0	0	0	2	0	9	9	0	0	0	0	7	0	0	12	18	0	2	0	0	28	0	2	1	1	0	0	3	1	0	0	0	3	0	1	1	0	1	1	1	0	2	0	0	0	0	0	0	0	0	0	0	0	0	0	0	1	2	0	2	1	0	0	14	0	1	0	0	9	0	5	59	36	1	0	8	0	0	0	0	1	0	1	0	1	0	0	0	0	1	1	98	1	9	5	0	0	0	6	0	0	12	0	25	18	1	0	0	0	107	0	0	0	0	0	0	0	0	0	2	0	0	0	18	8	0	0	0	0	0	0	0	2	0	9	10	3	7	2	0	1	0	0	15	0	0	4	0	0	0	4	0	0	1	0	8	4	0	0	17	0	0	0	0	0	0	0	0	0	0	0	1	0	0	0	1	0	1	0	1	0	0	0	0	0	1	1	0	4	0	0	0	0	0	0	1	7	7	0	216	2	2	9	0	3	1	0	1	0	4	0	2	15	1	8	8	0	1	0	0	0	0	5	1	12	0	0	0	0	0	0	30	0	4	1	31	4	0	11	17	4	0	7	0	10	0	10	0	7	0	4	4	6	7	2	1	5	0	5	1	10	0	0	0	11	0	6	1	15	21	13	17	13	9	14	8	0	13	9	16	0	13	1	0	0	16	8	0	12	1	0	0	8	12	7	0	0	0	0	0	0	3	1	0	0	0	5	5	0	1	0	1	46	0	0	0	0	0	0	0	0	0	0	1	4	0	3	7	1	1	0	0	0	0	0	0	0	0	1	0	159	0	1	17	16	15	0	10	2	5	1	0	2	75	0	0	0	0	1	0	2	30	0	0	1	0	0	0	0	1	22	0	0	28	5	0	36	0	2	0	0	0	46	23	0	2	0	1	4	2	1	1	0	9	0	3	4	0	0	4	0	0	0	20	3	1	0	1	1	0	0	599	190	218	1	0	0	2	2	0	4	0	37	0	2	2	0	0	0	50	150	22	5	0	0	11	0	0	0	31	1	0	0	0	0	4	0	0	1	0	0	0	0	0	0	0	0	0	0	1	0	40	183	0	0	2	0	0	0	0	8	1	0	0	0	0	0	12	2	0	1	0	0	6	2	0	1932	4	11	1	0	1	4	0	0	0	0	1	5	0	3	0	0	0	1	0	0	0	1474	0	0	1	0	2	0	0	0	0	0	0	0	0	0	0	7	0	3	0	0	1	0	1	0	0	0	0	0	0	0	1	0	0	0	1	0	1	0	0	0	0	0	0	0	0	0	3	0	0	0	0	0	0	0	3	2	1	0	0	20	0	0	0	0	0	0	30	0	0	0	0	0	0	113	4	0	1	0	0	11	0	315	18	10	4	1	0	12	2	0	33	0	1	72	17	0	0	0	0	0	0	0	6	0	2	0	0	0	0	0	0	0	0	0	0	420	3	0	0	0	0	0	0	0	1	0	1	0	0	0	0	0	0	0	0	2	0	1	0	0	0	7	1	0	1	6	6	4	17	8	0	0	0	0	0	0	0	0	13	3	0	2	0	13	0	10	0	0	0	0	0	1	0	23	0	0	0	9	4	1	0	5	1	2	0	0	1	1	0	2	0	2	0	0	0	2	0	11	9	0	16	0	41	3	0	0	1	0	1	0	0	0	4	14	0	0	0	0	0	0	25	92	0	0	0	1	0	2	0	0	2	0	0	1	0	0	1	0	13	6	19	4	0	0	0	0	0	0	0	0	20	0	8	0	1	0	1	0	1	5	1	6	0	0	0	0	13	0	0	0	4	0	4	0	56	1	1	31	0	0	0	0	18	0	1	0	11	1	1	0	0	0	0	0	70	0	0	0	2	0	1	3	0	0	0	0	3	0	1	0	0	0	1	72	0	0	0	0	0	0	1	43	1	0	0	29	0	0	0	0	0	0	1	0	0	0	0	0	0	0	0	0	0	1	0	0	0	0	1	0	1	0	0	0	0	0	1	0	0	1	1	0	4	0	0	55	0	0	0	0	0	0	0	0	0	0	0	0	0	0	2	0	0	1	1	0	1	0	0	0	0	0	0	0	0	4	0	0	0	0	0	0	0	0	0	0	4	0	0	0	18	0	3	1	4	0	0	2	1	0	0	0	0	1	0	0	0	0	4	0	0	0	0	0	0	0	0	1	0	5	0	1	1	0	71	2	0	0	11	0	0	0	0	0	0	2	0	5	0	0	0	1	7	0	0	0	0	10	3	0	1	1	4	0	0	0	0	1	1	0	0	0	0	0	3	0	0	30	0	0	0	0	1	0	0	0	6	0	0	0	0	0	0	1	0	0	0	0	0	1	1	0	2	0	0	0	0	0	0	5	0	12	0	0	0	0	0	122	0	4	0	0	0	0	1	0	1	83	0	0	1	0	0	1	0	0	0	0	1	0	1	0	0	0	1	0	0	0	0	1	0	15	0	0	0	1	6	0	0	0	0	8	0	0	0	0	0	2	0	1	0	5	0	0	1	0	0	0	0	0	0	0	0	0	0	0	0	0	0	0	0	0	0	0	1	0	0	0	0	7	0	0	0	0	0	0	0	0	0	3	0	0	0	0	0	0	0	0	0	0	25	0	0	23	2	0	1	0	0	4	0	0	7	0	1	57	0	0	4	0	0	0	3	0	0	6	0	36	29	5	0	0	11	105	0	2	0	0	5	8	4	1	0	1	0	1	0	0	0	0	0	0	0	0	0	1	0	0	1	18	0	0	1	0	0	0	7	0	0	0	0	1	0	0	0	0	0	0	0	0	2	0	0	43	0	14	1	0	0	0	0	1	0	0	0	0	62	0	0	0	0	1	0	1	0	0	0	0	0	0	0	1	0	0	2	0	0	3	0	0	0	13	0	0	0	0	2	150	0	0	0	2	0	1	1	3	1	0	2	0	0	0	0	0	0	0	3	0	2	0	38	0	0	0	0	0	8	0	25	52	0	0	2	0	1	0	0	0	0	0	0	1	0	0	0	0	0	0	1	0	1	0	2	0	0	0	0	0	0	31	8	2	0	0	0	2	0	0	0	4	0	0	0	0	0	0	0	4	0	0	0	0	0	0	0	0	8	1	0	0	0	0	0	8	1	0	0	0	0	0	0	0	0	0	0	0	1	0	0	0	0	2	0	0	0	0	6	0	0	0	1	0	0	0	0	0	0	0	0	13	9	0	12	0	0	0	0	1	0	0	1	0	0	0	1	0	0	0	0	0	59	0	118	0	9	0	0	0	5	0	0	5	0	25	0	0	0	0	0	2	0	0	0	0	2	3	4	0	2	0	0	0	0	11	0	0	16	0	0	0	1	0	0	0	0	2	0	0	3	1	0	0	0	0	0	0	0	0	0	0	18	0	0	0	0	0	5	0	1	2	0	0	12	0	0	0	0	0	1	0	0	0	2	0	0	1	0	3	1	0	0	1	0	0	0	6	1	1	0	58	21	3	177	516	0	1	2	0	158	0	10	31	0	0	0	0	14	74	0	18	0	5	28	0	150	0	0	0	1	0	0	0	4	8	0	9	0	6	1	0	6	35	20	0	0	4	1	4	0	11	2	0	5	4	0	0	0	0	0	2	0	2	7	0	0	0	0	16	10	1	14	0	3	0	0	0	6	0	0	0	0	4	0	0	2	8	0	4	6	54	0	2	0	15	2	10	0	0	0	0	1	0	0	0	0	0	16	39	0	2	1	1	0	0	0	0	0	0	0	0	0	0	0	17	10	0	2	0	0	0	1	18	1	4	0	1	0	0	0	0	0	0	0	9	4	0	0	0	0	3	1	1	0	0	1	4	0	0	1	0	0	0	13	0	0	8	0	8	10	0	2	0	4	2	2	7	1	0	5	0	0	0	0	5	2	0	0	133	163	205	0	6	20	33	147	1	56	48	13	5	260	247	55	0	174	38	75	20	44	1	85	15	147	1	14	0	39	0	0	0	0	0	0	1	0	5	0	3	0	5	5	0	3	0	0	0	21	2	0	8	8	0	0	1	0	0	1	0	0	3	14	0	1	0	0	0	0	33	0	0	0	0	0	0	0	46	4	0	0	2	6	0	0	10	2	9	0	31	0	1	1	1	0	0	3	53	2	15	28	23	0	1	0	1	1	0	3	0	0	0	0	0	0	1	1	19	0	0	0	0	3	0	0	0	1	19	0	0	6	0	3	0	1	0	1	2	2	5	8	2	26	1	3	0	1	0	0	4	1	7	2	0	10	0	0	1	0	0	0	0	0	3	0	65	0	1	84	0	0	0	2	0	0	0	19	0	2	0	0	8	35	2	0	0	7	0	0	12	2	4	3	0	5	1	5	0	0	0	0	0	0	1	0	0	0	0	0	0	0	3	1	0	0	1	14	0	0	9	4	0	2	0	1	0	0	1	63	0	0	2	1	9	5	1	2	18	0	0	0	16	67	109	0	0	1	0	10	0	0	0	1	8	0	0	0	2	0	0	0	0	0	91	1	3	0	50	0	0	0	0	6	0	0	0	14	0	0	0	0	0	0	0	0	0	0	16	0	3	1	0	1	1	5	0	1	31	2	1	0	0	13	0	3	3	0	30	0	0	0	1	8	0	0	19	0	0	0	1	39	0	5	2	2	0	0	0	0	9	0	5	1	0	0	0	0	0	0	0	388	0	0	1	10	0	3	3	0	11	4	0	5	0	3	1	1	1	0	1	2	11	0	0	1	0	0	1	1	0	0	0	0	0	0	0	0	0	12	0	1	0	2	2	1	0	1	1	33	0	7	0	0	0	0	1	11	0	0	0	2	0	0	0	29	2	0	0	0	3	0	1	1	0	2	0	1	0	0	0	0	0	1	0	0	4	0	0	2	0	0	3	7	2	1	0	0	34	27	12	5	0	1	0	0	0	0	0	0	3	0	0	25	1	0	4	0	0	0	4	0	0	8	3	28	6	10	18	1	0	0	0	0	1	14	0	1	2	2	1	0	0	0	0	0	19	0	6	21	2	30	2	6	19	0	1	0	0	52	0	0	0	11	0	0	1	0	0	0	1	0	0	0	0	0	0	0	3	2	0	0	0	1	0	0	50	14	1	0	0	0	3	6	8	0	0	0	1	0	0	9	0	1	0	0	0	1	2	0	15	0	0	8	1	0	2	10	2	2	2	0	0	2	0	0	2	0	0	1	1882	0	0	0	0	1	5	0	3	0	0	0	0	0	3	3	0	10	1	1	0	3	1	1	1	0	0	1	0	0	6	0	2	0	3	0	0	1	1	0	0	23	2	11	1	0	1	1	5	4	61	0	4	6	0	19	0	7	0	3	4	0	0	0	0	3	1	0	0	0	4	3	0	2	1	1	8	1	2	0	7	119	0	3	0	0	2	16	6	0	2	0	0	0	9	0	3	0	0	0	0	0	1	1	0	0	1	0	0	1	35	0	1	0	0	0	0	0	21	3	0	0	6	0	1	0	7	0	0	2	0	2	0	2	0	1	0	0	0	0	0	0	0	0	0	0	0	0	5	0	1	0	1	0	0	10	0	0	0	0	0	0	0	1	0	0	0	0	0	0	0	59	0	0	0	3	1	0	5	0	2	0	0	2	0	0	1	0	1	0	0	2	0	5	0	0	0	0	0	0	0	0	0	1	13	0	0	1	1	0	1	0	53	0	0	0	0	0	5	1	2	0	0	0	3	1	0	1	14	1	0	0	0	0	0	0	8	0	0	19	0	0	16	0	0	0	0	0	0	0	0	0	0	10	0	0	1	0	0	1	2	0	0	0	25	0	0	2	0	1	0	0	0	1	0	2	0	3	0	0	4	0	4	23	0	0	0	0	0	1	0	0	0	0	0	3	1	0	0	1	1	0	1	0	0	12	0	1	0	5	0	2	0	1	0	5	0	0	13	1	0	0	0	0	0	0	0	0	0	0	9	0	0	0	0	1	0	1	0	0	0	2	0	17	1	0	1	0	2	30	0	0	1	0	0	15	34	0	0	0	0	0	4	0	1	2	0	0	0	0	5	0	13	0	1	0	2	0	1	0	0	0	0	0	3	4	0	0	0	0	0	0	0	41	9	19	5	0	1	1	1	0	0	20	2	2	0	6	16	13	16	31	0	6	22	0	28	0	2	0	17	19	0	9	1	0	0	4	0	1	0	0	72	7	4	4	1	394	0	0	1	10	2	79	1	0	2	1	0	0	7	1	5	0	0	0	1	0	1	0	9	0	0	8	0	0	0	0	1	8	2	6	0	2	0	7	2	92	5	0	10	0	7	1	2	12	0	0	0	0	0	1	2	0	1	0	0	0	4	2	13	0	2	0	0	1	22	27	2	6	13	6	172	40	0	0	2	1	1	0	1	0	0	0	1	0	1	2	1	1	1	0	4	0	9	2	50	0	0	6	0	2	3	0	0	1	0	1	0	0	0	0	1	0	1	0	0	0	0	0	0	0	1	0	1	0	0	6	0	0	1	3	1	0	2	0	1	0	0	0	0	0	10	0	3	4	3	0	1	0	2	0	2	1	22	15	1	2	3	2	3	3	0	1	1	0	6	40	0	0	1	0	0	15	2	2	2	13	2	7	727	0	8	3	0	0	4	5	0	0	0	0	2	0	2	0	0	0	0	0	0	0	1	9	2	0	0	14	0	14	19	6	0	0	0	0	0	0	12	0	0	4	22	56	18	0	0	0	0	7	0	0	0	8	5	8	10	0	5	0	0	0	3	0	69	0	0	1	197	0	0	0	3	5	1	0	2	5	0	220	2	20	24	0	16	0	0	0	0	12	0	0	5	0	0	13	9	27	1	12	1	0	0	0	3	0	0	1	0	1	1	0	2	0	4	0	0	0	11	0	0	15	0	0	0	1	3	1	0	1	39	3	13	2	1	19	4	1	0	0	14	0	19	3	3	19	25	2	3	16	3	14	4	32	4	0	0	0	0	8	2	0	4	0	0	2	0	0	0	0	0	0	0	10	2	4	3	62	14	49	0	152	0	4	0	4	1	2	0	0	0	0	0	3	1	1	0	0	0	0	0	7	8	8	0	0	1	1	1	7	0	1	0	0	43	0	0	0	1	0	4	6	0	2	0	0	14	3	0	1	1	11	0	66	26	10	5	1	0	15	3	0	0	24	4	0	2	0	0	2	0	1	28	0	0	0	34	11	10	4	0	0	0	0	0	2	0	0	16	0	3	2	1	1	0	5	0	41	38	15	1	2	3	3	4	9	6	14	0	2	0	0	24	5	1	14	2	4	0	33	55	50	1	3	1	22	0	0	0	1	0	0	3	0	0	5	0	0	35	21	3	1	4	0	17	2	0	1	0	0	0	0	12	7	1	4	6	0	5	0	170	0	6	19	21	5	9	5	0	1	106	47	0	25	4	2	0	6	10	5	12	4	0	0	0	0	0	0	0	21	0	0	0	0	0	3	35	27	190	355	4	5	0	27	0	77	37	36	0	0	65	0	0	0	0	0	0	0	0	0	1	1	0	0	0	4	0	2	0	3	1	0	0	0	0	0	2	1	12	0	7	23	2	9	1	2	7	25	4	2	2	0	0	0	0	111	39	7	0	0	0	6	1	20	0	3	4	0	0	5	10	0	3	0	0	0	0	0	9	15	0	0	11	0	0	2	0	1	2	0	0	0	0	0	71	2	3	7	41	11	3	0	0	0	0	690	1	2424	0	7	0	4	44	14	7	1	0	0	0	0	0	0	0	14	1	5	1	0	1	0	0	2	2	1	3	0	0	109	0	2	3	0	0	0	2	8	0	20	16	0	0	5	0	0	0	1	0	0	1	3	0	0	0	1	0	1	0	0	3	0	0	0	0	0	0	0	0	10	1	0	7	0	2	0	0	0	27	0	0	0	0	0	1	0	0	91	0	0	0	0	1	1	1	0	0	0	0	170	14	1	12	10	0	1	0	0	4	0	66	8	9	2	1	0	0	1	2	0	0	33	0	0	0	2	59	0	0	0	2	2	0	0	0	1	0	1	0	0	792	9	5	6	6	669	0	15	75	6	81	10	339	309	195	3	38	42	59	0	9	132	86	53	25	7	8	5	0	490	0	3	5	5	0	54	7	0	0	303	9	8	0	1	0	0	1	18	0	0	0	5	14	11	9	13	5	12	8	11	0	4	0	21	12	13	20	2	0	0	0	0	0	0	0	0	1	16	1	0	4	1	18	0	3	17	0	2	0	0	0	5	4	2	0	13	0	0	11	5	0	0	0	0	0	56	0	5	0	4	0	6	3	0	26	1	0	0	12	72	227	0	1	7	16	22	1	7	13	2	15	0	20	1	1	17	0	0	2	4	4	40	7	2	16	8	24	6	0	0	17	2	1	0	15	1	7	1	1	3	19	1	1	3	5	2	0	5	1	1	2	7	0	1	2	0	0	0	0	0	0	0	40	2	6	0	0	1	3	0	178	24	8	0	0	0	5	2	7	0	0	13	0	0	2	36	18	1	38	58	1	3	5	2	0	0	2	12	1	1	1	6	4	11	14	89	83	24	5	0	0	0	0	0	1	0	0	0	1	0	2	0	0	0	0	0	1	19	9	0	9	0	0	0	0	2	0	9	2	1	1	0	10	0	0	0	2	1	1	2	0	0	0	0	1	1	0	8	0	0	10	0	0	0	13	3	0	0	0	10	11	0	1	0	1	0	0	0	4	0	0	3	0	0	0	0	5	6	1	0	5	3	0	3	0	0	0	0	0	0	0	0	21	113	1	0	10	0	0	0	11	7	20	0	0	1	0	0	10	0	10	3	4	5	0	0	0	0	1	55	0	0	0	0	14	47	118	13	41	3	22	41	5	44	0	26	4	18	1	123	81	44	21	40	23	24	31	18	2	27	0	0	16	4	13	1	5	94	36	78	100	3	34	9	59	7	4	21	5	25	29	4	35	6	1	0	1	164	118	1	29	6	78	69	2	1	73	101	197	1260	0	122	24	0	0	0	0	0	4	0	13	0	11	0	298	686	92	11	0	41	0	0	0	0	2	77	5	57	4	56	34	108	0	44	77	0	27	45	17	14	0	0	0	5	10	19	3	5	35	7	7	0	21	2	6	7	11	0	0	0	13	0	1	0	36	0	0	14	0	0	2	0	36	1	1	0	0	2	17	3	2	3	0	0	0	0	0	2	12	0	0	0	0	0	0	0	0	2	0	0	0	1	0	0	0	1	0	0	2	13	2	0	6	26	6	14	23	1	0	0	0	0	1	3	0	1	0	0	0	0	0	0	0	0	0	0	12	0	0	3	1	0	7	0	0	0	0	1	0	0	0	0	0	0	2	0	2	0	0	14	1	2	0	0	3	0	47	2	15	32	0	23	6	27	0	0	0	0	0	0	2	0	0	0	0	0	0	32	5	6	2	1	0	2	0	0	0	0	0	1	3	1	3	19	0	3	0	0	37	45	0	0	0	10	0	0	11	8	27	17	7	0	1	5	1	10	15	0	47	0	0	0	6	9	2	3	1	6	3	13	5	0	0	14	10	1	6	36	85	6	3	0	1	0	3	22	9	2	0	6	1	0	0	0	1	0	2	0	0	0	0	0	9	10	1	12	0	0	0	0	0	0	5	5	4	0	21	1	0	0	0	0	0	0	0	0	22	9	3	0	2	7	0	4	2	0	1	3	10	0	0	5	1	1	0	3	4	0	1	0	0	0	2	17	1	15	1	3	0	2	0	0	0	0	0	0	8	6	2	0	7	0	0	0	0	5	0	0	3	8	3	0	47	23	19	0	0	28	0	1	1	1	0	2	1	1	0	0	2	0	0	0	1	0	1	2	0	0	0	1	32	1	0	0	0	0	1	3	1	4	1	5	7	0	0	0	0	0	0	1	0	3	1	0	1	12	0	0	3	0	12	5	0	0	16	5	4	0	0	30	0	8	5	9	233	2	0	15	0	1	0	0	0	0	2	0	0	11	13	0	14	1	4	1	0	8	0	28	0	0	1	0	0	336	0	0	0	1	0	1	9	2	2	0	0	1	0	0	0	0	0	2	0	1	0	1	6	6	0	0	0	0	12	4	2	0	0	0	20	14	0	1	0	0	1880	2	26274	0	0	0	0	1	21	0	0	0	0	1	0	0	0	2	1	4	0	1	0	0	11	4	24	11	2	5	6	4	1	0	0	0	0	0	0	0	11	52	2	21	6	0	0	0	0	3	2	1	2	0	0	2	0	7	10	6	17	28	19	42	12	1	6	2	0	13	0	2	219	7	10	13	0	0	0	2	2	4	1	12	52	18	2	129	0	0	0	0	7	1	0	6	2	33	4	0	47	5	0	0	75	15	2	0	19	14	0	1	1	7	1	0	0	0	0	0	0	36	57	23	79	82	1	21	46	3	189	15	16	169	77	94	43	36	36	66	92	0	11	30	4	0	95	1	9	1	57	50	83	130	60	2	9	0	0	33	18	3	2	1	0	1	0	0	0	0	0	0	0	0	3	4	62	1	2	0	11	2	0	1	18	0	1	1	0	6	16	3	4	2	4	3	2	0	1	0	60	0	1	0	2	1	31	5	10	7	0	2	0	0	0	12	18	0	6	0	1	0	0	1	0	2	0	0	0	0	19	0	1	4	1	8	11	7	0	0	0	0	0	1	0	1	1	18	0	4	0	0	0	21	26	0	1	4	0	37	1	0	9	5	0	13	1	1	0	2	0	0	23	0	4	0	0	0	0	0	0	0	0	0	5	0	3	1	1	0	0	1	15	0	3	0	0	0	0	1	0	0	0	0	1	2	0	0	0	0	1	0	1	1	0	12	0	0	3	0	0	0	1	1	14	0	1	1	9	14	15	0	48	3	0	2	115	17	31	15	10	0	1	1	6	9	0	2	2	1	7	26	5	2	0	0	0	0	0	0	0	0	261	1	0	0	4	10	4	0	0	0	0	603	5193	0	0	1	0	0	0	1	26	10	46	9	1	12	0	13	8	1	20	9	5	0	15	16	4	12	0	203	0	0	19	20	303	2	3	1	0	0	0	1	0	10	1	7	56	15	10	0	0	0	23	14	2	3	0	0	0	1	2	0	0	1	0	0	3	1	2	0	6	1	2	4	1	1	0	1	2	6	5	1	0	0	0	2	0	0	50	250	37	15	8	15	29	76	0	1	5	3	13	9	0	2	1	3	10	0	3	2	3	0	0	2	10	2	2	0	0	1	0	2	0	2	0	4	1	2	0	7	14	3	0	0	9	0	0	1	0	0	0	1	1	73	0	16	0	1	0	1	3	0	0	0	2	2	0	4	0	0	1	0	0	1	0	34	23	0	1	1	0	0	0	5	0	0	0	1	2	2	0	0	0	3	1	0	0	0	1	3	0	0	3	0	0	0	14	2	1	0	42	0	6	11	34	65	12	25	0	0	0	0	0	0	0	0	0	2	0	5	1	0	5	0	9	20	0	0	0	3	0	4	0	0	0	0	0	2	1	4	0	0	27	0	0	19	3	2	3	4	0	11	4	1	1	1	15	1	10	18	18	3	31	4	2	12	47	20	62	81	0	0	11	4	1	1	6	26	9	0	1	0	0	1	13	105	0	0	3	1	185	0	0	0	0	2	55	0	1	1	0	1	2	0	0	0	2	0	0	0	0	12	5	0	0	1	11	112	36	0	0	0	3	0	0	0	2	6	0	0	0	1	0	1	17	9	0	1	0	0	8	0	0	1	26	1	0	15	6	3	0	1	0	2	0	8	4	17	0	2	3	1	0	0	601	2	0	11	0	36	10	1	0	4	86	7	3	1098	0	6	23	6	0	11	0	25	18	16	1	0	1	7	15	1	11	0	2	0	2	0	0	12	0	2	0	9	5	0	154	2	0	35	188	2	1	1	0	0	14	4	0	0	3	0	2	0	0	5	0	0	0	2	10	0	0	0	0	10	0	3	0	0	4	1	0	0	0	0	6	0	11	0	1	34	2	0	0	0	1	0	6	13	7	14	8	30	26	0	11	17	10	17	29	29	0	0	0	2	0	0	1	0	0	150	0	0	3	62	44	23	5	10	57	0	2	31	8	0	1	40	2	0	0	1	0	3	0	1	8	101	14	1	0	1	0	0	0	2	0	2	1	0	1	2	0	1	0	0	0	0	0	0	0	1	0	0	0	3	1	0	0	0	1	0	0	0	0	0	0	0	0	2	52	0	0	0	0	2	0	0	1	0	0	0	0	0	0	0	0	9	3	6	5	0	2	2	1	0	1	2	3	4	0	2	0	0	5	4	5	22	13	4	12	3	0	11	0	9	5	1	0	0	0	4	1	2	0	0	11	0	2	13	0	7	3	0	0	8	7	9	27	11	0	5	1	0	1	0	0	0	14	6	12	5	12	2	26	5	2	28	2	1	5	1	0	1	0	13	32	37	17	0	16	5	10	1	8	0	9	0	3	3	0	1	1	0	4	0	0	0	0	26	0	4	18	0	0	0	8	2	2	6	4	20	4	5	5	5	14	6	5	24	5	2	37	12	41	0	0	0	0	0	3	0	1	0	32	3	504	4	0	0	6	0	1	1	0	0	0	0	0	0	0	0	1	0	10	25	192	2	47	68	25	9729	18	0	3	0	0	0	0	0	5	6	3	1	0	0	11	0	0	1	4	0	4	0	0	1	0	0	0	21	48	1	6	53	3	1	0	0	0	1	25	0	26	0	6	36	0	0	0	27	1	17	0	0	0	1	2	0	0	0	0	0	0	5	0	0	0	0	0	0	0	0	2	1	0	0	0	0	0	1	1	1	0	4	0	0	0	2	1	0	0	0	244	81	1	16	35	5	30	4	16	14	0	3	0	7	0	0	0	0	0	2	0	0	0	0	0	6	0	0	1	0	0	0	0	0	0	9	0	9	0	0	0	0	6	0	0	0	0	0	0	3	0	0	12	4	0	0	0	0	0	0	0	0	0	0	2	3	1	6	0	11	8	17	4	17	0	0	0	0	0	0	0	0	2	0	26	0	0	0	4	0	12	33	0	0	0	0	58	0	0	0	0	6	2	0	0	0	0	0	0	1	0	0	0	0	0	0	0	0	0	2	1	0	1	0	0	0	2	0	113	0	0	0	1	0	0	1	0	1	21	0	0	0	10	6	0	0	0	0	0	0	0	1	0	0	2	0	0	0	1	0	0	0	0	32	0	2	3	0	1	0	13	4	0	2	1	0	0	0	0	5	0	0	0	4	0	0	0	1	0	1	0	0	2	1	0	0	1	1	0	1	0	1	1	0	1	0	0	0	0	0	0	0	0	1	0	0	0	0	0	0	0	1	12	0	0	0	0	3	0	0	0	0	0	0	0	0	0	0	0	0	0	0	0	9	0	0	0	0	0	0	0	0	5	0	0	1	1	1	0	0	0	0	0	0	0	17	0	0	0	0	0	0	0	0	0	0	0	0	0	0	0	3	0	0	0	0	2	0	2	0	0	0	90	0	0	0	0	0	0	2	3	0	0	1	0	1	27	0	85	5	0	0	0	7	0	3	0	0	3	61	0	3	0	1	17	1	5	0	0	3	0	0	1	5	0	5	1	1	0	2	1	1	1	6	0	2	0	0	2	0	4	6	41	0	2	0	0	6	1	1	29	0	7	1	0	1	0	0	2	1	6	0	3	2	3	0	0	2	5	3	3	19	1	2	2	1	8	3	0	0	0	1	20	7	13	2	2	0	11	1	3	0	2	7	0	2	13	0	1	235	0	1	2	0	2	0	55	1	27	9	1	0	4	1	1	2	7	2	8	1	0	0	0	19	2	9	2	10	8	12	5	60	80	14	7	0	1	3	26	0	6	0	0	0	5	0	0	0	0	15	0	0	0	0	0	2	0	17	1	209	9	14	0	0	1	0	0	62	0	54	0	97	7	0	1	0	6	2	1	0	0	2	0	0	4	0	0	0	3	0	2	3	2	15	0	0	0	3	0	0	3	0	0	0	3	0	1	0	0	0	0	1	0	0	0	1	1	94	0	4	1	3	0	7	2	0	6	0	3	7	0	1	0	1	0	7	0	0	0	1	0	0	0	1	1	1	0	5	0	0	0	1	0	0	0	1	0	0	1	0	1	0	0	0	12	1	67	0	2	0	0	0	0	0	0	0	0	73	0	5	3	0	2	0	2	0	0	0	0	1	0	0	0	1	1	0	0	0	0	0	24	39	1	11	35	0	1	0	8	1	0	5	0	392	1	2	5	24	0	0	1	1	9	8	4	0	0	0	5	5	0	0	1	0	6	180	7	395	0	6	17	17	0	3	0	3	0	1	0	0	2	0	0	1	0	0	1	1	8	1	2	0	15	19	0	0	3	0	0	1	0	0	0	6	30	8	9	38	35	0	26	20	1	0	28	2	4	26	0	0	2	10	0	3	0	0	0	5	7	6	0	1	1	0	91	2	1	0	0	16	0	0	0	0	0	6	0	0	14	6	4	12	0	49	0	0	0	0	1	0	1	0	3	0	2	2	4	3	5	4	0	22	0	5	0	0	1	0	7	0	4	0	6	0	29	10	4	0	7	1	0	9	2	4	2	117	29	1	0	0	0	0	0	0	0	0	7	0	0	0	0	0	0	2	9	9	0	1	0	2	11	6	11	0	2	0	3	16	8	11	16	0	2	0	1	11	7	17	23	5	9	4	0	1	3	11	0	0	0	6	5	0	49	41	61	1	10	0	0	1	3	6	3	2	0	0	0	12	21	45	33	4	7	6	31	101	0	7	1	0	4	0	4	12	22	16	3	1	12	34	26	0	0	0	2	0	0	0	19	2	0	53	0	2	0	1	4	1	4	36	11	6	0	0	0	0	1	0	0	1	0	2	5	3	0	0	0	1	11	8	96	2	5	0	0	0	4	0	8	0	3	0	2	0	0	0	8	0	1	26	5	1	25	0	0	0	10	107	0	0	4	0	0	9	0	1	1	1	0	0	0	2	12	9	0	8	3	10	4	0	0	0	0	0	3	0	41	1	1	0	48	0	0	123	0	18	5	0	20	64	0	0	0	0	0	20	3	0	1	0	2	0	3	0	0	12	2	5	0	0	35	10	3	1	1	1	0	0	3	0	0	0	0	12	8	22	11	0	77	10	2	168	29	19	56	68	23	22	102	257	14	114	69	23	96	45	19	39	0	0	0	1	2	2	0	0	0	1	1	1	5	0	0	3	0	0	0	4	1	4	0	1	0	5	2	1	4	2	0	0	0	0	0	0	0	0	0	0	0	0	1	0	5	0	0	0	0	0	0	0	0	0	0	0	0	7	7	1	0	0	0	0	0	0	0	0	0	0	0	0	0	0	0	0	0	0	0	0	0	1	0	22	6	1	73	3	1	0	4	0	0	0	28	13	29	8	3	12	64	1	0	2	1	2	0	0	0	0	0	0	0	1	21	17	2	8	17	26	0	0	0	13	1	12	1	1	0	1	3	0	0	0	13	0	0	4	1	8	4	3	0	9	6	27	2	6	0	4	5	7	0	15	38	8	0	0	1	0	0	0	5	37	1	0	0	1	1	0	0	7	4	11	0	0	564	7	1	13	0	13	0	0	0	0	1	0	0	0	63	6	0	3	0	1	95	0	0	1	2	7	1	2	0	0	8	0	0	2	13	1	6	8	31	0	7	16	1	1	1	4	0	5	0	2	2	2	4	2	1	5	0	8	0	2	1	17	1	0	3	13	7	15	12	3	7	1	9	0	0	6	0	1	11	0	2	0	1	17	0	0	3	7	5	0	8	3	0	0	1	0	0	2	0	1	0	1	0	0	4	2	2	3	0	1	0	0	0	4	0	0	0	0	0	0	2	466	3	0	4	2	0	0	0	0	5	2	2	5	13	0	12	0	1	22	38	25	25	17	2	2	196	104	0	9	36	1	32	0	3	12	3	0	0	12	0	20	14	9	0	1	4	0	0	25	6	10	0	0	13	20	66	3	0	0	2	0	0	0	32	0	2	1	2	2	2	0	0	0	0	0	0	105	3	55	13	9	1	18	19	10	0	0	0	0	0	1	0	0	0	6	0	42	1	1	15	3	0	27	1	197	14	8	0	0	17	9	8	68	19	10	4	5	34	0	21	54	4	0	0	0	1	1	1	3	326	89	8	0	8	0	0	3	1	11	0	1	1	2	0	5	0	57	45	0	0	0	178	22	31	17	2	11	68	19	50	0	1	28	0	1	8	3	9	0	2	0	0	0	0	0	7	4	0	0	1	1	0	0	0	1	0	0	0	0	1	0	87	0	0	0	1	80	3	2	0	0	0	5	2	1	1	0	0	15	16	1	11	12	2	11	1	0	0	6	11	0	17	5	0	0	11	2	5	22	15	12	7	3	2	1	66	5	17	24	1	0	0	0	0	0	0	0	5	0	1	0	7	0	0	0	0	0	0	0	7	0	6	0	13	0	13	0	1	5	2	6	0	0	4	2	7	0	0	1	11	1	2	22	7	17	14	1	21	0	0	0	1	0	0	0	0	0	0	1	3	0	0	0	1	0	1	2	0	0	0	9	0	0	9	2	5	2	1	1	0	84	0	167	0	0	66	0	0	4	0	0	0	0	0	1	22	0	0	4	0	0	2	3	7	9	0	12	1	13	0	3	0	247	0	220	99	0	1	1	1	6	1	0	0	12	70	367	28	21	56	9	61	16	26	29	23	6	11	0	14	11	0	0	1	9	0	0	0	1	0	0	35	1	0	1	0	1	0	0	5	0	0	0	0	5	1	0	0	0	0	0	0	0	0	3	1	0	0	0	0	0	0	0	0	0	0	0	1	0	9	3	0	47	4	42	72	16	30	1	0	0	6	0	0	4	0	2	623	0	0	37	10	1	0	0	3	0	16	0	32	6	20	0	2	1	0	1	0	2	0	0	0	1	0	0	1	8	11	14	0	27	0	6	4	9	0	0	0	1	2	1	19	14	1	0	5	8	11	0	19	1	1	2	5	0	2	0	12	1	0	2	0	0	0	0	0	0	2	1	0	0	90	4	3	4	2	2	9	0	2	3	1	0	0	0	0	0	0	1	2	1	36	84	1	0	0	1	0	0	0	0	1	0	0	5	0	3
LakWasM112_LOW13_2_rpkm	0	0	0	0	1	46	46	0	0	0	2	6	16	0	0	0	0	0	13	0	0	0	0	58	0	1	0	0	1	8	0	0	1	4	6	4	4	2	0	0	0	0	0	4	51	45	60	19	0	3	2	13	0	0	0	22	0	16	83	29	686	1	0	6	0	7	0	0	10	79	1	0	0	0	1	0	0	1	0	0	0	15	0	0	0	0	0	2	1	0	0	1	23	2	30	0	0	0	0	12	0	0	1	0	0	1	0	0	0	0	0	10	96	2	43	2	0	6	1	0	0	0	1	11	0	0	3	0	0	0	4	74	42	0	0	0	0	0	41	0	0	0	1	15	0	0	0	0	13	4	2	29	18	0	31	0	12	11	35	2	9	5	0	7	40	0	0	4	0	9	0	0	0	0	1	0	0	0	0	0	0	0	0	0	1	4	0	0	0	39	2	0	6	9	0	0	0	4	10	161	24	0	51	0	0	0	42	0	73	10	12	3	278	10	12	0	56	0	0	6	1	11	46	1	7	82	0	1	23	0	0	0	1	0	0	0	21	73	18	6	0	0	39	14	37	54	0	0	50	14	28	4	22	0	1182	561	0	0	0	0	0	0	0	8	25	0	2	0	2	30	45	0	8	0	0	1	0	1	79	69	0	14	62	14	16	0	1	0	4	1	1	0	0	0	1	0	0	6	5	0	0	22	104	1	21	1	28	15	45	2	80	0	24	5	0	0	0	1	207	0	0	0	0	1	16	60	4	0	0	0	1	0	0	0	0	0	1	0	0	0	0	1	26	33	11	3	8	8	0	0	14	0	4	0	1	0	0	0	0	93	18	0	2	0	0	42	5	19	100	7	0	22	0	0	9	19	0	2	0	2	0	0	2	4	9	0	197	0	0	0	0	1	79	3	0	7	264	0	0	60	0	50	0	0	8	0	4	0	1	2	0	6	37	0	1	40	39	6	2	1	0	0	0	1	0	0	0	0	2	0	22	0	0	1	0	0	0	0	12	0	32	72	0	0	59	30	0	0	0	0	0	146	60	1028	0	92	39	3	0	63	0	0	1	3	1	28	9	0	0	45	24	39	4	0	0	0	5	5	1996	1	1	1	3	1	0	0	0	280	5	6	0	1	55	29	10	0	0	0	0	0	0	0	1	0	1	2	0	0	2	1	0	0	0	1	1	0	0	0	0	7	0	0	0	0	0	0	0	0	0	0	0	0	0	0	7	0	8	3	0	10	0	37	0	17	20	0	0	0	3	0	0	0	1	0	2	58	0	0	0	0	1	9	0	2	15	0	48	0	36	0	0	0	1	0	16	84	131	144	0	35	186	122	65	152	12	0	98	4	9	0	1	0	3004	0	3	8	0	0	4	0	22	0	0	0	6	8	0	144	0	94	0	218	480	67	1	0	57	0	626	2	511	103	34	8	0	4	1	25	1	3	4	24	0	0	0	0	0	0	0	0	2	55	0	0	0	0	0	17	3	1	173	0	3	45	3	0	1	0	0	0	13	229	1	358	0	0	0	0	6	50	36	17	0	0	1	0	9	0	0	4	1	0	7	0	0	0	3	0	0	17	0	0	8	0	0	0	0	11	0	18	0	0	0	4	1	0	3	0	15	0	0	0	0	0	9	7	0	0	6	1	0	2	6	1	7	0	8	0	18	0	0	0	1	0	0	0	0	0	0	36	0	20	17	0	38	43	18	0	0	141	0	0	1	0	0	25	0	0	228	5	0	22	0	18	0	16	0	0	0	0	0	0	0	0	1	32	0	0	0	0	0	0	1	0	1	0	4	0	0	16	9	0	0	0	0	0	12	0	0	46	0	0	0	0	607	1	24	0	0	0	0	0	0	0	0	0	45	0	0	0	0	0	0	99	8	0	0	5	4	0	2	0	0	0	0	0	0	86	31	0	0	0	0	0	0	0	0	63	90	164	0	0	3	0	0	0	12	1	1	59	45	0	0	1	0	0	1	0	3	3	0	0	0	1	0	0	0	80	0	296	0	0	0	0	1	2	0	0	0	0	0	0	0	0	3	0	0	0	0	0	0	0	13	3	0	0	0	0	0	0	0	0	0	0	38	47	90	55	54	0	0	0	0	0	1	0	0	0	0	1	104	0	1	0	0	0	0	0	0	162	0	0	0	10	15	0	182	19	0	0	0	0	0	0	2	1	0	0	0	0	0	0	0	1	0	2	0	0	0	0	1	71	18	546	8	43	0	1	0	0	30	9	34	0	97	0	0	13	1	0	0	1	0	0	0	0	0	40	54	0	1	5	0	0	14	0	0	0	0	0	0	0	0	0	0	0	0	180	0	0	0	131	13	0	5	1	0	0	0	4	0	0	0	0	0	0	0	0	744	0	0	1	0	0	1	0	0	43	0	0	0	0	0	4	12	0	0	0	0	1	91	59	0	6158	0	0	0	0	147	1	62	0	0	1	6	1	16	0	6	10	0	0	0	0	0	0	0	0	0	29	2	3	0	0	0	0	2	0	0	2	0	2	0	0	1	0	88	0	22	94	0	1	0	0	18	0	0	7	1	1	0	3	0	0	0	0	11	27	9	0	35	0	1	0	0	6	1	0	0	0	0	0	0	1	0	0	0	0	0	0	1	0	0	0	57	0	0	1	0	7	0	7	0	0	0	0	0	0	0	0	41	22	0	1	1	0	8	0	4	0	0	0	6	0	1	0	0	1	0	0	0	7	19	19	237	222	1	0	0	19	1	0	0	8	0	0	8	0	0	0	0	0	44	0	0	0	1	2	0	0	0	3	7	0	0	0	0	0	210	1	0	0	0	4	0	0	0	4	13	0	16	0	1	11	0	0	0	2	1	0	2	1	0	75	60	0	0	4	0	1	52	0	0	33	0	2	0	0	0	0	1	2	16	15	8	8	2	13	0	27	4	7	7	18	0	0	0	0	6	1	0	2	0	0	0	2	0	0	10	4	2	0	2	0	0	0	0	5	1	30	0	1	0	0	0	0	0	0	0	0	0	0	148	0	0	0	1	0	2	0	0	0	0	8	17	0	27	91	18	39	0	2	10	0	0	0	0	9	2	7	0	1	2	0	0	0	54	23	0	3	0	0	25	0	13	0	7	10	2	45	0	0	30	1	7	6	3	6	1	0	0	0	35	0	80	0	10	7	4	74	13	7	115	0	0	8	7	42	0	0	0	1	12	9	4	0	1	1	5	17	0	25	35	18	0	0	11	0	0	0	0	0	0	6	46	0	0	0	13	2	36	36	1	41	51	0	1	8	8	10	2	5	0	30	39	69	0	0	0	1	0	0	22	302	133	10	21	0	0	0	0	0	0	0	0	125	4	1	0	12	1	1	0	5	102	56	134	59	0	0	0	416	1	0	0	0	5	0	0	0	145	11	21	59	85	42	0	17	134	12	0	0	0	0	0	0	373	2	0	0	0	16	0	19	0	0	0	0	0	3	0	1	0	0	0	1	7	0	0	0	0	0	0	3	10	50	0	0	0	0	0	0	0	2	0	0	0	0	8	0	0	0	5	2	0	0	0	0	0	0	0	2	3	1	0	0	0	0	0	0	0	0	0	0	0	0	0	0	0	0	0	0	0	0	1	1	0	1780	0	0	257	0	3	0	0	218	0	44	20	0	3	67	0	0	31	22	1	0	0	0	12	0	160	0	0	0	0	0	0	0	1	20	1	0	0	0	23	1	1	14	1	0	0	0	0	1	0	4	0	165	36	39	0	0	1	82	0	1	0	100	0	0	0	0	0	1	0	0	12	0	18	3	11	46	26	0	0	6	1	0	1	10	0	10	12	2	30	0	17	0	0	0	0	0	0	0	23	0	48	13	25	62	43	55	21	5	0	0	0	8	0	101	0	0	1	23	120	0	0	0	69	1	16	0	0	19	34	0	58	44	0	11	0	15	12	7	2	1	98	13	10	0	0	0	0	2	0	212	0	4	78	11	0	0	0	20	3	21	1	6	14	0	0	7	0	1	102	505	4	32	0	131	23	7	24	5	0	0	20	1	3	0	886	0	0	0	0	1	1	2	30	2	3	6	0	0	0	0	0	0	0	106	0	0	1	0	1	1	28	0	0	0	263	0	996	0	0	30	525	4	0	18750	15	0	20	0	0	2	2	2	0	0	0	0	0	5	0	0	4	22	1	0	0	0	0	0	0	6	0	22	0	4	0	2	1	48	1	0	0	0	35	0	3	1	0	0	17	0	1	0	0	0	0	0	15	1	1	26	87	0	1	0	117	805	2	30	0	53	115	0	49	17	86	1	27	43	35	24	133	37	0	12	3	0	0	0	3	0	0	0	0	1	1	1	0	0	9	0	1	12	0	30	47	0	0	2	0	0	0	0	1	0	0	0	1	0	0	0	0	0	7	14	124	0	0	2	3	0	2	0	0	0	0	2	7	0	2	0	2	0	0	0	0	0	7	0	0	0	0	1	0	0	0	1	0	0	1	0	0	0	0	0	42	0	2	0	1	6	1	0	57	1	167	33	74	2	1	0	0	0	1	0	0	0	0	14	0	0	133	1	2	0	0	7	0	0	0	0	0	2	0	0	27	0	33	21	38	37	0	103	1	0	0	0	38	27	117	25	0	0	0	1	0	2	0	0	0	0	10	0	3	0	0	18	2	0	0	0	0	0	1	0	0	0	6	0	0	0	0	0	0	0	0	1209	44	0	2	1	1	0	0	0	15	0	0	3	0	0	0	0	1	4	0	0	0	0	1	0	8	0	0	3	4	0	0	26	0	2	0	0	4	0	0	0	0	1	0	55	0	0	0	0	0	25	0	0	30	10	2	56	43	74	8	0	20	1	0	0	93	0	92	1	0	0	0	0	2	41	0	58	1	0	0	0	0	0	0	0	1	0	0	6	0	0	0	0	0	0	0	2	0	0	21	39	0	0	0	1	0	0	2	0	0	0	0	0	2	0	0	0	12	0	0	0	0	41	2	10	1	47	1	0	0	1441	0	4	154	467	75	3	6	0	15	16	0	0	0	0	0	16	48	0	2	6	8	10	0	0	0	0	10	0	24	0	0	2	1	54	0	0	14	0	63	0	0	0	0	0	0	19	0	0	0	2	0	7	0	0	0	0	0	1	0	0	145	42	0	11	15	0	0	0	18	2	0	1	8	0	5	1	0	0	3	1	1	1	0	2	88	0	0	0	0	0	0	0	0	5	0	0	2	0	0	0	0	1	0	0	0	0	0	0	0	0	0	0	1	0	0	1	0	0	0	0	1	0	1	12	1	0	3	0	0	0	49	0	14	0	24	1	1	0	0	0	0	1	9	1	0	0	0	1	185	154	140	281	229	82	809	198	3	179	86	453	308	121	6	73	36	294	341	21	16	0	568	524	163	303	88	78	200	75	72	4	119	0	0	4	0	0	0	0	0	0	3	0	218	88	0	0	0	0	0	0	0	0	0	0	0	0	0	0	1	8	0	0	0	0	31	0	1	0	20	2	0	0	1	0	112	0	8	0	0	3	0	0	0	0	0	0	0	0	2	8	0	0	0	0	14	13	5	9	13	0	0	11	0	1	1	14	0	0	6	1	0	0	0	0	269	0	0	38	0	0	0	0	0	0	0	0	0	0	0	13	0	3	0	0	0	0	0	0	0	8	0	0	0	0	1	1	0	2	0	88	1	0	4	9	0	0	0	0	0	0	0	0	0	0	0	0	0	76	9	1	0	0	0	3	17	0	4	6	3	0	2	3	3	3	1	0	1	90	4	1	0	1	0	0	1	1	0	0	18	0	0	67	0	0	0	0	0	8	0	0	0	1	1	0	0	0	0	0	0	0	1	1	0	0	0	0	0	0	0	1	5	0	2	0	0	22	0	1	0	198	2	0	0	0	0	1	0	2	0	0	0	0	0	0	0	1	15	1	13	17	0	1	0	0	31	4	0	20	18	0	4	3	1	54	6	6	14	8	0	0	0	0	0	0	0	5	0	2	1	0	0	0	3	0	14	0	1	0	3	0	0	0	0	0	0	0	1	0	0	0	0	0	0	0	0	0	66	0	0	0	0	49	0	13	52	365	9	0	4	0	0	0	0	0	0	0	0	0	0	0	0	0	0	0	23	1	2	0	0	3	1	1	2	0	3	0	17	15	2	0	0	0	1968	0	0	4	0	0	0	0	0	1	0	0	0	0	146	59	0	1	0	0	0	0	0	0	0	2	25	76	3	8	0	1	0	0	23	33	0	9	0	0	0	16	0	0	1	0	0	1	0	0	31	1	1	0	1	0	0	2	0	0	0	0	1	0	1	0	5	0	0	0	3	0	0	1	0	0	1	0	0	8	0	0	0	0	0	0	0	0	4	0	168	1	1	32	0	1	0	1	0	1	2	0	2	24	6	29	14	0	0	0	0	0	0	0	0	91	0	0	0	0	0	0	33	0	60	33	114	2	0	60	62	8	0	34	0	41	0	36	0	21	1	15	1	12	22	8	0	14	0	5	0	16	0	0	0	31	0	25	0	25	27	9	12	11	2	20	5	0	8	5	1	0	39	3	0	0	11	55	0	28	1	0	0	1	10	8	0	0	0	3	0	0	52	0	0	0	0	2	1	0	0	0	3	588	0	0	0	0	0	0	0	0	1	0	0	3	0	0	3	10	0	0	0	0	0	0	0	0	0	3	0	615	8	0	16	11	20	0	18	0	24	0	0	0	395	0	0	0	0	0	9	0	199	0	0	29	0	0	0	0	2	16	0	0	33	6	0	1474	0	31	1	0	1	24	127	0	0	8	2	1	0	1	0	0	24	0	1	1	0	0	43	2	0	0	150	107	0	0	0	0	2	0	196	1742	1072	1	0	0	0	17	0	0	30	53	0	0	0	1	0	1	10	212	31	2	0	0	0	0	0	0	63	1	0	60	0	0	0	0	0	17	0	0	2	0	0	0	0	0	0	0	0	0	196	218	1	0	0	0	0	0	0	232	0	0	0	0	0	0	54	4	0	0	0	0	0	0	0	41	3	0	0	0	0	21	0	0	0	1	0	7	1	12	0	0	0	0	0	0	0	3735	1	0	0	0	0	0	1	0	0	0	0	0	0	0	0	42	0	6	0	0	0	0	0	0	0	0	0	0	0	0	0	0	0	0	2	0	0	2	0	0	0	0	7	0	0	0	0	0	0	0	0	0	5	0	1	0	0	0	0	196	0	0	0	2	0	0	109	0	0	0	0	0	0	16	4	2	0	0	0	80	3	90	5	0	45	0	0	24	0	0	38	0	0	13	3	0	2	0	0	0	0	0	12	0	1	2	0	0	0	0	0	0	0	0	0	336	0	0	0	0	0	0	0	0	1	0	0	0	0	0	0	0	0	0	0	0	0	0	0	0	0	12	1	0	0	45	8	5	16	4	0	2	0	1	0	3	0	0	13	1	0	7	0	3	1	5	0	0	0	0	0	2	1	0	0	4	0	135	19	47	0	78	0	7	0	1	0	0	5	0	0	0	0	0	0	9	0	47	33	0	0	0	21	351	0	0	0	0	0	0	0	2	1	47	0	0	0	0	0	0	57	162	0	8	0	0	0	14	0	0	0	0	0	1	0	0	1	0	1	10	178	17	0	0	0	0	0	0	4	0	52	0	19	3	0	0	0	0	0	1	0	1	0	0	0	0	10	0	0	0	1	0	5	1	9	9	0	27	16	0	2	0	22	0	0	0	19	0	0	2	0	0	0	0	148	0	0	2	0	0	1	1	0	0	0	1	1	0	0	0	1	0	1	85	1	0	0	0	0	0	0	41	0	0	0	1	0	0	0	0	0	0	1	1	1	0	13	3	0	5	1	0	0	5	0	0	0	0	2	0	0	0	0	0	0	0	0	1	4	2	5	1	2	0	1	13	0	6	1	0	2	0	0	0	0	0	0	0	0	0	1	1	0	0	0	0	0	4	1	0	0	0	1	0	0	1	1	2	0	3	0	0	0	0	0	1	4	0	0	0	33	0	0	1	14	0	1	2	0	0	2	0	1	0	0	0	0	0	0	6	3	0	0	0	0	0	0	2	0	42	1	4	1	0	353	2	0	0	19	0	0	0	0	0	0	0	0	6	0	0	0	0	8	1	0	0	0	39	8	0	1	1	45	1	0	0	0	1	0	0	0	0	1	0	29	0	0	614	0	0	0	1	0	0	2	0	4	0	0	0	0	0	0	0	0	0	0	0	0	3	0	0	0	0	0	0	1	0	0	24	0	59	0	2	0	4	0	0	1	0	0	0	0	0	1	0	0	21	0	0	0	0	0	0	1	1	0	0	0	0	0	0	0	0	0	0	0	0	0	0	0	0	0	0	0	0	0	1	1	2	1	0	0	0	0	4	0	0	0	0	0	1	1	0	1	1	0	0	0	0	0	0	0	0	0	0	0	0	0	0	0	0	0	0	0	0	0	0	0	0	0	0	0	0	0	0	0	0	0	0	0	0	0	0	0	0	0	0	0	0	24	0	0	6	0	0	0	0	0	74	0	0	5	0	0	1	0	0	3	2	0	0	0	0	0	4	0	674	53	7	0	33	0	1325	0	0	0	0	0	1	7	5	1	0	0	2	0	0	0	0	0	0	0	0	0	2	0	0	1	10	0	0	0	1	0	0	0	0	0	0	0	0	0	0	0	0	0	0	3	0	0	0	0	368	0	64	15	0	2	0	0	0	0	0	0	0	37	0	0	0	0	0	0	0	0	0	1	0	1	1	0	4	0	0	0	0	1	2	0	1	1	3	0	0	0	0	41	6	0	0	0	0	0	0	0	14	9	0	2	1	0	0	0	0	1	0	0	0	0	0	43	9	0	0	0	0	21	0	1	33	0	0	0	0	0	0	0	0	0	0	0	0	0	0	4	1	0	0	4	0	0	0	1	0	0	0	0	1	0	20	0	0	0	0	0	0	0	0	0	0	2	0	0	0	2	0	1	15	0	0	0	1	0	0	1	0	17	1	0	0	0	0	4	0	1	0	0	0	0	0	0	0	0	0	0	0	0	0	0	4	3	2	1	0	5	0	1	0	0	0	0	0	0	0	0	0	0	0	1	107	10	0	39	0	0	0	0	0	1	5	0	0	2	0	0	0	0	0	0	0	190	0	0	0	37	0	2	0	3	0	0	3	0	92	0	0	0	0	0	0	0	0	0	0	1	8	3	0	0	0	1	0	0	65	2	0	32	0	1	0	0	0	0	0	0	0	0	0	0	1	0	0	0	0	0	0	0	0	0	0	14	1	1	0	0	0	4	0	0	0	0	0	58	0	0	0	0	0	0	0	0	0	2	75	0	1	0	2	0	0	1	0	0	0	0	13	6	20	0	18	12	2	191	717	0	0	29	0	1221	0	30	80	1	0	0	0	156	759	0	79	0	106	46	0	1089	0	0	0	1	0	0	0	12	52	2	32	0	3	18	0	95	80	5	0	0	6	2	9	0	36	1	0	33	8	0	0	0	0	0	2	0	17	77	0	0	0	0	13	0	0	156	0	1	1	0	0	0	0	0	0	0	103	0	0	0	5	0	6	2	56	1	0	0	22	1	10	0	0	0	3	0	0	0	0	0	0	392	144	0	0	0	1	0	1	0	35	15	0	0	0	0	0	0	30	2	0	2	0	0	0	0	143	0	0	0	0	0	0	0	0	0	0	0	0	8	2	0	0	1	34	0	3	0	1	4	1	2	2	4	0	0	0	31	0	0	9	0	74	14	2	0	0	0	0	2	3	7	0	72	0	0	0	0	23	0	0	0	62	12	312	2	24	20	5	709	0	138	57	25	5	774	545	150	0	1976	92	160	39	168	5	226	42	391	0	15	0	105	1	0	0	0	0	0	3	6	2	0	0	0	14	9	0	1	0	0	0	31	1	2	63	4	0	1	0	0	0	0	0	3	9	11	0	0	0	0	0	0	33	0	3	0	8	0	0	0	91	7	0	1	0	53	1	0	10	4	13	4	51	0	4	0	0	5	0	6	148	15	13	0	138	0	0	0	0	2	0	3	0	0	0	0	0	0	0	1	18	0	0	0	0	3	0	0	0	2	97	0	0	43	1	11	0	1	0	0	0	8	30	21	0	0	3	0	0	0	3	4	3	1	9	7	0	7	0	0	0	0	0	0	0	0	2	0	461	0	2	89	15	0	0	0	0	0	0	27	0	1	0	0	3	0	0	0	0	7	0	0	17	3	5	3	1	0	0	0	1	0	0	0	0	0	0	0	0	0	0	0	0	0	1	1	0	0	122	0	0	0	1	0	0	0	0	0	0	0	0	94	0	0	0	1	2	9	0	3	13	1	0	0	149	235	291	0	0	2	0	51	5	0	0	0	9	0	0	0	0	0	0	2	0	1	236	11	31	0	78	1	0	0	0	0	0	0	7	25	0	0	0	2	0	0	0	0	0	0	32	0	60	10	0	0	0	23	0	0	7	1	0	0	2	42	1	5	5	1	29	0	0	2	0	89	0	0	23	0	0	0	1	243	0	34	0	0	2	0	0	0	83	0	19	0	0	0	0	0	0	0	1	5	0	1	1	13	4	5	0	0	7	34	0	0	0	6	0	0	0	0	1	1	6	1	0	0	0	1	0	0	0	1	2	0	0	0	0	0	2	5	0	6	0	10	0	0	0	0	10	58	0	1	0	1	0	0	0	8	0	0	0	4	0	0	0	0	1	0	0	1	0	0	6	0	0	20	2	0	0	0	0	0	0	0	0	0	2	0	0	0	0	0	9	4	9	4	0	0	71	220	11	30	0	0	0	0	0	0	0	0	1	0	0	176	1	0	2	0	0	0	75	0	23	5	41	17	15	32	23	11	0	0	0	0	0	6	0	1	0	2	2	0	0	0	0	0	6	0	56	12	1	8	3	17	3	0	0	0	0	386	0	0	0	2	7	6	17	0	0	0	17	0	0	0	0	4	0	1	0	5	0	0	0	1	0	0	24	6	2	0	0	0	11	13	4	1	0	0	0	0	0	9	4	0	0	0	0	0	53	2	13	0	0	0	1	0	0	15	1	1	1	0	0	0	0	1	1	0	0	18	7	0	17	1	0	0	4	0	3	0	0	21	0	0	1	1	1	1	1	0	2	0	0	1	0	0	104	0	0	2	98	0	0	0	1	0	0	0	34	1	0	38	0	1	1	0	0	3	0	0	3	0	8	7	0	20	0	17	0	1	1	0	1	0	5	1	1	0	17	0	0	0	0	23	5	0	3	0	1	0	3	426	0	8	0	0	1	9	0	0	6	0	1	3	10	1	18	28	0	0	0	0	0	0	0	0	3	0	0	0	41	1	1	2	0	0	0	0	177	6	0	0	0	2	5	0	23	3	0	0	2	6	0	2	0	0	1	0	0	0	0	0	1	1	4	0	0	1	1	0	1	0	0	0	0	0	0	0	0	0	0	0	0	0	0	0	0	0	0	0	0	51	0	0	0	0	0	0	26	0	3	0	0	13	0	0	1	0	0	0	0	0	0	1	0	0	0	0	0	0	2	0	0	0	11	0	0	3	0	0	0	0	230	0	0	2	0	0	21	0	12	0	0	0	2	1	0	15	132	1	0	0	0	0	0	3	14	0	3	167	0	3	99	0	0	0	0	0	1	0	0	1	0	106	0	0	0	1	0	0	0	0	0	1	79	0	0	0	2	0	0	0	0	0	0	0	0	0	0	15	12	0	14	46	0	0	2	0	0	0	0	0	1	0	0	0	0	0	0	1	23	0	1	0	0	239	0	0	0	28	0	8	0	0	28	1	0	0	5	0	3	0	1	0	0	0	0	0	0	0	104	0	1	0	0	0	0	0	0	0	0	3	7	51	0	2	0	0	11	6	0	0	0	0	0	9	29	0	0	0	0	0	23	1	17	12	0	1	0	0	9	0	25	0	11	0	0	0	0	0	1	0	0	0	18	5	1	0	0	0	0	0	0	56	38	36	10	1	1	1	0	0	1	13	1	1	0	1	23	21	24	123	1	84	42	1	46	0	2	0	45	7	0	22	1	0	0	0	0	0	0	0	153	38	3	8	4	1613	0	0	0	7	7	4	0	2	2	7	0	1	7	0	36	0	0	0	0	1	0	0	43	0	1	13	1	0	1	0	0	183	0	8	2	3	4	72	46	67	32	0	31	0	1	1	23	25	1	0	0	0	0	0	1	1	0	0	0	0	0	1	23	0	4	0	0	0	36	49	7	1	6	3	186	5	2	0	20	0	0	1	0	0	0	0	0	0	0	0	2	0	0	0	2	0	11	1	378	0	0	1	0	0	11	0	1	0	0	1	0	0	0	0	0	0	0	0	0	0	0	0	0	0	0	0	1	0	0	0	0	0	0	2	0	0	3	0	0	0	0	0	0	75	4	0	6	0	4	0	0	5	1	0	52	1	76	67	5	4	0	0	2	1	0	6	0	0	3	457	0	1	0	0	1	8	1	3	4	15	5	16	1	1	5	2	0	0	6	38	0	1	0	0	0	0	15	0	1	0	2	0	0	0	0	58	1	0	0	97	0	0	30	35	0	0	0	0	0	0	41	0	0	2	57	19	0	0	0	0	0	12	0	0	0	10	19	30	25	0	119	0	1	0	73	0	496	1	12	0	1945	0	6	0	0	0	2	0	0	0	0	97	1	42	136	0	27	0	0	0	11	29	0	0	5	0	0	18	88	34	2	23	9	0	0	3	8	0	3	0	0	0	1	0	2	0	0	0	0	0	14	0	0	5	0	0	0	1	4	0	0	0	67	2	12	8	1	28	34	1	0	0	79	0	6	5	3	4	53	3	0	69	39	28	36	70	124	0	1	0	0	40	0	0	49	0	2	4	4	0	0	0	0	0	0	0	34	5	5	89	39	291	0	89	0	21	0	1	1	3	0	0	0	0	0	0	1	0	0	0	0	0	1	15	85	43	0	20	0	1	0	1	0	0	0	2	452	0	0	0	0	0	1	52	0	7	0	0	13	0	0	1	0	42	0	71	39	7	1	4	0	93	0	0	0	47	112	0	0	0	0	12	0	0	188	0	0	0	16	13	29	8	0	0	0	0	0	12	2	0	19	0	0	16	1	0	0	3	0	70	104	95	1	1	4	4	6	5	2	6	0	0	0	0	48	74	0	3	4	4	0	186	125	331	2	3	30	94	0	0	0	3	0	0	1	0	0	0	2	0	47	24	14	0	0	0	5	11	1	0	0	0	0	0	20	17	2	29	17	0	47	0	81	0	23	32	22	15	35	1	0	15	445	304	0	34	1	0	0	15	5	16	2	7	0	0	0	0	0	0	0	0	3	0	0	0	1	12	145	51	228	1006	10	75	0	2	0	16	36	35	0	0	21	1	1	0	0	0	0	0	0	0	0	0	1	1	0	1	2	7	0	2	0	0	1	0	0	0	16	10	24	0	4	125	19	28	13	9	44	12	15	11	12	1	0	0	0	162	43	61	0	1	7	35	17	33	0	24	5	0	1	10	6	10	1	0	0	1	0	0	25	14	0	1	0	1	0	20	0	0	3	0	0	0	0	0	183	3	1	4	72	12	0	0	0	0	0	54	0	12053	0	8	0	7	159	32	4	0	0	0	0	0	0	0	0	40	1	9	3	0	0	0	0	2	0	10	2	1	0	49	0	0	3	1	0	0	8	0	0	75	187	1	0	2	0	0	0	0	0	0	6	5	0	0	0	0	0	0	0	0	0	0	0	0	0	2	1	1	0	32	18	0	183	0	2	8	0	16	124	0	0	0	0	0	0	0	1	70	0	0	3	1	0	2	0	0	0	0	0	215	39	1	5	134	0	11	0	0	55	0	227	7	51	14	0	0	0	0	9	1	1	234	0	0	0	2	69	0	0	1	1	0	1	0	0	0	0	1	0	0	3259	83	16	0	13	3440	0	80	38	97	8	4	146	69	59	56	20	47	12	0	28	250	252	337	70	103	0	1	0	789	0	3	1	1	0	98	27	0	0	3879	1	0	0	0	1	0	3	47	0	0	0	5	9	58	53	9	26	38	10	11	0	3	0	21	45	10	48	0	0	0	0	0	0	0	0	0	1	6	1	0	57	1	19	0	22	94	0	0	0	29	0	4	17	2	0	4	0	0	10	113	0	0	0	0	0	43	0	0	0	15	1	12	26	0	86	24	0	0	106	470	279	2	0	70	205	199	10	78	117	0	50	0	49	9	0	305	1	0	9	5	10	85	42	0	75	22	41	47	0	0	41	44	0	0	73	14	13	0	0	0	51	0	0	22	6	13	0	10	11	0	0	50	0	0	1	0	0	0	0	0	0	6	0	0	23	0	0	0	5	1	315	8	8	0	0	2	31	0	117	3	0	11	0	0	0	396	5	1	179	442	0	19	20	8	3	9	4	27	19	10	2	57	2	78	23	77	15	13	2	0	0	1	0	0	0	0	0	0	0	0	18	0	0	0	0	0	7	16	27	0	5	0	0	0	0	0	0	13	3	2	0	0	0	0	0	0	6	2	0	0	0	0	0	0	1	2	0	4	0	0	26	0	0	0	19	5	0	0	0	11	0	0	0	0	0	0	0	1	5	0	0	0	0	0	0	0	0	0	9	1	14	9	0	19	0	0	0	0	0	0	0	0	7	34	0	1	177	0	0	0	12	39	16	1	1	0	0	0	137	0	6	21	52	15	2	0	3	0	3	6	0	0	0	0	147	60	133	22	45	37	21	63	16	16	0	61	23	211	69	12	247	83	28	89	29	12	10	16	0	22	0	0	13	9	9	33	21	19	143	48	187	26	46	259	20	126	32	17	117	29	46	17	31	0	0	9	0	934	1344	2	9	4	120	70	0	35	1486	531	124	2008	0	659	13	0	2	0	0	0	27	9	40	0	110	1	846	3806	190	0	0	0	0	0	0	0	0	191	13	282	21	272	5	874	11	9	6	0	26	2	66	72	0	1	0	0	0	2	21	8	15	120	17	13	1	19	33	32	42	0	0	0	0	0	0	1	31	1	1	0	2	0	0	0	57	0	0	0	0	2	42	15	2	5	1	0	8	0	0	4	16	0	0	0	0	0	0	0	0	2	2	0	0	2	0	0	0	2	0	1	0	11	0	0	9	13	0	26	477	2	0	0	0	0	0	9	0	0	0	0	0	0	0	0	0	0	0	0	110	0	2	0	0	0	12	0	0	0	0	2	0	0	0	0	0	0	0	0	0	0	0	16	1	2	0	0	37	0	119	2	20	114	0	60	2	75	0	0	0	0	0	2	0	0	1	0	0	0	0	22	22	25	8	0	1	0	0	0	0	0	0	5	17	28	0	53	0	6	0	0	17	68	0	0	0	29	0	0	19	81	84	219	14	1	0	53	0	0	12	11	62	0	0	0	26	14	18	0	1	8	86	25	42	0	11	67	2	0	1	72	649	18	13	2	0	0	0	2	10	4	0	30	2	1	0	1	3	0	0	0	1	2	1	0	7	1	0	25	1	0	0	0	0	0	0	1	0	0	111	3	0	0	0	0	0	0	0	0	15	9	21	0	10	60	0	18	3	0	8	30	64	0	0	15	13	5	0	6	8	1	0	0	0	0	0	19	1	18	1	1	4	0	0	0	0	0	0	4	20	29	0	0	2	0	1	0	0	1	0	0	8	133	40	0	136	45	17	0	1	55	0	6	14	11	0	0	0	0	0	3	1	0	0	0	0	0	0	8	0	0	0	8	26	0	0	0	0	0	0	1	7	1	2	1	0	0	1	2	0	2	0	2	0	2	2	0	1	113	0	5	1	0	39	73	0	0	11	46	20	0	0	39	1	23	17	36	2117	0	0	64	0	0	0	0	0	0	1	0	0	24	184	0	30	4	26	21	1	0	0	20	0	0	0	0	0	11	0	0	0	0	0	1	0	1	1	0	1	2	0	0	1	0	0	8	0	12	0	3	5	41	0	0	3	0	21	32	1	0	0	0	122	58	0	2	0	0	5	1	82611	0	0	1	0	0	0	0	0	0	0	0	0	0	0	4	0	8	0	0	0	0	41	19	37	155	0	31	12	28	0	1	0	0	0	0	0	4	11	165	1	135	83	0	0	0	0	0	71	2	4	0	0	1	0	182	16	19	66	25	305	82	53	0	24	3	0	157	0	1	369	9	13	26	0	1	0	1	3	4	0	5	33	194	19	9	1	0	2	0	33	1	0	4	2	65	87	0	153	24	0	0	39	16	0	0	71	25	0	28	0	1	0	0	0	1	0	0	0	52	270	470	80	37	0	6	10	1	21	44	38	114	152	39	10	24	6	88	28	0	4	36	31	0	0	11	0	0	35	13	109	21	37	0	6	0	0	21	19	25	8	18	0	0	0	0	0	0	0	0	0	0	4	10	55	0	2	2	5	4	0	11	27	0	1	0	0	10	33	12	2	26	1	36	21	0	1	0	243	0	2	0	12	6	0	7	14	51	0	8	0	0	0	81	36	0	0	0	1	3	0	0	0	0	0	0	0	0	9	1	0	0	0	9	14	5	0	0	0	0	0	0	2	23	1	8	1	45	0	0	1	66	181	0	2	2	0	46	0	0	15	9	2	14	1	1	0	5	0	1	1	0	0	5	0	0	1	3	0	0	0	0	2	0	2	0	0	0	0	0	0	0	0	0	0	0	0	0	0	0	0	0	0	0	2	0	0	0	5	1	0	0	2	102	0	0	1	0	0	0	0	0	37	0	4	0	0	6	9	0	40	0	0	2	437	9	12	12	4	0	0	15	47	54	0	0	28	8	9	2	15	6	0	0	0	0	0	0	1	0	0	9	0	0	5	54	19	0	3	0	0	29	329	0	0	0	0	0	0	20	13	50	87	33	5	193	0	139	29	11	6949	41	0	0	34	20	22	39	3	69	0	0	160	1	110	5	1	0	0	0	0	0	0	11	0	1	232	8	9	0	1	0	23	27	0	0	0	0	0	2	2	0	1	0	0	0	74	6	25	0	24	0	9	58	0	5	0	1	1	60	29	3	0	0	0	0	1	1	53	121	8	11	7	28	35	14	0	0	4	7	1	5	0	10	0	0	7	0	12	18	0	0	0	0	7	0	4	1	0	1	0	21	0	5	5	4	2	7	2	31	0	7	0	0	89	0	0	0	1	0	1	0	0	571	0	5	0	0	0	8	45	0	2	0	2	0	0	0	0	0	1	0	0	0	0	3	19	0	0	2895	0	0	6	5	0	0	0	1	1	7	0	0	1	2	2	6	1	0	0	0	0	0	0	0	0	0	0	3	0	1	401	0	5	2	16	95	1	12	0	0	0	0	0	0	0	0	0	0	0	0	2	0	0	1	0	15	0	0	1	4	0	0	2	0	0	0	0	0	1	1	0	0	259	0	0	0	2	23	10	39	0	2	54	12	4	18	4	6	35	13	5	2	22	15	10	32	138	51	84	453	0	0	16	3	0	1	20	13	1	0	0	0	0	0	0	502	0	0	6	0	603	0	0	0	0	1	1364	4	59	0	5	0	24	2	0	0	0	0	0	0	1	0	0	0	0	0	1	119	70	0	0	0	1	0	0	0	1	30	0	0	2	0	0	1	59	42	0	0	0	0	2	0	0	0	53	3	0	11	23	1	2	2	0	10	0	7	20	75	2	3	0	0	0	0	0	1	0	3	1	44	10	0	0	116	407	15	33	259	0	0	1	0	0	0	0	51	16	14	0	0	0	2	65	1	21	5	16	0	2	0	0	41	0	0	1	155	474	12	190	2	0	46	546	0	0	0	0	3	26	2	4	0	12	0	61	0	0	3	0	8	0	3	0	0	0	0	0	8	0	0	0	0	23	5	2	0	0	1	16	17	64	0	9	227	11	0	0	0	0	0	20	26	5	28	27	173	226	1	0	93	0	20	40	40	0	0	0	0	2	1	11	0	0	239	7	0	11	20	51	37	0	45	2	0	3	5	26	9	1	278	25	0	0	4	0	28	0	0	12	173	84	1	0	0	0	2	0	0	0	0	0	7	0	0	1	0	0	1	0	0	0	0	0	0	0	0	0	0	0	0	0	0	1	0	0	0	0	0	0	0	0	1	35	0	0	0	0	1	0	0	0	0	0	0	0	3	0	0	0	8	7	18	3	0	4	10	1	21	0	9	2	62	0	2	0	0	12	761	3	9	14	5	79	3	3	49	0	27	10	0	0	0	0	9	4	0	0	0	14	0	1	7	1	28	19	0	2	3	0	0	26	59	0	33	0	7	0	1	0	0	17	35	19	32	27	8	22	62	6	74	24	8	0	0	0	5	0	9	8	94	49	0	63	13	13	6	0	0	19	0	0	1	0	0	3	0	1	0	0	0	0	36	0	0	1	0	5	0	11	1	5	10	27	14	15	0	15	7	112	85	10	35	23	3	135	210	93	0	0	0	1	0	6	0	6	3	43	7	668	156	0	0	5	0	0	0	0	0	0	0	1	0	0	1	1	0	58	29	312	2	3	133	35	23615	80	0	10	0	0	0	0	0	11	2	4	1	0	6	62	0	0	3	4	0	0	0	0	1	0	0	1	10	153	1	38	37	3	8	0	1	1	0	4	0	65	0	2	11	0	0	0	11	0	105	0	0	0	15	30	0	0	0	0	0	0	20	0	0	1	0	0	44	0	0	1	0	0	0	1	0	0	1	3	1	3	2	0	0	0	0	2	0	11	0	892	1308	0	9	30	11	25	20	53	19	0	2	1	54	0	0	0	0	0	0	0	0	3	0	0	9	0	0	0	0	0	58	0	0	0	3	3	24	0	0	0	0	9	0	0	0	0	0	0	22	0	1	12	18	1	2	0	1	1	0	0	0	1	0	2	3	1	8	0	49	56	93	1	29	0	0	0	0	0	0	1	0	12	0	20	0	0	0	6	0	21	86	0	0	0	0	11	0	0	1	0	8	2	0	0	0	0	0	0	0	0	0	0	0	0	2	0	0	0	4	0	0	0	0	1	0	0	0	154	0	0	0	0	0	1	0	0	0	18	0	0	0	0	0	0	0	0	9	0	0	0	7	0	1	0	0	0	0	5	1	0	0	0	108	0	0	65	0	0	0	23	0	0	1	0	0	2	3	0	1	0	0	0	0	0	0	0	0	0	25	0	0	0	0	0	0	0	0	10	0	0	0	0	0	0	0	0	0	0	0	0	0	0	2	0	0	0	0	0	0	0	0	190	0	0	0	0	4	6	1	0	0	0	0	0	0	0	0	0	0	0	0	0	1	0	0	2	1	0	1	0	0	117	0	0	0	0	0	0	0	0	0	0	0	0	18	0	0	0	0	0	0	0	0	0	0	0	0	2	0	5	3	0	0	0	0	0	4	3	0	0	0	837	0	0	0	1	0	0	7	71	0	1	3	3	13	494	0	313	27	4	0	0	31	0	18	0	0	14	641	0	27	0	0	272	8	9	0	0	5	0	2	5	2	1	7	42	2	0	16	25	1	10	38	0	27	0	1	6	1	25	0	32	0	2	0	0	19	63	5	196	7	15	32	0	4	16	3	17	0	44	7	2	9	24	0	0	16	31	6	15	147	8	3	10	14	76	51	4	0	0	0	269	63	76	33	10	0	61	1	9	1	14	39	1	11	176	0	0	940	0	1	4	0	12	0	934	11	208	59	26	0	20	3	17	56	17	0	8	2	4	5	0	39	34	85	11	51	137	50	22	324	95	189	49	0	0	29	64	0	23	0	1	0	16	0	0	0	0	25	0	0	0	0	0	1	0	6	0	28	20	45	0	1	2	0	0	18	0	87	0	120	9	0	0	0	17	16	0	1	0	0	0	0	52	0	0	0	19	1	5	0	0	17	1	0	0	12	0	0	0	0	1	0	0	0	0	0	0	0	1	0	0	0	0	2	3	3	0	0	0	3	3	0	7	2	0	0	5	33	3	1	0	0	0	77	0	0	0	3	0	0	0	0	1	19	0	5	0	0	0	1	0	0	1	1	0	0	7	0	3	0	0	0	96	19	61	0	20	0	0	2	0	0	1	0	0	157	0	21	4	0	0	0	2	2	0	0	0	0	0	0	0	0	0	0	0	0	0	7	79	77	2	29	26	1	0	0	0	0	0	8	0	140	3	13	45	306	0	1	14	0	2	11	0	0	0	0	67	0	0	0	8	0	9	2	177	1156	0	5	76	17	0	0	0	0	0	0	0	1	0	0	0	0	8	0	1	1	36	0	0	0	13	72	0	2	22	0	0	0	0	0	0	12	44	12	26	61	41	1	36	18	2594	0	36	1	2	36	0	0	22	54	0	0	0	0	0	0	9	9	0	0	0	0	73	16	2	1	0	15	0	0	0	0	1	1	4	0	75	15	9	1	0	145	0	0	0	0	2	0	0	1	2	0	2	17	1	20	6	25	2	133	0	8	0	0	0	3	13	0	28	0	75	0	6	19	20	23	16	1	0	50	23	24	30	1020	53	0	3	0	0	0	0	0	1	0	2	0	0	0	0	0	0	11	20	185	0	1	0	3	6	8	34	0	20	1	1	5	21	6	15	0	0	0	2	21	17	13	46	10	0	3	0	0	0	111	1	0	0	0	9	1	135	291	56	1	87	0	0	17	35	6	4	0	0	0	0	10	60	0	111	0	18	9	3	211	0	1	7	1	24	0	3	24	9	74	31	0	1	86	152	0	0	0	0	0	0	0	99	0	0	55	0	0	0	2	1	8	1	100	9	6	0	0	0	0	2	0	0	0	3	2	2	1	0	0	0	2	2	3	181	7	1	0	1	0	1	0	26	0	1	0	10	0	0	0	10	0	3	29	47	19	367	0	1	0	12	24	0	0	3	0	0	71	0	1	0	0	0	0	0	0	13	49	0	10	2	5	12	0	6	3	0	0	1	0	165	1	3	0	72	0	0	49	1	3	24	0	9	104	0	0	0	3	0	67	64	0	2	3	13	0	34	0	0	9	3	5	3	0	30	64	18	9	0	0	0	0	6	0	0	0	0	1	0	94	9	0	123	3	9	204	79	97	185	31	22	26	38	111	73	65	28	42	66	15	45	23	0	18	0	3	1	46	0	6	0	0	5	9	9	0	0	0	0	0	0	4	1	1	0	0	0	10	0	0	1	3	11	0	0	0	1	0	0	0	0	0	0	0	0	0	0	1	0	0	0	1	0	0	0	0	0	0	0	34	4	0	0	2	0	0	1	0	0	0	0	0	0	0	0	0	0	0	0	0	0	0	0	1	0	12	14	0	33	21	0	1	10	0	0	0	41	16	42	23	1	33	42	2	0	4	0	3	3	0	0	1	0	0	0	0	10	51	2	87	22	43	0	1	0	57	2	20	6	0	0	0	0	3	1	0	0	0	0	19	3	6	6	6	0	22	12	86	6	17	0	11	25	12	0	13	65	0	0	0	0	0	0	0	1	66	1	0	0	0	0	0	0	2	6	5	0	0	299	5	1	32	0	120	0	1	0	0	0	4	1	0	261	12	3	8	0	0	266	0	0	0	3	12	0	37	0	0	27	0	1	1	13	1	87	16	14	0	20	157	0	0	3	49	0	1	0	11	6	5	10	11	22	14	0	14	0	10	2	46	2	0	3	8	11	5	19	11	2	4	5	3	0	9	0	1	53	4	0	0	0	13	0	1	23	7	7	1	4	22	0	4	1	0	0	17	0	0	0	0	0	0	5	0	0	0	0	0	0	0	1	6	1	0	0	0	0	0	14	13	3	0	93	0	0	0	0	2	16	49	2	11	2	1	51	0	0	477	34	84	34	26	0	2	808	245	0	67	105	3	0	0	16	151	5	2	0	19	0	35	23	32	1	2	15	0	0	11	10	11	0	0	4	30	55	31	0	0	0	0	0	0	471	0	5	5	4	0	0	0	0	0	0	0	3	150	7	55	26	47	0	144	8	3	0	0	1	0	0	3	0	0	0	37	0	46	0	0	27	1	0	37	0	1143	223	3	0	0	36	7	80	172	66	18	3	55	651	3	56	177	0	0	0	0	0	4	5	2	789	141	20	0	1	0	2	0	0	40	0	0	0	32	1	5	0	53	165	1	0	0	38	41	52	29	4	26	20	11	18	1	3	237	0	0	58	5	1	1	0	0	0	0	0	0	50	15	0	0	0	2	0	0	0	2	0	0	0	0	0	0	168	0	0	1	0	82	76	1	0	0	9	6	23	1	0	1	0	18	19	16	1	98	4	45	13	0	0	7	31	0	33	27	0	2	129	66	22	34	48	187	231	7	33	14	365	27	100	157	0	0	0	0	0	0	0	0	2	1	0	0	0	0	0	0	1	0	0	0	30	5	2	23	5	2	11	0	1	14	2	8	0	0	2	3	6	0	0	0	5	0	3	17	16	8	18	0	8	0	0	0	0	0	3	0	0	0	0	0	2	0	1	0	0	0	0	0	0	0	0	12	0	0	2	1	4	0	2	5	0	23	0	78	0	0	6	1	0	21	0	1	0	0	0	9	4	0	0	2	1	1	13	6	10	2	0	93	9	99	0	33	0	821	0	426	561	0	0	20	0	5	1	0	0	40	824	741	34	51	80	8	247	8	19	23	15	18	22	0	18	40	0	0	11	56	0	1	0	0	0	1	16	0	0	0	0	2	1	2	66	0	0	0	0	2	0	2	0	0	0	0	0	0	0	0	0	0	1	0	0	0	1	0	0	0	0	8	13	0	61	27	0	33	0	22	31	105	59	1	0	0	4	0	0	0	0	4	205	0	0	73	10	0	0	0	4	1	82	0	52	8	17	0	0	0	0	6	0	0	0	0	0	1	0	0	0	4	2	0	0	10	2	7	5	0	0	4	0	1	1	1	44	101	9	0	5	5	24	0	7	7	2	30	6	0	6	0	32	8	0	1	0	0	0	0	0	3	8	3	0	0	496	0	6	0	2	6	7	0	2	1	3	0	0	0	0	0	1	5	10	0	109	51	0	0	2	0	0	2	0	0	8	0	13	0	4	2
LakWasM115_HOW13_2_rpkm	0	0	0	0	0	11	3	1	0	0	0	0	0	0	0	0	0	0	0	0	1	0	0	57	0	0	0	0	0	19	0	0	0	40	0	14	0	0	0	0	0	0	0	6	49	91	99	48	0	87	1	47	0	0	0	1	0	0	115	14	27	0	0	0	1	0	0	0	1	48	0	0	0	0	0	0	0	0	0	0	0	14	0	0	0	0	0	0	0	0	0	0	11	1	107	0	0	0	0	0	0	0	0	0	0	0	0	0	0	0	0	0	135	1	49	0	0	0	0	0	0	0	32	1	0	0	2	1	0	0	108	383	1	0	0	0	0	0	2	0	0	0	0	0	0	0	0	0	115	2	0	94	0	1	315	0	0	1	93	0	19	19	0	2	1	0	0	2	0	2	0	0	0	0	0	0	0	0	0	0	1	0	0	0	0	2	0	0	0	1	8	6	26	40	1	0	0	45	73	242	1	0	1	0	0	0	6	0	0	2	55	10	28	82	23	0	3	27	0	0	0	0	0	1	0	4	0	0	55	0	0	0	0	0	0	0	21	4	48	1	0	0	58	1	68	18	0	0	1	0	2	25	34	0	1071	25	0	0	0	0	1	0	0	64	0	1	2	0	0	397	2	0	0	0	0	2	0	0	1	3	2	131	2	274	91	0	0	0	45	6	1	0	0	0	0	0	0	1	2	0	0	22	60	0	1	0	3	195	13	0	3	0	264	93	0	0	0	1	0	0	0	0	0	0	1	30	1	0	2	0	1	0	0	0	0	0	0	0	0	0	0	0	31	1	39	0	16	3	0	1	1	0	0	0	1	0	0	0	0	29	3	0	0	0	0	42	1	98	2	1	1	105	0	0	11	0	0	41	0	6	0	1	21	1	0	0	32	0	0	0	0	0	351	0	0	5	7	1	0	84	9	33	0	8	42	0	0	0	0	0	0	1	1	770	0	44	33	2	3	0	0	0	0	0	0	0	0	0	0	0	1	0	0	3	0	1	0	0	18	0	55	2	0	0	0	134	1	0	0	0	3	120	1	559	0	23	84	0	0	0	0	0	0	59	0	84	70	0	0	0	33	0	11	0	0	0	55	1	8	0	0	0	4	28	0	0	0	26	26	0	0	0	82	58	0	0	0	0	0	0	0	0	87	1	0	0	0	0	0	0	0	0	0	0	0	0	0	0	0	18	1	0	0	0	0	0	0	0	0	0	0	0	328	72	3	0	34	0	0	31	0	1	7	44	46	0	0	0	0	0	0	0	1	2	0	1	0	15	0	0	0	0	0	0	73	0	1	0	143	0	0	1	0	7	2	2	2	129	0	1	3	15	1	1	220	0	1	0	22	0	0	0	29	4	18	36	0	0	0	0	50	0	0	14	10	15	0	35	0	1	0	897	14	576	0	0	349	0	1254	0	10	5	148	45	0	23	0	19	0	12	0	1	0	0	0	0	0	0	0	2	0	567	0	0	0	0	0	23	8	0	4	0	17	13	0	0	0	0	0	0	0	9	0	3	0	0	1	0	2	2	5	16	1	68	0	0	1	0	0	0	1	0	0	0	0	0	0	0	0	36	0	0	18	0	0	0	0	2	0	1	0	3	0	3	0	0	0	0	3	0	0	25	0	0	3	1	0	0	19	0	0	0	1	0	0	0	93	0	70	0	0	0	0	0	0	0	0	0	0	0	0	20	0	0	2	175	0	0	0	21	1	0	0	0	0	0	0	0	6	0	0	2	0	50	1	0	9	0	0	1	0	0	0	0	0	225	0	0	0	0	0	0	7	0	0	0	0	0	0	0	8	2	0	0	0	0	30	0	0	0	0	0	0	0	8	25	272	0	0	0	0	0	0	0	28	0	4	0	1	0	0	0	0	0	37	1	0	2	0	23	18	0	0	0	0	0	0	80	10	0	0	0	0	2	0	0	0	0	45	205	0	0	0	0	0	0	0	0	0	3	62	0	0	0	0	0	0	0	1	0	1	0	0	0	0	0	1	0	18	0	0	0	0	1	1	5	84	0	0	0	0	0	0	1	3	0	0	0	0	0	0	1	9	1	1	0	0	0	0	0	0	0	0	1	2	0	2	5	2	1	0	0	0	0	0	5	0	0	0	0	2	0	0	0	0	0	0	0	0	2	0	0	0	33	24	0	3	17	0	0	0	0	0	0	0	0	0	0	1	0	0	0	5	0	0	2	0	0	0	1	0	17	28	422	0	20	0	77	0	0	90	43	1	0	2	0	0	11	0	0	0	0	0	0	0	0	0	0	0	0	0	1	0	0	1	0	0	0	0	0	0	0	0	0	0	0	0	374	4	1	0	34	1	0	0	0	0	0	5	0	49	0	3	0	0	0	0	0	3	20	0	0	0	0	0	0	0	0	0	0	0	1	0	0	0	0	0	0	0	0	0	1	0	151	0	0	0	0	5	2	9	0	25	0	0	0	6	2	0	6	0	2	0	0	0	0	0	0	0	50	1	0	0	0	5	0	0	0	0	0	0	0	0	0	0	2	2	1	7	5	0	5	0	0	11	0	0	17	0	0	0	1	0	0	0	0	1	3	139	0	0	2	0	0	0	0	1	0	0	0	0	0	0	0	0	0	0	0	0	0	0	0	0	0	1	0	1	0	0	2	0	0	0	0	0	0	0	0	0	0	113	2	0	0	1	0	31	1	0	0	0	0	6	0	0	0	0	1	0	0	1	7	18	24	185	139	0	0	0	360	1	0	0	1	0	1	1	0	0	0	0	0	0	0	0	0	0	0	0	0	0	0	38	0	0	0	0	0	8	0	0	0	0	0	0	0	0	0	0	0	2	1	164	4	0	0	2	0	0	0	42	0	2	164	229	0	0	0	1	0	2	0	0	130	0	0	0	0	0	0	0	0	0	102	0	0	63	40	0	168	0	0	0	0	0	32	0	0	36	0	0	2	0	0	0	30	0	0	3	0	0	0	0	0	0	0	1	0	0	5	0	0	0	0	0	0	0	1	0	0	0	0	5	0	0	7	1	0	0	0	0	0	0	0	0	0	76	5	70	1	0	23	68	0	0	0	0	0	0	28	0	0	8	0	0	0	46	15	0	0	1	0	0	1	23	0	11	0	0	2	0	0	3	58	0	1	22	3	0	0	0	0	0	0	105	0	40	43	17	45	14	0	47	0	0	44	0	19	0	0	0	13	0	28	10	0	23	0	7	1	0	0	8	14	7	0	59	0	0	0	0	0	0	3	0	0	0	0	0	0	1	53	0	0	1	0	23	10	0	1	0	0	1	1	0	0	0	2	1	0	0	0	0	8	27	388	47	0	0	0	0	0	0	0	0	520	0	1	2	14	1	0	0	0	324	1528	4	97	0	0	42	189	0	0	0	1	0	0	0	1	225	0	120	3	224	2	0	6	0	52	0	0	0	0	0	0	7	99	0	0	0	16	0	105	0	0	0	1	0	19	0	4	0	0	0	0	24	0	0	0	0	0	0	1	1	0	0	0	0	0	0	0	0	4	0	0	0	0	10	0	0	0	42	0	0	0	0	0	0	1	0	0	0	34	0	0	0	0	0	0	0	0	0	0	0	0	0	0	0	0	0	0	0	0	0	0	0	26	0	0	2	0	0	6	0	139	0	55	373	0	0	1	0	38	15	4	0	0	2	0	250	2	135	0	0	0	0	1	0	0	0	0	3	0	0	0	3	0	0	0	0	0	0	0	0	0	0	2	1	57	0	0	0	0	29	1	0	0	0	1	0	0	0	0	2	0	0	1	0	0	0	0	0	92	21	0	0	58	0	0	0	1	0	15	4	17	1	0	2	0	0	0	1	0	0	0	1	0	53	4	7	107	169	76	310	157	0	0	0	0	1	3	0	0	1	0	173	0	0	0	0	0	3	0	1	90	99	0	280	0	1	18	0	3	0	6	5	0	7	1	0	0	0	0	0	1	2	153	0	6	2	0	0	0	0	0	3	45	0	0	2	0	0	0	0	1	30	257	9	158	0	2	1	14	0	8	0	1	0	0	0	0	5	0	0	0	0	0	0	3	1	37	1	24	0	0	0	0	0	0	0	1	0	0	0	0	1	0	2	0	0	0	2	0	13	160	0	0	24	0	0	152	0	0	1	0	0	0	0	0	0	58	0	0	0	15	0	0	0	0	1	0	0	0	0	0	0	1	0	27	0	1	0	0	0	0	10	0	0	0	1	0	4	1	0	1	24	0	0	0	0	5	0	0	34	0	0	59	1	0	0	0	665	11	141	1	0	42	200	0	26	0	212	0	45	0	1	0	4	1	0	103	0	0	0	0	0	0	0	0	0	0	0	1	0	0	0	25	0	5	0	1	76	0	0	0	0	0	0	0	0	0	0	0	0	0	32	0	1	0	14	14	3	48	0	0	0	0	0	0	35	0	0	109	0	0	0	0	0	0	0	0	0	0	0	0	0	0	0	31	0	0	0	2	0	0	0	0	0	0	0	0	110	0	1	24	2	0	1	0	82	0	1	71	429	5	0	0	0	0	0	0	0	0	0	1	3	0	5	0	0	0	0	0	10	0	0	0	0	0	0	0	0	2	1	2	37	5	0	107	16	0	52	0	50	82	30	0	0	0	0	0	0	0	1	0	0	0	0	0	66	0	0	0	0	0	0	0	0	0	1	0	0	2	0	0	0	0	0	0	0	2	1	9	0	0	0	0	0	1	0	0	8	0	0	175	1	0	13	0	0	0	0	0	1	0	3	0	668	0	0	344	0	0	0	121	0	0	0	0	0	0	0	0	0	0	0	0	16	13	12	0	0	81	0	0	0	10	0	27	45	34	3	0	0	0	0	0	10	0	64	2	0	0	0	0	0	2	0	1	0	0	0	0	0	0	0	0	11	0	0	0	0	0	0	0	0	3	1	0	0	0	1	268	0	0	0	112	0	0	0	0	0	0	0	0	0	0	0	0	3	0	0	0	0	0	1	0	0	82	0	0	0	5	0	32	0	2	1	1	0	9	36	0	2	0	0	0	0	2	127	2	0	0	0	0	0	0	0	18	48	135	32	0	0	0	1	2	0	0	0	0	1	0	1	0	0	0	0	88	0	0	0	0	1	0	0	0	19	0	0	1	0	0	40	2	0	12	0	0	0	0	0	5	0	0	0	0	0	0	0	0	15	0	0	0	0	0	4	0	0	0	0	0	0	1	0	0	1	0	0	0	0	0	0	0	0	0	1	0	0	0	0	0	0	0	0	0	0	0	3	0	0	0	0	0	0	0	0	0	9	0	2	3	1	0	40	0	0	2	29	0	0	0	0	17	18	1	0	0	0	0	7	184	44	18	66	13	10	2	2	234	6	119	13	5	3	21	1	17	15	2	3	0	31	23	68	94	14	34	4	1	16	4	3	48	0	0	0	0	0	0	0	0	0	0	11	229	0	0	2	0	0	0	0	0	0	0	0	0	0	0	0	7	1	0	0	0	18	0	95	0	3	21	1	0	0	0	1	0	0	0	0	23	0	0	0	0	0	0	0	0	0	44	0	0	1	0	0	44	0	18	1	1	14	27	0	0	1	0	0	0	31	0	0	0	0	0	21	0	0	0	0	0	0	0	0	0	0	0	0	0	25	18	0	26	0	0	0	0	0	0	0	1	0	0	18	0	0	0	0	0	0	157	0	0	20	144	0	0	0	0	0	1	0	0	0	0	0	0	0	2	34	15	0	0	0	2	0	0	136	56	69	1	0	56	69	58	6	4	1	361	58	34	1	0	0	0	0	0	0	0	0	0	5	4	0	0	0	0	0	0	0	0	7	0	0	0	0	0	0	0	0	2	0	22	0	0	0	9	0	0	0	0	0	0	0	0	0	0	0	3	0	692	11	0	0	23	1	0	0	0	0	30	0	0	0	0	44	0	0	0	3	2	0	0	0	0	17	0	1	5	14	0	0	2	0	141	0	1	0	0	0	0	0	0	0	1	0	10	2	1	0	0	0	0	1	0	0	1	0	0	0	0	0	0	0	0	0	0	0	1	0	0	0	0	9	0	0	0	50	0	1	0	0	1	1	0	125	143	4	0	37	0	0	0	0	0	0	0	0	0	0	0	0	0	0	0	284	6	36	32	0	0	0	17	0	0	0	0	94	122	0	0	0	0	5	0	0	0	0	0	0	0	1	0	0	0	0	0	82	1	0	0	0	0	0	0	1	4	0	28	28	0	21	0	0	1	0	0	89	0	0	0	0	0	0	0	0	0	0	0	17	0	0	0	66	1	0	0	0	0	0	0	0	0	0	0	0	0	0	0	0	0	0	1	0	0	0	1	0	0	0	0	0	32	0	0	0	0	0	0	0	2	4	0	333	0	0	26	0	1	11	0	1	0	24	0	0	38	0	22	1	0	0	0	0	0	0	0	1	1	0	0	0	0	0	0	276	0	0	1	100	1	0	2	0	2	1	0	0	1	0	3	0	0	1	0	0	0	14	3	0	1	0	6	0	0	0	0	0	21	0	52	0	59	73	59	73	86	59	49	77	0	83	57	60	0	1	0	0	0	23	0	0	35	0	27	0	0	144	26	0	0	0	0	0	0	2	0	0	0	0	0	21	0	0	0	1	8	0	0	0	0	0	0	0	0	0	0	0	27	0	1	14	0	13	0	0	11	0	0	0	0	0	1	0	14	0	1	10	4	4	0	31	0	1	1	0	1	73	0	0	0	0	2	0	0	4	0	0	0	0	0	0	0	12	120	0	0	64	8	0	9	0	12	0	0	0	163	37	0	0	0	0	24	0	0	0	0	7	0	7	7	0	0	6	0	0	0	156	2	0	0	0	0	0	0	1770	24	17	1	0	0	0	0	0	3	0	183	0	15	0	4	0	0	5890	454	286	0	0	0	118	0	10	0	176	5	1	0	0	0	0	0	0	0	0	0	0	0	0	0	0	0	0	0	0	0	108	694	0	0	0	0	0	1	0	7	0	0	0	0	0	0	42	8	0	5	0	0	19	4	0	15425	185	302	0	0	0	1	0	0	72	0	0	62	0	0	0	1	0	0	0	0	0	1005	0	0	0	0	2	0	0	0	0	0	0	0	0	0	2	3	1	29	0	0	0	0	0	2	0	0	0	0	0	0	2	0	0	0	0	0	0	0	0	0	1	27	0	0	1	0	41	1	0	0	0	0	11	0	0	30	0	0	0	2	0	0	0	7	0	0	143	0	3	0	0	0	0	702	14	0	4	0	0	1	1	20	1	0	1	0	0	157	15	0	68	0	0	0	0	0	0	0	0	0	0	0	4	1	0	1	0	0	0	0	0	0	0	0	0	0	3	0	0	0	0	0	0	0	0	0	1	0	0	0	0	0	0	0	0	0	0	0	0	0	0	44	0	0	25	3	66	13	0	35	0	0	0	0	0	0	0	8	15	0	0	1	0	34	0	75	0	0	0	0	0	0	0	47	0	0	0	3	25	1	0	0	0	33	0	0	10	9	1	0	0	0	0	1	0	9	0	2	0	0	2	0	299	2	0	0	0	0	0	0	0	15	15	56	8	0	0	0	0	0	80	245	0	18	0	0	0	1	0	0	0	0	0	0	0	0	0	0	3	1	3	0	0	0	0	0	0	0	0	0	129	2	33	0	0	0	0	0	0	2	0	1	0	0	0	0	30	1	0	1	2	0	8	7	7	0	0	134	0	0	0	0	104	0	0	0	18	0	1	0	0	0	0	0	174	0	0	1	0	1	0	0	0	0	0	0	2	0	1	0	0	0	0	117	0	0	0	0	0	0	0	848	0	0	0	129	0	0	0	0	0	0	0	0	1	0	0	0	0	0	0	0	0	15	0	0	0	0	0	0	1	0	0	0	0	0	0	0	9	0	1	0	0	0	0	20	0	0	0	0	1	0	0	0	0	0	0	0	0	0	0	0	0	0	0	0	0	0	0	0	0	0	0	0	0	0	0	0	0	0	0	0	0	0	0	8	26	0	0	0	58	0	0	1	0	0	1	0	0	0	0	0	0	0	0	0	0	0	0	2	1	0	0	0	0	0	0	0	0	2	0	0	3	0	2	0	0	0	7	0	0	0	0	3	0	1	0	1	0	0	0	0	0	0	0	0	0	24	1	0	0	0	0	0	0	0	0	0	0	0	0	0	0	0	1	0	0	1	0	0	0	0	0	0	0	0	0	0	0	0	0	0	0	1	0	0	0	1	0	0	0	0	4	0	0	0	0	0	0	17	3	2	0	0	0	9	0	10	0	0	0	0	0	0	0	0	0	206	0	0	0	0	0	0	0	0	0	0	0	0	0	0	0	0	0	0	0	0	0	1	0	0	0	0	0	0	57	0	0	0	0	14	0	0	0	0	0	5	0	0	0	15	1	0	0	0	0	0	0	0	43	0	0	1	0	0	0	0	0	0	0	0	0	0	0	0	0	0	0	36	2	0	0	0	0	0	0	0	98	10	0	0	0	1	0	0	0	0	0	0	130	0	0	19	20	1	1	0	0	201	0	0	18	1	1	530	0	0	3	0	2	0	0	0	0	8	0	3	73	26	0	30	0	699	0	10	1	0	0	101	0	0	0	0	0	0	0	0	0	0	0	0	0	0	0	1	0	0	0	44	0	2	1	0	1	0	1	0	0	1	0	0	0	1	0	0	0	0	0	0	0	0	0	170	0	66	0	0	0	0	0	1	0	0	0	0	83	0	0	0	0	0	0	0	0	0	0	0	1	0	0	0	0	0	0	0	0	0	0	0	0	94	0	0	0	0	0	153	0	0	0	0	0	0	0	1	0	0	16	0	0	0	0	0	0	0	0	0	2	0	347	0	0	0	4	0	2	0	0	249	0	0	0	0	0	0	0	0	0	0	0	0	1	0	0	0	0	0	0	0	0	0	2	0	0	0	0	0	0	78	2	0	0	0	0	0	0	1	0	6	0	0	0	0	0	0	0	0	0	0	0	0	0	0	1	0	63	0	0	0	0	0	2	176	0	1	0	0	0	0	0	1	2	0	0	0	0	0	1	0	4	0	9	0	0	0	85	0	0	0	0	0	0	0	0	0	0	0	0	4	1	0	2	0	0	0	0	0	0	0	0	1	0	5	0	0	0	0	0	0	14	0	230	4	1	0	0	0	0	0	0	0	0	121	178	1	0	0	0	13	0	0	0	6	5	28	12	0	33	0	0	0	0	0	0	0	94	0	0	0	0	0	0	0	0	3	0	0	17	0	0	0	0	0	0	0	0	0	0	0	13	0	3	0	0	0	41	0	0	0	0	0	1	0	0	0	0	0	0	0	0	1	10	1	1	0	0	16	0	0	0	3	0	0	0	55	1	1	0	290	56	22	1436	2180	0	0	0	0	24	0	27	2	3	0	0	0	6	16	0	161	1	0	130	0	47	0	0	0	10	3	0	0	0	0	0	0	0	1	2	0	1	6	112	0	0	17	0	0	0	0	0	0	0	0	1	0	0	0	0	0	0	4	0	0	0	0	0	85	47	0	1	0	2	0	0	0	0	0	0	0	0	0	0	0	0	2	0	2	3	19	0	0	0	45	0	7	1	0	0	0	0	0	28	0	0	0	8	178	1	1	1	0	0	1	0	1	0	0	0	0	0	0	0	28	12	0	4	0	0	0	0	1	0	0	0	1	0	0	0	0	0	0	0	1	1	0	0	2	0	1	0	0	0	0	0	13	0	0	1	0	0	0	12	0	0	3	0	45	0	1	29	0	34	0	2	146	0	0	0	0	0	0	0	0	0	0	0	167	268	281	0	1	18	3	14	0	2	67	14	5	8	220	10	0	42	5	8	2	11	2	89	11	241	0	59	0	2	0	1	0	0	2	0	1	0	0	0	4	0	2	0	0	0	0	0	0	0	0	0	1	16	0	0	0	0	0	0	2	0	0	43	0	1	0	1	0	0	190	1	0	0	0	0	0	0	136	27	0	0	0	0	0	0	0	1	15	0	4	0	0	0	0	1	0	11	157	3	114	236	5	0	0	0	0	0	0	0	0	0	0	0	0	0	0	0	3	0	0	0	0	13	0	0	0	0	141	0	0	1	0	6	0	0	0	0	0	273	1	2	23	2	0	0	0	0	0	3	5	3	0	0	2	0	0	0	0	0	0	0	0	0	0	0	1	0	0	177	0	0	0	0	0	0	0	7	0	30	0	0	0	668	50	0	0	21	0	0	109	1	117	16	0	0	1	0	0	0	0	0	0	0	0	1	0	0	0	0	0	0	0	1	0	0	1	98	0	0	49	41	0	0	0	0	0	0	0	51	0	0	17	0	1	1	3	0	5	0	0	0	46	1	82	0	0	0	0	43	0	0	0	0	3	0	0	0	0	0	0	0	0	0	7	0	0	0	42	0	0	0	0	17	0	0	0	23	2	0	0	1	0	0	0	0	0	2	68	1	0	1	0	2	0	7	0	1	0	0	0	1	4	0	1	8	3	0	74	0	0	3	0	1	0	0	112	0	13	0	3	2	0	1	0	0	1	0	0	0	1	0	22	0	0	0	0	0	0	0	0	2	0	0	1	34	12	14	0	0	71	2	0	30	0	0	0	0	0	0	0	0	8	0	0	0	0	0	0	4	0	0	0	0	0	0	0	0	2	1	0	0	0	0	19	0	0	0	0	173	1	4	0	0	0	0	0	34	0	0	0	0	0	0	0	11	0	0	0	3	46	1	1	0	0	0	0	73	0	0	0	0	0	0	0	0	0	0	0	0	0	0	6	37	0	0	0	0	335	4	88	1	0	0	0	0	0	0	0	0	0	0	0	141	0	0	1	0	0	0	1	0	0	108	0	152	1	33	91	0	3	0	0	0	0	35	0	1	1	7	0	0	0	0	0	0	31	0	44	13	0	47	14	32	112	0	0	0	0	113	0	1	0	4	0	0	0	0	0	0	0	0	0	0	0	0	0	6	2	0	0	0	0	0	0	0	86	32	0	0	0	0	3	0	51	0	4	0	0	0	0	64	0	0	0	0	0	0	18	1	101	6	0	94	10	0	0	58	0	0	2	0	0	1	0	0	0	0	0	0	32	0	0	3	0	0	54	0	0	6	0	0	0	0	31	15	0	2	6	0	0	22	0	1	0	0	1	0	0	0	1	0	0	0	1	0	0	0	8	0	0	65	0	1	1	0	0	0	5	0	355	0	0	53	0	58	0	6	0	9	1	0	1	0	0	0	0	0	1	0	0	1	0	0	0	0	290	0	31	0	0	485	0	9	0	0	1	14	7	0	33	0	0	0	146	1	1	10	0	0	0	0	0	5	0	0	1	0	0	0	16	2	0	0	0	0	0	0	33	9	0	0	16	0	1	0	2	0	0	1	0	0	0	1	0	0	1	0	0	0	0	1	0	0	2	0	0	0	0	0	0	1	0	0	0	0	0	0	1	0	0	0	0	0	0	0	0	0	0	0	0	25	0	1	1	0	0	2	0	0	2	0	0	2	0	0	0	0	0	1	0	0	1	17	0	0	0	0	1	0	0	0	0	0	1	0	0	0	0	0	0	0	11	0	0	0	0	0	0	0	1	0	0	0	0	0	0	1	23	1	0	3	0	0	0	0	0	1	1	12	0	0	4	0	0	0	0	0	1	0	0	16	0	2	1	0	25	0	0	2	1	1	0	0	7	0	0	0	0	0	0	0	0	0	0	0	4	10	0	0	0	0	39	66	0	0	0	0	0	0	0	1	0	0	0	9	0	0	0	0	0	0	0	0	0	6	41	0	0	0	0	0	0	0	0	29	0	0	21	0	1	0	0	0	0	0	0	0	0	0	4	0	1	0	0	0	0	0	0	0	0	14	0	0	0	0	1	0	0	192	0	0	0	0	0	60	8	0	0	0	0	0	2	0	0	0	0	2	0	0	1	0	49	0	10	0	0	0	0	0	0	0	0	0	0	0	0	0	0	0	0	0	0	153	1	45	2	1	0	0	0	0	0	2	1	0	0	0	54	22	45	7	0	3	30	0	51	0	0	0	6	194	0	4	0	0	0	0	0	0	0	0	212	8	0	0	267	528	0	0	0	3	10	5	0	0	1	0	0	0	46	0	3	0	0	0	0	1	0	0	0	0	0	65	0	0	0	0	0	67	0	4	1	6	0	34	1	85	4	1	34	0	3	1	0	43	0	0	0	0	0	0	1	0	1	0	0	0	0	0	56	1	2	0	0	0	108	45	1	1	2	4	246	0	0	0	0	0	0	0	0	0	0	0	0	0	0	25	0	0	0	0	13	0	46	0	10	8	1	0	1	0	0	0	0	0	0	0	0	0	0	0	2	0	0	0	0	10	0	0	0	0	1	0	1	0	1	0	0	1	0	21	0	0	1	0	0	0	0	0	0	0	0	0	28	17	2	1	7	0	0	0	1	6	144	2	1	2	0	1	0	0	0	0	0	0	2	19	0	0	4	0	0	14	4	3	1	2	1	1	3	0	3	1	0	0	4	6	0	0	0	0	0	0	1	0	0	0	0	0	0	0	0	1	1	0	0	3	0	0	61	1	0	0	0	0	1	0	1	1	1	0	1	112	17	0	0	0	0	55	0	0	0	38	0	43	28	0	2	0	0	0	0	0	11	0	0	0	397	0	0	0	39	0	0	0	0	0	1	35	16	84	0	0	47	0	0	0	3	25	0	0	20	0	0	57	3	132	1	53	2	0	0	0	45	0	0	1	0	0	8	1	0	0	0	0	0	0	73	0	0	0	0	0	4	0	2	0	0	0	94	0	21	1	0	91	2	1	0	0	1	0	191	2	19	117	63	0	1	59	1	36	0	47	4	0	0	0	0	45	0	0	0	0	9	0	0	0	0	0	1	4	1	2	1	0	0	15	7	6	0	118	1	0	0	58	2	0	0	0	0	0	0	0	0	0	0	0	0	0	0	22	25	1	0	0	0	2	0	73	0	0	0	0	8	1	0	0	1	0	0	0	0	1	0	0	80	0	0	1	0	8	0	724	697	47	34	0	0	1	0	0	0	42	2	0	1	0	0	0	0	0	1	0	0	0	117	18	13	3	1	0	2	0	0	0	0	0	22	0	3	0	0	0	0	0	0	97	146	31	0	1	10	2	0	2	0	1	0	0	0	0	38	1	0	0	2	0	0	53	177	4	3	3	0	82	0	0	0	0	0	0	9	1	0	0	0	0	470	32	1	1	3	0	135	1	1	0	0	0	0	0	9	46	2	1	0	1	1	0	1177	0	68	45	120	29	100	48	0	0	404	66	0	82	0	0	0	25	22	0	0	0	0	0	0	0	0	0	0	63	0	1	0	0	0	1	7	2	778	1206	0	4	1	87	0	187	201	147	0	0	114	0	0	0	0	0	0	0	0	0	0	0	0	0	0	0	0	0	0	2	0	0	4	0	0	0	24	0	52	0	1	161	1	13	1	22	6	156	39	1	0	0	0	0	0	520	90	1	1	0	0	1	1	200	0	1	8	0	0	1	65	0	0	1	0	0	0	0	43	89	0	0	0	0	0	0	0	0	8	1	0	0	0	0	5	0	4	3	142	2	0	0	0	0	0	434	0	1676	0	52	0	21	32	4	7	0	0	0	0	0	0	0	0	66	3	19	1	0	0	0	0	0	2	0	2	0	0	515	0	0	11	0	0	4	0	0	0	0	2787	0	0	0	0	0	0	0	0	0	15	0	0	0	0	0	0	0	0	0	0	0	0	0	0	0	6	0	0	60	2	0	1	0	0	0	0	2	129	0	0	0	3	0	0	0	0	291	0	0	1	2	0	0	0	0	0	0	0	1381	0	1	106	8	0	0	0	0	0	0	5	30	48	0	0	0	0	0	9	0	0	2	0	0	0	0	109	0	0	0	0	4	0	0	0	0	0	0	0	0	845	3	21	0	1	175	0	4	340	7	82	63	1318	1436	732	0	264	145	146	0	0	333	10	9	22	3	4	174	0	3183	0	1	0	0	0	81	0	0	0	14	40	26	1	0	0	0	0	45	0	1	0	62	17	55	3	57	1	77	1	46	0	1	1	49	0	12	55	0	0	0	0	0	0	0	0	0	0	110	0	0	0	0	64	0	0	103	0	0	0	0	0	37	1	0	0	10	0	0	26	1	0	0	0	0	0	0	0	77	0	0	0	31	6	0	141	1	0	0	1	133	1424	1	19	0	5	2	0	1	5	0	1	0	153	0	0	1	0	0	40	1	24	176	2	0	28	0	82	4	0	0	48	0	1	0	144	0	50	0	4	0	176	1	0	0	0	1	0	41	15	0	0	5	0	0	0	1	0	0	0	0	0	0	0	0	41	0	0	4	1	0	10	104	34	0	0	0	0	0	4	0	0	82	0	0	0	35	92	0	74	99	0	0	13	0	0	0	0	3	3	1	0	3	2	2	77	158	77	126	0	0	0	0	0	0	0	1	0	3	0	3	2	0	0	0	0	0	1	73	1	0	5	0	0	0	0	0	0	19	0	1	0	0	0	0	0	0	5	0	0	0	0	0	0	0	0	0	0	23	0	0	1	0	0	0	38	12	0	1	0	17	37	0	0	0	0	0	0	0	21	0	0	23	0	1	0	0	1	0	0	1	23	9	0	1	0	0	0	0	0	0	0	0	0	115	0	0	1	0	0	0	17	3	91	0	0	1	2	0	5	0	28	2	163	19	0	1	1	0	0	298	7	0	0	0	2	583	384	21	102	4	1	226	1	198	0	254	0	1	3	258	551	174	13	76	50	97	151	57	0	133	0	0	112	35	88	7	0	171	2	141	235	1	129	2	215	2	1	142	0	102	43	3	106	0	0	0	0	274	8	0	139	125	71	336	1	1	5	310	491	2643	0	15	112	0	0	0	0	3	1	1	45	0	1	0	6	53	181	4	0	19	0	0	0	0	0	2	8	1	5	3	7	4	15	80	159	0	205	105	180	3	0	0	0	3	79	72	0	2	121	3	2	1	130	0	0	38	10	0	0	0	73	0	0	0	71	0	0	1	0	0	0	0	165	0	0	0	0	0	54	2	1	0	0	0	0	0	0	0	90	0	0	0	0	0	0	0	0	0	3	0	0	1	0	0	0	0	0	14	0	1	1	1	53	146	209	153	5	0	0	0	0	0	0	1	0	0	0	0	0	0	1	0	0	0	0	0	7	0	0	0	0	0	25	0	0	0	0	1	0	0	0	0	0	0	0	0	0	1	0	77	0	1	0	0	2	0	279	31	41	135	0	114	0	153	0	0	0	0	0	0	0	0	0	0	0	0	0	28	2	22	1	1	0	0	0	0	0	0	0	3	11	0	0	3	0	3	0	0	169	70	0	0	0	36	0	0	32	0	87	1	46	0	0	0	0	0	49	0	111	0	0	0	2	38	0	1	15	25	1	49	2	0	1	157	3	0	4	106	118	25	0	6	1	0	14	68	3	1	0	0	0	0	0	0	0	0	0	0	0	0	0	0	35	28	0	64	0	0	0	0	0	0	2	1	0	0	48	0	0	0	0	0	0	0	0	0	144	15	1	0	0	1	0	0	1	0	0	2	1	0	0	3	0	0	0	0	0	0	0	0	0	0	0	87	1	47	0	1	0	0	0	0	1	0	0	0	29	2	0	0	91	0	0	0	0	0	1	0	1	0	0	2	521	54	55	0	0	5	1	0	0	0	0	0	0	0	0	0	0	1	0	0	0	0	2	2	0	0	0	0	94	22	0	0	0	0	0	1	3	23	3	14	18	0	0	0	0	0	0	2	0	1	0	0	0	1	0	1	0	0	72	4	0	0	62	2	0	0	1	90	0	26	0	0	85	0	1	29	0	0	0	0	0	0	0	0	1	79	1	0	62	0	29	2	0	0	0	210	0	0	0	0	0	1009	0	0	0	0	0	0	0	0	1	1	0	0	0	0	0	0	1	1	0	3	0	0	40	22	0	0	0	0	38	0	0	0	0	0	68	40	0	1	0	0	245	0	60770	0	0	0	0	0	51	0	2	0	0	0	0	0	0	0	0	108	0	0	0	0	1	0	63	6	0	2	35	0	0	0	0	0	0	0	10	0	32	62	1	6	1	0	0	0	0	5	2	0	0	0	0	3	0	1	40	34	46	99	1	4	96	0	9	0	0	0	0	0	138	72	109	352	0	0	0	3	2	1	0	9	279	5	0	1807	0	0	0	0	2	0	0	0	0	52	1	0	7	0	0	0	153	93	0	0	128	2	0	0	2	0	0	0	0	0	0	0	0	44	175	0	231	312	0	27	152	0	702	1	2	351	19	49	43	72	3	361	415	1	1	43	0	0	117	0	0	0	77	108	158	259	156	9	24	0	0	122	84	2	15	2	0	0	0	0	0	0	0	0	0	0	0	0	23	0	18	0	24	0	0	0	79	0	1	0	0	30	49	29	22	0	0	0	0	0	19	19	2	0	21	0	1	0	0	6	47	34	0	34	0	0	0	9	106	0	1	0	1	1	0	0	0	0	0	0	0	0	1	3	0	1	0	2	38	38	0	0	0	17	0	0	1	0	1	95	0	27	0	0	0	91	6	0	0	1	0	171	2	0	18	1	0	0	0	0	0	0	0	0	0	0	0	0	0	0	0	1	0	0	0	0	0	1	15	0	0	0	0	1	10	0	0	0	0	3	0	0	0	0	0	0	0	2	0	0	0	0	0	0	1	0	0	70	0	0	0	0	0	0	1	0	1	0	0	5	33	46	45	0	385	13	0	2	32	114	126	20	71	0	0	0	3	73	0	0	0	0	43	0	19	13	0	0	0	0	0	0	0	0	470	0	14	0	46	3	1	0	0	2	0	3601	25466	0	0	0	0	0	0	0	64	0	43	0	1	4	0	45	29	1	22	0	0	0	45	65	1	38	1	837	0	0	5	2	1058	0	0	2	0	1	4	1	0	198	0	5	122	72	112	0	0	0	85	5	3	0	0	0	0	0	0	0	0	0	0	0	1	23	0	0	1	0	0	2	0	1	3	3	1	0	1	13	1	0	0	0	0	0	238	1162	350	72	184	42	323	2813	1	0	21	61	74	72	0	0	5	1	18	0	1	0	0	0	0	0	71	0	0	1	0	0	0	1	0	21	1	18	1	1	0	0	79	19	0	0	10	0	0	0	0	4	0	0	2	74	0	110	0	1	0	0	0	0	0	0	0	0	0	0	0	0	0	0	1	0	0	44	170	0	0	1	0	0	1	5	0	0	1	3	0	5	1	0	1	0	0	0	0	0	0	0	0	0	1	0	0	0	0	0	1	0	5	0	23	33	55	272	59	109	0	0	0	0	0	0	0	0	0	1	0	0	0	0	0	1	0	77	0	0	0	0	0	35	0	0	0	0	0	0	0	19	0	0	151	0	0	1	49	0	22	0	0	51	0	0	0	2	1	0	32	56	46	0	612	0	3	3	12	0	3	16	0	0	84	1	0	2	2	235	51	0	0	1	1	0	0	9	0	0	0	0	266	0	0	0	1	2	5	0	0	0	0	0	1	0	0	0	1	0	0	0	2	2	0	0	0	0	1	214	2	0	0	0	0	0	0	0	1	53	0	0	0	0	0	0	184	1	0	0	0	0	15	0	0	0	66	2	0	65	4	1	0	0	0	0	0	32	1	18	2	0	0	1	0	0	156	0	4	0	0	59	0	0	0	21	215	40	2	4392	0	32	127	23	0	61	0	335	145	257	9	0	0	0	5	0	1	0	6	0	57	1	0	2	0	0	0	4	338	4	1	1	0	3	1470	0	8	0	0	0	170	73	0	0	0	0	0	0	0	33	0	0	0	26	15	0	0	0	1	44	0	22	0	0	1	0	0	0	0	6	0	1	2	0	2	4	4	0	0	0	1	0	0	1	16	73	31	96	6	1	56	72	35	53	35	88	0	0	0	0	0	0	0	0	0	475	0	0	0	339	98	53	20	1	291	0	5	87	2	0	1	3	0	0	0	0	0	0	0	0	9	1329	68	2	0	0	0	3	0	0	0	0	0	0	1	2	1	0	0	0	0	0	0	1	0	1	0	0	0	0	1	0	0	0	0	0	0	0	0	0	0	0	0	1	8	0	0	1	0	0	0	0	0	0	0	0	0	1	0	0	0	27	0	23	0	0	1	8	0	0	0	0	0	1	0	0	0	0	21	12	20	165	18	1	2	2	2	1	0	90	34	0	0	0	0	29	0	16	0	0	32	0	19	31	0	2	13	0	1	1	5	41	123	3	0	1	0	1	0	0	0	0	81	2	76	2	28	0	98	7	0	210	1	1	37	12	0	0	0	18	212	62	0	0	52	48	47	0	36	0	38	0	0	0	0	0	0	0	1	0	0	0	0	150	0	9	65	0	0	8	18	2	13	25	1	34	1	0	19	0	91	0	25	48	1	14	171	2	61	0	0	0	0	0	0	0	2	0	199	1	26	8	0	0	24	0	0	0	0	0	0	0	0	0	0	0	0	0	0	44	38	0	40	35	120	543	1	0	23	0	0	0	0	0	1	0	3	0	0	1	48	0	0	0	0	1	31	0	0	0	0	0	1	37	41	0	21	78	0	0	0	0	0	0	77	1	19	0	16	5	0	0	0	51	0	0	0	0	0	0	0	0	0	1	0	0	16	1	0	0	0	0	0	1	0	0	0	1	0	0	0	0	0	0	3	3	0	0	0	0	0	0	0	0	60	0	106	35	0	39	119	19	43	31	95	17	0	92	0	0	0	0	0	0	0	0	0	0	0	0	0	63	0	0	0	1	1	0	0	0	11	5	0	67	0	0	0	0	24	0	0	0	0	0	0	3	0	0	24	1	0	0	0	0	0	0	0	0	0	0	0	0	0	1	0	2	2	1	0	110	0	0	0	0	0	0	0	0	2	0	66	0	3	1	32	1	40	462	0	0	0	0	0	0	0	0	0	0	0	0	0	0	0	0	0	0	0	0	0	0	0	0	0	0	0	3	0	0	0	0	0	11	0	0	594	0	0	0	0	0	0	0	0	0	0	0	0	0	134	27	0	0	0	2	0	0	0	0	0	0	0	0	0	0	0	0	0	0	0	59	0	0	14	0	0	1	88	0	0	16	0	0	0	2	0	0	0	1	0	0	1	0	0	0	0	3	0	0	0	0	0	0	1	0	0	0	0	0	0	0	0	0	0	0	0	1	0	0	0	5	0	0	0	0	0	0	0	0	2	0	0	0	0	40	0	0	1	0	0	0	0	0	0	0	3	0	0	0	0	45	0	0	0	0	0	0	0	0	0	0	0	0	0	0	0	0	0	0	0	0	0	62	0	0	0	0	0	0	0	0	0	0	0	0	1	0	0	0	0	0	0	0	25	0	0	0	0	0	92	0	0	0	0	1	0	0	2	1	1	0	0	0	9	0	4	2	0	0	0	1	0	1	0	0	4	3	1	1	0	0	31	1	397	0	0	0	0	0	0	1	0	1	1	0	0	0	0	1	0	0	0	1	0	0	1	0	1	61	1	0	0	0	4	1	0	0	2	0	0	1	0	1	1	0	0	0	0	1	0	0	2	0	0	0	2	1	1	9	3	0	1	0	2	4	10	0	0	1	4	0	6	0	1	0	0	0	4	5	0	0	0	1	6	0	0	14	0	1	1	1	0	0	3	0	1	3	0	0	0	0	0	3	0	1	0	0	0	0	1	117	0	2	0	1	2	26	3	11	58	1	2	0	0	0	74	0	0	0	1	0	4	0	0	0	0	46	0	1	0	0	0	3	0	0	0	263	10	1	0	0	2	0	0	160	0	131	0	27	11	1	0	0	42	0	0	0	0	0	0	0	0	0	0	0	5	1	24	0	0	0	0	0	0	1	0	0	0	0	0	0	0	3	0	0	0	0	6	0	0	0	0	0	0	0	0	0	0	75	0	10	0	0	6	0	0	7	0	0	0	1	0	3	0	0	0	0	0	0	0	251	0	23	0	13	0	0	0	0	0	0	0	0	0	0	2	0	0	0	0	0	13	0	369	0	0	0	0	0	0	0	0	0	0	325	0	1	0	0	2	0	0	3	0	0	1	0	0	2	0	0	0	1	0	0	0	0	106	48	0	181	20	0	0	0	0	0	0	0	0	1688	0	0	0	25	0	0	0	2	4	19	0	0	0	2	0	0	0	0	0	0	27	11	5	34	0	18	2	96	0	0	0	0	0	0	1	1	0	0	0	0	0	0	0	0	0	1	5	0	2	41	0	0	18	1	0	0	0	0	0	40	3	90	42	64	151	0	60	109	2	2	77	2	1	61	0	0	0	2	0	0	0	0	0	0	48	21	0	0	0	2	242	6	0	0	0	106	0	0	0	0	0	0	1	0	10	0	1	61	0	184	0	0	1	0	0	0	0	1	21	0	17	0	33	7	11	2	0	89	0	12	0	0	0	0	26	0	33	0	0	0	5	3	1	0	2	1	0	7	0	1	1	24	31	5	0	0	0	0	0	0	0	16	0	0	0	0	11	0	0	7	83	2	0	54	0	3	38	56	30	0	1	0	0	56	0	36	79	3	0	0	0	28	0	19	39	2	52	1	0	0	0	0	0	3	0	0	0	0	248	5	109	0	1	0	0	1	1	44	33	0	0	0	1	3	3	0	0	11	23	10	0	12	0	3	1	1	17	1	24	31	224	49	0	0	35	98	13	0	0	0	1	0	0	0	15	0	0	263	0	5	0	1	0	0	17	139	9	24	0	0	0	0	0	0	0	0	0	0	2	1	0	1	0	21	41	17	91	0	31	0	0	0	0	0	41	0	18	0	22	0	2	0	21	0	0	85	2	0	10	0	0	0	24	554	0	0	1	0	0	2	0	0	10	0	0	0	0	1	62	1	0	22	0	81	0	2	5	0	0	0	0	0	5	0	0	1	115	0	0	657	0	38	0	0	27	0	0	0	0	0	0	51	7	0	0	0	0	0	0	0	0	1	0	1	0	0	131	2	24	0	1	0	0	1	0	0	0	0	0	26	32	1	0	0	196	0	1	347	10	118	90	106	12	8	663	175	2	182	1428	62	225	6	0	15	0	0	0	4	0	0	0	1	5	0	1	0	35	0	0	0	0	0	0	0	0	1	0	0	0	18	1	0	0	2	0	0	0	0	0	0	0	0	0	0	0	1	0	0	0	0	0	0	0	0	0	0	0	0	0	0	1	14	12	0	0	0	0	0	0	0	0	0	0	0	0	0	0	0	0	0	0	0	0	0	0	0	0	80	30	0	361	7	0	0	34	0	0	0	58	56	87	3	0	2	136	1	0	1	0	0	0	0	0	0	0	0	0	0	8	1	1	1	106	225	0	0	0	23	4	32	0	12	0	0	1	0	0	0	0	0	0	1	0	0	0	0	0	9	1	36	0	17	0	10	13	62	0	36	0	52	0	0	0	0	0	0	30	100	0	1	0	0	0	0	0	1	6	4	0	0	32	13	12	178	0	5	0	0	0	0	17	0	0	1	117	0	0	0	0	0	204	0	0	0	0	27	0	0	0	0	0	0	0	0	27	0	0	24	110	0	12	33	0	8	0	80	0	1	0	1	0	1	21	10	1	34	0	1	0	0	0	97	12	0	0	53	17	15	70	0	27	1	35	0	0	18	0	0	3	0	7	0	0	71	0	0	0	2	16	0	13	0	0	1	0	0	0	0	0	0	0	0	0	0	1	0	0	0	0	1	0	0	0	0	0	0	0	0	0	0	1	0	0	0	1	0	2	0	0	0	39	8	0	24	30	0	7	0	17	4	102	47	95	63	0	30	363	184	0	5	454	1	79	0	0	0	1	0	0	39	0	61	70	1	0	0	1	0	0	0	47	3	0	0	38	28	342	0	0	0	0	0	0	0	3	0	0	0	0	0	0	0	0	0	0	0	0	304	3	78	107	19	0	34	0	12	0	0	0	0	0	1	0	0	0	2	0	91	0	8	41	1	0	58	3	2628	3	4	0	0	2	1	0	51	79	9	4	3	15	0	8	5	5	0	0	0	0	15	0	22	1402	63	9	0	0	0	0	0	0	28	1	0	0	6	1	29	0	166	3	0	0	0	436	4	5	1	0	3	157	89	120	10	1	1	0	0	1	1	77	0	3	9	0	0	0	0	1	0	0	0	0	1	1	0	0	0	0	0	0	0	0	0	417	0	0	0	0	406	5	3	0	0	0	16	0	1	0	0	0	3	30	1	75	3	0	20	1	0	0	76	3	0	1	0	0	0	2	0	0	53	42	2	2	105	7	1	34	13	8	5	0	0	0	0	0	0	0	0	19	0	0	0	73	0	0	0	0	0	0	0	53	0	0	0	42	0	26	0	0	45	0	27	0	0	11	0	7	0	0	8	2	25	29	131	158	30	58	1	177	0	0	0	0	0	0	0	0	0	0	1	7	0	0	0	0	0	0	11	0	0	0	35	0	0	1	1	10	0	0	0	0	200	0	381	0	0	294	1	0	1	0	0	0	0	0	3	151	0	0	0	1	0	1	3	1	1	0	4	0	18	0	1	1	10	3	5	9	0	4	0	0	23	0	0	0	67	2	2146	102	92	84	30	90	50	49	52	103	54	39	0	89	27	0	0	0	3	1	0	0	0	0	0	1	0	0	0	0	0	0	1	2	0	0	0	0	1	0	0	0	0	0	0	0	0	0	0	1	0	0	0	0	0	0	0	0	0	0	1	1	0	76	0	0	112	0	365	277	1	109	0	0	0	21	0	0	1	0	0	42	0	0	158	168	1	0	0	16	0	21	0	50	63	83	0	0	0	0	2	0	0	0	0	0	0	0	0	0	21	6	8	0	92	0	22	16	18	0	0	1	0	0	0	63	1	0	0	0	33	40	0	67	0	0	0	28	0	77	0	35	0	0	1	0	0	0	0	0	0	8	0	6	0	6	25	2	0	0	0	51	1	2	0	0	0	0	0	2	0	0	0	9	0	36	58	0	0	0	0	0	0	0	0	0	0	0	0	0	0
LakWasM117_HOW13_2_rpkm	0	0	0	0	0	12	0	0	3	0	1	632	0	0	0	0	0	0	0	0	1	0	1	21	0	1	0	0	1	7	0	0	0	16	0	8	0	0	0	0	0	0	0	2	42	32	30	6	0	22	0	6	0	0	0	0	1	0	77	18	0	0	0	1	0	0	0	0	1	31	2	0	21	0	36	0	0	0	0	0	0	34	1	0	1	0	1	0	2	0	0	0	2	0	64	0	0	0	3	0	0	0	0	0	0	0	0	0	0	0	1	0	69	0	23	0	0	0	0	0	0	0	2	0	0	0	2	0	0	2	58	194	1	2	0	0	1	0	1	0	0	0	0	11	0	0	0	1	9	0	3	19	0	0	119	0	0	1	51	0	11	0	2	0	0	0	0	11	1	7	0	0	0	0	0	0	0	0	1	0	1	0	0	0	2	37	0	0	0	0	7	3	7	2	32	0	2	15	63	100	0	0	0	0	0	0	1	0	0	0	61	25	13	23	7	0	0	7	1	0	0	1	1	1	0	0	0	0	27	0	0	1	0	0	1	0	20	0	10	0	0	0	16	0	30	0	0	0	0	0	0	3	10	0	284	0	0	0	0	0	1	1	0	51	0	0	5	0	9	194	0	0	4	0	0	1	0	0	0	0	0	150	0	249	63	0	0	0	6	3	0	0	0	0	4	1	0	7	14	0	0	689	26	5	0	2	3	176	1	4	1	0	96	50	1	1	0	1	151	2	0	0	0	0	17	6	0	0	0	0	0	0	0	0	0	0	9	0	0	0	0	2	10	0	40	0	4	0	1	0	0	3	4	3	2	0	0	0	0	15	0	0	2	0	0	16	0	25	0	1	2	105	0	0	11	0	1	34	0	6	1	1	3	0	5	0	30	0	0	0	0	0	208	0	0	13	28	0	0	7	0	8	0	7	19	1	0	0	0	0	0	2	15	194	0	8	37	4	0	0	0	0	0	0	0	0	0	1	0	0	1	1	0	0	0	4	0	1	6	0	52	0	0	1	0	10	0	0	0	0	0	70	0	690	0	0	36	0	0	0	1	0	0	14	2	20	16	1	0	0	18	1	6	1	1	0	16	0	1	0	0	0	1	1	0	2	1	5	2	0	0	1	60	45	2	0	0	0	0	0	0	1	22	0	0	0	0	0	0	3	0	0	0	0	1	0	2	0	0	7	2	0	0	1	1	0	0	0	0	0	1	0	14	15	7	0	8	0	0	20	0	0	0	8	10	0	0	0	1	0	0	0	2	0	0	0	0	1	0	0	0	3	0	0	16	0	0	0	82	1	0	0	5	8	0	0	0	27	0	0	3	27	0	0	249	0	0	1	14	0	0	0	1376	0	16	9	0	0	0	0	23	0	0	10	7	4	0	19	0	0	0	479	4	834	3	0	178	1	529	4	5	0	128	17	0	8	0	1	1	4	0	2	0	0	0	0	0	0	0	1	2	399	0	1	0	0	0	10	0	6	23	0	2	6	1	0	1	0	1	2	0	9	1	0	1	0	3	0	2	0	0	10	1	0	1	0	1	0	0	0	0	0	5	1	0	0	6	0	0	19	0	0	25	1	0	0	0	4	0	0	0	1	0	5	5	0	0	0	64	0	1	0	0	5	4	3	1	0	17	1	0	0	3	3	0	0	0	3	21	1	0	3	0	0	0	0	1	0	0	0	0	39	13	0	1	57	1	0	0	1	2	0	15	0	0	0	2	0	5	2	0	0	0	10	0	0	14	0	0	0	0	0	0	0	0	64	0	0	0	0	0	0	2	0	0	0	0	0	0	0	4	11	0	0	0	0	3	0	0	2	0	0	1	0	0	3	97	0	0	0	0	0	1	0	22	0	0	0	0	0	0	2	0	0	45	0	0	0	2	1	6	0	0	0	0	2	0	132	23	0	0	1	0	0	0	0	0	0	18	110	0	0	0	0	0	0	0	1	0	0	15	1	0	0	0	4	0	0	2	0	0	0	0	0	0	0	2	0	0	0	0	0	0	0	0	44	176	0	0	0	0	0	0	0	0	0	0	4	0	0	0	0	1	0	0	1	0	0	0	0	0	0	0	0	11	2	0	18	0	1	0	1	0	1	0	0	0	0	0	0	0	0	0	0	0	0	0	0	0	0	0	0	0	10	10	0	0	8	0	0	0	0	0	0	2	1	0	0	1	0	0	0	0	1	27	0	0	0	0	12	0	0	3	64	2	22	0	22	0	0	32	9	6	0	1	0	0	0	0	0	0	0	0	0	0	0	0	0	0	0	1	0	0	0	0	0	0	0	0	0	0	0	0	0	0	1	0	156	0	0	1	24	1	0	0	6	0	0	4	0	11	0	0	0	0	0	0	5	6	13	0	0	0	0	0	0	0	0	0	0	6	0	0	2	0	0	1	0	0	0	0	0	0	4399	1	0	0	0	0	0	4	0	2	0	0	1	0	0	1	81	0	0	0	0	0	0	0	0	0	7	1	0	1	0	0	0	3	1	0	0	0	0	0	0	1	0	2	0	0	0	0	0	0	0	2	0	0	14	0	0	1	2	0	0	0	0	0	0	14	0	0	0	0	0	0	4	0	1	0	0	3	0	0	2	0	0	0	0	0	0	0	0	0	0	0	0	0	1	1	1	0	0	0	0	0	0	0	0	0	0	10	0	0	0	0	0	19	0	11	0	0	0	10	0	0	0	0	3	0	0	0	0	13	10	137	155	1	0	0	66	5	0	0	0	0	8	1	0	0	0	0	0	0	0	0	0	1	1	0	0	0	1	5	0	0	0	1	0	3	0	0	0	0	1	0	0	0	0	5	1	5	0	78	0	6	0	1	1	19	0	28	0	1	53	223	4	0	2	6	0	0	0	0	30	0	1	0	0	0	0	0	1	0	18	0	88	29	1576	0	28	0	1	1	1	0	19	1	0	9	0	0	0	0	0	0	2	0	0	0	0	1	0	0	0	1	1	4	27	0	6	0	0	0	0	1	0	0	0	0	2	0	0	6	0	0	0	1	0	4	0	0	0	0	0	2	0	24	1	18	0	0	0	19	0	0	0	0	0	1	11	0	0	4	0	0	0	8	4	0	0	0	0	0	0	2	0	3	0	0	0	0	13	2	24	0	0	4	0	0	0	0	0	0	0	176	1	17	28	8	16	21	4	25	0	0	17	0	11	0	3	1	2	0	8	12	0	5	1	1	0	0	1	4	8	8	0	23	0	0	0	0	0	0	11	0	0	0	0	0	0	0	37	3	2	0	0	11	16	0	0	0	5	2	5	0	0	1	4	0	0	0	0	0	644	34	147	30	2	12	0	0	0	0	0	0	203	2	14	0	14	0	0	0	5	264	782	30	58	19	1	33	51	1	0	0	2	0	0	0	0	50	0	66	1	105	0	0	28	1	15	0	0	0	0	0	0	0	73	0	0	0	1	0	9	0	1	0	0	0	22	0	4	0	3	0	1	26	0	0	0	0	0	0	8	0	1	0	0	0	0	0	0	0	0	0	1	0	0	1	1	0	0	10	1	0	0	0	0	0	6	0	0	0	8	0	0	0	0	0	0	0	0	0	0	0	0	0	0	0	0	0	0	1	0	0	0	0	0	0	0	0	0	3	0	3	28	0	45	123	0	0	9	0	0	3	2	0	0	1	0	97	0	30	0	0	3	0	3	0	0	0	0	168	1	0	0	9	0	3	1	0	0	0	0	0	1	0	6	0	25	0	0	0	0	55	1	0	0	0	1	0	0	0	1	1	1	0	0	0	0	0	0	0	26	16	0	0	12	0	0	0	0	0	12	5	4	0	0	0	0	0	0	0	1	0	0	0	0	10	8	29	33	12	12	18	32	0	0	0	8	0	3	0	0	0	0	31	0	0	0	0	0	5	0	0	70	60	4	17	0	0	16	0	25	0	5	4	0	43	0	0	1	0	0	0	2	0	39	1	5	0	4	0	3	1	0	5	113	12	0	1	0	0	0	0	4	2	102	0	72	2	0	3	18	0	2	0	0	0	0	0	1	34	2	1	1	0	0	0	0	0	12	5	10	0	0	0	0	0	0	0	0	0	0	0	0	5	0	17	0	0	0	0	0	0	0	0	0	8	0	0	0	1	0	2	0	0	0	0	0	9	2	30	0	0	9	0	1	0	3	1	0	0	2	0	0	0	3	0	26	0	0	0	0	1	0	15	1	0	1	0	0	0	3	0	0	8	0	0	0	0	0	0	0	30	0	1	96	0	1	0	2	72	0	36	31	0	9	149	0	13	0	292	2	25	0	0	0	0	1	1	67	2	0	0	0	0	1	0	0	1	0	0	2	0	0	58	4	1	1	1	1	39	0	0	0	0	0	0	0	0	0	0	0	0	0	8	9	0	0	0	4	0	14	0	0	1	0	2	0	24	0	0	9	1	0	0	0	2	0	0	0	0	1	0	0	0	0	0	5	0	0	0	1	0	0	0	0	0	0	0	0	92	0	5	4	0	4	2	0	72	0	42	31	693	17	0	2	1	0	0	0	0	0	0	0	0	0	0	0	0	0	0	0	0	0	0	0	1	1	0	0	0	1	0	0	11	0	0	108	6	0	1	0	40	145	19	0	0	0	0	0	0	0	0	2	0	0	2	0	0	0	0	0	1	0	0	0	0	0	0	0	0	0	0	1	0	0	3	0	0	0	0	0	0	0	0	0	0	0	0	0	3	0	0	62	0	0	1	0	1	1	0	0	16	0	0	0	46	0	0	111	7	0	0	91	1	0	0	0	0	0	0	0	0	0	0	2	0	0	0	0	1	14	0	0	0	11	1	10	11	15	0	0	0	0	0	0	3	0	57	0	0	0	1	0	1	0	0	0	0	0	0	0	0	0	0	0	2	1	0	0	0	1	0	0	0	0	0	0	0	1	2	155	0	0	0	310	0	0	0	0	0	0	0	0	0	0	0	0	1	0	0	0	0	0	0	0	0	4	0	0	0	2	0	3	0	13	1	13	0	2	7	0	0	0	0	0	0	0	26	4	3	5	1	0	0	4	2	0	12	49	13	0	1	0	2	2	0	0	4	0	1	0	0	2	0	0	0	0	0	0	0	1	3	0	4	0	8	1	0	1	1	0	10	0	1	4	2	1	0	0	1	0	2	0	0	0	2	0	1	0	2	3	4	1	0	2	11	0	0	0	0	0	0	0	0	2	22	10	1	0	0	0	0	0	0	0	1	0	0	1	0	0	0	0	0	0	1	0	6	0	0	0	5	0	0	0	0	0	6	0	0	0	1	0	5	0	0	0	57	0	0	0	0	6	9	0	0	0	0	0	5	50	28	160	25	2	28	2	0	75	4	157	5	21	0	8	5	4	59	0	10	0	19	12	57	93	29	28	10	1	8	5	2	83	0	1	0	0	0	0	2	0	0	0	0	839	0	0	0	0	0	0	0	0	0	0	0	0	0	0	0	0	0	0	1	0	4	1	35	0	290	7	1	0	2	0	0	3	0	0	14	20	0	1	0	0	2	0	0	0	0	12	0	0	0	0	2	16	2	29	0	0	3	7	0	1	0	1	0	0	7	1	0	0	0	1	0	0	0	2	45	0	0	0	0	1	0	0	0	2	10	18	0	67	0	0	0	0	0	0	0	1	0	1	2	1	0	2	0	2	20	68	1	0	20	8	0	0	0	0	0	2	0	0	1	0	0	0	0	0	18	0	0	0	0	0	0	0	42	15	37	0	0	21	10	16	3	8	0	2	31	29	0	2	0	0	0	0	0	0	2	0	0	0	2	0	0	0	0	0	0	0	0	2	0	0	4	0	3	0	0	0	0	1	0	0	0	9	0	0	0	0	9	3	2	0	0	3	0	21	0	730	1	0	0	11	0	0	4	0	0	1	1	0	0	0	3	0	9	0	3	0	0	0	0	0	33	0	0	39	4	0	0	0	0	116	0	1	2	0	0	0	0	1	1	0	0	3	0	2	0	0	1	1	0	0	0	0	9	0	0	0	0	0	1	0	0	0	0	0	4	0	0	0	0	0	0	0	16	0	0	0	0	1	0	0	77	23	0	0	15	0	0	3	0	0	0	0	0	0	0	0	0	0	0	0	71	2	19	47	0	1	1	40	0	0	0	0	2	46	2	0	0	0	2	0	0	0	0	0	0	0	0	0	0	0	0	0	67	0	0	0	0	0	0	0	0	1	0	12	12	1	5	0	6	1	0	2	32	0	0	0	0	0	0	0	0	0	12	1	4	1	0	0	37	1	0	1	0	0	1	0	11	0	0	0	1	0	1	0	2	0	0	0	1	0	0	2	0	0	1	0	0	16	0	0	0	0	0	0	1	5	2	0	602	0	0	6	0	4	0	0	9	1	0	0	2	20	4	10	1	0	0	0	0	0	0	1	0	2	0	0	9	0	0	0	117	0	0	1	51	9	0	2	1	5	1	0	1	1	0	2	1	0	4	1	0	3	1	3	1	0	3	1	0	1	0	0	0	14	0	8	3	17	24	7	13	14	19	8	9	0	15	15	21	0	0	1	0	0	11	2	1	2	0	4	0	6	54	5	0	0	0	0	0	0	0	0	0	0	0	0	3	0	1	0	1	20	0	0	0	0	0	0	0	0	1	0	0	4	0	1	17	0	3	0	0	18	0	0	0	1	0	1	0	9	0	1	18	45	28	1	7	2	2	0	0	0	31	0	0	0	0	0	1	0	0	0	1	0	0	0	0	0	1	35	0	0	25	9	0	18	0	0	2	0	0	86	16	0	2	0	12	1	0	1	0	0	0	0	3	0	0	1	2	3	0	0	73	0	2	0	0	0	0	0	834	10	1	6	0	0	0	0	0	0	0	62	0	256	0	2	0	0	171	600	83	0	1	0	22	0	0	0	33	1	0	0	0	2	0	0	0	0	0	0	1	0	0	0	1	0	0	0	0	0	38	276	0	4	0	0	0	0	0	0	0	1	0	0	0	0	2	0	0	0	1	0	2	1	0	5764	11	91	0	0	0	0	0	0	13	1	0	14	0	0	0	0	0	0	0	0	1	450	0	1	0	0	7	0	0	0	0	0	0	0	0	0	0	0	0	20	0	0	0	0	0	1	0	0	1	0	0	0	0	1	0	0	0	0	0	0	0	0	0	0	0	1	0	0	3	0	0	0	0	0	0	0	0	2	0	2	0	25	0	0	0	0	0	0	35	0	0	0	0	0	0	112	0	0	0	0	1	0	4	123	4	0	0	0	0	30	2	0	51	0	0	0	1	0	0	0	0	1	0	0	0	0	0	0	0	0	0	0	0	0	0	0	0	0	0	1	0	0	0	0	0	0	2	0	0	0	3	1	0	0	1	0	0	2	0	0	0	0	0	5	0	0	0	0	14	7	0	3	0	0	0	0	0	3	1	2	2	0	0	0	0	3	0	8	0	0	0	0	0	0	0	0	1	0	0	0	10	0	0	0	0	5	0	0	0	2	0	0	0	0	0	0	0	1	0	1	0	0	0	0	476	0	0	0	0	0	0	0	0	0	4	23	0	0	0	0	0	0	143	91	0	0	0	0	0	0	0	0	0	0	0	0	0	2	0	0	9	0	0	0	0	0	0	0	0	0	0	0	33	0	13	0	0	5	0	0	1	7	1	1	0	0	0	0	9	10	0	0	2	0	11	5	15	0	0	40	0	1	0	14	55	5	0	0	20	1	11	0	0	0	0	1	0	0	0	2	3	0	1	0	0	0	0	0	2	0	0	0	0	0	0	115	2	0	0	0	0	0	0	137	0	0	0	48	0	0	0	0	0	0	0	1	6	0	0	1	1	0	0	0	0	3	1	0	8	0	1	0	0	0	0	2	0	0	0	3	10	0	0	0	5	0	0	59	0	0	0	0	0	0	0	0	0	0	0	0	0	0	1	1	0	0	0	0	0	0	0	0	1	0	0	0	0	1	1	0	0	0	0	0	0	0	0	7	35	0	0	0	38	0	1	661	19	0	0	0	0	0	0	0	0	0	0	0	0	0	0	5	1	0	98	0	1	0	0	1	0	28	0	5	0	0	3	0	3	0	25	0	0	10	0	0	1	0	0	1	0	1	0	2	0	1	0	0	0	28	0	1	0	1	0	0	0	0	0	0	0	0	0	0	0	0	2	0	0	0	0	0	1	0	0	0	0	0	4	0	0	0	0	0	0	0	0	0	0	0	0	0	0	0	4	0	0	0	1	0	0	0	44	4	0	0	1	0	0	110	0	0	1	0	0	2	0	0	0	39	0	0	0	0	0	2	0	0	0	0	0	0	0	0	0	0	0	0	0	0	2	0	166	3	0	0	0	1	0	0	0	0	0	2	0	0	0	0	0	17	1	0	0	10	0	0	2	0	0	0	1	0	1	2	0	0	0	0	0	0	0	0	0	0	0	0	1	0	0	0	0	1	0	0	0	0	0	0	0	0	0	9	0	1	0	0	0	0	0	0	0	0	35	0	0	4	2	26	0	0	0	118	1	0	8	1	0	55	0	1	1	1	4	0	1	0	0	22	0	0	22	3	0	1	2	48	0	53	4	0	0	44	0	4	0	0	0	2	0	0	1	1	0	0	0	0	0	0	0	0	0	13	0	0	0	0	0	0	10	0	0	0	0	1	0	0	0	0	8	1	0	0	0	2	0	51	0	28	2	0	0	0	0	0	0	0	0	0	25	2	0	0	0	0	1	0	0	0	0	0	0	0	0	0	0	0	0	0	0	2	0	3	0	127	0	0	0	0	3	256	0	0	0	0	0	0	0	0	0	0	4	0	0	0	0	1	0	0	1	0	0	0	125	0	0	0	5	0	4	0	0	331	0	12	0	0	0	1	0	1	2	0	0	0	19	0	5	2	0	0	0	0	0	0	0	1	0	1	0	0	0	43	0	0	0	0	0	1	0	0	0	0	4	0	0	0	1	0	0	0	0	0	0	1	0	0	0	0	19	0	0	0	0	0	0	1	1	1	0	0	0	0	0	0	0	0	0	0	1	0	1	0	0	0	0	0	0	0	6	0	0	0	1	0	0	0	0	0	0	0	1	10	7	0	13	0	0	0	0	0	0	0	1	0	73	11	0	0	0	0	0	0	15	0	327	0	0	0	0	0	0	0	0	0	0	29	0	0	0	0	0	4	0	0	0	2	0	28	2	0	19	0	0	0	0	0	2	0	4	1	0	2	0	0	0	0	0	1	0	1	18	0	0	0	0	0	0	0	0	0	4	0	16	0	0	0	0	2	8	0	0	0	0	0	8	0	0	2	0	0	0	2	0	0	4	0	0	2	0	7	0	2	1	4	0	1	0	8	1	0	2	122	32	17	1203	891	0	0	0	0	6	0	22	0	2	0	0	0	0	2	0	23	0	1	27	0	12	0	0	0	0	4	0	0	3	3	1	1	0	0	1	1	0	7	51	1	0	7	0	24	0	0	0	0	0	0	1	0	0	0	0	0	0	7	0	1	0	0	0	32	4	0	0	0	1	0	0	0	0	0	0	0	0	0	2	0	0	5	3	0	41	58	10	0	0	0	6	6	1	0	0	0	0	0	0	0	0	0	0	139	0	2	1	0	0	2	3	0	1	0	0	0	0	0	0	10	9	0	4	0	0	0	0	0	0	1	1	3	0	0	5	0	0	0	0	27	50	0	2	0	0	0	1	0	0	0	1	10	1	1	0	0	0	0	20	0	0	2	0	31	0	1	0	0	1	0	0	12	0	0	0	0	0	0	0	5	0	0	0	48	94	403	9	2	10	1	7	1	4	31	22	7	0	406	7	0	1	8	5	13	2	10	100	1	249	1	57	0	819	0	0	0	0	3	1	22	7	0	0	0	0	2	0	1	2	1	0	0	0	0	0	4	13	0	1	1	0	0	1	0	0	0	15	0	0	0	2	1	1	100	0	39	0	0	0	0	0	38	5	0	0	0	0	0	0	0	5	9	0	6	0	0	0	0	1	0	10	94	1	9	65	19	0	1	0	0	0	0	0	0	0	0	0	0	0	0	4	1	0	0	0	0	2	0	0	0	2	74	0	0	0	0	7	0	1	0	0	3	6	0	1	7	20	0	1	0	0	0	4	1	0	4	3	1	1	0	0	0	0	1	1	0	0	2	0	0	1	0	79	2	0	0	2	1	0	0	7	0	4	0	0	0	271	31	0	0	3	0	2	17	2	1	10	0	0	3	2	0	0	0	0	0	0	1	0	0	0	0	0	0	1	0	0	0	1	0	56	0	1	2	20	0	0	0	0	0	0	0	55	0	0	8	0	7	6	0	5	10	1	0	0	36	0	11	0	0	36	0	19	0	0	0	0	5	0	0	1	15	0	0	0	0	0	4	0	0	0	51	0	0	0	0	3	0	0	0	2	0	0	1	2	1	0	0	0	0	2	49	0	0	0	0	0	0	1	0	1	0	0	0	0	7	1	0	6	33	0	84	0	0	0	0	0	0	11	61	0	0	0	1	3	0	2	0	1	0	0	0	0	0	0	2	0	0	0	0	0	1	0	0	9	0	3	0	11	0	12	3	0	48	0	0	15	0	1	0	0	0	0	0	1	2	0	0	0	0	1	2	1	0	0	0	0	0	0	0	0	12	42	0	0	0	0	1	0	1	0	0	58	0	23	0	4	0	0	1	177	1	0	0	1	0	0	0	5	14	0	0	0	15	0	1	0	0	0	0	6	0	0	0	0	0	0	0	0	0	1	0	0	2	0	0	21	0	1	0	0	57	0	27	5	0	0	0	0	0	0	0	0	2	0	0	40	0	0	2	0	0	0	0	0	0	39	0	35	4	11	31	0	0	0	0	0	0	12	1	2	1	8	2	0	0	0	0	0	12	0	21	5	5	32	7	8	62	0	0	0	0	10	0	4	0	1	0	0	1	0	0	0	0	0	0	0	0	1	0	1	3	3	0	2	0	0	0	0	25	14	5	0	6	0	56	4	109	0	0	0	0	0	0	17	0	0	0	0	0	1	2	7	91	0	0	0	0	0	0	11	2	11	1	0	0	0	0	0	2	0	0	0	75	0	0	4	0	0	5	0	0	0	0	0	0	0	5	0	2	0	0	0	1	6	0	3	0	2	11	1	0	0	0	0	1	0	0	0	0	0	2	0	0	15	0	3	1	0	0	0	13	4	62	0	1	11	0	23	0	13	0	2	12	0	0	0	1	0	1	1	0	0	0	0	0	0	0	0	48	0	9	0	0	248	0	2	0	0	0	4	60	0	12	0	0	1	161	3	0	52	0	0	0	0	0	0	0	0	12	0	0	0	4	4	4	0	0	0	0	0	0	9	0	0	1	0	0	0	9	0	0	0	1	2	0	1	0	0	1	0	1	0	0	0	0	0	0	0	0	0	0	0	0	0	0	0	0	0	0	0	0	0	0	0	0	0	0	0	0	0	0	0	0	135	0	0	1	0	0	3	77	0	2	0	0	7	0	0	0	0	0	0	0	0	0	4	0	0	0	1	0	0	0	0	0	0	1	0	0	0	0	0	2	0	0	0	9	0	0	0	3	0	1	0	0	2	0	1	0	2	126	0	0	1	0	0	0	0	0	0	2	0	0	2	0	0	0	0	0	0	1	0	0	6	0	0	0	0	0	0	6	0	0	0	0	0	0	0	0	0	0	0	0	0	0	0	1	3	0	5	0	0	0	0	14	41	0	0	2	0	0	0	0	0	1	2	0	2	0	0	0	0	0	0	0	0	0	2	0	0	0	0	0	0	0	0	0	13	0	0	7	0	0	0	0	0	0	0	0	0	0	0	0	1	0	0	0	0	0	0	0	0	0	18	0	0	0	0	0	0	0	2	0	0	1	0	1	415	14	0	0	0	0	0	1	1	1	1	0	1	0	0	0	0	22	0	0	0	0	0	1	0	0	0	0	1	8	0	0	1	0	0	0	0	0	58	0	16	0	6	0	0	0	0	0	8	3	0	0	1	507	14	19	1	0	0	18	0	29	1	1	1	8	50	0	3	3	0	0	0	3	0	0	0	103	3	4	4	113	195	0	0	0	13	1	5	0	0	0	2	1	0	56	0	9	0	0	0	1	1	0	0	41	0	0	9	7	0	2	0	1	54	0	993	0	1	0	51	1	44	0	2	13	0	0	0	0	6	1	0	0	0	3	0	2	1	0	0	0	0	7	0	8	0	0	0	0	2	24	26	1	1	9	0	180	12	0	0	0	0	0	0	0	0	0	0	0	0	0	7	0	2	0	0	8	0	111	0	3	3	0	4	0	0	4	0	0	2	0	0	0	2	0	0	3	0	0	0	0	0	0	0	1	0	0	0	0	0	1	0	0	1	0	2	0	0	0	0	0	2	0	0	0	0	7	0	0	4	0	0	2	0	6	0	0	1	105	0	0	2	1	2	0	1	0	0	1	0	15	10	0	0	29	0	0	56	5	7	3	14	4	16	7	0	9	2	0	1	3	0	0	0	0	2	2	0	0	0	0	0	0	0	0	0	0	1	7	0	0	3	0	0	34	0	0	0	0	0	0	0	0	3	0	6	6	44	7	0	0	0	0	26	1	0	0	4	0	11	9	7	1	0	0	0	2	0	0	3	0	0	292	0	0	2	23	33	67	0	32	2	2	39	2	16	0	0	28	0	0	0	3	6	0	0	10	5	0	17	0	26	1	18	0	0	0	1	27	0	0	1	0	0	1	4	0	0	0	0	0	0	55	0	0	0	0	2	0	0	3	0	1	1	28	0	6	0	0	61	11	2	0	2	2	0	173	0	3	81	17	1	15	15	4	8	1	18	0	0	0	0	0	5	0	0	0	0	1	1	5	0	0	0	0	0	5	3	2	0	2	22	24	102	0	207	521	0	0	11	3	3	0	0	0	0	0	0	0	0	0	0	0	0	0	10	3	17	0	1	3	1	0	7	0	0	0	1	4	0	0	0	0	0	0	0	0	2	0	0	40	0	17	0	0	5	0	85	66	14	12	0	0	3	1	0	0	12	0	0	1	2	0	0	0	2	64	0	2	0	44	17	28	6	0	0	0	0	0	2	0	1	7	0	2	1	0	0	0	2	0	17	46	11	2	1	7	0	4	4	3	5	0	0	0	0	14	0	0	5	3	7	0	18	68	2	1	102	0	45	0	0	0	3	0	0	7	1	0	0	0	2	562	61	0	0	2	0	13	3	0	2	0	0	0	0	19	17	2	0	4	0	0	0	601	0	15	37	32	8	45	23	0	0	189	12	0	19	0	0	0	8	7	0	0	0	0	0	0	0	0	0	0	9	0	0	0	0	0	1	4	0	751	1497	1	0	2	28	0	83	87	30	0	1	39	1	0	0	0	0	0	0	0	1	0	0	0	0	0	1	0	0	0	4	0	0	0	0	0	0	10	0	9	2	0	49	0	6	0	12	0	37	29	0	0	0	0	0	0	196	58	1	0	0	2	0	0	42	1	0	1	0	0	0	20	1	0	4	0	0	0	0	7	24	0	0	0	0	0	0	0	1	1	0	3	0	2	0	0	0	5	0	445	0	0	0	0	0	0	1833	1	656	0	46	0	11	11	1	4	0	0	0	0	0	0	0	1	24	1	12	0	0	0	0	0	0	17	2	0	0	1	212	0	0	7	0	0	0	0	4	0	0	9495	0	0	0	0	0	0	0	0	0	8	0	2	1	0	0	0	0	5	0	0	0	0	0	0	1	20	4	0	35	0	0	0	0	0	3	1	0	65	0	0	0	0	0	1	0	0	145	1	0	11	2	0	3	0	0	0	0	0	673	0	0	5	5	0	0	0	0	2	0	1	9	7	0	0	0	0	1	5	0	0	0	0	0	0	2	78	0	0	3	1	0	0	0	1	0	1	1	0	2	1550	0	23	4	0	1	0	0	98	0	56	22	268	294	186	32	42	26	48	0	0	26	1	0	0	0	1	0	5	1695	0	2	2	0	0	96	0	0	11	17	39	17	3	0	1	19	0	44	0	0	0	12	10	49	5	34	8	16	1	19	0	5	0	24	0	9	25	0	0	0	0	0	0	0	0	0	3	14	0	0	0	0	36	0	1	52	0	1	0	3	0	21	0	0	0	5	0	0	31	0	0	0	1	0	1	0	0	31	1	1	2	19	2	0	41	0	0	0	0	51	390	0	61	0	2	14	0	11	2	0	4	0	38	0	1	3	0	0	6	0	17	64	1	0	13	0	67	0	0	0	0	0	1	0	69	0	15	0	7	4	82	1	0	0	0	0	0	17	4	0	0	8	0	0	2	0	0	0	0	0	0	0	0	0	55	0	0	11	8	0	3	55	5	0	0	0	1	0	0	1	0	40	0	0	0	1	38	0	17	78	0	0	12	0	1	1	0	0	0	0	0	0	55	0	44	60	34	49	1	0	0	0	1	2	0	0	0	0	6	1	0	0	0	0	0	0	53	25	0	0	3	0	0	0	0	0	0	7	1	0	2	0	0	0	0	0	0	1	0	0	0	0	0	2	1	0	0	12	0	0	1	0	0	0	48	4	0	1	2	5	2	0	0	1	0	0	0	0	6	0	0	4	0	0	0	0	0	0	0	0	4	7	0	0	0	0	0	0	1	0	0	0	7	54	0	0	0	0	0	0	22	0	12	0	0	0	0	0	2	0	15	0	10	4	0	1	1	0	1	91	0	0	0	0	0	86	122	18	60	1	43	68	0	81	0	92	0	0	0	213	353	205	89	104	14	39	58	19	2	52	0	0	22	12	11	0	0	112	1	58	108	0	29	1	90	0	0	47	6	37	50	0	61	0	0	0	4	39	0	0	27	52	67	46	0	0	0	109	185	496	0	6	53	1	0	0	0	0	6	0	79	0	1	0	6	1	75	2	0	2	0	0	1	0	0	5	2	3	0	0	3	0	1	42	108	0	14	77	40	0	0	0	0	1	30	33	0	0	52	1	22	0	40	0	0	20	1	0	1	0	53	0	0	2	45	0	0	0	0	0	0	0	50	2	1	1	0	0	16	0	6	3	0	0	7	0	0	3	23	0	0	0	0	0	0	0	0	0	1	0	0	0	0	0	2	3	1	0	2	6	2	6	8	27	18	27	1	1	0	1	2	0	1	0	0	0	0	1	0	0	0	0	0	0	0	0	0	0	3	1	0	0	16	0	0	0	1	0	0	0	0	1	0	0	2	0	3	0	1	31	1	0	0	0	0	0	83	2	18	66	0	37	0	87	1	0	0	0	0	0	0	0	0	0	0	0	0	16	0	9	0	0	0	2	0	0	1	0	0	1	4	1	2	5	2	3	0	1	73	38	0	0	0	14	1	1	28	0	64	16	11	0	0	0	0	0	30	0	50	0	0	0	0	12	0	0	16	8	0	8	71	0	0	186	0	0	1	149	60	6	0	6	0	0	9	38	4	4	0	0	2	0	0	0	0	0	4	1	2	0	0	0	15	14	19	19	1	0	0	0	0	0	4	3	0	0	64	6	0	0	2	0	0	0	0	0	70	10	4	0	1	0	0	0	4	0	0	0	0	0	1	1	0	0	0	0	2	0	0	0	0	0	0	31	2	9	0	1	5	0	0	2	0	0	2	0	7	0	0	0	25	0	16	0	0	0	0	1	0	12	0	0	192	76	17	0	0	0	0	4	0	0	1	0	0	0	0	3	3	1	0	1	0	0	0	1	2	0	0	3	15	10	0	3	0	0	0	1	4	5	0	12	4	0	0	0	0	2	11	1	1	4	1	1	0	2	0	0	2	0	27	0	1	0	29	2	1	0	0	18	0	9	0	0	0	0	0	14	0	2	0	0	0	0	1	0	2	50	0	0	23	0	8	0	4	0	0	32	0	0	0	1	0	351	0	0	0	0	0	0	0	0	1	2	0	0	0	0	3	0	0	0	0	0	1	4	10	12	0	0	0	0	32	0	2	1	0	0	24	18	0	2	1	0	3407	0	44388	0	0	2	0	0	8	0	2	0	0	0	0	0	0	1	0	15	0	0	0	0	1	6	43	0	0	0	5	0	0	3	0	0	0	0	2	0	10	32	2	6	0	0	1	0	0	0	0	0	5	0	0	2	0	4	10	10	49	19	0	0	14	0	8	1	0	0	3	2	150	15	24	24	0	0	0	3	4	3	0	0	206	1	0	1178	0	0	1	0	0	0	30	6	2	29	1	1	224	95	0	0	81	81	1	1	37	0	0	1	0	1	0	0	0	5	0	4	0	43	132	0	82	189	1	14	40	0	73	20	15	125	37	310	38	48	9	32	329	0	7	106	0	133	126	0	0	0	61	56	37	204	60	1	7	0	0	95	20	1	9	0	0	0	0	0	0	0	0	0	0	0	0	0	4	3	0	1	3	0	0	0	29	0	0	0	0	9	17	15	8	0	0	0	0	0	17	0	0	0	3	0	0	0	0	0	14	8	0	3	1	0	0	8	25	0	2	0	6	0	0	0	0	3	0	0	0	0	0	0	0	14	0	3	1	15	3	0	0	2	0	0	36	0	0	49	0	20	2	0	1	35	3	0	13	6	1	83	6	0	10	10	0	3	0	2	0	1	0	0	2	0	1	3	0	0	0	0	0	0	0	0	5	0	6	0	2	0	0	1	0	0	0	0	0	1	0	2	0	1	1	0	0	0	0	0	0	0	0	0	0	0	11	14	0	2	8	0	0	0	1	0	0	1	1	1	13	9	15	28	359	2	1	8	5	32	34	13	42	0	1	1	0	33	0	0	10	0	33	1	9	3	0	0	0	0	0	0	0	0	74	10	207	2	7	8	0	0	0	1	0	628	2030	0	0	1	0	1	1	1	25	0	39	0	1	8	0	15	13	1	2329	1	0	0	43	12	0	14	0	337	0	0	6	0	186	0	0	0	1	0	1	0	0	27	0	0	58	47	38	0	1	0	26	0	0	2	1	0	0	0	3	1	0	2	3	0	1	11	0	0	2	0	0	0	4	1	2	1	4	0	1	1	0	0	0	0	0	1	128	866	231	21	32	53	132	303	0	0	6	16	17	20	1	0	2	0	5	1	1	0	2	0	0	0	30	1	0	1	5	0	0	0	0	6	0	9	2	0	1	0	2	2	0	0	10	0	0	0	0	0	0	0	0	40	2	51	0	0	0	1	1	1	0	2	3	2	0	0	1	3	0	1	0	0	0	2	126	0	0	1530	0	0	0	11	2	0	1	4	6	8	0	0	0	0	0	0	0	0	1	0	2	0	0	0	0	0	0	0	0	0	0	0	14	8	51	176	11	35	0	0	0	0	0	0	0	0	0	0	1	0	0	0	0	0	6	52	0	0	0	0	0	22	0	0	0	0	0	0	0	16	0	1	24	0	0	0	8	1	14	0	0	25	0	0	0	0	2	0	5	18	73	0	158	0	0	3	61	2	1	15	0	0	19	1	0	1	1	21	1	1	0	0	0	0	0	233	0	1	0	0	180	0	2	0	1	7	1	0	0	0	0	0	0	6	0	0	0	0	0	0	0	2	0	0	0	1	5	65	0	0	0	0	3	0	0	0	0	40	1	0	0	1	0	0	80	0	2	0	0	0	7	1	0	0	38	1	0	30	0	21	3	2	1	0	0	11	1	9	0	2	0	3	0	0	2062	1	0	0	0	4	2	0	0	35	182	18	0	430	0	7	28	3	0	20	0	65	37	95	4	12	2	0	0	2	0	0	0	0	15	0	0	0	0	4	0	0	105	0	0	1	1	0	88	1	1	0	1	3	25	20	1	0	0	0	16	0	0	5	1	0	2	4	3	0	2	0	0	17	2	9	0	0	0	0	0	0	0	0	1	0	1	0	0	2	0	0	0	0	0	0	0	0	5	16	5	20	3	0	45	32	5	34	41	131	0	0	0	0	0	0	0	0	0	220	0	0	0	115	40	18	3	0	86	0	0	11	5	0	11	0	0	0	0	2	0	0	0	0	0	1104	60	4	0	0	0	0	0	2	0	1	0	3	0	1	1	0	0	0	0	0	0	0	0	0	0	0	0	0	1	0	0	0	0	0	0	0	0	0	0	0	0	0	0	0	0	0	0	0	0	0	8	0	0	0	0	2	0	0	0	7	0	6	0	0	5	2	3	0	0	0	4	0	0	2	0	0	5	425	7	22	11	0	0	0	0	0	0	41	9	1	0	0	0	16	0	11	0	0	21	0	2	9	0	3	12	0	3	10	21	2	47	0	1	0	0	0	0	0	0	0	21	1	26	2	9	0	43	3	1	62	0	1	17	3	0	1	0	7	71	78	68	1	41	15	24	1	10	0	2	0	4	7	0	0	2	1	0	0	0	0	0	4	0	55	8	0	0	0	14	0	7	26	0	16	0	0	10	2	22	0	6	32	1	14	33	0	49	0	0	0	1	0	4	0	0	2	64	0	14	0	0	0	12	0	0	0	0	0	0	0	0	0	0	0	1	0	2	16	6	3	10	14	37	447	3	0	8	0	0	0	0	0	15	1	9	0	0	5	24	0	0	0	7	3	2	0	1	0	0	0	88	20	16	0	5	47	1	0	0	0	0	0	14	0	43	0	1	42	0	0	0	9	3	0	0	0	0	0	1	0	0	0	1	0	5	5	0	0	0	0	0	1	0	1	0	0	1	1	1	0	0	0	1	1	2	0	0	1	1	1	0	2	66	5	44	17	0	16	30	11	44	11	12	6	0	0	0	0	0	0	0	0	0	0	0	0	1	0	0	7	0	1	0	0	21	0	0	0	0	4	0	14	0	0	0	0	11	0	0	0	0	0	0	0	0	0	7	1	0	0	0	0	0	0	0	0	8	0	1	1	0	2	0	1	1	0	1	33	0	0	0	0	0	0	0	0	37	0	47	0	1	1	2	1	11	405	0	0	2	0	0	0	0	0	0	7	2	0	0	0	0	0	0	5	0	17	0	0	0	0	0	0	0	18	1	0	0	0	0	0	0	0	332	0	1	0	1	0	8	0	0	0	0	0	0	0	47	33	0	0	0	7	0	0	1	0	0	0	0	0	0	0	0	0	3	0	0	47	0	1	0	0	1	0	26	0	0	37	0	1	0	2	0	5	2	0	0	2	0	0	1	1	0	2	0	0	2	1	0	0	0	3	0	0	0	0	0	0	0	0	0	0	0	0	0	0	0	0	0	0	0	0	0	0	0	1	0	0	0	0	0	5	0	0	1	0	0	0	0	5	0	0	0	1	0	0	0	11	0	0	2	1	0	0	0	0	0	0	0	0	0	1	0	0	0	0	0	0	0	10	0	0	0	0	0	0	0	0	0	0	0	0	0	0	0	0	0	0	0	0	0	0	0	0	1	0	1	0	0	0	0	0	0	0	0	0	0	0	0	0	0	0	0	0	0	0	0	0	0	0	0	0	0	0	0	0	0	0	29	0	0	0	0	0	0	0	0	0	0	0	0	0	0	0	0	0	0	0	0	0	0	0	2	0	1	1	0	0	0	0	0	0	0	0	0	0	0	12	0	0	0	0	1	0	0	0	0	0	0	0	0	0	0	0	0	0	0	1	0	0	0	0	1	1	0	0	0	0	3	0	0	0	57	0	0	0	0	0	0	0	0	0	0	0	0	0	0	0	0	0	0	0	0	0	0	0	0	0	0	0	0	0	0	0	0	1	0	13	0	1	0	1	0	1	0	0	44	1	0	0	0	0	34	0	0	0	3	0	1	0	0	0	0	12	0	4	0	0	0	4	0	0	0	113	10	0	1	0	1	0	0	62	1	147	0	27	8	0	1	0	22	0	1	1	0	0	0	0	0	0	0	1	6	1	11	0	8	6	2	0	0	0	0	0	0	0	2	1	0	0	0	0	0	0	0	3	0	0	0	1	0	0	0	0	0	16	0	0	0	0	1	0	0	9	1	0	0	0	0	0	0	0	0	1	3	0	0	27	1	1	4	76	0	0	0	0	1	0	0	0	2	0	0	0	1	0	0	0	0	0	176	0	0	0	1	0	0	0	0	0	0	271	0	6	0	0	0	0	0	0	0	0	0	0	0	0	0	0	0	0	0	0	0	0	32	28	0	238	16	1	3	0	0	3	67	28	0	3898	0	0	0	2	0	0	0	7	3	25	7	0	0	0	0	1	1	0	0	0	25	0	1	0	0	25	9	34	0	0	0	1	0	0	1	3	2	0	0	0	0	0	0	0	0	0	0	0	0	18	3	0	3	0	0	0	1	0	0	6	1	91	57	66	61	0	29	29	1567	1	25	1	0	18	0	0	7	0	2	0	1	0	0	0	23	5	0	0	0	1	65	1	0	0	0	49	0	0	0	0	1	3	1	0	5	0	0	29	0	105	0	0	0	0	1	0	0	2	3	0	5	0	11	0	11	0	0	6	0	5	0	0	0	0	13	0	11	0	2	0	4	4	2	1	3	0	1	1	0	6	0	6	18	1	1	0	0	0	0	1	0	0	1	0	0	0	5	2	0	15	71	0	0	15	0	0	32	12	21	0	0	0	32	19	1	21	38	0	1	0	0	4	5	19	28	3	60	6	0	1	4	0	0	2	0	1	0	0	142	1	46	0	0	0	0	1	0	15	8	0	0	0	0	4	2	1	0	0	4	5	0	0	0	0	1	1	18	0	14	30	81	58	0	0	8	43	13	0	0	0	4	0	0	1	0	0	0	52	0	4	0	1	2	0	4	50	11	20	0	0	0	0	5	0	0	0	1	1	0	0	0	1	0	30	21	16	148	0	19	0	2	0	0	0	11	0	5	0	5	0	1	0	7	1	10	20	6	20	0	0	3	0	21	317	0	0	0	0	0	7	0	0	1	0	0	0	0	7	21	1	0	4	1	23	0	0	0	0	1	0	1	0	4	0	1	1	51	0	0	501	0	19	1	0	10	0	0	0	0	0	0	24	0	0	0	1	0	0	1	0	0	1	9	3	0	0	42	7	5	0	0	0	0	0	6	0	0	0	0	12	23	0	9	0	48	6	0	117	31	86	78	37	0	19	133	141	0	52	198	52	53	7	15	21	0	0	1	5	0	0	0	1	0	0	0	1	8	0	0	0	12	0	0	1	0	2	0	1	0	46	0	4	1	8	5	0	0	0	0	0	0	0	0	0	0	0	1	0	0	0	0	0	0	0	0	0	0	0	0	0	0	7	31	0	0	0	0	0	0	0	0	0	0	0	0	0	0	0	0	0	0	0	0	0	0	15	0	38	7	0	152	1	0	2	12	0	0	0	45	17	23	0	6	0	76	0	0	0	1	0	0	0	0	0	0	0	0	0	18	1	3	1	39	78	0	3	0	7	1	20	0	13	1	0	0	0	1	1	0	1	4	48	0	9	0	0	0	16	0	34	0	11	0	38	59	24	0	17	1	1	0	0	1	0	0	0	184	52	0	0	0	1	0	0	0	3	3	6	0	0	33	8	6	23	0	4	0	0	0	0	0	2	2	1	599	0	0	0	0	0	89	0	0	0	1	9	1	1	0	1	1	1	0	1	5	0	0	10	46	0	5	0	0	6	0	16	0	5	0	6	1	2	5	5	0	22	0	0	0	0	0	32	8	0	0	39	7	11	10	2	5	0	6	32	0	4	1	14	3	0	3	0	0	16	0	0	0	3	12	0	15	0	0	3	1	0	0	0	2	0	0	0	0	0	1	1	1	1	0	0	0	0	2	1	0	0	0	0	0	0	0	1	1	0	0	0	0	0	0	0	11	4	1	7	38	0	1	0	2	1	77	33	40	48	0	7	336	151	0	1	323	2	32	0	30	0	6	1	0	17	0	17	15	0	3	3	5	1	1	44	12	8	0	0	13	6	167	0	0	0	0	0	0	0	0	0	0	0	0	8	0	0	0	0	0	4	0	107	0	36	40	6	0	16	0	3	0	0	0	0	0	1	0	0	0	150	0	26	0	2	2	3	0	18	1	573	0	1	0	0	2	8	0	8	25	14	12	2	5	0	13	14	4	0	0	0	0	1	5	6	765	19	36	0	1	0	1	0	0	25	0	0	0	2	0	1	0	44	0	1	0	1	55	10	3	2	0	0	84	57	68	0	1	0	0	0	1	0	10	1	5	1	0	0	0	3	1	1	0	0	0	0	1	0	0	0	0	0	0	0	0	0	130	0	0	0	0	161	5	7	0	0	0	4	0	16	0	2	0	34	15	0	3	4	0	8	0	1	0	12	0	0	4	1	0	0	2	4	2	25	57	16	8	53	1	0	23	5	2	1	3	1	0	0	5	0	0	1	8	0	0	0	44	0	0	0	0	0	0	0	11	0	1	1	17	7	6	0	3	9	0	12	0	0	2	1	8	0	0	4	6	12	9	65	90	11	52	3	96	0	0	1	1	3	4	0	0	0	1	4	2	1	1	0	0	0	4	12	1	0	0	13	0	0	2	1	3	0	1	2	0	74	0	212	0	0	123	0	0	2	0	0	0	0	0	6	54	0	0	0	0	0	1	1	1	2	0	45	0	15	0	0	0	2	0	0	105	0	1	2	0	0	0	0	0	19	0	780	23	42	66	10	39	21	30	18	38	19	8	4	9	17	1	0	0	2	0	1	0	0	0	1	2	2	0	0	0	0	1	1	0	0	0	0	1	0	0	0	0	0	1	0	0	0	0	0	0	1	0	0	0	0	0	0	0	9	0	1	0	0	15	1	0	42	0	111	71	1	34	0	0	0	2	0	0	8	0	1	846	0	0	103	11	0	0	0	1	0	9	0	42	18	41	0	0	0	0	8	0	0	0	1	0	0	0	0	0	4	3	1	0	32	0	3	1	3	1	0	0	0	0	4	32	0	0	0	11	11	41	0	22	0	0	0	6	0	2	0	19	2	0	0	0	0	0	1	0	0	9	0	0	0	0	7	0	1	1	1	21	1	5	0	0	0	0	0	1	0	0	1	0	4	2	18	0	1	1	0	0	0	0	0	1	0	0	15	6	2
LakWasM118_HOW13_2_rpkm	0	0	0	0	0	9	2	0	0	0	0	184	1	0	0	1	0	0	1	0	1	0	0	22	1	0	0	0	0	4	0	0	0	12	0	10	1	0	0	0	0	0	0	2	15	50	34	16	0	16	0	6	0	0	0	0	0	1	14	8	10	1	0	2	0	0	0	1	6	18	3	0	3	0	4	1	1	0	0	0	0	17	1	0	0	0	0	0	0	0	0	4	11	2	40	0	0	0	4	0	0	0	1	0	0	0	0	0	0	0	0	0	41	0	17	0	0	0	0	0	0	0	1	0	0	0	0	1	0	0	21	709	5	0	0	0	0	0	1	0	0	0	0	3	0	2	0	0	44	0	1	36	0	0	119	1	2	1	31	0	12	1	0	0	3	0	0	4	1	5	0	1	0	0	0	0	1	0	0	0	1	0	0	0	1	5	0	0	0	1	4	4	15	9	0	0	0	20	15	82	0	0	2	0	0	0	3	0	3	0	26	15	16	17	7	0	0	17	0	0	2	6	1	17	0	1	0	0	57	0	0	0	53	0	2	1	20	0	12	0	0	0	46	0	18	2	0	1	0	3	1	6	8	0	529	9	0	0	0	0	4	0	1	17	1	0	17	0	11	58	3	0	8	0	0	0	0	2	7	1	1	84	4	144	94	0	0	0	5	11	0	0	0	0	3	1	0	7	1	0	0	21	30	0	0	1	2	46	8	2	4	0	61	18	0	1	0	0	1	2	1	2	0	0	14	9	1	0	0	0	0	2	0	0	0	0	1	0	0	0	0	0	12	2	9	0	4	2	1	2	1	1	14	0	1	0	0	0	0	10	0	0	1	1	1	30	2	32	1	14	0	44	0	3	9	0	0	13	0	13	0	1	4	1	2	1	105	2	0	0	1	0	142	0	0	6	13	0	0	82	0	17	1	6	28	0	4	0	1	0	0	10	6	267	0	16	19	1	1	0	0	0	0	0	0	0	0	0	1	2	1	0	0	0	0	3	0	0	4	0	35	3	0	0	0	20	0	0	0	0	0	62	3	153	0	5	51	7	0	1	0	0	0	7	2	35	11	0	0	1	44	3	10	7	0	0	18	0	34	0	3	0	7	94	0	1	1	11	8	1	1	0	42	44	1	0	0	0	0	0	0	5	13	0	0	0	1	0	0	2	0	0	1	0	1	0	2	0	0	9	1	0	0	0	10	0	0	0	0	1	0	0	30	16	6	0	6	3	0	18	0	0	2	21	12	0	0	0	2	1	0	0	1	0	0	3	0	3	0	0	0	1	0	1	23	0	26	1	32	0	0	1	0	0	1	2	0	34	0	5	1	28	3	3	37	0	0	4	15	2	1	0	8	0	10	5	0	0	1	0	18	0	1	1	3	6	0	21	0	3	0	873	22	825	2	0	99	0	432	1	19	0	94	22	0	6	0	3	0	4	0	2	1	0	0	0	0	0	1	2	2	456	0	3	0	4	1	19	3	2	9	0	6	9	0	0	0	0	1	0	1	21	0	11	1	0	5	0	2	1	3	7	2	0	0	0	1	0	0	1	0	0	8	0	0	0	4	0	0	20	0	0	4	1	0	0	0	2	0	1	0	3	0	5	2	2	3	2	78	0	0	0	0	0	9	3	0	0	16	1	0	3	2	1	0	0	0	0	35	0	0	1	1	0	0	0	0	1	0	4	0	27	16	1	3	37	1	0	1	5	1	0	7	1	0	0	0	0	11	3	0	0	0	20	0	2	3	0	0	0	0	0	0	0	1	54	0	0	0	0	0	0	11	0	1	0	2	0	0	1	1	9	1	0	0	0	7	0	0	8	0	0	0	0	10	6	152	0	0	0	1	0	0	0	21	0	1	0	0	0	0	0	1	0	20	0	0	0	5	13	3	1	0	0	0	0	0	41	19	0	0	0	0	0	0	0	0	0	54	26	0	0	2	0	0	0	0	0	0	1	29	1	2	1	0	37	0	0	0	0	0	0	1	0	0	0	0	0	2	4	0	4	0	0	0	4	165	0	1	0	0	0	0	0	0	0	0	0	0	0	0	3	0	3	0	0	0	2	0	0	0	0	0	0	8	6	9	2	6	0	0	0	0	0	0	0	0	0	0	0	3	0	0	0	0	0	0	0	1	1	0	0	0	9	11	0	2	10	0	0	0	1	0	0	0	0	0	0	2	0	0	0	0	0	3	0	0	0	0	2	0	1	6	172	3	74	0	5	0	0	34	3	6	0	8	0	0	0	0	0	1	1	0	0	0	0	0	0	0	0	0	1	0	0	0	0	0	1	0	0	0	0	0	0	0	0	0	158	0	0	0	22	2	0	4	10	0	0	9	1	12	0	0	0	0	0	0	2	12	5	0	1	0	0	0	0	0	0	3	0	6	0	2	11	0	0	1	0	0	1	2	1	0	55	0	0	0	0	2	0	11	0	0	1	0	0	0	1	2	25	0	0	0	0	0	0	0	0	0	17	0	0	0	0	0	0	0	7	0	1	0	0	0	0	1	0	7	0	3	16	0	19	0	0	2	0	0	17	0	0	2	1	1	0	0	0	0	3	62	0	1	0	1	0	0	1	0	0	0	0	0	0	0	0	0	0	0	0	0	0	0	0	0	0	0	0	0	0	0	3	0	0	0	0	0	0	0	0	0	0	15	1	1	0	4	0	23	0	2	0	1	0	5	0	0	0	0	3	0	0	0	4	7	7	144	78	1	0	0	57	6	0	0	1	0	5	11	0	0	0	0	0	0	1	0	1	4	1	2	1	0	0	4	0	0	0	0	0	6	0	0	0	0	0	1	0	1	0	6	0	3	2	111	4	1	0	1	4	4	1	29	0	1	65	76	0	0	1	6	0	0	0	0	17	3	2	0	0	0	0	0	19	1	39	0	9	23	1082	0	49	0	3	0	4	0	26	2	0	9	0	0	1	0	0	3	11	0	0	0	1	5	0	0	0	0	1	4	5	0	10	0	6	0	0	0	0	0	4	0	1	0	0	10	0	1	0	0	0	0	0	0	0	0	3	1	0	28	4	14	1	0	0	23	0	0	0	0	0	0	11	0	1	1	0	0	0	24	8	0	0	0	0	0	0	8	0	6	0	1	3	0	6	4	22	0	0	7	0	2	0	0	0	0	0	34	1	17	45	7	17	16	6	41	0	0	13	4	9	0	1	1	16	0	8	2	0	7	0	0	1	3	1	5	9	1	0	25	0	0	0	0	0	0	1	1	0	0	1	1	0	1	35	1	1	2	0	14	7	0	1	0	6	0	6	1	1	1	0	0	0	0	0	0	853	25	84	17	0	2	0	0	0	0	0	1	72	6	5	0	13	0	11	0	1	154	311	12	96	0	0	21	120	1	0	0	0	0	0	2	0	69	0	44	2	83	2	0	29	4	6	0	0	0	0	0	0	3	17	0	0	0	4	0	13	0	1	0	0	0	8	1	4	0	1	0	2	23	0	0	0	0	0	0	7	1	7	0	0	0	0	0	1	0	1	0	1	0	0	1	5	0	0	5	0	0	0	0	0	0	6	0	1	0	9	0	0	0	1	0	0	0	0	0	0	0	0	0	0	0	0	0	0	0	0	0	0	0	18	0	0	2	0	2	1	0	81	0	21	71	0	8	134	0	0	3	15	0	0	0	0	79	0	145	0	0	0	0	1	0	2	1	0	54	1	1	0	12	1	1	1	0	0	0	0	0	0	1	4	1	50	0	0	0	0	10	1	0	0	0	1	2	0	0	0	0	3	0	0	3	0	1	0	2	24	19	0	1	17	0	0	1	4	0	7	2	4	1	0	2	0	0	0	0	0	0	0	2	0	13	20	31	64	134	27	162	58	0	0	0	2	0	3	0	0	0	0	58	0	1	0	1	0	5	0	0	16	59	0	60	0	0	6	0	9	0	5	4	0	51	4	3	1	1	0	0	1	0	66	5	3	0	1	0	0	21	0	4	129	10	1	1	0	2	1	0	19	23	219	1	23	0	1	0	5	0	6	0	0	1	0	3	0	34	2	0	0	0	0	0	1	0	1	8	7	0	2	0	0	0	0	0	1	0	0	2	0	3	3	5	0	0	0	5	0	45	0	0	4	19	0	0	554	0	0	2	0	0	0	0	1	11	4	5	1	0	11	0	0	0	7	0	0	1	0	0	1	0	12	0	31	2	2	0	0	0	1	8	1	0	0	0	0	2	4	1	2	8	0	0	0	0	0	0	0	15	1	0	29	2	0	1	4	156	39	60	20	0	22	98	0	13	1	116	6	15	0	0	2	4	7	0	73	1	0	0	0	0	0	0	0	0	0	2	3	0	0	25	5	1	3	0	1	88	0	0	0	0	0	0	1	2	0	0	0	0	0	4	0	0	0	9	6	6	18	0	0	6	0	1	0	21	0	0	87	2	0	0	0	6	0	0	1	0	0	1	0	0	0	1	10	0	0	0	4	0	0	0	0	0	0	0	0	51	1	3	0	1	0	18	0	40	0	3	26	294	4	0	1	0	0	0	0	0	0	0	1	0	1	0	0	0	0	1	0	5	0	0	0	0	1	0	0	0	5	0	0	18	1	0	95	5	0	7	0	25	52	13	0	0	0	0	0	0	0	6	0	0	0	2	0	6	0	5	1	1	0	0	0	0	0	0	0	0	0	1	0	0	0	0	0	0	0	0	41	2	0	0	0	0	0	0	0	10	0	0	21	0	0	0	0	5	3	0	0	40	0	1	0	23	1	6	76	7	0	1	52	1	0	0	0	0	0	0	0	1	1	0	4	0	0	1	0	1	24	0	0	1	11	0	10	18	66	2	0	0	0	0	0	2	0	88	0	0	0	0	0	4	0	0	0	2	0	0	0	0	0	0	1	6	0	0	0	0	2	0	3	0	2	0	0	0	0	3	79	0	0	0	22	0	1	0	0	0	0	1	0	3	0	0	0	2	0	0	1	0	2	4	3	0	1	5	0	1	188	0	14	33	50	4	9	0	3	16	2	1	0	0	0	0	0	76	1	0	1	0	0	0	2	2	0	15	19	12	0	0	0	0	4	0	1	5	0	0	0	7	2	0	0	0	4	0	0	0	2	6	1	3	0	3	5	0	1	6	0	27	0	0	6	1	4	0	0	1	0	1	0	2	0	0	0	0	0	6	1	2	1	0	2	10	1	0	0	0	0	1	0	0	3	7	6	1	1	0	0	0	1	0	0	1	0	0	2	0	0	1	0	0	0	0	0	2	0	0	0	1	0	0	1	2	0	3	1	0	0	2	0	18	0	0	1	2	1	0	0	0	19	7	0	0	0	0	0	10	54	108	90	42	12	7	33	0	120	6	63	19	85	0	69	6	35	70	0	24	0	92	111	49	167	191	94	14	3	11	74	7	117	0	0	0	0	0	0	0	0	0	0	3	429	0	0	0	0	0	0	0	0	0	0	0	0	0	2	0	1	0	0	2	0	5	0	29	0	6	36	1	0	1	1	50	8	2	0	4	19	0	5	0	0	0	0	0	0	0	24	0	0	0	0	2	8	1	18	0	2	2	16	0	0	0	1	0	0	2	0	0	0	0	0	12	0	0	1	11	0	0	0	0	2	0	0	1	1	5	5	0	13	0	1	0	0	0	0	0	2	0	1	0	0	0	1	1	3	7	94	0	0	16	6	0	1	1	0	0	1	0	0	0	0	0	0	0	3	9	0	0	0	0	0	1	0	67	11	11	0	0	27	12	7	1	46	0	43	3	3	0	0	0	3	0	0	0	0	6	0	0	3	1	0	0	0	0	0	0	0	2	0	0	0	0	1	2	0	1	0	0	3	0	0	2	1	0	0	0	0	2	6	0	0	0	1	0	4	0	424	25	0	0	6	9	0	0	0	0	1	1	0	0	0	0	1	1	0	4	5	0	0	0	0	25	0	0	14	5	0	0	0	0	59	0	0	0	0	0	0	0	2	0	0	0	2	1	4	0	0	0	0	0	0	1	0	11	1	0	0	0	0	0	0	2	1	0	0	2	0	3	0	1	0	0	0	14	1	0	0	0	1	1	0	59	63	0	0	4	0	0	1	0	0	0	1	0	0	0	0	0	0	0	0	114	10	15	28	1	0	0	19	0	0	0	0	24	35	0	0	0	0	18	1	0	10	0	0	0	0	0	1	1	0	0	0	23	1	0	0	0	0	0	0	2	1	0	13	17	3	8	2	1	0	0	0	19	0	0	1	0	0	0	0	0	0	10	0	2	1	0	0	43	1	1	0	1	0	6	0	3	0	4	0	0	0	1	0	1	0	2	0	2	0	0	2	0	0	0	1	0	8	0	0	0	1	1	0	0	5	1	0	165	0	0	23	0	12	0	2	5	0	4	0	2	9	1	12	1	0	0	0	0	0	0	0	0	1	0	1	0	0	0	0	83	0	1	1	62	10	0	5	10	2	0	5	3	3	0	11	0	1	1	2	4	5	13	0	0	4	2	6	0	5	0	0	0	67	0	20	1	39	43	11	33	59	23	81	20	0	31	25	28	0	2	4	0	0	12	34	1	18	0	2	0	4	58	25	0	0	0	1	0	4	2	0	0	0	0	8	5	0	0	0	1	11	0	0	0	0	0	0	0	0	0	0	0	12	0	0	11	0	3	0	0	5	0	0	0	1	0	0	0	22	1	2	12	28	22	0	10	1	1	0	0	0	178	0	0	0	4	2	1	2	5	0	2	1	0	0	0	0	0	38	0	0	29	9	3	68	0	3	0	0	0	36	14	0	0	24	17	13	0	1	0	0	4	1	5	0	0	2	2	2	0	0	21	1	0	1	0	0	0	0	599	38	35	0	0	0	0	1	0	2	0	64	0	74	0	2	0	0	182	423	88	1	0	0	49	0	0	0	37	0	0	0	0	0	2	0	0	1	0	0	1	0	0	0	0	0	0	1	2	0	70	268	1	14	0	0	0	0	0	3	1	0	0	0	0	0	40	0	0	1	0	0	0	5	0	1541	8	33	0	0	0	0	0	1	38	0	0	23	0	1	0	0	0	0	0	3	1	578	0	1	2	0	3	0	0	0	0	0	0	2	0	0	0	1	0	17	0	0	0	0	0	0	0	0	0	0	0	0	1	0	0	0	0	0	0	0	0	0	0	1	0	0	0	1	4	0	0	0	0	0	0	0	0	3	0	0	0	15	0	0	0	0	0	0	108	0	0	0	0	0	0	450	3	0	0	0	1	0	2	24	13	0	2	0	0	21	3	0	40	1	0	2	5	0	0	1	0	0	0	0	4	0	0	0	1	0	0	0	0	0	0	0	0	0	0	0	0	0	0	1	0	0	0	0	0	0	2	1	0	0	1	0	1	4	0	0	0	0	1	17	0	0	1	1	17	5	1	13	0	0	0	1	0	0	0	3	4	0	1	1	0	12	0	11	0	0	0	0	0	0	1	10	1	4	0	1	12	1	2	3	0	4	0	0	0	5	0	0	0	0	1	0	0	4	0	1	2	0	0	0	210	1	0	0	0	0	0	0	0	30	3	12	0	0	0	0	0	0	56	205	0	1	0	0	0	0	0	0	0	0	0	0	0	1	1	0	12	0	0	1	0	0	0	0	0	0	0	0	50	4	19	1	0	2	0	0	1	2	2	7	0	0	2	0	27	2	0	0	1	1	4	3	6	0	0	47	3	0	0	9	52	0	0	0	7	1	14	1	0	0	0	0	184	0	0	0	3	0	1	0	0	0	1	0	3	1	0	0	0	3	0	51	0	0	0	0	0	0	0	351	0	0	0	16	0	0	0	0	0	0	0	1	1	0	0	0	0	0	0	0	0	2	0	0	1	0	3	0	0	0	0	1	0	0	0	0	7	6	5	0	2	0	1	15	0	1	0	1	0	0	0	1	0	0	0	0	0	1	2	0	0	0	0	2	2	0	1	0	0	0	1	0	0	0	0	0	0	0	0	0	0	0	0	6	17	0	2	0	38	3	0	5	3	0	0	2	1	0	0	0	0	0	0	0	0	0	0	3	1	0	25	0	0	0	1	0	0	18	0	0	0	0	56	1	0	0	15	0	0	1	0	0	5	2	0	11	0	0	0	0	1	0	0	0	1	17	4	1	1	5	2	0	0	0	0	0	0	0	0	0	0	0	7	0	0	2	0	0	0	0	0	0	0	12	3	0	2	0	0	0	0	1	0	0	1	0	0	18	9	0	14	0	0	0	0	0	0	1	24	13	0	0	0	0	0	3	0	0	0	0	0	0	1	0	0	122	0	0	0	0	0	0	0	0	0	0	0	0	1	0	0	0	0	0	0	0	0	1	39	3	0	0	0	0	0	0	1	0	3	14	0	0	2	1	0	4	2	0	0	6	0	0	0	0	0	0	2	0	0	0	0	0	0	0	0	2	0	0	0	0	0	0	0	0	0	0	0	3	0	0	0	1	0	0	1	0	0	6	0	1	0	0	0	0	0	0	0	2	82	0	0	14	12	9	1	0	3	97	1	0	19	0	0	137	0	0	0	9	1	2	2	1	0	4	0	46	39	6	1	3	7	140	0	1	1	0	0	34	2	1	0	0	0	0	1	0	1	0	0	2	0	1	0	0	0	0	0	19	0	0	0	0	0	0	1	1	0	0	0	0	0	0	1	0	1	0	0	0	0	0	0	84	3	40	6	0	0	0	0	0	0	0	0	0	268	0	0	0	0	0	2	0	0	1	0	0	2	1	0	2	1	0	0	0	2	5	0	0	2	27	0	0	0	0	3	13	0	1	0	0	0	0	0	1	3	0	1	0	0	0	0	1	0	0	0	0	0	0	152	5	0	0	0	1	52	0	10	221	0	9	0	0	0	0	0	0	1	0	0	1	12	0	2	4	0	0	0	0	0	0	1	0	0	0	0	0	0	26	0	1	0	0	0	0	0	0	0	0	0	0	0	0	0	0	0	0	0	0	0	2	0	0	9	0	10	1	0	0	1	0	0	45	1	1	0	0	0	0	0	0	0	0	0	0	0	0	0	2	0	1	0	0	1	0	6	0	0	0	1	0	0	0	0	0	0	0	3	1	4	0	1	0	4	0	0	0	0	0	8	0	54	10	0	0	0	0	1	0	12	1	78	0	1	0	1	0	1	1	0	0	0	72	0	1	0	0	0	3	0	0	0	2	0	34	4	0	3	2	0	0	0	4	1	0	13	0	0	0	2	0	0	0	0	0	0	0	4	0	0	0	0	1	1	0	0	0	1	1	27	0	0	0	1	4	14	0	0	0	0	0	7	0	0	0	0	0	0	0	0	0	20	1	4	2	0	3	0	0	1	1	0	0	0	11	0	0	0	87	24	9	192	728	0	0	0	0	36	0	25	8	5	0	0	0	8	56	0	39	2	0	17	0	143	0	0	0	47	0	0	0	10	2	1	2	0	0	3	1	7	5	57	0	1	7	0	2	0	2	1	1	0	0	2	0	0	0	0	0	0	3	1	0	0	0	0	39	0	0	3	0	0	0	0	0	0	0	0	0	0	1	0	0	0	10	0	2	24	30	0	1	0	17	1	11	0	0	0	0	0	0	1	1	0	0	6	111	0	1	1	1	0	0	0	1	1	0	0	0	0	0	0	11	5	0	1	0	0	0	0	0	0	0	0	1	0	0	4	0	0	0	0	13	6	0	3	1	1	0	0	0	0	1	0	10	0	2	0	0	0	0	34	0	0	1	0	26	1	1	0	0	5	1	0	39	0	0	0	0	0	0	0	8	0	0	0	186	126	147	2	1	17	7	29	2	21	14	12	10	34	258	13	1	38	15	12	117	7	0	34	1	30	1	33	0	323	0	0	0	0	5	1	6	1	0	0	2	0	2	0	1	4	0	0	0	26	2	1	23	8	0	2	1	1	0	2	0	0	0	15	0	1	1	1	0	0	63	1	0	0	0	0	0	0	56	6	0	0	0	1	1	0	7	1	12	0	20	0	2	0	0	0	0	11	89	0	29	21	45	0	0	0	1	0	0	4	2	0	0	0	0	0	0	4	1	0	0	0	0	2	0	0	0	0	19	0	0	0	1	8	1	0	0	0	1	52	1	1	1	3	0	2	0	0	0	3	1	1	22	3	0	2	0	0	0	0	1	0	0	0	1	0	7	0	0	58	0	0	0	0	0	0	0	5	0	3	0	0	0	115	8	0	0	10	0	0	37	1	5	6	0	5	1	2	0	0	5	1	0	0	0	0	0	0	0	0	0	3	0	3	3	0	1	11	0	0	1	27	0	0	0	0	1	0	0	45	0	0	1	0	9	4	4	2	1	0	0	0	96	3	29	0	0	15	0	12	1	0	0	0	5	0	0	0	3	0	0	0	0	0	4	1	0	0	36	0	0	0	0	3	0	0	1	32	0	1	1	3	0	0	0	1	0	21	51	0	0	0	0	0	2	0	1	1	0	1	0	0	7	0	1	10	22	1	48	0	0	2	0	0	0	4	20	0	0	0	1	3	0	4	1	1	0	0	0	0	2	0	9	0	0	0	0	0	1	0	0	75	0	1	1	13	0	10	0	0	23	2	0	7	0	2	0	2	1	0	1	0	7	0	1	0	1	2	2	2	0	0	0	0	0	0	0	0	4	24	0	2	0	0	3	0	1	0	0	96	0	11	0	2	0	0	0	29	0	0	0	5	0	0	0	4	4	0	0	0	5	1	0	2	0	3	0	2	0	0	0	0	1	0	0	0	0	0	1	1	0	2	0	7	0	1	0	0	138	1	16	1	0	0	0	0	0	0	0	0	1	0	0	67	1	0	0	0	0	0	0	0	0	32	1	81	1	11	34	0	2	0	1	0	0	6	1	1	1	4	3	2	0	0	0	2	12	0	12	8	2	40	8	15	57	0	0	0	0	61	0	1	0	12	0	1	0	0	0	0	0	0	0	0	0	1	0	0	1	8	0	1	0	0	0	0	70	99	0	0	2	0	11	3	51	0	0	0	1	0	0	5	0	2	0	0	0	1	6	1	41	0	0	50	0	0	1	16	1	3	1	0	0	0	0	0	2	1	0	4	6	0	4	6	0	2	10	2	1	3	0	0	0	0	14	0	0	0	2	0	1	7	1	5	1	0	89	0	1	2	4	0	0	0	0	0	0	0	8	0	2	29	0	3	2	2	1	0	4	0	358	0	6	15	0	99	0	11	0	5	14	0	0	0	2	2	0	0	0	0	2	1	0	21	4	4	23	1	6	0	1	217	0	3	0	0	1	9	34	0	3	0	0	2	18	0	25	30	0	0	0	0	6	29	0	9	5	0	0	0	26	1	0	0	0	0	0	0	31	6	0	0	2	0	2	0	6	0	0	1	1	0	0	0	0	0	2	1	0	0	0	0	0	0	0	0	0	0	3	0	2	1	0	0	0	0	0	0	0	0	0	0	0	0	0	0	0	0	0	0	0	68	0	0	3	0	3	1	147	0	0	0	0	5	0	0	0	0	0	2	0	0	0	0	0	0	0	0	1	0	0	0	0	0	22	0	0	0	0	0	2	0	28	0	0	3	0	0	2	0	4	0	0	0	1	0	0	1	19	0	0	1	0	0	0	0	1	0	0	1	0	0	3	0	0	0	0	0	1	0	0	5	0	1	0	0	3	3	0	0	0	0	1	0	20	0	0	2	0	0	1	0	0	0	0	0	0	6	0	0	1	0	19	49	1	0	0	0	1	0	0	0	1	0	0	3	0	0	0	0	0	0	1	0	0	1	3	0	0	0	0	0	0	0	0	15	0	0	4	1	0	0	0	0	0	1	0	0	0	0	9	1	0	0	0	0	0	0	0	0	0	9	0	1	0	0	0	0	0	9	0	0	1	0	1	119	11	0	0	0	0	1	3	1	0	1	0	6	0	0	2	0	11	0	0	0	1	0	0	0	0	0	0	0	0	2	0	1	2	0	0	0	0	58	1	24	0	5	1	0	0	0	1	19	3	0	0	4	380	15	17	6	0	4	26	0	41	0	2	1	13	15	0	8	2	0	0	3	2	0	0	0	107	5	3	6	335	364	0	0	0	27	19	7	0	0	1	7	0	1	30	0	3	0	0	0	0	0	0	0	51	0	0	4	3	0	1	2	1	19	0	7	2	11	0	22	3	119	5	0	11	0	1	0	1	39	0	0	0	0	1	0	1	3	0	0	0	0	7	1	13	1	0	0	0	1	23	24	4	4	22	0	242	7	1	0	2	0	0	0	1	0	0	0	1	0	1	7	0	0	1	0	3	0	51	0	15	2	0	1	0	0	2	0	0	0	0	0	0	3	0	0	3	0	0	0	0	0	0	0	1	0	0	0	0	0	2	2	0	0	0	6	1	0	2	0	0	4	0	1	0	0	4	0	8	0	3	0	3	0	2	0	0	4	55	2	0	8	2	0	0	1	0	0	0	0	7	20	0	0	18	0	0	32	4	12	4	8	3	13	3	0	4	3	0	3	2	11	0	0	0	0	0	0	1	0	0	0	0	0	0	0	0	0	7	0	0	6	0	0	44	0	0	0	0	0	0	0	4	0	0	0	3	39	6	2	0	1	0	37	0	0	1	19	1	17	11	3	7	0	0	0	4	2	17	1	0	0	132	0	0	0	23	22	6	0	43	12	1	56	2	14	0	0	24	0	0	0	1	10	0	0	12	1	0	26	7	28	0	18	1	0	0	4	20	0	0	0	0	0	0	1	0	0	0	0	0	0	26	0	0	0	0	0	6	3	1	0	1	1	25	0	13	1	0	66	10	0	0	0	12	0	119	1	6	86	36	3	1	28	2	13	1	50	3	0	0	0	0	7	0	0	0	0	1	2	2	0	0	0	0	0	0	1	3	0	1	24	26	63	0	276	0	0	0	7	2	2	0	0	0	0	0	0	0	0	0	0	0	0	0	6	8	16	0	0	1	3	0	8	0	1	0	0	11	0	8	0	2	0	1	0	0	2	0	0	28	0	0	3	0	31	0	96	28	15	14	1	0	1	2	0	0	47	1	2	0	2	1	0	0	1	3	0	0	0	62	10	17	7	0	0	0	0	0	4	0	2	23	0	5	8	4	0	0	3	0	38	43	13	4	1	5	3	3	3	1	6	0	1	0	0	22	2	0	3	2	9	0	35	158	5	3	0	2	32	1	0	0	2	0	4	2	0	4	0	1	0	196	44	1	5	2	0	13	6	0	1	0	0	0	0	37	6	2	2	0	0	2	0	423	0	43	10	52	1	43	11	0	1	176	26	0	15	1	1	0	10	12	2	0	1	0	0	0	0	0	0	1	14	0	0	0	0	0	0	5	0	327	348	5	1	3	24	0	77	48	32	0	0	42	0	0	0	0	0	1	0	0	1	0	0	1	0	0	0	0	3	0	5	0	0	1	0	0	0	10	0	9	0	0	85	1	4	2	4	2	43	12	1	3	0	0	0	0	268	53	4	0	1	2	1	0	33	0	1	2	0	2	2	15	0	1	0	0	0	1	0	15	35	0	0	1	0	0	1	1	1	5	0	0	0	0	0	0	3	1	1	241	0	0	0	0	0	0	1857	0	1817	0	21	0	1	30	880	5	0	0	0	0	0	0	0	0	26	0	10	0	0	0	0	0	3	34	1	2	0	0	331	0	2	5	0	0	4	0	0	0	0	3053	1	0	0	0	0	0	1	0	0	12	2	1	1	0	0	0	1	1	2	0	0	0	0	0	0	12	2	0	24	1	0	3	0	0	0	1	2	76	0	0	0	1	1	0	0	0	91	0	0	3	1	0	0	3	1	0	14	0	647	11	0	9	36	0	0	0	0	2	0	10	15	11	0	0	0	0	0	2	0	0	1	0	0	0	0	130	0	0	0	2	1	0	0	1	2	0	0	4	9	1845	1	30	5	0	49	0	3	60	2	72	10	229	297	135	2	69	40	41	0	0	87	16	18	1	1	2	10	14	2948	1	0	3	3	0	69	0	0	0	43	90	49	16	0	0	20	0	41	0	0	0	12	5	25	9	17	8	14	4	13	0	2	0	21	0	15	42	1	2	0	0	0	0	0	0	0	3	41	1	0	2	0	36	0	1	29	0	0	0	1	0	16	1	1	0	8	0	0	20	6	0	2	0	0	0	0	0	23	0	4	2	13	1	0	38	3	0	0	0	40	381	1	10	1	8	7	0	5	7	0	19	0	39	4	0	12	0	0	14	3	4	96	2	0	9	8	52	2	0	0	9	0	1	0	11	1	12	0	3	3	94	0	0	2	0	0	0	2	3	0	1	4	0	0	0	1	0	1	0	0	0	0	0	1	21	0	1	8	2	0	36	28	21	0	0	2	2	1	2	1	0	29	0	0	0	5	23	0	55	91	0	8	9	9	2	23	4	0	0	0	0	2	22	0	36	43	42	20	1	0	0	0	0	0	2	0	0	0	4	0	1	0	0	0	1	0	22	33	3	0	5	0	0	0	0	0	0	14	0	0	1	0	0	0	0	1	5	0	1	1	0	0	0	0	2	0	0	12	0	0	0	0	0	0	23	7	0	0	1	6	3	0	0	0	0	0	0	0	5	0	0	0	0	0	0	0	0	0	0	0	9	11	0	4	0	0	0	1	1	0	0	0	4	62	0	0	0	0	0	0	28	1	35	0	0	0	0	0	1	0	21	0	7	4	0	1	1	0	1	19	0	0	0	0	3	132	85	12	26	0	30	68	0	72	0	84	0	1	2	83	411	115	45	59	37	32	65	15	0	62	0	1	40	2	22	2	3	172	3	30	63	4	19	9	179	5	0	45	8	35	30	1	68	0	0	1	1	77	26	0	13	14	44	69	0	3	25	189	515	463	0	27	31	3	0	0	0	1	5	1	84	1	1	0	128	64	90	6	0	6	1	0	1	0	1	36	6	26	14	5	1	59	0	53	79	0	29	38	33	1	0	0	1	3	12	32	4	0	23	3	8	0	52	1	2	17	8	0	0	0	33	2	0	0	43	1	0	1	0	0	1	0	150	1	0	0	0	1	37	1	3	4	0	0	0	0	0	1	39	0	0	0	0	0	0	0	0	0	0	0	0	1	2	0	1	4	0	6	2	0	2	1	6	39	7	11	6	2	0	0	1	0	1	0	0	0	0	0	0	1	2	0	1	0	0	0	1	0	2	1	0	0	9	0	0	0	1	1	0	0	0	0	0	0	0	3	0	0	0	44	0	0	0	0	0	0	64	3	14	43	0	67	0	61	0	0	0	0	0	0	0	0	0	0	0	2	0	10	3	10	0	0	0	0	1	0	0	0	0	5	8	0	2	6	0	1	0	0	103	51	0	0	4	21	0	1	14	4	44	35	14	0	0	0	0	0	21	0	30	0	0	0	4	14	1	0	9	14	1	19	48	0	0	175	0	0	3	51	150	21	0	2	0	0	4	19	6	5	0	0	2	0	0	1	5	2	1	0	0	0	0	0	12	2	12	19	0	0	0	0	0	0	2	8	2	0	56	10	0	2	4	0	0	0	0	0	65	8	0	0	3	2	0	0	3	0	3	2	1	0	0	1	2	0	0	1	3	0	0	0	0	2	1	21	0	15	0	6	0	1	0	0	0	0	1	2	6	0	3	0	16	0	2	0	0	4	2	0	6	79	0	0	385	44	20	0	0	5	0	1	1	0	0	0	0	1	0	2	0	2	0	0	1	2	0	1	1	0	0	0	33	13	0	2	0	0	0	4	9	5	11	6	4	0	0	0	0	0	2	0	0	3	2	0	0	2	0	0	1	0	38	1	0	0	34	4	3	0	0	24	0	14	1	1	25	0	0	12	0	0	0	0	0	0	0	0	1	55	3	0	21	1	11	0	3	0	0	42	0	0	0	0	0	903	0	0	0	0	0	0	0	0	4	3	0	1	0	0	0	0	5	1	0	0	0	2	15	7	0	0	0	0	28	0	1	2	0	0	28	22	0	1	0	0	161	2	27069	0	0	1	0	0	23	0	0	0	0	0	0	0	0	2	0	42	0	2	0	0	2	1	62	0	1	1	5	2	0	1	0	0	0	0	0	0	17	45	5	10	2	0	0	0	0	0	2	1	6	0	0	1	0	3	11	10	21	78	0	0	30	0	10	1	0	2	3	0	70	12	14	16	0	0	0	8	6	5	0	2	146	3	0	640	0	0	0	0	2	0	2	6	4	30	2	1	159	21	0	1	162	97	1	1	90	0	1	0	0	0	0	0	1	4	0	0	0	31	52	7	71	230	7	38	33	1	125	8	69	88	197	57	13	51	8	47	68	6	44	18	0	1	71	0	0	2	35	89	39	133	59	5	11	1	1	92	25	1	10	0	0	0	0	0	0	0	0	0	0	0	0	1	8	2	4	1	6	1	0	0	96	0	1	0	0	10	10	25	11	1	1	1	1	0	11	2	6	0	19	0	0	0	0	2	24	13	0	4	0	0	0	11	29	0	1	0	5	1	0	0	0	0	0	0	0	0	1	4	0	8	0	7	6	23	0	0	0	2	0	0	1	1	2	23	0	12	1	0	2	27	9	0	4	33	0	97	5	0	3	12	1	3	7	1	0	0	0	0	0	0	0	5	0	0	1	1	0	2	1	0	15	3	6	1	1	0	0	1	3	0	0	0	0	2	0	2	0	0	0	0	1	0	1	0	1	0	3	0	0	1	3	20	0	0	7	1	0	0	0	0	1	0	0	0	12	19	21	0	140	0	0	8	48	56	70	9	16	0	1	0	4	43	0	0	4	0	22	2	12	8	0	0	0	0	0	0	0	0	218	6	103	3	8	2	6	0	1	0	0	597	8599	0	0	2	0	0	3	0	14	1	35	1	1	16	0	33	17	1	8	1	6	0	56	36	7	20	0	272	0	0	10	1	122	1	2	0	0	0	1	0	0	29	0	0	65	28	20	0	0	1	44	0	0	0	4	2	0	0	0	0	0	1	0	0	2	5	1	0	4	0	0	11	5	1	2	1	2	3	7	0	0	0	0	0	0	7	193	569	68	38	40	41	76	938	0	0	12	8	22	18	0	0	1	1	14	0	4	0	3	0	1	0	18	1	0	0	1	0	0	1	0	2	0	21	2	1	0	2	25	7	0	0	0	0	0	0	0	1	0	3	0	82	0	30	0	0	0	0	1	1	1	5	1	0	0	1	1	3	0	0	0	3	0	13	119	0	0	0	0	4	0	2	0	1	0	16	0	6	0	0	0	0	0	0	0	0	0	0	0	1	0	0	1	0	0	0	0	0	18	0	12	12	21	128	19	27	0	0	0	0	0	0	0	0	0	0	0	0	0	0	0	0	2	109	0	0	0	0	0	1	1	0	0	0	0	0	0	2	0	0	60	0	0	2	18	0	8	0	0	40	0	1	1	20	4	0	12	46	52	0	83	3	5	12	73	6	11	82	0	0	43	0	0	0	0	40	41	1	1	0	0	0	0	459	0	0	0	0	385	1	0	1	0	8	17	2	13	2	0	0	0	0	0	0	0	0	0	0	0	0	2	0	0	3	1	129	1	0	0	0	1	0	0	0	1	11	0	0	0	1	0	0	142	9	1	0	0	0	6	0	0	0	47	1	0	26	0	11	0	1	0	0	2	9	1	4	8	0	0	4	0	0	541	6	1	2	0	7	11	1	0	4	165	28	0	1148	0	9	11	7	0	24	0	89	31	110	0	0	3	0	3	0	3	0	0	0	2	0	0	4	0	4	0	2	486	4	0	0	0	1	135	0	7	0	0	0	34	11	2	2	0	0	0	0	0	21	0	0	0	5	8	0	2	0	0	32	4	3	0	0	1	1	1	0	0	0	27	1	1	0	1	4	0	0	0	0	0	0	0	0	8	24	49	33	12	0	3	36	12	20	37	131	0	0	0	0	0	0	1	0	0	425	0	0	2	63	56	21	3	0	53	0	1	7	22	1	1	10	1	0	0	1	0	2	0	1	1	844	52	6	0	0	0	1	0	1	1	0	0	2	1	0	3	0	0	0	4	0	0	0	0	1	0	0	0	0	0	0	0	0	0	0	0	0	0	0	0	0	0	1	0	0	0	0	0	0	0	0	1	0	1	0	0	2	0	0	0	14	0	4	0	0	4	33	1	1	1	1	3	3	0	1	0	0	6	2	9	40	5	0	2	1	1	1	0	13	6	0	0	0	0	8	0	5	0	0	12	0	1	27	0	4	13	0	1	24	4	3	72	4	0	2	0	0	1	0	0	0	55	2	20	3	11	1	48	2	2	62	0	5	13	4	0	1	0	11	58	125	61	0	23	13	17	0	11	0	9	0	3	6	0	0	3	0	0	0	0	0	0	35	0	3	8	0	1	0	6	0	7	14	1	17	0	0	8	5	18	1	5	31	0	3	72	2	94	1	1	0	0	0	24	0	1	5	146	1	10	7	1	0	18	0	0	0	0	0	0	0	0	0	0	0	2	0	2	16	18	0	5	9	20	793	3	0	12	1	0	0	0	0	7	2	6	0	0	3	9	0	1	1	4	1	4	0	0	0	0	0	21	13	18	0	10	47	0	0	0	0	2	0	10	0	39	0	3	17	0	0	0	20	1	26	0	0	0	0	1	0	0	2	0	0	4	1	0	0	0	0	0	0	0	0	0	1	0	0	0	0	2	1	0	0	0	0	0	0	0	0	1	0	26	3	41	115	0	15	82	13	12	13	27	20	0	6	0	3	0	0	0	0	0	0	0	0	0	0	0	11	0	0	0	1	43	1	1	0	4	2	0	21	0	0	0	1	11	2	0	0	0	2	0	1	0	0	22	2	0	0	0	0	1	0	0	0	3	0	1	3	0	4	0	1	1	6	2	32	1	0	1	0	0	0	0	7	8	0	46	0	0	1	13	1	17	136	0	0	0	0	0	0	0	0	0	1	0	0	0	0	0	0	0	0	6	9	0	0	0	0	0	2	0	1	0	0	4	0	0	2	1	0	1016	0	0	0	0	0	1	0	0	0	1	0	0	0	60	0	0	0	0	1	0	0	2	1	0	1	0	0	0	2	0	0	0	0	0	57	0	0	3	0	0	0	15	1	0	7	0	0	0	1	0	3	0	0	0	1	4	0	1	2	3	5	0	0	3	0	0	0	0	0	0	0	0	0	0	0	3	0	0	0	0	1	0	0	0	0	0	0	0	0	2	0	0	0	0	0	0	0	0	13	0	0	2	1	0	0	0	1	0	0	0	0	0	0	0	10	0	0	2	2	0	0	0	0	0	0	0	1	0	1	0	0	0	0	0	0	0	22	0	0	0	0	0	0	0	0	0	0	0	0	0	0	0	0	0	0	0	0	2	0	1	0	1	0	13	0	0	0	0	0	2	0	1	0	0	0	0	0	4	0	8	0	0	0	0	2	0	1	0	0	3	22	0	1	0	3	2	0	27	0	0	0	0	0	0	1	0	1	1	1	0	1	1	0	0	1	0	0	1	0	2	0	0	4	2	0	0	1	0	0	0	2	10	1	0	1	0	0	3	0	1	254	2	0	0	0	1	0	0	1	0	0	0	4	0	1	0	0	1	0	8	0	0	0	2	3	15	1	1	0	105	0	1	0	0	2	0	1	3	0	0	17	0	0	0	0	0	0	4	0	0	3	1	0	0	0	1	0	1	1	0	0	0	0	0	27	3	3	7	6	4	5	1	7	29	5	0	1	0	2	68	0	3	0	0	0	1	0	0	0	0	12	0	3	0	0	0	6	0	0	0	272	14	2	0	1	1	0	0	178	0	39	0	31	15	0	2	0	24	1	1	1	0	0	0	0	0	0	0	0	6	0	7	0	0	6	1	0	0	0	0	0	1	0	1	0	3	0	2	0	0	0	0	1	0	0	0	0	1	0	0	0	0	16	0	6	0	0	0	0	0	27	0	1	0	0	0	4	0	0	0	0	2	0	0	3	2	13	6	2	1	0	0	1	0	0	0	0	1	0	1	1	1	0	0	1	2	0	248	0	0	1	0	0	1	0	0	0	0	217	0	27	0	0	0	0	0	0	0	0	0	0	0	0	0	0	0	1	0	0	0	2	35	22	0	169	36	1	1	0	1	1	18	8	0	2033	1	0	2	18	0	0	1	0	3	20	5	0	0	0	1	0	1	0	0	0	28	0	1	21	0	14	8	21	0	0	0	2	0	2	3	1	1	1	0	0	8	0	0	0	2	0	0	0	7	27	0	0	15	1	0	0	1	0	0	9	2	34	36	31	77	0	31	44	8	3	44	3	4	47	1	2	15	1	1	1	0	0	0	1	24	7	0	0	0	0	96	1	1	0	0	32	0	0	0	0	0	15	0	0	15	1	2	13	0	38	0	0	0	0	1	1	6	2	4	0	3	0	3	1	4	0	1	7	0	8	0	0	0	0	4	0	8	0	4	0	6	28	15	34	13	1	1	0	2	29	0	30	6	0	2	0	0	0	0	0	0	0	0	0	0	2	5	1	0	6	53	2	2	5	0	2	7	23	16	0	1	0	7	3	0	25	76	0	2	0	1	18	4	11	23	0	9	2	0	1	3	1	0	4	1	0	2	2	85	7	25	1	5	0	0	0	2	13	18	1	0	0	0	2	5	0	0	0	4	6	0	3	0	1	2	8	21	0	8	11	4	25	2	0	29	66	10	1	0	1	3	0	0	3	2	0	0	68	0	3	0	0	3	2	9	67	5	8	0	0	0	1	0	0	0	1	0	0	0	1	0	0	0	4	3	5	59	0	16	0	2	0	1	0	19	0	2	0	10	0	3	0	9	2	8	32	4	21	11	0	1	0	18	422	0	0	1	1	0	8	0	0	1	0	0	0	1	3	25	3	1	7	1	21	0	0	2	0	0	0	2	0	4	0	0	1	44	0	0	340	0	8	0	0	23	2	0	0	1	1	0	30	6	0	0	2	0	0	0	0	0	12	2	7	0	0	31	4	6	0	0	1	0	0	5	0	0	0	0	24	4	2	8	0	77	2	0	103	103	57	59	27	14	14	146	117	46	85	108	20	75	18	11	27	0	0	0	40	0	1	0	1	2	2	1	0	28	0	0	4	0	1	0	1	0	2	0	0	0	2	0	1	3	9	1	0	0	0	0	0	0	0	3	0	0	0	0	0	0	0	0	0	0	0	1	0	0	0	0	0	1	5	13	0	0	0	0	0	0	0	0	0	0	0	0	0	0	0	0	0	0	0	0	0	0	5	0	38	15	0	128	12	0	0	10	0	0	0	65	23	49	0	2	2	75	0	0	0	4	1	4	0	0	0	0	0	0	0	26	5	3	9	46	63	0	3	0	10	3	10	2	5	0	0	1	0	1	2	0	1	10	17	0	0	1	0	2	11	2	19	0	8	0	17	15	15	0	17	4	2	0	0	16	0	0	0	127	41	0	2	0	0	0	0	0	3	0	3	0	0	62	14	1	192	0	20	0	0	0	0	0	3	2	0	200	8	0	0	0	1	117	0	0	0	0	12	1	2	0	0	4	1	0	0	8	0	3	9	21	1	16	13	0	2	0	29	0	6	0	1	0	0	6	5	2	7	0	0	1	0	0	38	1	0	2	33	8	6	20	7	11	0	24	35	1	7	0	0	4	1	2	0	0	16	0	1	2	4	15	0	8	0	0	5	0	0	0	2	0	3	1	0	1	0	3	0	0	0	1	0	0	0	0	2	0	0	0	0	0	0	0	2	4	0	3	0	0	0	0	0	7	2	1	11	23	0	4	0	1	14	72	49	20	37	1	6	190	358	0	7	135	3	32	0	20	4	19	0	0	30	0	30	18	3	3	1	0	0	0	0	45	1	0	0	19	6	136	0	0	0	0	0	0	0	2	0	0	1	3	2	0	0	0	0	0	3	1	116	0	16	21	5	0	20	2	6	0	0	0	0	0	4	0	0	0	45	0	76	0	1	101	1	1	30	8	505	6	6	0	0	0	2	0	18	21	9	11	7	15	0	13	38	2	1	0	0	1	2	6	4	461	52	4	0	4	0	0	0	0	26	0	1	0	2	0	3	0	82	9	0	0	0	172	8	22	0	0	3	90	35	97	0	3	4	0	0	3	0	10	1	10	1	1	0	0	1	4	3	0	0	0	3	0	1	0	1	0	0	0	0	0	0	77	0	0	0	0	178	2	7	0	0	0	4	4	3	0	0	0	21	11	0	6	5	1	9	0	0	0	8	7	1	1	6	1	0	2	11	2	21	29	10	6	50	1	0	56	2	11	3	0	0	0	0	2	0	0	0	7	0	4	0	29	0	0	0	0	0	0	0	11	1	1	2	19	24	11	0	1	17	1	16	0	1	7	0	9	0	0	0	2	9	8	59	53	13	62	1	28	1	0	0	5	0	0	0	0	0	1	0	3	0	3	0	0	0	0	2	0	0	0	7	0	1	0	0	2	0	1	1	0	157	0	176	2	0	81	0	0	3	0	0	0	0	0	1	38	0	0	0	1	0	2	2	0	3	0	34	0	6	0	0	0	43	0	21	17	0	0	0	2	6	0	0	0	15	7	101	25	28	92	10	39	9	22	9	41	29	21	0	13	15	3	0	0	3	0	0	0	1	1	0	2	2	0	0	0	0	3	0	1	0	0	0	0	1	0	0	0	0	2	0	0	0	0	0	0	0	0	0	0	0	0	0	0	3	0	1	1	0	32	2	0	50	0	59	66	4	19	0	0	0	17	0	0	5	0	1	16	0	0	116	33	0	0	0	7	0	33	0	12	18	39	1	0	0	0	7	0	0	0	1	1	0	0	0	0	12	12	8	0	49	0	13	10	12	1	0	0	0	0	0	64	1	2	0	2	49	9	0	116	2	0	0	9	0	0	0	22	0	0	1	1	0	0	0	0	0	2	0	0	0	60	7	1	0	0	0	63	2	5	0	0	1	0	0	0	0	0	3	1	3	8	33	0	3	0	0	0	0	0	0	1	0	0	8	1	2
LakWasM121_LOW14_2_rpkm	0	0	0	0	0	5	7	0	0	0	0	1	5	4	0	0	0	0	3	0	0	0	0	6	0	0	0	0	0	0	0	0	0	1	2	1	1	0	0	0	0	0	0	0	5	6	8	12	0	1	0	0	0	0	0	2	0	2	19	28	133	0	0	0	0	1	0	0	0	7	0	0	0	0	0	0	2	0	0	0	0	6	1	0	0	0	0	0	0	0	0	0	2	0	4	0	0	0	0	2	0	0	0	0	0	1	0	0	0	0	1	0	21	0	5	0	0	0	0	0	0	0	0	0	0	0	5	0	0	0	0	8	18	0	0	0	0	0	6	0	0	0	0	1	2	0	0	0	1	1	0	5	3	0	6	0	1	2	2	0	0	0	0	0	6	0	0	2	0	12	1	0	0	0	0	0	0	0	0	0	0	0	0	0	0	31	0	0	0	3	0	1	0	0	0	0	1	8	0	12	6	0	7	0	0	0	3	0	9	2	5	0	38	1	3	0	7	0	0	9	0	0	5	3	0	13	7	0	15	0	0	4	0	0	0	0	0	6	1	1	0	0	5	2	10	10	0	0	7	5	14	0	14	0	104	58	0	0	0	0	0	0	0	2	5	0	179	0	0	14	64	0	3	0	0	1	0	0	15	15	0	0	20	0	3	0	0	0	0	0	0	0	0	0	0	0	0	12	0	0	0	7	10	0	2	0	6	0	13	0	5	0	2	0	0	0	0	0	47	0	0	0	0	0	2	1	1	0	0	0	0	1	0	0	0	0	0	4	0	0	0	0	2	8	0	0	0	0	12	0	2	0	0	0	0	0	0	0	0	11	1	0	0	0	0	2	1	1	14	0	1	9	0	25	35	2	0	0	0	3	1	0	0	1	2	0	23	1	0	0	0	0	10	1	0	6	50	0	0	1	2	4	0	1	1	0	0	0	0	0	0	0	14	0	0	7	2	1	1	5	0	0	2	0	0	0	0	0	0	0	0	0	0	1	0	9	0	1	2	0	11	33	0	0	8	2	0	0	0	0	0	35	14	176	0	13	2	0	0	6	0	0	0	0	0	8	0	0	0	7	2	17	1	1	0	0	6	1	318	0	4	2	17	1343	1	1	0	58	10	1	0	0	10	19	1	0	5	0	0	0	0	0	0	0	0	2	0	0	0	0	0	0	0	0	1	0	0	0	0	5	0	0	0	0	0	0	0	0	0	0	0	0	0	0	1	0	0	3	0	0	0	7	0	0	5	0	0	0	0	14	0	0	1	2	0	11	0	1	1	0	0	1	1	0	2	0	12	0	4	0	0	0	0	0	2	16	20	26	4	6	17	26	14	9	4	0	5	4	29	0	0	0	755	0	47	1	1	0	5	0	1	0	0	0	0	2	0	22	0	45	1	35	125	65	0	0	4	0	54	0	24	9	1	3	0	3	1	0	0	0	0	5	0	0	2	0	0	0	3	2	6	17	0	0	0	1	4	2	0	4	34	0	1	22	4	0	1	0	1	0	3	45	0	134	0	0	0	0	2	5	29	0	10	0	0	0	5	1	0	0	0	0	2	0	0	0	0	0	0	6	0	0	2	0	0	0	0	0	0	2	0	13	0	2	1	0	3	0	1	0	0	0	0	0	0	4	0	0	5	2	0	0	0	5	0	0	0	0	2	0	0	0	0	0	0	0	0	0	0	11	0	2	1	0	4	5	3	0	0	28	0	0	3	0	0	4	0	0	38	10	0	5	0	4	0	2	0	0	0	0	0	0	0	0	9	3	0	0	0	0	0	0	0	0	0	0	0	0	0	2	0	3	0	0	0	0	1	5	0	11	0	0	0	0	65	0	4	0	0	0	0	0	0	0	0	0	5	0	0	0	0	0	0	4	1	0	0	1	25	0	0	0	0	0	0	0	0	35	15	0	0	0	0	0	0	0	0	4	6	13	0	0	2	0	0	0	3	0	0	5	7	0	0	1	0	0	0	0	4	1	0	0	0	0	0	0	0	15	0	16	0	0	0	0	0	0	5	0	0	0	0	0	0	0	0	0	0	0	0	0	0	47	2	15	0	0	0	0	0	0	0	0	0	0	4	8	27	4	2	0	0	2	0	0	0	0	0	0	0	0	47	0	0	0	0	0	0	0	0	11	0	0	0	0	3	0	1	1	0	0	0	0	0	0	0	0	0	0	0	0	0	0	0	0	0	0	0	0	0	0	0	4	1	141	0	12	0	0	0	0	1	0	4	0	48	0	0	0	0	0	0	0	0	0	0	0	0	4	2	0	0	1	0	0	0	0	0	0	0	2	0	0	0	0	0	0	0	31	0	0	0	14	2	0	0	1	0	0	8	0	2	0	0	0	0	0	2	0	123	0	0	0	0	0	0	0	0	3	0	0	0	0	0	0	3	0	0	0	0	0	6	2	0	1689	0	0	0	0	111	0	19	0	0	0	1	0	5	0	2	0	0	0	0	0	0	0	0	0	0	2	0	0	2	0	0	0	0	0	0	0	0	0	0	0	0	0	44	0	4	137	0	122	0	0	1	0	0	19	0	0	2	0	0	0	0	0	1	2	10	0	4	0	0	0	0	0	0	0	0	0	0	0	0	0	0	0	0	0	1	0	0	5	0	0	9	0	0	0	0	0	0	0	0	0	0	0	0	0	0	0	5	4	0	0	54	0	0	0	1	0	0	0	0	0	0	0	0	1	0	0	0	0	0	15	119	65	0	0	0	3	0	0	0	0	0	0	1	0	0	0	0	0	2	0	0	0	0	0	0	0	0	0	0	0	0	0	0	0	17	0	0	0	0	0	1	0	0	4	0	0	6	0	0	4	0	0	36	0	0	0	2	0	0	11	1	0	0	0	1	0	7	0	0	9	0	6	0	0	0	0	0	0	4	16	1	10	0	0	0	1	0	0	2	2	0	40	8	3	7	0	0	0	0	0	0	0	0	0	0	1	0	0	0	0	0	0	0	0	0	3	0	0	0	0	0	0	0	0	0	0	0	0	27	0	0	0	0	0	1	0	0	0	0	1	7	0	3	29	5	10	0	0	1	10	0	0	2	1	0	0	0	1	0	0	0	0	10	2	0	0	0	0	5	0	2	0	0	1	2	8	0	0	6	0	2	2	1	1	0	0	0	0	3	0	7	0	1	0	4	20	0	1	11	0	0	0	0	4	0	0	0	0	3	1	0	0	0	1	0	11	1	3	9	4	1	0	13	0	0	0	0	0	0	0	5	0	0	4	6	0	4	3	6	1	7	0	4	0	1	2	0	1	0	5	2	2	0	0	1	0	0	0	0	9	19	4	45	0	0	0	0	0	0	0	0	21	15	1	0	8	0	0	0	0	53	12	14	12	1	0	0	38	0	0	2	0	0	0	0	0	16	2	1	6	16	8	0	1	14	6	0	0	0	0	0	0	30	0	0	0	0	2	0	3	0	0	0	0	0	6	0	0	0	0	0	0	0	0	0	0	0	0	0	1	4	13	0	0	0	0	0	0	0	0	0	0	0	0	1	13	0	0	3	0	0	0	0	0	0	0	0	0	0	1	0	0	0	0	0	0	0	0	0	0	0	0	0	0	0	0	0	0	0	0	1	0	0	214	0	0	27	0	0	0	0	18	0	7	28	0	0	1	0	0	1	0	1	0	0	0	4	0	17	0	0	0	0	0	3	0	0	2	1	0	0	0	7	0	0	5	0	0	0	0	0	0	0	13	0	31	6	16	0	0	0	9	0	0	0	2	0	0	0	0	0	0	0	0	3	0	3	1	6	6	3	0	0	2	0	0	0	1	0	0	1	0	6	0	5	0	0	0	0	0	0	0	3	0	2	0	204	10	3	6	0	0	0	0	0	1	0	21	0	0	0	3	15	0	0	0	9	1	2	0	0	12	6	0	1	8	0	26	0	0	2	2	5	0	1	0	0	0	0	0	0	0	0	49	0	0	7	1	0	0	0	9	0	1	1	0	3	0	0	0	0	0	33	191	2	20	0	9	1	0	5	2	0	0	2	0	0	0	160	0	0	0	0	2	0	0	6	0	2	0	0	0	0	0	0	0	0	9	0	0	0	0	0	3	29	0	0	0	41	0	568	0	0	2	230	0	7	8054	6	0	2	0	0	0	0	0	1	0	0	0	0	1	0	0	0	3	0	0	0	0	0	7	0	76	0	0	0	0	0	1	0	7	0	0	0	0	9	0	2	12	2	21	29	0	0	0	0	0	0	0	10	0	0	4	3	0	0	0	7	47	7	8	0	7	13	0	7	4	26	0	4	5	7	1	37	5	0	2	0	0	0	0	0	0	0	0	0	0	0	0	0	0	2	0	0	20	0	5	61	0	0	0	0	0	0	0	1	0	0	0	1	0	0	0	0	0	1	2	18	0	0	0	0	0	0	1	0	0	4	0	3	0	0	0	0	0	0	0	0	0	0	0	0	0	0	0	0	0	3	130	1	0	0	0	0	0	0	0	21	0	16	3	12	5	0	0	19	0	18	32	5	2	1	0	0	0	0	0	0	0	0	1	0	0	12	0	0	0	0	0	0	0	0	0	0	0	0	0	6	26	2	5	4	8	0	9	15	0	0	0	98	1	15	3	0	0	0	0	0	0	0	0	0	0	1	0	0	0	0	2	10	0	2	0	0	0	0	4	0	0	0	0	0	0	0	0	0	0	0	451	8	0	0	0	0	0	0	0	1	3	0	6	0	0	0	0	1	1	0	0	0	0	2	0	0	0	0	0	1	0	3	93	0	0	1	0	0	0	1	0	0	0	0	1	0	0	0	0	0	7	0	0	6	2	0	4	72	15	3	0	2	0	0	0	20	0	10	0	0	0	0	0	0	3	0	7	0	0	1	0	0	0	0	0	0	0	3	1	0	0	0	0	0	1	0	0	1	0	5	7	0	0	0	0	0	20	4	0	0	0	0	0	55	0	0	0	1	0	0	0	0	20	5	1	15	0	0	0	0	188	0	0	53	71	23	1	1	0	7	4	0	0	1	0	0	2	13	0	0	1	0	3	0	0	0	0	17	9	0	0	0	0	1	13	0	3	0	0	17	0	51	0	0	0	0	3	0	0	0	0	0	2	2	0	0	4	0	0	0	0	7	2	0	1	2	0	0	0	1	3	0	0	7	0	1	0	0	0	0	0	0	0	0	0	20	0	0	0	0	0	0	0	0	0	0	0	8	0	0	0	0	1	0	0	0	0	1	0	0	0	0	1	0	0	0	0	0	0	0	0	9	0	0	5	0	0	0	0	0	2	6	0	0	1	0	0	0	0	0	0	0	0	0	0	0	0	0	0	43	12	222	44	16	19	33	34	0	18	13	116	32	16	4	8	6	30	16	6	4	0	54	24	12	7	32	18	16	8	26	0	10	2	0	0	0	0	0	0	0	0	0	0	16	22	0	0	0	0	0	0	0	0	0	0	0	0	0	0	0	2	0	0	0	0	3	0	2	0	36	0	1	0	10	0	24	0	0	0	11	0	0	0	0	0	0	0	0	0	0	1	0	0	0	0	0	11	0	0	1	0	0	0	0	0	0	1	0	0	2	3	0	0	0	0	52	0	0	10	0	0	0	0	0	1	0	0	0	0	0	1	0	4	0	0	0	0	0	1	0	1	0	0	0	0	0	0	0	1	0	22	4	0	1	3	0	0	0	0	0	0	0	0	0	0	0	0	0	22	0	0	0	0	0	0	0	0	4	0	0	0	0	0	0	0	0	0	1	13	0	1	0	12	0	0	0	0	0	0	2	0	0	11	0	0	0	0	0	0	0	0	0	0	1	0	0	0	0	0	0	0	0	0	0	0	2	0	0	0	0	0	0	0	0	0	0	0	0	12	0	8	0	0	0	0	0	0	1	0	0	0	0	0	0	0	0	0	0	0	1	4	0	0	0	0	4	1	0	14	1	1	0	1	0	10	1	0	5	5	0	0	0	0	0	3	0	7	0	1	0	0	0	0	1	0	3	6	0	0	0	0	0	0	0	0	0	9	0	0	0	0	0	0	0	0	0	0	11	0	0	0	0	11	9	11	7	35	2	0	0	0	0	0	0	0	0	0	1	0	0	0	0	0	0	0	0	5	1	2	0	0	0	1	0	0	0	0	0	2	0	0	0	0	230	0	0	0	0	3	0	0	0	0	0	0	4	0	16	11	0	0	0	0	0	0	6	0	0	0	1	5	0	1	0	0	0	0	12	2	0	0	0	0	0	0	0	0	0	0	0	1	0	0	4	0	0	0	0	1	0	0	0	0	0	0	1	0	0	0	0	0	5	0	0	0	0	4	0	0	0	0	0	0	0	0	0	0	0	0	0	0	0	0	59	0	0	16	0	25	0	7	3	0	0	0	0	0	0	6	3	0	0	0	0	0	0	0	0	7	0	0	4	0	0	0	6	0	10	5	12	0	0	11	18	4	0	9	0	10	0	88	0	4	0	3	0	1	3	0	0	9	0	1	0	5	0	0	0	3	0	0	0	4	2	0	7	2	0	5	0	0	5	1	0	0	5	0	0	0	3	0	0	2	0	0	0	0	12	6	0	0	0	1	0	3	37	2	0	0	0	14	0	0	0	0	0	99	0	0	0	0	0	0	0	0	0	0	0	15	0	0	0	0	3	0	0	0	0	0	0	0	0	0	0	19	0	0	35	15	5	0	21	0	5	0	0	0	18	0	1	0	0	0	1	0	52	0	0	4	0	0	0	2	0	1	0	0	3	4	0	77	0	4	0	0	0	29	36	0	0	0	2	0	0	0	0	0	5	0	0	0	0	4	11	0	1	0	53	12	0	0	0	0	0	0	32	265	513	1	0	0	0	1	0	0	3	5	0	0	0	1	0	0	0	42	14	0	0	0	0	0	0	0	47	0	0	1	0	0	19	0	0	1	0	0	0	0	0	0	0	0	0	0	0	0	176	60	0	1	0	0	0	0	5	23	0	0	0	0	0	0	1	0	0	9	0	0	0	0	0	20	0	0	0	0	0	3	0	0	0	0	0	0	0	1	0	0	0	0	0	0	0	2241	0	0	0	0	1	0	0	0	0	0	0	0	0	0	0	6	0	0	0	0	0	0	0	0	0	0	0	0	0	0	0	0	0	0	0	0	0	0	0	1	0	12	12	0	0	0	0	0	0	0	0	0	1	0	0	0	0	0	0	10	0	0	0	0	0	0	444	0	0	0	0	0	3	1	1	0	0	0	0	14	0	49	4	0	10	0	0	2	58	0	2	0	0	2	0	1	0	0	0	0	0	0	12	0	0	0	0	0	0	0	0	0	0	0	0	0	0	0	0	0	0	0	0	0	0	0	2	0	14	0	0	0	0	0	0	0	0	0	0	0	0	1	0	0	0	10	1	0	0	0	0	0	0	4	0	0	0	0	1	0	0	2	0	14	0	0	0	0	0	0	0	0	0	0	0	0	0	28	0	5	37	13	3	7	0	0	0	0	2	0	0	0	5	0	0	1	0	8	13	0	0	0	215	16	0	0	0	0	0	0	0	333	0	5	0	0	0	0	0	0	0	5	0	0	0	0	0	2	0	0	0	0	0	0	6	8	33	0	0	4	8	5	0	0	0	0	0	0	0	0	5	60	4	11	0	0	0	0	0	0	0	39	0	0	0	0	1	0	0	0	0	0	1	0	1	1	0	4	1	0	0	0	11	0	8	0	1	0	7	0	0	0	0	0	21	0	0	0	0	0	0	0	0	0	0	0	1	0	0	0	0	0	0	39	0	0	0	0	0	0	0	14	0	0	0	0	0	1	0	0	0	0	0	0	0	0	3	0	0	0	0	0	0	0	0	0	0	0	0	0	0	0	0	0	0	0	0	0	0	0	2	0	8	0	0	0	0	0	0	0	0	0	0	0	0	0	0	0	0	0	0	0	0	0	0	3	0	0	0	0	0	0	1	0	0	3	0	0	0	0	0	0	0	0	0	0	0	0	0	0	3	0	0	0	0	0	0	0	0	0	0	0	0	0	0	0	0	0	0	0	0	0	0	0	0	0	2	3	6	0	0	1	0	0	45	0	0	0	3	0	0	0	0	0	0	13	0	2	0	0	0	0	0	0	0	0	0	50	0	0	0	0	4	0	0	0	0	0	0	0	0	0	0	0	1	0	0	80	0	0	0	0	0	0	0	0	1	1	0	0	0	0	0	0	0	0	0	0	0	0	0	0	0	0	0	0	2	0	0	3	0	14	0	1	0	0	0	0	0	6	0	0	0	0	0	0	0	2	0	0	0	0	0	0	0	0	0	0	0	0	0	0	0	0	0	0	0	0	0	0	0	0	0	0	0	0	0	0	0	0	0	0	0	0	0	0	0	0	0	0	0	0	0	0	0	0	0	0	0	0	0	0	0	0	0	0	0	0	0	0	0	0	0	0	0	0	0	0	0	0	0	0	1	4	0	0	3	0	0	2	0	0	0	0	0	0	0	0	0	0	2	0	0	17	0	1	0	0	0	1	0	0	1	0	1	12	0	0	0	0	0	0	0	0	0	0	0	85	2	0	0	10	0	213	0	0	0	0	0	0	1	0	0	0	0	1	0	0	1	0	0	0	0	0	0	0	3	0	0	0	0	0	0	0	0	3	0	0	0	4	1	0	0	0	0	0	0	0	0	0	0	0	0	68	0	4	0	0	0	0	0	0	0	0	0	0	0	0	0	0	0	0	0	0	0	0	0	0	0	0	0	0	0	0	0	0	0	0	6	0	0	2	0	0	0	0	8	0	0	0	0	0	0	0	0	6	2	0	0	2	1	0	0	0	0	0	0	0	1	0	2	2	0	0	0	0	0	0	0	2	0	0	0	0	0	0	0	0	0	0	0	7	0	0	0	0	0	0	0	0	0	0	0	0	0	0	0	0	0	13	0	0	0	0	0	0	0	0	0	0	0	0	0	0	0	0	0	0	0	0	0	2	0	0	45	0	0	0	0	0	0	0	0	0	0	0	0	0	0	0	0	0	0	0	0	0	2	0	0	0	0	0	0	0	1	0	0	0	0	0	0	0	0	0	0	0	0	0	0	19	1	0	4	0	0	0	0	0	0	0	0	0	0	0	0	0	0	0	2	0	91	0	0	1	20	0	0	0	0	2	2	0	0	6	0	9	0	0	0	0	0	0	0	0	0	0	53	0	0	0	0	0	0	5	0	0	7	0	0	2	0	0	0	1	0	0	0	0	0	0	0	0	0	0	0	0	0	0	0	0	0	0	0	0	0	0	0	0	0	0	0	0	20	0	0	0	0	0	1	0	0	0	1	9	0	1	0	1	0	0	4	0	0	0	0	0	2	2	0	1	6	0	12	48	0	0	2	0	143	0	4	9	0	0	0	0	22	89	0	16	0	11	1	0	238	0	0	0	560	0	0	0	3	7	0	11	0	0	4	0	19	28	21	0	0	0	1	3	0	4	0	0	4	5	0	0	0	0	0	0	0	2	4	0	0	0	0	1	0	0	45	0	0	0	0	0	0	0	0	0	0	7	0	0	0	37	0	0	0	18	0	0	0	77	1	0	0	0	0	0	0	0	4	0	0	0	43	110	0	0	0	0	0	0	0	2	3	0	0	0	0	0	0	4	0	0	0	0	0	0	0	28	0	0	0	0	0	0	0	0	0	0	0	1	0	0	1	0	5	3	0	0	0	0	1	5	0	1	0	0	0	0	4	0	0	1	0	9	2	1	1	0	0	0	0	0	1	0	3	0	0	0	0	31	0	0	0	5	0	37	0	3	1	2	41	0	33	7	4	0	41	34	26	0	434	17	24	9	21	1	40	1	39	0	1	0	4	0	0	0	0	0	0	1	0	0	0	75	0	5	0	0	0	0	0	0	2	0	0	2	0	1	0	3	5	0	0	0	0	2	1	0	0	0	0	0	0	10	25	0	1	1	0	0	0	45	3	0	0	0	2	0	0	24	0	4	1	9	0	0	0	0	1	0	12	21	2	0	0	14	0	0	0	0	0	0	0	0	0	0	0	0	0	0	0	6	0	0	0	0	1	2	0	0	0	11	0	0	6	12	0	0	0	0	0	5	0	3	6	0	0	0	0	0	0	0	0	12	0	1	4	0	0	0	0	0	0	0	0	0	0	0	0	89	0	0	27	0	0	0	2	0	0	0	10	0	0	0	1	0	0	0	9	0	3	0	0	0	0	0	1	0	0	0	0	0	0	0	0	0	0	0	0	0	0	0	0	0	0	0	0	0	0	9	0	0	0	0	0	0	0	0	0	0	0	0	50	0	0	0	0	11	5	3	0	0	0	0	0	17	45	124	0	0	1	0	19	2	0	0	0	0	0	0	0	0	0	0	0	0	0	76	3	5	0	9	0	0	0	0	0	0	0	5	1	0	0	0	0	0	0	0	0	0	0	0	0	7	1	0	0	0	3	0	0	0	0	0	0	0	2	0	0	1	0	4	0	0	4	0	7	0	2	2	0	3	5	0	25	0	6	0	0	0	0	0	0	10	0	5	0	0	0	0	0	0	0	0	0	0	0	14	15	1	2	0	0	3	24	0	0	0	0	0	19	0	0	2	0	38	0	0	0	0	5	0	30	5	0	0	0	0	0	0	0	0	2	0	0	0	2	0	0	0	0	0	12	0	0	0	0	3	0	0	0	0	0	0	2	0	0	0	0	0	0	1	0	0	0	1	0	0	2	0	0	0	0	0	0	0	0	0	0	0	0	1	4	0	0	0	0	0	7	0	0	9	18	1	3	0	0	0	0	0	0	0	0	0	0	0	20	0	0	0	0	0	0	14	0	5	1	16	5	9	7	5	2	0	0	0	0	0	3	0	0	7	0	0	0	5	0	0	0	0	0	2	0	0	1	0	1	0	0	0	0	0	193	0	0	0	0	0	0	0	0	0	0	0	0	0	0	0	0	0	0	0	1	0	0	0	0	0	0	22	0	0	0	0	0	9	1	0	0	0	0	0	0	0	0	1	0	0	0	0	0	4	0	7	0	0	0	0	0	0	0	0	0	5	0	0	0	0	0	1	0	0	0	5	0	2	0	0	0	84	0	0	0	0	0	0	0	11	3	0	0	0	0	1	3	0	0	0	0	0	0	0	0	11	0	2	0	0	0	0	0	0	0	7	7	0	4	0	3	0	0	0	0	31	0	1	0	0	0	0	0	0	0	9	0	0	0	0	0	0	0	0	0	0	0	0	1	1	33	19	2	0	0	1	95	0	0	0	0	0	1	0	0	0	10	0	5	0	0	6	0	0	0	0	0	0	0	0	0	0	0	0	0	5	0	1	0	0	0	0	0	32	0	0	0	0	0	0	0	0	0	0	27	26	0	0	0	0	0	0	0	0	0	0	0	0	0	1	0	0	0	0	0	18	0	0	0	0	0	0	0	0	1	0	0	0	0	0	0	0	0	0	0	0	2	0	0	0	0	0	0	0	0	0	0	0	1	0	4	0	0	0	0	0	0	0	0	0	0	0	0	0	0	0	0	0	0	0	0	0	0	0	0	0	0	22	0	0	0	0	0	3	0	2	0	0	6	0	0	0	2	32	1	0	0	0	0	0	0	6	0	1	22	0	1	36	0	0	0	0	0	0	0	0	0	0	9	0	0	0	1	0	0	0	0	0	0	12	0	0	0	0	1	0	0	0	0	0	0	0	0	0	1	3	0	7	11	0	0	0	0	0	2	0	0	12	0	0	0	0	0	0	0	0	0	0	0	0	16	0	0	0	3	1	0	0	0	1	0	0	0	0	0	0	0	0	0	0	0	0	0	0	0	24	0	0	0	0	0	0	0	0	0	0	0	0	0	0	0	0	0	1	1	0	0	0	0	1	4	1	0	0	0	0	0	3	0	3	1	0	56	0	0	3	0	3	0	2	1	0	0	0	0	0	0	0	0	4	3	0	0	0	0	0	0	0	65	5	8	2	18	0	0	0	0	0	5	0	0	0	0	0	2	2	22	0	11	4	0	1	0	0	0	13	0	0	11	9	0	0	0	0	0	0	0	19	9	0	5	0	85	0	0	0	0	1	2	1	0	0	1	1	0	4	0	8	0	0	0	0	0	0	0	1	0	0	0	0	0	0	0	2	16	0	2	0	0	2	24	5	27	17	0	4	0	3	0	2	164	0	0	0	0	0	0	2	0	1	1	0	0	0	1	5	1	0	0	0	0	4	25	6	27	1	0	22	10	1	0	6	0	0	0	0	0	0	0	0	0	0	0	1	1	0	0	8	0	1	0	86	3	2	2	0	0	1	0	0	0	0	0	0	0	0	0	0	0	0	0	0	0	0	0	1	0	0	3	0	0	0	3	0	0	0	0	2	0	31	0	0	0	0	0	0	2	0	0	1	0	0	0	0	0	1	0	5	0	13	16	0	98	0	0	0	0	0	3	0	0	0	25	0	0	204	0	0	110	7	0	8	1	12	2	2	0	1	2	0	25	6	4	0	0	0	0	0	0	4	0	0	0	0	0	0	0	0	9	7	0	0	27	0	0	5	4	0	0	0	0	0	0	5	0	0	0	12	5	0	0	0	0	0	2	0	0	0	5	4	8	1	0	19	0	0	0	7	13	99	0	2	0	665	0	0	0	0	0	0	0	0	0	0	3	1	14	4	0	4	0	0	0	0	2	0	0	0	0	0	2	24	5	1	2	1	0	0	0	5	0	2	0	0	0	4	0	0	0	0	0	0	0	2	0	0	0	0	0	3	21	0	0	0	0	2	1	2	1	0	2	5	0	0	0	21	0	0	1	2	0	17	0	0	6	5	5	8	10	13	9	0	0	0	8	0	0	8	0	0	0	0	0	0	4	0	0	1	1	5	1	0	7	144	48	0	7	0	4	0	0	43	1	0	0	0	0	0	0	0	0	0	0	0	0	0	2	9	0	0	0	2	20	0	0	0	0	0	0	124	0	0	0	0	0	0	2	1	0	0	0	5	1	0	0	0	6	0	7	6	0	0	1	0	8	0	0	0	5	9	0	0	0	2	1	0	0	48	0	0	1	0	3	56	12	0	0	0	0	0	0	0	0	0	0	0	3	0	1	0	15	0	11	9	11	0	0	17	20	2	0	0	1	0	0	0	0	12	6	0	0	0	0	0	16	9	25	3	0	3	12	0	0	0	0	0	22	0	0	0	0	0	0	4	5	6	86	10	0	9	14	0	0	0	0	0	0	0	5	0	11	2	0	9	0	13	0	171	6	2	3	5	1	0	3	74	18	0	4	2	0	0	0	0	2	0	1	0	0	0	0	0	0	0	0	0	1	0	0	0	3	19	8	67	112	23	19	0	0	0	0	6	14	0	0	4	0	0	0	0	0	0	0	0	0	0	0	0	0	0	0	0	0	0	20	0	0	0	0	2	0	0	0	6	0	0	15	4	1	5	1	4	7	1	3	5	1	0	4	0	22	26	12	0	0	0	7	1	1	0	8	2	0	0	1	6	2	0	0	0	0	0	0	5	8	0	0	0	0	0	2	0	0	0	0	0	0	0	0	6	0	0	1	0	0	0	0	0	0	0	3	0	971	0	0	0	0	68	2	3	0	0	0	0	0	0	0	0	3	0	8	0	0	0	0	0	0	0	0	1	0	0	6	0	0	0	0	0	0	1	0	0	6	37	0	0	0	0	0	0	2	7	0	0	6	0	0	0	0	0	0	0	0	0	2	0	0	0	0	1	1	0	10	4	1	57	0	0	0	0	9	15	4	0	0	7	0	0	0	0	26	0	0	0	0	0	0	0	0	0	0	0	27	13	0	6	35	0	3	0	0	14	0	43	0	6	2	0	0	0	0	2	0	0	12	0	0	0	0	1	0	0	0	4	0	0	0	1	0	0	0	0	0	285	8	7	1	6	448	0	23	9	16	3	0	36	2	12	1	5	6	1	0	19	138	206	237	11	23	0	0	0	49	0	6	0	1	0	14	9	0	0	552	0	6	0	0	0	0	0	8	0	0	0	2	1	8	6	1	4	7	16	0	0	0	0	7	8	1	3	0	0	0	0	1	0	2	0	0	0	1	10	0	6	1	1	0	3	7	0	0	0	2	0	1	1	1	0	0	0	0	5	23	0	0	0	0	0	0	0	0	0	2	0	1	4	0	10	3	0	0	14	54	166	0	0	5	59	25	2	11	31	0	9	0	6	1	0	30	1	0	2	0	3	84	7	0	3	6	24	11	0	0	7	5	0	0	15	9	1	0	0	0	19	1	0	3	0	10	0	0	1	0	0	9	0	0	12	0	2	0	0	0	0	0	0	6	2	0	0	0	0	0	313	0	0	0	0	0	30	3	16	0	7	5	0	0	0	29	0	0	19	34	0	2	15	3	0	1	0	1	6	2	1	3	1	23	1	19	0	0	0	0	0	0	0	0	24	0	0	0	0	0	7	0	0	0	0	0	1	1	9	0	0	0	0	0	0	0	0	23	5	1	0	0	0	0	0	0	1	0	0	0	0	0	0	0	8	0	0	0	0	0	6	0	0	0	2	2	0	0	0	5	0	0	0	0	0	0	0	0	0	1	0	0	0	0	0	0	0	0	6	0	1	21	0	4	0	0	0	8	0	0	0	0	7	1	0	0	3	0	1	1	1	8	3	0	0	3	0	0	23	0	0	2	3	1	0	0	0	0	1	2	0	0	0	0	22	10	17	2	20	3	4	12	3	1	0	17	4	18	7	2	38	11	11	18	5	2	2	4	0	2	0	0	13	2	0	11	10	9	44	6	61	33	71	76	12	47	5	2	14	10	4	5	8	0	0	1	0	103	376	8	0	0	102	42	0	40	231	154	8	823	0	347	5	2	2	1	0	1	2	2	5	0	9	0	156	717	29	0	0	14	0	0	0	0	0	112	15	57	20	17	0	146	2	3	22	0	2	3	10	20	0	6	0	0	0	2	8	3	1	13	3	2	6	6	5	1	4	0	0	1	0	0	0	0	6	0	0	3	0	0	0	0	19	0	0	0	0	0	8	4	0	0	1	0	2	0	0	0	1	0	0	0	0	0	0	0	0	0	0	6	0	0	0	0	0	0	0	31	0	4	3	0	4	0	0	8	117	0	0	9	0	0	3	2	0	0	0	0	0	0	17	0	0	0	0	0	21	0	1	0	0	0	2	0	0	0	0	1	0	0	0	0	0	0	0	0	0	0	0	14	0	0	0	0	7	0	26	12	2	20	0	23	0	7	0	0	0	0	0	1	0	0	0	0	0	0	0	2	11	4	1	0	0	0	0	0	5	0	0	16	2	6	0	15	0	2	1	0	184	12	0	0	0	1	0	0	4	11	12	33	3	0	0	4	0	0	0	2	18	0	0	0	12	0	2	0	0	2	6	14	7	0	3	21	1	0	0	61	41	3	2	0	0	0	0	2	0	1	0	6	5	0	2	1	1	0	0	1	0	0	0	0	0	0	1	4	1	0	0	0	0	0	1	0	19	0	11	0	0	0	1	0	0	0	0	0	0	0	5	0	0	16	0	3	10	0	0	5	6	0	0	2	11	1	0	1	3	0	0	0	0	0	0	1	0	3	0	0	0	1	0	0	0	0	0	0	1	3	0	0	3	0	0	0	0	0	0	0	14	1	5	0	27	2	12	0	0	15	0	1	4	1	0	0	0	15	0	0	0	0	0	0	0	0	0	0	0	0	0	9	2	1	0	3	3	0	0	0	0	0	6	0	0	0	0	0	0	0	0	0	0	0	0	0	0	23	0	0	0	0	4	14	0	0	0	10	5	0	1	22	0	23	2	6	279	0	0	17	0	0	0	0	0	0	0	0	0	5	27	0	7	2	3	3	0	0	0	2	0	0	0	0	0	0	9	0	0	0	0	0	0	0	0	1	0	1	3	0	0	0	36	1	0	2	0	14	2	3	0	0	0	0	3	6	0	0	0	0	31	11	0	0	0	0	0	0	21995	0	0	0	0	0	0	0	0	0	0	0	1	0	0	0	0	1	0	0	0	0	12	10	1	18	2	4	4	5	0	0	0	0	0	0	4	0	1	8	0	22	12	0	0	0	2	4	5	0	1	0	0	1	0	30	57	9	4	0	16	10	14	0	1	0	0	4	0	0	81	3	15	3	0	0	0	65	1	6	0	2	2	51	3	1	0	0	0	0	5	0	2	0	0	6	10	0	1	0	0	0	6	4	0	0	11	7	0	5	0	1	0	0	0	0	0	0	0	19	13	33	5	5	0	1	0	0	0	12	0	23	5	0	0	4	1	12	0	0	0	3	7	0	0	0	0	0	55	61	21	0	0	0	1	0	0	5	2	5	0	2	4	0	0	0	0	0	0	0	0	0	3	1	6	1	0	1	11	1	0	1	3	0	0	0	0	8	13	10	2	1	7	14	3	1	0	0	111	0	2	0	3	1	0	15	6	15	0	23	0	0	0	16	5	0	0	0	0	0	0	0	0	0	0	0	0	0	1	10	0	0	0	11	5	0	0	0	2	0	0	0	1	2	0	0	0	11	0	0	0	12	66	0	0	0	0	3	26	0	4	15	0	0	1	0	0	0	0	0	0	0	0	0	0	0	0	0	0	0	0	0	0	31	0	0	0	0	0	0	7	0	0	0	0	0	0	0	0	0	0	0	0	0	0	0	0	0	2	0	0	0	0	18	0	4	0	0	0	0	4	0	17	0	0	0	0	1	2	0	26	0	0	0	77	1	1	8	4	0	0	1	16	8	0	0	1	2	4	1	18	0	0	0	0	0	0	0	0	0	0	2	0	0	0	5	2	0	0	0	0	6	7	0	0	0	0	0	0	2	0	7	5	3	0	23	0	58	10	3	828	18	0	0	4	18	13	10	0	115	0	0	55	5	66	0	1	0	0	0	0	0	0	1	0	0	29	4	9	0	0	0	0	6	0	0	0	0	0	0	3	0	0	0	4	0	14	2	2	0	2	0	2	76	0	0	0	0	0	8	7	0	0	0	0	0	0	0	12	12	3	0	8	11	11	0	0	0	31	8	0	56	0	0	0	0	0	0	1	4	0	0	0	0	1	0	2	1	0	0	0	5	0	0	2	0	0	3	0	11	42	0	0	0	6	0	0	3	0	0	0	0	0	56	0	2	0	0	0	1	6	4	0	0	0	0	0	0	0	0	0	0	0	0	0	0	3	0	0	681	0	0	1	0	0	0	0	61	1	60	2	0	0	0	0	0	0	0	0	0	0	0	0	0	0	0	0	0	0	1	61	0	0	0	0	1	0	8	0	0	0	0	0	0	0	0	0	0	0	0	1	0	0	0	0	1	0	0	0	0	0	0	0	0	0	0	0	0	17	0	0	0	73	0	0	0	0	1	51	2	0	1	11	2	1	1	0	0	0	5	0	0	1	3	9	19	193	3	88	529	0	0	3	0	0	0	3	4	0	0	0	0	0	0	0	123	0	0	1	0	85	0	0	0	0	0	143	0	1	0	0	0	2	0	0	0	2	0	0	0	0	0	1	0	0	0	0	9	9	0	0	0	0	0	0	0	0	1	0	0	0	0	0	1	4	4	0	0	0	0	2	0	0	0	7	4	0	1	2	0	0	0	0	1	0	2	4	13	140	0	0	11	0	0	2	0	0	1	0	5	4	17	0	30	65	0	7	128	0	0	0	0	0	0	0	4	0	1	0	0	0	0	18	0	4	0	2	0	0	0	0	15	0	0	5	20	93	2	13	1	0	22	68	0	0	0	0	0	0	0	0	8	1	0	18	0	0	1	0	0	0	0	1	0	0	0	0	22	2	0	0	0	3	1	0	0	0	0	1	0	13	0	2	26	5	4	0	0	0	0	2	6	0	4	459	13	13	0	0	22	0	8	16	46	0	0	0	0	0	0	4	0	0	34	0	0	0	1	8	2	0	9	0	0	0	1	12	4	0	51	5	0	2	0	0	3	0	0	6	41	7	0	0	0	0	12	0	0	2	0	0	0	0	0	0	0	0	0	0	0	0	0	0	1	0	0	0	0	0	0	0	0	0	0	0	0	0	0	0	7	0	0	0	0	0	0	0	0	0	0	0	0	0	0	0	0	0	0	0	3	1	4	2	0	0	431	0	1	0	7	0	5	0	0	0	0	5	187	9	3	0	2	16	0	0	6	0	6	1	0	0	0	0	0	0	0	0	0	14	0	3	0	0	5	16	0	0	0	0	0	7	12	0	8	0	0	0	0	0	0	9	9	18	8	5	2	11	9	0	6	4	0	0	0	0	1	0	0	2	3	2	0	5	1	7	1	1	0	0	0	2	0	1	0	0	0	0	0	0	0	0	15	0	0	0	0	0	0	2	0	0	3	9	0	4	0	32	0	9	19	0	4	2	0	28	20	17	0	0	0	0	0	0	0	1	5	377	7	11	14	0	0	0	0	0	0	0	0	0	0	0	0	0	0	0	0	13	28	158	0	1	59	4	7595	7	0	1	2	0	0	0	0	0	0	35	0	0	12	7	0	0	0	0	0	0	0	0	0	0	0	0	1	44	0	7	10	0	1	0	0	0	1	14	0	14	0	1	1	0	2	0	2	0	10	0	0	0	2	4	0	0	0	0	0	0	2	0	0	0	0	0	6	0	0	0	0	0	0	1	0	0	0	0	0	0	0	0	0	0	0	0	0	0	0	362	254	0	1	2	4	0	18	7	1	0	0	1	6	0	0	0	0	0	0	0	0	0	0	0	3	0	0	0	0	0	12	0	0	0	1	0	164	0	0	0	0	0	0	0	0	0	0	0	2	0	0	1	4	0	0	0	0	0	0	0	0	0	0	0	1	0	0	0	8	16	17	0	8	0	0	0	0	0	0	0	0	1	0	0	0	0	5	6	0	6	21	0	0	0	0	0	0	0	0	0	0	0	0	0	0	0	0	0	1	0	0	0	0	0	0	0	0	0	0	3	0	0	0	0	0	0	0	12	0	0	0	0	0	0	0	0	0	2	0	0	0	0	0	0	0	0	0	0	0	0	1	0	0	0	0	0	0	0	0	0	0	0	5	0	3	31	0	0	0	2	0	0	0	0	0	0	0	0	0	0	0	0	0	0	0	4	0	0	9	0	0	0	0	0	0	0	0	0	0	0	0	0	0	0	0	0	0	0	22	0	0	0	0	0	0	0	0	0	0	0	0	8	0	0	0	0	1	0	0	11	0	0	0	0	0	0	0	0	0	0	0	0	0	0	0	6	0	0	0	0	0	8	0	0	0	0	0	0	0	0	0	0	0	0	0	0	0	0	0	0	0	0	0	0	0	0	0	0	0	0	0	0	0	0	0	0	7	0	0	0	0	94	0	0	0	0	0	0	1	4	0	0	1	1	1	58	0	122	3	0	0	0	3	0	8	4	0	2	266	0	12	0	0	45	4	1	0	0	0	0	0	0	2	0	2	5	0	0	2	4	0	1	5	0	5	0	0	1	0	8	0	24	0	2	0	0	3	3	2	131	5	6	3	0	1	8	0	1	0	6	0	0	1	11	0	0	2	6	0	3	23	0	0	1	1	17	6	0	0	0	0	30	21	11	3	1	0	5	0	1	0	0	5	0	1	22	0	0	275	0	0	0	0	1	0	56	3	12	8	3	0	3	1	1	5	5	0	1	0	0	0	0	6	1	23	0	5	17	7	2	42	14	10	3	0	0	4	11	0	18	0	3	0	0	0	0	0	0	12	0	1	0	0	0	0	0	1	0	0	2	9	0	0	0	0	0	5	0	27	0	26	9	0	5	0	1	15	0	0	0	0	0	0	2	0	0	0	1	0	0	0	0	4	0	0	0	1	0	0	0	0	22	0	0	0	0	0	0	0	1	0	0	0	0	0	1	0	0	0	0	8	0	0	0	0	0	0	0	6	1	0	0	0	0	74	0	0	6	3	0	0	0	1	0	5	0	13	0	0	0	0	0	0	0	1	0	0	1	0	1	0	0	0	7	2	17	0	3	0	0	0	0	0	0	0	0	27	0	2	1	0	0	0	0	0	0	0	0	0	0	0	0	0	0	0	0	0	0	0	7	4	0	1	1	12	0	0	0	0	0	0	0	5	0	9	5	76	0	0	1	0	0	0	16	0	0	0	6	5	0	0	3	0	0	0	29	295	0	5	3	11	0	0	0	0	0	2	3	0	0	0	0	0	0	0	0	0	21	0	0	0	8	35	0	1	1	0	0	0	0	0	0	1	3	0	5	9	21	0	6	2	539	0	7	0	0	10	0	0	9	9	1	2	0	0	0	0	1	3	0	0	0	0	10	5	0	0	0	1	0	0	0	0	1	0	0	0	4	6	3	0	0	15	2	0	0	0	0	0	0	0	0	0	0	5	0	6	0	3	0	33	0	1	0	0	0	0	3	0	4	0	9	1	0	1	0	1	2	7	0	21	14	11	2	297	4	0	0	2	0	0	0	0	0	0	0	0	0	0	0	0	0	1	1	20	1	0	5	2	2	0	6	0	3	0	6	5	4	0	4	0	0	0	0	5	4	10	5	7	0	0	0	4	0	12	0	52	6	0	4	1	18	42	10	0	23	0	0	6	5	3	1	0	0	1	0	1	9	0	14	0	6	0	0	14	0	0	17	4	7	0	0	3	3	9	5	1	0	13	19	1	0	12	0	0	0	0	19	0	0	4	0	0	0	0	0	1	0	15	0	2	0	0	0	0	8	0	0	0	0	0	0	0	0	0	0	0	2	0	23	3	3	0	5	0	0	0	0	0	0	0	0	0	12	0	0	5	0	3	4	1	55	0	0	0	0	863	0	0	0	0	0	16	0	0	2	0	0	0	0	1	0	8	0	0	2	0	3	0	1	0	0	0	0	0	25	0	0	0	5	1	0	1	0	0	3	0	0	22	0	0	0	1	0	18	10	0	0	0	3	0	0	0	0	0	1	0	0	0	5	17	1	2	0	0	0	0	1	0	0	0	0	0	39	22	1	0	13	0	0	17	23	1	8	2	0	4	1	1	1	2	2	7	15	0	7	0	0	1	0	0	0	3	0	5	0	0	0	2	0	0	0	0	0	0	0	0	0	0	0	2	0	6	0	5	0	34	4	0	0	0	0	0	0	0	0	0	0	0	0	0	0	0	0	0	0	0	0	0	0	0	0	0	0	2	1	0	0	0	0	0	0	0	0	0	0	0	0	0	0	0	0	0	0	0	0	0	0	0	0	13	2	0	35	1	2	0	0	0	0	0	3	6	4	5	0	7	9	0	0	0	0	0	4	0	0	0	0	0	0	0	0	11	1	22	2	4	0	6	3	7	37	3	1	0	0	0	0	1	0	0	0	0	0	2	0	1	4	3	8	3	4	14	1	3	0	4	1	3	0	3	9	3	0	0	0	0	0	0	2	8	0	0	0	0	0	0	0	0	0	1	0	0	30	3	0	0	0	33	0	0	0	0	0	0	0	0	33	0	0	1	0	23	64	0	0	0	1	3	0	5	0	0	3	0	0	0	3	0	17	14	0	5	2	22	0	0	0	9	0	0	0	2	0	2	1	1	11	1	0	1	0	1	1	0	1	0	0	2	6	0	4	0	2	0	0	0	9	2	1	0	4	1	0	0	0	0	0	0	2	4	0	0	0	2	0	34	0	0	0	2	0	0	0	0	0	0	12	0	0	0	0	0	0	0	0	2	0	0	0	0	0	0	0	2	1	0	7	1	0	0	0	1	3	7	1	19	0	0	9	0	0	51	3	4	1	2	0	0	39	33	0	3	29	0	0	0	5	11	49	0	0	2	0	8	11	1	0	0	0	0	0	0	5	3	0	0	12	17	5	5	0	0	0	0	0	0	39	0	2	0	0	0	0	0	0	0	0	12	7	59	1	2	0	5	0	9	0	0	0	0	0	0	0	0	1	0	0	4	0	3	0	0	1363	0	0	7	0	92	29	0	0	0	3	16	11	51	15	7	29	8	84	0	6	19	0	0	0	0	0	0	4	0	188	31	2	1	0	0	0	0	0	3	0	0	0	2	0	0	0	6	52	0	0	0	99	7	8	4	0	5	1	1	0	0	1	45	0	0	5	0	0	0	0	0	0	0	0	0	7	1	0	0	0	0	0	0	1	0	0	0	0	0	0	0	15	0	0	0	0	34	10	2	0	2	0	0	0	0	0	0	0	0	2	7	0	17	0	6	3	0	0	0	3	0	8	5	0	0	21	3	5	4	6	25	41	3	3	2	41	2	26	26	3	0	0	0	0	0	0	0	0	0	0	0	0	0	0	0	5	0	0	0	1	0	0	3	2	0	1	0	0	4	0	31	0	0	0	0	8	0	0	2	0	0	0	2	5	1	3	0	1	0	0	0	0	0	1	0	0	0	0	0	0	0	25	0	0	0	0	0	0	0	0	0	0	0	0	0	0	1	2	3	0	15	0	117	14	0	57	0	1	4	0	0	0	0	7	1	1	0	0	0	0	0	9	13	0	0	0	40	3	16	4	4	0	498	0	192	230	0	0	4	0	0	0	0	0	0	104	280	5	7	1	1	21	0	0	5	3	0	0	0	3	6	0	0	2	14	0	1	0	0	0	0	0	0	0	3	0	0	0	1	16	0	0	0	0	0	0	0	0	0	0	0	0	0	0	1	0	0	0	0	0	0	0	0	0	0	0	2	5	0	7	6	0	6	0	5	5	18	10	0	0	0	1	0	0	0	0	0	84	0	0	30	0	0	0	0	1	0	4	0	4	1	3	0	0	0	0	0	0	0	0	5	0	0	0	0	0	0	0	34	0	5	0	24	31	0	3	0	2	1	0	0	683	10	0	0	3	41	4	0	3	1	0	6	0	0	1	0	11	5	0	1	1	0	0	0	0	1	2	0	1	0	224	0	1	0	2	1	2	0	6	0	0	0	0	0	0	0	0	2	2	0	18	5	0	0	0	0	0	0	0	0	0	0	1	0	0	16
LakWasM122_LOW14_2_rpkm	0	0	0	0	0	0	1	0	0	0	0	3	2	3	0	0	0	0	0	0	0	0	0	5	0	0	0	0	0	1	0	1	0	1	0	1	0	0	0	0	0	0	0	2	11	10	7	8	0	4	0	2	0	0	0	0	0	0	9	18	32	1	0	0	0	0	0	0	0	4	0	0	0	0	0	0	2	0	0	0	0	5	1	0	0	0	0	0	0	0	0	0	3	0	4	0	0	0	0	0	0	0	0	0	0	0	0	0	0	0	2	0	4	0	3	0	0	0	0	0	0	0	0	0	0	0	4	0	0	0	3	24	8	0	0	0	0	0	0	0	0	0	0	2	0	0	0	0	7	0	0	6	1	1	25	0	0	1	7	0	1	0	0	0	0	0	0	2	0	11	1	0	0	0	0	0	0	0	0	0	0	0	0	0	0	32	0	0	0	2	0	1	3	0	1	0	2	10	4	20	0	0	0	0	0	0	0	0	0	0	5	2	4	8	3	0	0	0	0	9	0	1	0	3	0	0	4	0	11	0	0	2	0	0	0	0	2	0	3	0	0	0	3	0	8	1	0	0	0	3	1	0	19	0	130	10	0	0	0	0	0	0	0	3	0	0	137	0	0	19	54	0	2	0	0	0	0	0	0	1	0	7	0	8	4	0	0	0	1	0	0	0	0	0	0	0	0	9	0	0	0	6	5	0	0	0	1	4	9	0	0	0	9	0	0	0	0	0	0	0	0	0	0	0	5	2	0	0	0	0	0	1	0	0	0	0	0	1	0	0	0	2	7	1	0	0	2	1	9	0	0	0	0	0	0	0	0	0	0	2	1	0	0	0	0	4	1	12	1	1	0	17	0	18	19	0	0	1	0	4	1	0	0	0	2	0	4	2	0	0	0	0	40	0	0	6	3	0	0	11	2	4	0	1	7	0	6	0	0	0	0	2	0	117	0	4	1	1	1	8	0	0	2	0	0	0	0	0	0	0	1	0	0	1	0	7	0	1	1	0	15	1	0	0	1	19	0	0	0	0	0	23	0	63	0	1	10	0	0	0	0	0	0	1	0	4	4	0	0	0	4	13	1	0	0	0	8	0	15	0	4	2	15	910	1	0	0	17	11	0	0	0	12	18	0	0	5	0	0	0	0	0	8	0	0	1	0	0	0	0	0	0	0	0	0	0	0	0	0	4	0	0	0	0	0	0	0	0	0	0	0	0	41	3	0	0	2	4	0	6	0	0	0	5	0	0	0	0	0	9	0	0	1	2	0	2	0	2	0	0	0	0	0	0	0	0	0	0	2	0	0	0	0	0	0	0	1	16	4	0	0	10	4	1	9	0	0	4	17	0	0	0	6	0	51	0	1	0	7	0	4	0	0	1	1	1	0	4	0	32	1	74	43	53	0	0	10	0	28	0	4	1	6	4	0	3	0	1	1	0	0	0	0	0	2	0	0	0	4	2	4	32	0	0	0	0	1	2	1	1	2	0	1	18	3	0	0	0	2	0	0	5	0	8	0	0	0	0	0	0	0	1	5	0	0	0	0	1	0	0	0	0	2	0	0	0	0	0	0	6	0	0	1	0	0	0	0	0	0	0	0	8	0	1	1	0	3	0	7	0	1	1	0	0	2	5	0	0	4	2	0	0	0	4	0	0	0	0	9	0	0	0	0	0	0	0	0	0	0	1	0	3	0	0	1	5	0	0	0	2	0	0	1	0	0	0	0	0	6	6	0	1	0	9	0	0	0	0	0	0	0	0	0	0	3	18	0	0	0	0	0	0	2	0	0	0	0	0	0	0	0	2	0	0	0	0	1	4	0	3	0	0	0	0	9	1	32	0	0	0	0	0	0	0	1	0	1	0	0	0	0	0	0	1	4	0	0	0	23	5	1	0	0	0	0	0	0	9	7	0	0	0	0	0	0	0	0	1	7	12	0	0	1	0	0	0	0	0	0	0	5	0	0	0	0	0	0	0	5	0	0	0	0	0	0	0	0	0	1	3	0	0	0	0	0	0	2	0	0	0	0	0	0	0	0	0	0	0	0	0	0	3	1	15	0	0	0	0	0	0	0	0	0	0	1	1	4	1	1	0	0	2	0	0	0	0	0	0	0	0	1	0	0	0	0	0	0	0	0	1	0	0	0	1	2	0	1	1	0	0	1	0	0	0	0	0	0	0	0	0	0	0	0	0	1	0	0	0	0	0	0	0	2	16	2	7	0	1	0	0	7	7	0	0	39	0	0	0	0	0	0	0	0	0	0	0	0	0	0	0	0	0	0	0	0	0	0	0	0	1	0	0	0	0	0	0	0	9	0	0	0	7	0	0	2	0	0	0	7	1	3	0	0	0	0	0	1	0	6	0	0	0	0	0	0	0	0	0	0	0	0	0	0	0	0	0	0	0	0	0	0	1	0	3	0	0	0	0	0	1	2	0	0	1	0	0	0	0	6	0	0	0	0	0	0	0	0	0	0	6	0	0	2	0	0	0	0	0	0	0	0	0	0	0	0	4	15	0	0	80	0	88	0	0	1	0	0	18	0	0	0	0	0	0	0	0	1	3	21	0	0	0	0	0	0	1	0	0	0	0	0	0	0	0	0	0	0	0	0	0	0	4	0	0	0	0	2	0	0	2	0	0	0	0	0	0	0	0	0	0	10	0	0	0	50	0	1	0	1	0	0	0	0	0	0	0	0	2	0	0	1	2	18	4	5	26	1	0	0	9	0	0	0	0	0	1	1	0	0	0	0	0	0	0	0	0	0	2	0	0	0	0	0	0	0	0	0	0	4	0	0	0	0	0	0	0	0	0	1	0	8	0	2	0	0	0	25	0	0	0	1	0	0	10	14	0	0	0	0	0	1	0	0	7	0	6	0	0	0	0	0	0	2	22	0	3	5	1	0	7	0	0	0	0	0	38	4	5	11	0	0	0	0	0	0	0	0	0	3	1	0	0	0	0	0	0	0	0	0	1	0	0	0	0	0	0	0	0	0	1	0	0	1	0	0	0	0	0	0	0	0	0	0	0	5	0	7	5	4	0	0	0	2	10	0	0	1	0	0	1	0	0	0	0	0	0	5	1	0	0	0	0	1	0	0	0	2	0	3	1	0	0	1	7	0	0	1	0	0	0	0	0	0	0	1	0	3	7	7	9	2	2	7	0	0	1	0	3	0	0	0	0	0	3	0	0	3	0	0	5	1	0	8	1	3	0	11	0	0	0	0	0	0	0	0	0	0	3	0	0	0	9	7	0	0	0	1	2	0	1	0	0	0	2	0	0	0	0	0	0	0	0	1	46	6	27	37	0	0	0	0	0	0	0	0	9	6	0	0	9	0	0	0	0	62	38	0	5	1	0	3	29	0	0	1	0	0	0	0	0	4	0	5	2	19	2	0	3	0	11	0	0	0	0	0	0	12	7	0	0	0	1	0	11	0	0	0	0	0	5	0	0	0	0	0	0	1	0	0	0	0	0	1	2	0	3	0	0	0	0	0	0	0	0	0	0	0	0	1	14	0	0	4	0	0	0	0	0	0	0	0	0	0	1	0	0	0	0	0	0	0	0	0	0	0	0	0	0	0	0	0	0	0	0	0	0	0	13	0	0	1	0	0	0	0	35	0	7	38	0	0	23	0	19	1	0	0	0	0	0	3	0	0	0	0	0	0	0	4	0	0	0	1	0	0	0	10	0	0	4	0	0	0	0	0	0	0	13	0	8	0	0	0	0	4	0	0	0	0	0	0	0	0	1	0	0	0	0	0	0	3	0	5	4	2	0	0	5	0	0	0	0	0	1	1	1	2	0	0	0	0	0	0	0	0	0	0	0	7	2	159	5	28	6	3	2	0	0	0	0	0	2	0	0	0	0	12	0	0	0	0	1	0	0	0	9	10	0	10	0	0	30	0	0	0	3	3	0	14	1	2	0	0	0	0	0	0	14	0	3	0	0	0	0	1	0	0	5	0	2	0	0	0	1	0	2	11	19	3	17	0	0	0	3	0	3	0	0	1	0	1	0	6	0	0	0	0	2	0	1	1	2	2	2	0	0	0	0	0	0	0	8	0	0	0	0	0	2	11	0	0	0	4	0	18	0	0	0	15	0	8	233	2	0	0	0	0	0	0	0	1	4	0	0	0	0	0	0	0	7	0	0	0	0	0	11	0	72	0	7	0	0	0	0	0	0	0	0	0	0	5	0	0	11	3	19	24	0	0	0	0	0	0	0	10	0	0	4	0	0	0	0	40	6	9	1	0	7	18	0	2	0	25	0	2	0	0	0	3	1	0	3	0	0	0	0	0	0	0	0	0	0	0	0	0	0	1	2	0	22	0	0	71	0	0	0	0	0	0	0	0	0	0	0	0	0	6	0	0	0	2	3	1	4	0	0	0	0	0	1	4	0	8	18	3	0	2	0	0	0	0	0	0	0	0	0	0	0	0	3	0	0	1	113	0	0	0	0	0	0	0	0	29	0	14	6	15	3	0	0	8	0	1	14	63	1	0	0	0	0	0	0	0	0	0	0	0	0	2	0	0	0	0	1	0	0	0	0	0	0	0	0	1	3	1	0	3	0	0	8	17	0	1	0	87	7	19	1	0	0	0	0	0	0	0	0	0	0	0	0	6	0	0	0	10	0	3	0	0	0	0	4	0	1	0	0	0	0	0	1	0	0	0	7	0	0	0	0	0	0	0	0	3	5	0	7	0	0	5	0	0	2	0	0	0	0	5	0	26	0	0	2	1	0	4	100	0	0	1	0	0	0	2	0	0	0	0	0	0	0	0	0	0	10	0	0	0	5	0	5	46	8	1	0	1	0	0	0	4	0	3	0	0	0	0	0	0	0	0	0	0	0	2	0	0	0	0	0	0	0	1	0	0	0	0	0	0	0	0	0	0	0	1	20	0	0	0	3	0	15	4	0	0	0	0	0	46	0	0	0	2	1	0	0	0	1	4	1	13	1	0	0	0	58	0	6	4	11	1	0	1	0	6	0	0	0	0	0	0	0	41	0	0	1	0	0	0	0	0	0	28	46	3	0	0	0	2	4	0	7	8	0	2	0	28	0	0	0	0	3	0	0	0	0	0	0	5	0	0	5	0	0	0	0	4	0	0	0	0	0	0	0	0	5	0	0	4	0	0	0	0	0	1	0	0	0	0	1	2	0	0	0	0	0	0	1	0	0	0	0	11	0	0	0	0	0	0	0	0	0	1	0	0	0	0	1	0	0	0	0	0	0	0	0	6	0	0	0	0	0	0	0	0	1	0	0	5	1	0	0	0	0	1	0	0	0	0	0	0	0	0	0	2	3	207	6	2	3	1	4	0	12	0	6	2	2	0	0	1	14	2	0	0	0	14	11	3	21	9	5	4	0	18	1	2	8	0	0	0	0	0	0	0	0	0	0	2	25	0	0	0	0	0	0	0	0	0	0	0	0	0	0	0	5	0	0	0	0	1	0	6	0	23	1	0	0	10	0	35	0	0	0	9	0	0	0	0	0	0	0	0	0	0	3	0	0	0	0	0	10	0	3	1	0	0	5	0	0	0	0	0	0	2	1	0	0	0	0	26	0	0	2	0	0	0	0	0	2	0	0	0	0	2	2	0	6	0	0	0	0	0	0	0	0	0	0	0	0	0	0	0	1	0	55	5	0	1	10	0	0	0	0	0	0	0	0	0	0	0	0	0	0	1	0	0	0	0	0	0	0	11	3	7	0	0	1	3	2	2	2	0	17	0	4	0	7	0	0	0	0	0	0	0	0	1	1	0	0	0	0	0	0	0	0	0	0	0	0	0	0	0	0	0	0	0	4	0	0	3	0	0	0	0	0	0	0	0	0	0	0	0	10	0	153	2	0	0	3	0	0	1	0	0	5	0	0	0	0	0	0	1	0	4	0	0	0	0	0	3	0	0	15	1	1	2	0	0	16	0	1	8	1	0	0	0	0	0	3	0	10	0	1	0	0	0	0	0	0	0	5	0	0	1	0	0	0	0	0	0	8	0	0	0	0	0	0	1	0	0	0	2	0	0	0	0	4	0	7	18	30	0	0	0	0	0	0	0	0	0	0	0	0	0	0	0	0	0	0	3	8	1	6	0	0	0	1	0	0	0	0	3	11	0	0	0	0	14	0	0	0	0	2	0	0	0	0	0	0	2	0	10	0	0	0	0	0	0	0	8	0	0	8	1	0	0	0	0	0	0	0	11	0	0	0	0	0	0	0	0	0	0	0	3	2	0	0	5	0	0	0	1	0	0	0	0	0	0	0	0	0	0	0	0	0	6	0	0	0	0	4	0	0	0	0	0	2	0	0	0	0	0	0	0	0	0	0	52	0	0	17	0	19	0	11	2	0	1	0	0	3	0	3	1	0	0	0	0	0	0	0	0	1	0	0	3	0	0	0	29	0	0	1	7	1	0	1	1	0	0	0	0	1	0	73	0	0	0	1	0	1	0	0	0	4	0	0	0	0	0	0	0	1	0	2	0	10	3	1	9	5	6	1	3	0	8	2	2	0	0	0	0	0	3	7	0	5	0	0	0	0	19	2	0	0	0	0	0	9	27	3	0	0	0	14	1	0	0	0	0	3	0	0	0	0	0	0	0	0	0	0	0	15	0	0	0	0	5	0	0	0	0	0	0	0	0	0	0	8	0	0	57	11	5	0	21	0	4	0	0	0	36	0	1	0	0	0	0	0	1	0	0	0	0	0	0	2	0	16	0	0	9	0	0	15	0	1	0	0	0	17	9	0	0	0	3	1	0	0	0	0	3	0	0	1	0	2	3	1	0	0	46	1	0	0	0	0	0	0	241	22	6	1	0	0	0	0	0	0	0	16	0	0	0	1	0	0	21	88	9	0	0	0	1	0	0	0	43	0	0	0	0	0	17	0	0	0	0	0	0	0	0	0	0	0	0	0	0	0	127	119	1	1	0	0	0	0	4	4	0	0	0	0	0	0	7	3	0	8	1	0	0	0	0	1144	6	11	0	0	1	0	0	0	0	0	0	0	0	0	0	0	0	0	0	0	0	402	0	0	0	0	0	0	0	0	0	0	0	0	0	0	0	0	0	3	0	0	0	0	0	0	0	0	0	0	0	0	0	0	0	0	0	0	0	0	0	0	0	4	0	0	0	0	1	0	0	0	0	0	0	0	0	1	0	0	0	0	0	0	0	0	0	0	339	0	0	0	0	0	1	22	1	0	1	0	0	1	1	18	2	0	0	0	0	1	56	0	16	1	0	1	0	2	0	0	0	0	0	0	12	0	0	0	0	0	0	0	0	0	0	0	0	0	0	0	0	0	0	0	0	0	0	0	3	0	11	0	0	0	0	0	0	0	0	0	0	0	0	3	0	0	1	1	8	2	0	2	0	0	0	3	0	0	0	0	1	0	0	3	0	18	0	4	0	0	0	0	0	0	0	0	0	4	0	1	4	0	42	0	2	6	0	0	1	0	0	0	0	0	2	0	0	5	0	0	0	0	7	0	161	4	0	0	0	0	0	0	0	242	3	7	0	0	0	0	0	0	9	35	0	9	0	0	0	0	0	0	0	0	0	0	6	12	31	0	0	0	3	3	0	0	0	0	0	0	0	0	10	45	2	12	0	0	0	0	0	0	0	37	0	0	0	0	1	0	0	0	0	0	1	0	2	0	0	8	0	0	0	0	15	1	9	0	0	0	8	1	0	0	0	0	4	0	0	0	0	0	0	0	0	0	1	0	2	0	1	0	0	0	0	30	0	0	0	0	0	0	0	17	0	0	0	0	0	1	0	0	0	0	0	0	0	0	0	0	0	0	1	0	0	1	0	0	0	0	2	0	0	0	0	0	0	0	0	0	0	2	1	0	17	0	1	1	0	0	0	0	0	0	0	0	0	0	0	0	0	0	0	0	0	0	0	2	0	0	0	0	0	0	0	0	0	2	0	0	0	0	0	0	0	0	0	0	0	1	0	0	5	0	0	0	0	0	0	1	0	0	0	0	0	0	0	0	0	0	0	3	0	0	0	0	0	0	2	4	2	5	0	0	2	0	19	0	0	0	2	0	0	0	0	0	0	13	0	6	0	0	0	0	5	0	0	0	0	47	0	0	0	0	1	0	0	0	0	0	0	0	0	0	0	0	0	0	0	3	0	0	0	0	0	0	0	0	0	0	0	0	0	0	0	0	0	0	0	0	0	0	0	0	3	0	0	0	3	0	0	0	0	4	0	0	0	0	0	0	0	3	0	0	0	0	0	0	0	27	0	0	0	2	0	0	0	0	0	0	0	0	0	0	0	0	0	0	0	0	0	0	0	0	0	0	0	0	0	0	0	0	0	0	0	0	0	0	0	0	0	0	0	1	0	0	0	0	0	0	0	0	1	0	0	0	0	0	0	0	0	0	0	0	0	0	0	0	0	0	0	0	0	0	0	3	0	0	2	0	0	1	0	0	0	0	0	0	0	0	0	0	24	0	0	12	0	0	0	0	0	27	0	0	0	0	1	39	0	0	0	0	0	0	0	0	0	0	0	8	12	2	0	1	4	45	0	0	0	0	0	12	0	0	0	0	0	0	0	0	4	0	0	0	0	0	0	0	6	0	0	3	0	0	0	0	0	1	0	0	0	5	0	0	0	0	0	0	0	0	0	0	0	0	0	9	0	8	1	0	0	0	0	0	0	0	0	0	5	0	0	0	0	0	2	0	0	0	0	0	0	0	0	0	0	0	0	0	0	0	10	0	0	8	0	0	0	0	1	2	0	0	0	0	0	0	0	3	1	0	1	2	0	0	0	0	0	0	0	0	1	0	2	1	0	0	0	0	4	0	0	38	0	0	0	0	0	0	0	0	0	0	0	2	0	0	0	0	0	0	0	0	0	0	1	0	0	0	0	0	0	20	0	0	0	0	0	0	0	0	0	0	0	0	0	0	0	0	0	0	0	0	0	1	0	0	32	0	0	0	0	0	0	0	1	6	0	0	0	0	0	0	0	0	0	0	0	0	2	0	0	0	3	0	1	0	0	0	5	0	0	0	0	0	0	0	0	0	0	0	0	3	3	0	0	0	0	0	0	0	0	0	0	0	0	0	0	0	0	0	0	0	5	0	0	1	0	0	0	0	0	1	2	0	0	10	0	11	0	0	0	0	0	0	0	1	0	2	32	0	1	0	0	0	0	2	0	0	5	0	0	0	0	0	0	1	0	0	0	0	1	0	0	0	0	0	0	0	0	0	0	0	4	0	0	0	0	0	6	0	0	0	0	0	0	0	0	0	0	0	1	0	0	0	0	0	0	0	0	1	0	0	3	0	0	0	0	2	0	0	0	15	9	2	52	129	0	0	0	0	15	0	0	1	0	0	0	0	5	8	0	5	0	0	19	0	63	0	0	0	428	1	0	0	0	1	0	0	0	0	0	0	2	14	18	0	0	0	0	0	0	0	0	0	0	0	0	0	0	0	0	0	0	0	0	0	0	0	0	5	0	0	1	0	0	0	0	0	0	0	0	0	0	0	0	0	0	38	0	0	0	9	0	0	0	60	1	0	0	0	0	0	0	0	4	0	0	0	7	39	0	0	0	0	0	0	0	1	0	0	0	0	0	0	0	5	0	0	0	0	0	0	0	0	10	0	0	0	0	0	0	0	0	0	0	4	0	0	1	0	2	0	0	0	0	0	0	8	0	0	1	0	0	0	7	0	0	1	0	9	0	2	0	0	2	0	1	19	0	0	1	0	0	0	0	26	0	0	0	19	15	10	0	0	3	1	4	1	0	16	2	1	3	20	5	0	28	1	0	4	0	1	6	1	8	0	5	0	6	0	0	0	0	0	0	0	0	0	0	62	0	3	0	0	0	0	0	0	1	0	0	9	0	0	0	2	1	0	0	0	0	1	3	0	0	0	0	0	0	52	18	0	0	0	0	0	0	42	1	0	0	0	0	0	0	21	0	4	0	4	0	1	0	0	0	0	10	18	0	15	26	20	0	0	0	0	0	0	0	0	0	0	0	0	0	0	0	3	0	0	0	0	0	1	0	0	0	4	0	0	0	10	2	0	0	0	0	6	14	0	4	0	5	1	0	0	0	0	0	11	0	1	6	0	0	0	0	0	0	0	0	0	0	0	0	3	0	0	34	0	0	0	4	0	0	0	5	0	4	0	0	2	27	14	8	0	3	0	0	3	0	0	2	0	0	0	0	0	0	0	0	0	0	0	0	0	0	0	0	0	0	0	0	0	0	1	3	0	0	0	1	0	0	0	0	0	0	0	13	0	0	1	0	11	4	3	0	2	0	0	0	36	1	22	0	0	1	0	15	0	0	0	0	0	0	0	0	0	0	0	0	0	0	3	0	0	0	9	0	0	0	0	2	0	0	4	4	0	0	0	0	0	0	0	0	0	0	15	0	0	0	0	0	0	0	0	0	0	0	0	0	0	0	0	0	0	0	10	0	0	3	0	0	0	2	11	0	5	3	0	2	0	0	0	0	0	0	0	0	1	0	6	0	0	0	0	0	0	0	0	0	0	0	13	12	1	0	0	0	3	8	0	0	0	0	0	12	0	0	3	1	37	0	0	0	0	9	0	26	4	0	0	0	0	0	0	0	0	2	0	0	0	0	0	0	0	0	0	20	1	1	0	0	4	0	0	7	0	0	0	1	0	0	0	4	0	0	1	0	0	0	1	0	0	1	0	0	0	0	0	0	0	0	0	0	0	0	1	5	0	0	2	2	0	4	0	0	20	3	3	0	0	0	0	0	0	0	0	0	0	0	0	16	0	0	0	0	0	0	0	0	0	5	4	11	0	4	8	0	0	0	0	0	0	8	0	0	5	2	1	0	5	0	0	0	3	0	4	1	0	3	2	3	5	0	0	0	0	6	0	2	0	1	0	0	1	0	0	0	0	0	0	0	0	0	0	0	0	0	0	0	0	0	0	0	23	0	0	0	0	0	11	0	4	0	0	0	0	0	0	6	0	0	0	0	0	0	1	1	24	0	0	14	0	0	0	5	0	0	4	0	0	0	0	0	1	0	0	3	2	0	0	0	0	0	95	0	1	0	1	0	0	0	10	2	0	0	0	0	0	1	1	0	0	0	7	0	0	0	3	0	2	0	0	0	0	0	10	0	1	4	0	4	0	4	0	0	0	0	29	0	2	1	0	3	0	3	0	1	8	0	0	0	0	0	0	0	0	0	0	0	0	5	0	86	32	2	0	0	0	55	0	1	0	0	0	3	0	0	0	7	0	4	0	0	2	0	0	0	0	0	0	0	0	0	1	0	0	0	13	0	0	0	0	0	0	0	7	0	0	0	2	0	1	0	0	1	0	22	54	0	0	0	0	0	0	0	0	0	0	0	0	0	0	0	0	0	0	0	15	0	0	0	0	0	0	0	0	0	0	0	0	0	0	0	0	0	0	0	0	21	0	0	0	0	0	0	0	0	0	0	0	2	0	4	0	0	0	1	0	0	0	1	0	0	0	0	0	0	0	0	0	0	3	0	0	0	0	0	0	0	2	0	0	1	0	0	0	0	0	0	0	5	0	0	1	0	3	0	0	0	0	0	0	0	3	0	2	4	0	0	1	0	0	0	0	0	0	0	0	0	0	2	0	0	0	0	0	0	0	0	0	0	2	0	0	0	0	0	0	0	1	0	0	1	0	0	0	1	1	0	11	11	0	0	0	0	0	0	0	0	9	0	0	0	1	0	0	0	0	0	1	0	0	0	1	0	0	0	1	0	0	0	0	1	0	0	3	0	0	0	0	0	0	0	0	0	0	0	5	0	0	0	0	0	0	0	0	0	0	2	0	0	0	0	0	0	0	12	0	0	0	0	0	7	0	0	0	0	0	0	0	0	1	0	0	67	0	0	0	0	4	0	0	0	0	0	0	0	0	0	0	0	1	0	0	0	0	0	0	0	0	39	0	7	0	12	0	0	0	0	0	5	0	0	0	0	6	6	8	2	0	0	3	0	7	0	0	0	7	3	0	5	7	0	0	1	0	0	0	0	20	5	0	3	1	24	0	0	0	0	1	2	0	0	0	0	0	0	3	0	1	0	0	0	0	0	0	0	0	0	0	2	0	0	0	0	2	3	0	1	0	0	1	6	0	11	5	0	1	0	3	0	0	149	0	0	0	0	0	0	1	0	1	0	0	0	0	3	4	1	0	0	0	0	8	18	6	22	2	0	75	8	0	0	0	1	0	0	0	0	0	0	0	0	0	2	0	0	0	0	5	0	2	0	8	4	2	0	0	0	1	0	0	0	0	0	0	0	0	0	0	0	0	0	0	0	0	0	3	0	0	1	0	0	0	2	0	0	0	1	2	0	31	0	0	0	0	0	0	0	0	0	1	6	0	0	4	0	1	0	0	0	7	1	0	61	0	0	0	0	0	0	0	0	1	8	0	0	172	0	0	83	6	0	11	2	9	0	2	0	2	3	0	19	11	2	0	0	0	0	0	0	1	0	0	0	0	0	0	0	0	0	7	0	0	4	0	0	4	0	0	0	0	0	0	0	1	0	0	0	1	8	0	0	0	0	0	1	0	0	0	6	0	8	4	0	2	0	1	0	1	6	8	0	0	0	62	0	0	0	1	0	0	0	0	0	0	24	1	2	1	0	4	0	0	0	2	2	0	0	3	0	0	4	16	5	0	2	0	0	0	0	3	0	0	0	0	0	4	0	0	0	0	0	0	0	1	0	0	0	0	0	3	1	0	0	0	0	6	1	2	0	0	7	0	0	0	0	4	0	1	1	1	3	10	0	0	7	1	4	0	11	0	8	0	0	0	6	0	0	0	0	0	0	0	0	0	3	0	0	0	0	0	0	0	3	71	9	0	133	1	0	0	2	34	1	0	0	0	0	0	0	0	0	0	0	0	0	0	1	7	0	0	0	1	19	0	1	0	0	0	0	5	0	0	0	0	0	1	0	2	0	0	0	12	0	0	0	0	0	0	14	12	0	2	0	0	0	0	0	0	3	2	0	0	0	4	0	0	0	20	0	0	0	7	2	33	13	0	0	0	0	0	1	1	0	3	0	1	0	0	4	0	21	0	8	8	5	0	0	2	21	1	0	0	1	0	0	0	0	11	1	0	0	0	0	0	19	19	3	4	0	1	6	0	0	0	0	0	16	0	0	0	0	0	0	20	8	4	103	10	0	18	10	2	1	1	0	0	0	2	1	0	8	0	0	0	0	61	0	137	3	9	5	1	5	0	0	64	1	0	4	2	0	0	2	2	0	0	0	0	0	0	0	0	0	0	12	0	1	0	0	0	0	2	0	31	44	17	2	0	4	0	23	5	15	0	0	6	0	0	0	0	0	0	0	0	0	0	0	0	0	0	0	0	0	0	22	0	0	0	0	1	0	1	0	2	0	0	5	0	1	4	4	1	15	1	0	1	0	0	4	0	58	19	1	0	0	0	0	1	15	0	1	1	0	0	0	5	0	0	0	0	0	0	0	2	19	0	0	0	0	0	0	0	0	0	0	0	0	0	0	0	0	0	2	18	1	0	0	0	0	0	67	0	448	0	0	0	0	23	2	5	0	0	0	0	0	0	0	0	6	0	7	0	0	0	0	0	0	0	0	1	0	0	15	0	2	2	0	0	0	0	0	0	0	16	0	0	0	0	0	0	2	5	0	0	11	0	1	0	0	0	0	0	0	0	1	0	0	0	0	3	1	0	1	0	1	1	0	0	0	0	4	10	4	0	0	6	0	0	0	1	60	0	0	0	0	0	0	0	0	0	0	0	78	1	0	11	3	0	0	0	0	4	0	3	4	2	0	0	0	0	0	4	0	0	1	0	0	0	0	16	0	0	0	2	0	0	0	0	0	0	0	0	0	336	0	11	1	3	152	0	0	10	2	12	10	77	60	25	0	24	11	13	0	0	5	1	4	4	3	0	25	0	419	0	9	0	1	0	17	0	0	0	50	2	3	0	0	0	0	0	1	0	0	0	3	1	6	2	1	4	8	22	4	0	2	0	9	1	2	4	0	0	0	0	0	0	3	0	0	0	3	12	0	1	1	8	0	0	3	0	0	0	0	0	1	0	0	0	0	0	0	8	1	0	0	0	0	0	0	0	1	0	0	0	3	1	0	20	0	0	0	1	25	239	0	0	0	0	9	0	4	14	0	4	0	3	0	0	3	0	0	1	0	5	99	0	0	1	1	27	0	0	0	3	0	0	0	10	6	3	0	0	0	24	0	0	1	0	12	0	1	2	0	0	1	0	0	10	0	2	0	0	0	0	0	0	5	6	0	0	0	0	0	16	3	2	0	0	1	22	2	1	0	2	6	0	0	0	2	1	0	18	9	0	1	8	2	0	1	0	1	0	0	0	1	0	1	3	12	9	3	0	0	0	0	0	0	20	0	0	21	0	0	3	0	0	0	0	0	2	9	1	0	2	0	0	0	0	0	0	20	7	0	0	0	0	0	0	0	0	0	0	0	0	0	0	0	4	0	0	2	0	0	0	0	0	0	4	3	0	0	0	3	5	0	1	0	0	0	0	0	2	1	0	1	0	0	0	0	2	0	4	1	0	14	0	2	0	0	0	9	0	0	0	0	8	11	0	0	0	0	0	0	0	0	18	0	0	6	0	0	3	0	2	0	4	1	0	0	0	0	0	14	0	0	0	0	7	11	34	4	12	3	1	15	0	8	0	11	0	0	5	20	6	17	5	8	10	2	3	2	0	11	2	1	13	2	2	0	3	10	1	19	81	1	63	3	32	6	2	3	2	11	6	4	10	0	0	0	0	133	10	6	8	4	77	25	1	21	13	31	47	1421	0	17	5	2	0	0	0	1	1	0	0	1	0	0	75	59	29	0	0	21	0	0	0	0	0	16	7	12	24	3	1	18	4	17	49	0	3	17	4	3	0	4	0	0	2	5	5	1	28	2	2	1	10	1	1	1	0	0	0	0	4	0	0	0	19	0	0	3	0	0	0	0	26	0	0	0	0	0	5	1	0	0	0	0	0	0	0	0	8	0	0	0	0	0	0	0	0	0	0	4	0	1	0	0	0	0	0	19	0	3	6	0	4	5	1	7	6	0	0	9	0	0	6	1	0	0	0	0	0	0	16	0	0	0	0	0	4	0	0	0	0	0	8	0	0	0	0	1	0	0	0	0	0	0	0	0	0	0	0	17	0	1	0	0	0	0	39	10	6	11	0	18	1	4	0	0	0	0	0	1	0	0	0	0	0	0	0	2	6	1	0	0	0	0	0	0	2	0	0	10	4	0	0	2	0	2	1	0	162	9	0	0	0	2	0	0	5	0	10	1	6	0	0	0	0	0	6	1	13	0	0	0	4	2	0	0	1	3	0	16	1	0	0	11	1	0	0	60	20	0	0	0	0	0	0	4	1	0	0	0	7	0	1	2	0	0	0	1	0	0	0	0	3	1	0	3	0	0	0	0	0	0	1	0	10	0	11	0	0	0	1	0	0	0	0	0	12	3	1	0	0	3	0	1	10	0	2	0	1	0	0	0	5	0	0	0	0	0	0	0	0	0	0	1	0	4	0	0	0	1	0	0	0	0	0	1	5	1	0	0	6	0	0	0	0	0	0	1	15	14	0	0	27	4	22	0	0	11	0	0	0	0	0	0	0	13	0	0	0	2	0	0	0	0	0	0	0	0	0	3	14	0	0	3	3	0	0	0	0	5	6	3	1	0	0	0	0	0	0	0	0	0	0	0	0	14	0	1	0	0	1	2	0	0	7	1	1	0	1	15	0	23	0	0	18	0	0	4	0	0	0	0	0	0	0	0	0	6	1	0	3	0	1	0	0	0	0	32	0	0	0	0	0	1	6	0	0	0	0	0	0	0	0	0	0	3	3	0	0	0	21	0	0	1	0	17	6	2	0	0	0	0	2	0	0	0	0	0	5	11	0	0	0	0	64	0	12659	0	0	0	0	0	1	0	0	0	0	0	0	0	0	0	0	6	0	0	0	0	0	0	4	0	2	1	5	0	0	0	0	0	0	0	6	0	5	10	0	2	0	0	0	0	5	3	0	0	0	0	0	2	0	7	70	6	1	3	0	3	17	0	1	0	0	1	0	0	173	1	17	4	0	0	0	13	3	9	0	4	25	1	0	1	0	0	0	0	3	0	2	0	0	12	0	0	12	0	0	0	5	7	0	0	3	0	0	0	0	2	0	0	0	0	0	0	0	12	3	2	3	3	0	2	5	0	10	2	5	18	23	6	0	7	1	19	18	0	0	2	0	0	1	0	0	0	57	84	7	2	7	0	2	0	0	23	8	2	1	0	4	0	0	0	0	0	0	0	0	0	2	0	4	2	2	0	12	0	0	0	2	0	0	0	0	4	4	7	0	0	4	4	0	1	2	0	4	0	0	0	0	0	0	14	12	1	0	19	0	0	0	3	4	0	0	0	0	1	0	0	0	0	0	0	0	0	0	8	0	0	0	8	2	4	0	0	0	3	0	0	2	0	0	1	0	2	0	0	0	8	46	0	0	0	0	14	17	0	1	16	0	0	0	0	0	0	0	0	0	0	0	0	0	0	0	0	0	0	0	0	0	41	1	0	0	0	0	0	7	0	0	0	1	1	0	0	0	0	0	0	0	0	0	0	0	0	0	0	0	0	0	5	0	3	0	0	0	0	3	0	10	0	0	0	0	5	4	0	30	0	0	0	4	5	7	9	5	0	0	0	0	17	0	0	2	0	1	0	19	1	0	0	0	0	0	0	0	0	79	0	0	0	1	3	3	0	0	0	0	526	2215	0	0	0	0	0	0	0	3	1	13	3	1	3	0	46	7	0	8	2	0	0	3	21	8	6	0	152	0	0	26	5	126	1	1	0	0	0	0	0	0	14	0	0	8	3	13	0	0	0	4	1	0	0	0	0	0	0	1	0	0	0	3	0	0	2	0	0	0	0	0	43	0	0	0	1	1	0	3	0	0	0	0	0	1	0	7	22	6	4	15	17	14	16	0	0	36	7	4	53	0	0	1	0	1	0	0	0	0	0	0	0	5	0	0	0	0	0	0	0	0	0	1	1	0	2	0	0	62	2	0	0	3	0	0	3	0	0	0	0	0	21	0	6	0	0	0	1	0	3	0	0	0	0	0	0	0	0	0	0	0	0	0	1	9	0	0	0	0	0	0	1	0	0	0	55	0	40	2	0	0	0	0	0	0	0	0	0	0	0	0	0	0	0	0	0	1	0	4	0	2	2	5	38	9	6	0	0	0	0	0	0	0	0	0	0	0	0	1	0	0	1	0	8	0	0	0	0	0	0	0	0	0	0	0	0	19	1	0	0	37	0	0	0	0	0	36	0	0	5	2	2	0	33	2	0	0	2	1	0	14	2	3	7	14	17	1	2	0	0	3	0	0	0	0	5	0	0	0	0	0	0	0	36	0	0	0	0	47	0	0	0	0	0	5	3	32	1	0	0	1	0	0	0	3	0	0	0	0	0	0	0	0	0	0	24	1	0	0	0	0	0	0	0	1	3	0	0	0	0	0	0	7	0	0	0	0	0	3	0	0	0	4	0	0	3	0	0	0	0	0	0	0	1	0	3	61	0	0	8	0	0	126	0	0	0	0	2	1	15	0	2	28	2	0	401	0	5	14	1	0	5	0	28	6	15	0	0	0	0	3	0	1	0	0	0	0	0	0	4	0	0	3	1	35	0	2	0	0	0	34	0	0	0	0	0	2	0	0	9	0	0	0	0	0	3	0	0	0	0	2	0	0	0	0	27	6	0	0	0	0	0	0	0	0	2	0	0	4	0	0	2	0	4	0	0	0	0	0	0	1	2	553	10	1	1	0	15	1	11	12	35	0	0	0	0	0	0	2	0	0	16	0	0	1	16	15	3	1	1	21	0	0	4	13	1	0	6	1	0	2	0	0	0	0	0	6	20	2	0	0	0	0	9	0	0	2	0	0	0	0	0	0	0	0	0	0	0	0	0	0	0	0	0	0	0	0	0	0	0	0	0	0	0	0	0	0	4	0	0	1	0	0	0	0	0	1	0	0	0	0	0	0	0	0	0	0	3	0	5	1	0	0	446	0	0	0	2	0	0	0	0	0	0	4	1	7	5	1	0	3	1	0	0	0	1	1	0	0	0	0	1	0	1	0	0	13	0	3	3	0	1	5	0	0	0	0	1	12	0	0	0	0	0	0	0	0	0	10	4	10	2	1	0	14	1	0	6	0	1	1	0	0	0	0	4	21	15	2	0	6	1	11	1	2	0	5	0	3	0	1	0	0	0	0	0	0	0	0	13	0	0	1	0	0	0	1	0	1	1	0	0	0	0	16	0	5	1	2	8	0	1	30	2	5	0	0	0	0	0	0	0	0	4	386	8	1	0	0	0	3	0	0	0	0	0	0	0	0	0	0	0	0	0	3	42	12	0	4	8	8	212	0	0	1	2	0	0	0	0	1	0	40	0	0	7	6	0	0	0	0	0	4	0	0	0	0	0	0	3	9	0	4	4	0	0	0	0	0	0	25	0	14	0	2	3	0	1	0	3	0	3	0	0	0	0	0	0	0	0	0	0	0	0	0	0	0	0	0	0	0	0	0	0	0	0	0	0	0	0	0	0	0	0	0	0	0	0	0	0	2	0	101	25	0	5	8	3	2	25	34	5	0	0	0	0	0	0	0	0	0	0	0	0	0	0	0	9	0	0	0	0	0	0	0	0	0	1	0	161	0	0	0	0	2	0	0	0	0	0	0	1	0	0	4	0	0	0	0	0	0	0	0	0	0	0	0	1	0	0	0	2	4	1	0	11	0	0	0	0	0	0	0	0	2	0	16	0	0	7	6	0	9	10	0	0	0	0	0	0	0	0	0	0	0	0	0	0	0	0	0	0	0	0	0	0	0	0	0	0	0	1	2	0	0	0	0	0	0	0	91	0	0	0	0	0	0	0	0	0	4	0	0	0	0	1	0	0	0	1	0	0	0	0	0	0	0	0	0	0	0	0	0	0	0	16	0	3	1	0	0	0	2	0	0	1	0	0	0	0	0	0	0	0	0	0	0	0	3	0	0	0	0	0	0	0	0	0	0	0	0	0	0	0	0	0	0	0	0	0	0	19	0	0	0	0	0	0	0	0	0	0	0	0	0	0	0	0	0	2	0	0	14	0	0	0	0	0	0	0	0	0	0	0	0	2	0	0	2	0	0	0	0	0	0	0	0	0	0	0	0	0	0	0	0	0	0	7	0	0	0	0	0	0	0	0	0	1	0	0	0	0	0	0	0	0	0	0	2	7	0	0	0	0	12	0	0	0	0	0	0	0	0	0	0	0	0	0	3	0	5	1	0	0	0	0	0	0	2	0	0	3	0	6	0	0	7	0	11	0	0	0	0	0	0	0	0	0	1	0	0	0	2	0	0	0	0	1	0	0	0	0	1	2	1	0	1	0	2	0	0	0	2	2	1	0	0	0	5	0	0	0	0	0	2	0	9	0	0	0	0	0	0	3	0	0	0	0	2	1	0	0	0	0	1	0	0	0	0	0	0	0	0	0	0	0	0	0	1	0	0	9	0	0	1	0	0	0	6	0	0	1	0	0	0	0	0	2	1	0	0	0	0	0	0	13	1	8	3	0	1	1	0	0	6	0	1	0	0	0	14	0	7	0	3	0	0	0	0	0	0	8	0	1	0	0	0	0	0	0	0	64	2	15	0	0	0	0	0	7	0	32	0	20	9	0	5	0	3	5	0	0	0	0	0	0	0	0	0	0	1	0	1	0	0	0	0	1	0	0	0	0	0	0	29	0	0	0	0	0	0	0	0	0	0	0	0	0	0	1	0	0	0	11	0	0	0	0	0	0	0	5	0	0	0	0	0	2	0	0	2	5	0	0	0	3	0	3	0	3	0	0	0	1	0	0	0	0	0	1	1	0	0	0	0	0	0	0	19	0	0	0	0	0	0	0	0	0	0	30	0	0	0	0	0	0	1	0	1	0	0	0	0	0	0	0	0	0	0	0	0	0	7	4	0	3	3	12	0	0	0	0	0	1	0	48	0	1	2	5	0	0	0	0	0	0	16	0	0	0	1	5	0	0	0	0	1	2	2	30	0	7	3	19	0	0	0	0	0	2	3	0	0	0	0	0	7	0	0	0	1	0	1	0	0	16	0	0	5	0	0	0	0	0	0	1	0	2	1	12	11	0	8	12	46	0	6	0	0	9	0	0	9	4	1	1	0	0	0	1	5	1	0	0	0	0	15	1	0	0	0	6	0	0	0	0	1	0	0	0	3	3	1	8	0	7	1	0	0	0	0	0	0	0	0	0	0	0	3	0	0	1	0	14	0	0	0	0	0	0	2	0	4	0	1	0	0	34	17	27	2	6	0	0	1	9	2	66	2	0	0	1	0	0	0	0	0	0	0	0	0	0	1	0	0	1	17	0	1	1	2	4	2	4	9	0	0	0	7	10	1	2	8	0	0	0	0	8	2	15	7	5	3	0	0	4	0	0	0	43	5	0	3	1	19	3	7	0	12	0	0	3	0	1	0	0	0	0	0	0	1	1	0	4	4	1	0	4	0	0	18	2	3	0	0	3	3	5	0	0	1	8	6	1	0	10	0	0	0	0	1	0	0	10	0	0	0	0	0	1	1	11	1	1	0	0	0	0	5	0	0	0	0	0	0	0	0	0	0	3	3	1	15	0	3	0	3	0	0	0	2	0	0	0	2	0	14	0	0	4	0	4	2	1	5	0	0	0	1	800	0	0	0	0	0	5	0	0	1	0	0	0	0	1	5	0	0	1	3	2	0	0	0	0	0	0	0	0	14	0	0	0	6	0	0	20	0	2	0	0	1	6	0	0	0	1	0	11	1	0	0	0	0	0	1	0	0	0	0	0	0	0	11	0	1	0	0	0	0	0	0	0	0	0	0	0	29	0	2	0	12	0	0	15	2	12	6	13	5	0	20	17	12	9	20	3	25	0	0	2	0	0	0	0	0	0	0	3	0	0	0	0	2	0	0	0	0	0	0	0	0	0	0	2	0	2	1	7	0	37	0	0	0	0	0	0	0	0	0	0	0	0	0	0	0	0	0	0	0	0	0	0	0	0	0	0	0	3	4	0	0	0	0	0	0	0	0	0	0	0	0	0	0	0	0	0	0	0	0	0	0	0	0	18	4	0	35	0	3	0	1	0	0	0	5	0	11	1	0	1	4	1	0	0	0	0	4	0	0	0	0	0	0	0	1	2	0	3	4	9	0	7	4	3	27	1	0	0	1	0	0	0	0	0	0	0	0	0	0	0	0	1	10	0	3	4	1	5	0	5	1	6	0	3	1	12	0	0	0	0	0	0	4	4	0	0	0	0	0	0	0	0	0	2	0	0	11	6	0	9	0	0	0	0	0	0	2	0	0	0	28	1	0	0	0	30	46	0	0	0	0	5	0	1	0	0	0	0	0	0	5	1	0	17	9	4	0	2	0	1	1	5	0	0	0	0	1	0	1	0	12	2	0	0	0	0	0	1	0	0	0	2	6	2	4	2	3	0	4	0	10	1	2	1	0	1	0	0	0	4	0	0	0	3	0	0	0	0	0	23	0	0	0	2	0	0	0	0	0	0	13	0	0	0	0	0	0	0	0	1	0	0	0	0	0	0	0	4	1	0	0	0	0	0	0	2	3	0	0	20	3	0	2	0	2	3	36	9	14	4	0	2	22	5	0	1	20	0	9	0	0	0	44	0	0	2	0	3	3	2	0	0	0	0	0	0	7	0	0	0	13	8	11	0	0	0	0	0	0	0	6	0	2	1	1	0	0	0	0	0	0	11	5	40	0	7	0	4	0	2	0	0	0	0	0	0	0	1	0	0	0	0	0	46	0	0	1627	0	0	6	1	57	1	0	0	0	2	18	5	48	17	6	24	5	34	0	0	2	0	0	0	0	0	0	5	2	180	18	0	0	0	0	1	0	0	2	0	0	0	1	0	1	0	13	13	0	0	0	104	5	1	0	0	0	7	6	6	0	1	1	0	0	1	0	0	0	0	0	0	0	0	0	0	1	0	0	0	0	0	0	0	0	0	0	0	0	0	0	18	0	0	0	0	68	1	3	0	1	0	2	0	0	0	0	0	4	3	1	1	2	0	4	0	0	0	1	0	0	1	0	0	0	1	2	1	6	4	5	12	2	0	1	21	3	17	10	3	0	0	0	0	0	0	0	0	0	0	0	5	0	0	0	4	0	0	0	2	0	0	2	1	0	1	0	0	6	0	33	0	0	1	0	8	0	0	0	3	1	2	9	20	2	4	0	4	0	0	0	0	0	0	0	0	0	0	0	0	0	20	0	0	0	0	0	0	0	0	4	0	0	0	0	1	1	2	4	0	23	0	96	11	0	80	0	0	0	0	0	0	0	5	2	5	0	0	0	0	0	7	8	0	0	0	6	0	1	4	1	0	12	0	6	11	0	0	0	0	2	0	0	0	11	5	85	7	8	17	1	9	4	8	9	11	4	7	0	7	4	0	0	0	0	0	0	0	0	0	0	0	0	0	3	0	0	0	1	6	0	0	0	0	0	0	0	0	0	0	0	0	0	0	1	0	0	0	0	0	0	0	0	0	0	0	1	0	0	16	0	0	3	0	17	25	1	14	0	0	0	2	0	0	0	0	0	7	0	0	23	5	0	0	0	0	0	4	0	3	4	4	0	0	0	0	0	0	0	0	6	0	0	0	0	0	2	0	39	0	9	0	19	11	0	5	0	3	1	0	0	559	0	0	0	2	38	3	0	7	0	0	0	1	0	0	0	7	1	0	1	1	0	0	0	0	0	2	0	1	0	30	2	0	0	2	0	3	0	6	0	0	0	0	0	0	0	0	1	0	0	2	7	0	0	0	0	0	0	0	0	1	0	0	0	0	14
LakWasM127_HOW14_2_rpkm	0	0	0	0	0	13	1	3	0	0	1	1	0	0	0	0	0	0	0	0	1	0	1	86	0	0	0	0	0	23	0	0	0	16	0	14	0	0	0	0	0	0	0	3	41	176	83	49	0	92	0	54	0	0	0	1	0	0	33	21	17	0	0	1	0	0	0	0	1	42	2	0	0	0	0	0	0	0	0	0	0	4	0	0	0	0	0	0	0	0	0	0	6	0	88	0	0	0	0	0	0	0	0	0	0	0	0	0	0	2	0	6	203	0	45	0	0	0	0	0	0	0	31	1	0	0	0	0	0	0	66	629	2	0	0	0	0	0	2	0	0	0	0	2	0	0	0	0	175	5	0	273	4	1	1064	0	0	1	79	0	19	3	0	3	1	0	0	3	0	4	0	0	0	0	0	0	0	0	0	0	0	0	0	0	0	3	0	0	0	0	4	17	36	24	0	0	0	44	54	80	1	0	0	0	0	1	4	0	0	0	91	27	32	80	27	0	7	38	0	0	0	0	0	1	0	4	0	0	46	0	0	0	1	0	0	0	16	0	58	1	0	0	65	1	42	3	0	0	0	0	2	30	50	0	2116	10	0	0	1	0	0	0	3	21	0	1	1	0	0	205	2	0	2	0	0	1	0	1	1	1	6	101	2	330	96	0	0	0	28	8	0	0	0	0	0	0	0	0	3	0	0	19	101	0	1	0	2	91	5	0	3	0	283	70	0	0	0	0	127	0	0	0	0	0	35	26	2	0	0	0	1	0	0	0	0	1	0	0	0	0	0	0	24	3	31	0	10	1	0	0	1	2	0	0	0	0	0	0	0	16	1	0	0	0	0	41	0	82	0	3	0	68	0	0	11	1	0	64	0	1	0	0	11	0	0	0	87	0	0	0	0	0	338	0	0	5	5	2	0	77	5	33	0	4	26	0	0	0	1	0	0	0	1	1076	0	22	21	1	1	0	0	0	0	0	0	0	0	0	0	0	1	0	0	1	0	1	0	0	15	0	39	0	0	0	0	218	0	0	0	0	0	129	1	1359	0	37	129	0	0	1	2	0	0	74	0	117	73	0	0	0	17	0	9	4	0	0	59	0	0	0	0	0	2	0	0	0	0	48	12	0	0	0	58	61	1	0	0	0	0	0	0	1	39	0	0	0	0	0	0	0	0	0	0	0	0	0	0	0	0	10	2	0	0	0	0	0	0	0	0	0	0	0	384	64	6	0	90	1	0	44	0	0	8	72	45	0	0	0	0	0	0	0	1	2	0	1	0	22	0	0	0	3	0	1	79	0	1	1	81	0	0	1	0	4	0	0	0	82	0	5	1	15	0	0	142	0	1	0	38	0	0	0	1786	2	25	19	0	0	1	0	43	0	0	24	11	11	0	45	0	1	1	892	8	262	0	0	329	0	345	0	4	2	51	45	0	14	0	7	0	13	0	1	0	0	0	0	0	0	0	2	0	279	0	0	0	0	0	24	5	0	1	0	12	9	0	0	0	0	0	0	0	3	0	0	0	0	0	0	3	0	2	19	0	47	1	0	1	0	0	0	0	0	1	1	0	0	0	0	0	22	0	0	9	0	0	0	0	1	0	1	0	4	0	1	0	0	2	0	6	0	0	31	0	0	3	2	0	0	26	0	0	0	0	1	1	0	8	0	80	0	0	0	1	0	0	0	1	0	0	0	0	23	3	0	3	167	2	0	0	9	0	0	0	0	0	0	0	0	11	0	0	1	0	33	0	0	7	0	0	2	0	0	0	0	0	210	0	0	0	0	0	0	3	0	0	0	0	0	0	0	11	1	0	0	0	1	65	0	0	0	0	0	0	0	2	35	404	0	0	0	0	0	0	0	58	0	0	0	2	0	0	0	0	0	16	0	0	2	1	9	17	0	0	1	0	1	1	50	22	0	0	0	0	0	0	0	0	0	60	85	0	0	0	0	0	0	1	0	0	4	57	0	0	0	0	0	0	0	0	0	0	0	0	0	0	0	0	0	10	0	0	0	0	1	0	11	137	0	0	0	0	0	1	0	0	0	0	0	0	1	0	0	47	0	0	0	1	0	0	0	0	0	0	2	0	0	0	15	2	3	0	0	0	0	0	2	0	0	0	0	0	0	0	0	0	0	0	0	0	1	0	0	0	53	35	0	0	23	0	0	0	0	0	0	0	0	0	0	0	0	0	0	2	1	0	12	0	0	0	0	0	32	31	1665	0	6	1	43	0	0	165	38	1	0	5	0	0	4	0	0	0	1	1	0	0	0	0	0	0	0	0	1	0	0	0	0	4	0	0	0	0	0	0	0	0	0	0	520	0	0	0	58	1	0	0	3	0	0	2	0	44	0	0	0	0	0	2	0	0	7	0	0	0	0	0	0	0	0	0	0	0	0	0	0	0	0	0	0	0	0	0	0	0	3726	0	0	0	0	0	0	7	0	2	0	0	0	3	2	1	12	0	2	0	0	0	0	0	0	0	73	0	0	0	0	4	0	0	0	0	0	0	0	0	0	0	1	1	1	14	0	0	0	0	0	9	0	0	10	0	0	0	1	0	0	0	0	1	6	198	0	0	4	0	0	0	0	0	0	0	0	0	0	0	0	2	0	0	0	0	0	0	0	0	0	0	0	0	0	0	0	0	0	0	0	1	0	0	0	1	0	274	0	0	0	0	0	33	0	2	0	0	1	7	1	0	0	0	5	0	0	0	0	9	1	19	23	0	0	0	197	3	0	0	0	1	1	5	0	0	0	0	0	0	0	0	0	1	0	0	1	0	0	19	0	0	0	0	0	4	1	0	0	0	0	0	0	1	0	0	0	0	1	168	7	0	1	0	0	0	0	103	0	0	282	243	0	0	0	4	0	4	0	0	96	0	1	0	0	0	0	0	0	0	129	0	1	12	58	0	247	0	0	0	1	0	19	0	0	36	0	0	1	0	0	0	22	0	0	1	0	0	0	0	0	0	0	0	0	0	8	0	0	0	1	0	0	0	1	0	0	0	0	3	0	0	4	1	0	0	0	0	0	0	2	0	0	72	7	92	1	0	7	96	0	0	0	0	0	0	19	0	0	0	0	0	2	71	16	0	0	0	0	0	0	11	0	13	0	0	5	0	0	2	45	0	1	19	0	0	0	0	0	0	0	37	0	74	33	12	23	16	1	29	0	0	34	0	20	0	0	0	6	0	37	7	0	23	0	7	0	0	0	7	18	5	0	70	0	0	0	0	0	0	2	0	0	0	0	0	0	0	69	0	0	0	0	12	10	0	1	0	0	0	1	0	0	0	1	0	0	0	0	0	13	16	305	36	1	0	0	0	0	0	0	0	106	0	0	0	9	3	0	0	1	187	1101	5	109	0	0	32	222	1	0	0	2	0	0	0	0	187	0	78	1	162	3	0	3	1	42	0	0	0	0	0	0	8	159	0	0	0	6	0	102	0	0	1	0	0	9	0	3	0	0	0	0	17	0	0	1	0	0	0	0	1	0	0	0	0	0	0	0	0	6	0	0	0	0	3	0	0	0	15	0	0	0	0	0	1	1	0	1	0	42	0	0	0	0	0	0	0	0	0	0	0	0	0	0	0	1	0	0	1	0	0	0	0	12	0	0	1	0	1	1	0	111	0	53	273	0	0	1	0	16	3	7	0	0	0	0	452	1	87	0	0	0	0	0	0	0	0	0	5	0	0	0	5	0	0	0	0	0	0	0	0	0	0	1	1	45	0	0	0	0	11	1	0	0	0	0	0	0	0	0	0	1	0	0	0	0	1	1	0	116	15	0	0	70	0	0	0	1	0	6	1	9	0	0	1	0	0	0	0	0	0	0	1	0	53	10	0	68	165	27	280	126	0	0	0	0	0	1	0	0	0	0	149	0	0	0	0	1	2	0	0	55	78	0	331	1	0	12	0	2	0	2	5	0	18	1	0	0	0	0	0	1	10	202	0	19	0	2	0	0	0	0	0	31	2	0	1	2	0	0	0	2	87	497	6	556	0	2	0	19	0	35	0	0	1	1	0	0	0	0	0	1	0	0	0	1	1	25	8	19	0	0	0	0	0	0	0	0	0	0	0	0	0	0	19	0	0	0	1	0	0	91	0	0	20	0	0	2	0	0	1	0	0	0	0	0	4	31	0	1	0	33	0	0	0	1	0	0	0	0	0	0	0	0	0	26	2	0	0	1	0	0	9	0	0	0	0	0	2	0	0	0	19	0	1	0	0	1	0	0	37	0	0	88	0	0	0	1	936	7	38	0	0	57	104	0	40	0	129	0	25	0	2	0	2	0	0	28	0	0	0	0	0	0	0	0	0	0	0	0	0	0	3	40	0	4	0	0	111	0	0	0	0	0	0	0	0	0	0	0	0	0	25	0	0	0	5	6	2	33	0	0	1	0	2	1	63	0	0	70	0	0	0	0	0	0	0	0	0	0	0	0	0	0	0	19	0	0	0	2	0	0	0	0	0	0	0	0	107	0	4	14	1	0	0	0	11	0	3	100	993	7	0	0	0	0	0	0	0	0	0	2	2	0	0	0	0	1	0	1	2	0	0	0	0	0	0	0	0	2	0	0	57	1	0	112	15	0	53	0	31	43	19	0	0	0	0	0	0	0	5	0	0	0	0	0	79	0	0	0	1	0	0	0	0	0	0	0	0	0	1	0	0	0	0	0	0	0	0	0	0	0	0	0	0	0	0	1	2	0	0	91	0	0	4	0	0	0	0	0	1	0	0	0	607	0	0	779	0	0	1	459	0	0	1	0	0	0	0	0	0	0	0	0	17	35	28	0	0	71	0	0	0	5	0	17	27	38	1	0	1	0	0	0	7	0	31	2	0	1	0	0	0	0	0	1	0	1	0	0	0	0	0	0	11	1	1	0	0	0	0	0	0	3	1	0	1	0	1	210	0	0	0	298	0	0	0	0	0	0	0	0	0	0	0	0	0	0	0	0	0	0	0	0	0	54	0	0	0	2	0	15	0	0	0	0	0	5	24	0	4	0	0	0	0	1	325	6	0	4	0	0	0	0	0	5	51	54	31	0	0	0	2	0	0	0	0	0	1	0	1	0	0	0	0	73	0	0	0	0	0	0	1	0	10	1	0	0	0	0	12	1	0	14	0	0	0	0	0	5	0	0	0	0	4	0	0	0	14	3	1	2	1	0	5	0	0	0	0	0	0	0	0	1	0	0	0	0	0	0	0	0	0	0	0	0	0	0	0	0	0	0	0	0	0	0	1	0	0	0	0	0	0	0	0	0	4	0	1	2	2	0	55	0	0	2	1	0	0	0	0	17	25	0	0	0	1	0	2	103	28	7	20	24	8	2	5	134	3	55	1	8	0	5	1	6	12	0	2	0	33	3	54	124	3	32	2	2	6	3	4	53	0	0	0	0	0	0	0	0	0	0	3	103	0	0	1	0	0	0	0	0	0	0	0	0	0	0	0	0	0	0	0	0	8	1	70	0	4	17	2	0	0	0	0	0	0	0	0	27	0	0	1	0	0	0	0	0	0	71	0	0	2	0	0	26	0	33	0	1	4	9	0	0	0	1	0	0	0	1	0	0	0	0	5	0	0	2	0	0	0	0	0	0	0	0	0	0	27	12	0	6	0	0	0	0	0	0	0	0	0	1	14	0	0	0	0	0	0	161	0	0	32	202	0	0	0	0	0	1	0	0	0	0	0	0	0	1	29	6	0	0	0	0	0	0	73	47	42	0	0	37	60	47	9	5	0	136	43	11	0	0	0	0	0	0	0	0	0	0	5	12	0	0	0	0	0	0	0	0	7	0	0	0	0	1	0	0	0	3	0	30	0	0	1	10	0	0	0	0	3	0	2	0	0	1	0	6	0	963	8	0	0	15	3	0	0	0	0	13	0	0	0	0	119	0	3	0	0	1	0	0	0	0	16	0	0	11	13	0	0	0	0	96	0	0	4	0	0	0	0	0	0	1	0	11	1	3	0	0	0	0	1	0	0	0	0	0	0	0	0	0	0	0	0	0	0	0	0	0	1	0	1	0	0	1	56	0	1	0	0	0	0	0	86	194	3	0	40	0	0	0	0	0	0	1	0	0	0	0	0	0	0	0	43	6	51	27	0	0	0	21	0	0	0	0	104	80	0	0	0	0	0	0	0	0	0	0	0	0	0	0	0	0	0	0	76	1	0	0	0	0	0	0	1	4	0	16	32	1	11	0	0	0	0	0	49	1	0	0	0	0	0	0	0	0	0	0	12	0	0	0	114	0	0	0	0	0	0	0	0	0	0	0	0	0	0	0	0	0	0	0	0	0	0	7	0	0	0	0	0	15	0	0	0	0	0	0	0	3	5	0	53	0	1	20	0	0	2	0	1	0	59	0	1	24	0	27	0	0	0	0	0	0	0	0	0	1	0	0	0	0	0	0	334	0	1	3	63	0	0	1	3	2	0	0	0	6	0	0	1	0	0	2	0	0	12	1	1	1	0	6	0	0	0	0	0	13	0	24	0	70	64	51	85	76	52	56	91	0	103	75	53	0	1	0	0	0	22	0	0	45	0	11	0	1	43	29	0	0	0	0	0	0	0	0	0	0	1	0	33	0	0	0	0	3	0	0	0	0	0	0	0	0	0	0	0	32	0	1	9	0	16	0	0	26	0	0	0	0	0	0	0	27	0	1	9	11	7	1	28	0	1	0	0	2	61	0	0	0	0	2	0	0	1	0	0	0	0	0	0	0	15	203	0	0	54	9	0	24	0	10	0	1	0	79	44	0	0	1	0	21	0	1	0	0	8	0	6	6	0	0	12	0	0	0	79	1	0	0	1	0	0	0	3253	14	1	1	0	0	0	0	0	1	0	125	0	28	0	0	0	0	4765	970	55	0	1	0	111	0	10	0	213	2	2	0	1	0	0	0	0	2	0	0	0	0	0	0	0	0	0	0	0	0	84	775	0	1	0	0	0	0	0	4	0	0	0	0	0	0	33	5	0	1	1	0	9	2	0	40827	77	303	0	0	1	0	0	0	87	0	0	61	0	0	0	0	0	0	0	0	0	3610	0	1	0	0	0	0	2	0	0	0	0	0	0	0	1	0	1	13	0	1	0	0	0	1	0	0	0	0	0	0	8	0	0	0	1	0	0	1	0	0	0	59	0	0	0	0	50	0	0	0	0	0	6	0	0	33	0	0	0	3	0	0	0	1	0	0	133	0	0	0	0	0	0	1324	12	0	2	0	0	1	1	57	2	1	1	0	0	116	9	0	75	0	0	1	0	0	0	0	0	0	0	0	1	0	1	0	0	0	1	0	0	0	0	0	0	0	3	0	0	0	0	0	0	0	0	0	0	0	0	0	0	0	0	0	0	0	0	0	0	0	0	59	0	0	22	2	150	5	0	64	0	0	0	0	0	0	1	28	11	0	0	1	0	39	0	74	0	0	1	0	0	0	0	43	0	0	0	1	13	0	0	0	0	6	0	0	3	13	0	0	0	1	0	0	0	1	0	0	1	0	2	0	91	0	0	0	0	0	0	0	0	7	9	50	6	0	0	0	0	0	106	218	0	15	0	0	0	0	0	0	0	0	0	0	0	0	0	0	4	0	5	0	0	0	0	0	0	0	0	0	98	1	38	0	0	0	0	0	0	1	0	0	0	0	0	0	48	4	0	0	2	0	6	7	6	0	0	97	0	0	0	0	123	0	0	0	12	0	0	0	1	0	0	0	220	0	0	1	0	1	0	0	0	0	0	1	2	0	0	0	0	0	0	111	0	0	0	0	0	0	0	1586	0	0	0	137	0	0	0	0	0	0	2	1	3	0	1	1	0	0	0	0	0	31	0	0	0	0	0	0	0	0	0	0	0	0	0	0	4	1	0	0	1	0	0	39	0	0	0	0	0	0	0	0	0	0	0	0	0	0	1	0	0	0	0	0	0	0	0	0	1	0	0	0	0	2	1	0	0	0	0	0	0	0	0	8	26	0	0	0	80	0	0	2	0	0	0	0	0	0	0	0	0	0	0	0	0	0	0	1	1	0	0	0	0	0	0	0	0	9	0	2	5	0	1	0	1	0	8	0	0	0	0	0	0	0	0	4	0	0	0	0	0	0	0	0	0	40	1	0	0	1	0	0	0	0	0	0	0	1	0	0	0	0	3	0	0	0	0	0	0	0	0	0	0	0	0	0	0	0	0	0	0	1	0	0	0	0	0	0	0	0	3	0	0	0	0	0	0	10	2	2	0	0	0	8	0	4	0	0	0	0	0	0	0	0	0	120	0	0	0	0	0	0	0	0	0	0	0	0	0	0	0	0	0	1	0	0	0	1	0	0	0	0	0	0	41	0	1	0	0	44	0	0	0	0	0	7	0	0	0	11	0	0	2	0	0	0	1	0	4	0	0	0	0	0	0	0	0	0	0	0	0	0	0	0	0	0	0	10	2	0	0	0	0	0	0	1	19	19	0	0	0	0	0	0	0	0	0	0	241	0	0	13	17	1	0	0	0	15	0	0	3	1	0	757	0	0	0	1	0	0	0	0	0	2	0	1	52	30	0	63	0	800	0	74	0	0	1	101	1	0	0	0	0	2	1	0	0	0	0	0	1	0	0	0	0	0	0	25	0	0	0	0	0	1	5	0	0	1	0	0	0	0	0	0	0	0	0	0	0	1	0	207	0	70	0	0	0	0	0	0	0	0	0	0	55	1	0	0	0	0	0	0	0	0	0	0	0	0	0	0	0	0	0	0	0	1	0	0	0	58	0	0	0	0	0	153	0	0	0	0	0	0	0	0	0	0	20	0	0	0	0	0	0	0	0	0	0	0	608	0	0	0	2	0	2	0	0	204	0	0	0	0	0	0	0	0	0	0	0	0	2	0	1	0	0	0	1	0	0	0	1	0	0	0	0	0	0	116	0	0	0	0	0	0	0	0	0	2	0	0	0	0	0	0	0	0	0	0	0	0	0	0	0	0	53	0	0	0	0	0	0	239	0	0	0	0	0	0	0	1	0	0	0	0	0	0	0	0	7	1	1	0	0	0	48	0	0	0	0	0	0	0	0	0	0	0	0	0	2	0	17	0	0	0	0	0	1	0	1	0	0	14	0	0	0	0	0	0	4	0	262	1	0	0	0	1	0	0	0	0	0	121	408	0	0	0	0	7	0	0	0	7	7	56	3	0	29	0	0	0	0	1	0	0	175	0	0	0	0	0	0	1	0	3	0	0	18	1	0	0	0	0	0	0	0	0	0	0	5	0	1	0	0	0	33	0	0	0	0	0	0	0	0	0	2	0	0	0	0	0	38	0	1	1	0	8	0	0	1	6	0	0	0	80	0	0	0	92	41	12	787	2379	0	0	1	0	7	1	29	4	4	0	0	0	14	7	0	179	0	1	29	0	24	0	0	0	0	0	0	0	1	0	1	1	0	0	1	0	1	20	93	1	0	2	0	1	0	0	0	0	1	0	1	0	0	0	0	0	0	5	0	0	0	0	0	140	22	0	0	0	1	0	0	0	0	0	0	0	0	0	0	0	0	1	0	1	8	35	0	0	0	60	0	18	1	0	0	0	0	0	6	0	1	0	5	115	1	0	0	2	0	0	0	0	0	0	0	0	0	0	0	78	16	0	0	2	0	0	0	0	0	0	0	1	0	0	4	0	0	0	0	0	2	0	3	5	0	0	0	0	0	1	0	9	1	0	1	0	0	0	16	0	0	2	0	60	0	1	23	0	18	0	1	124	0	0	0	0	0	1	0	1	0	0	0	144	247	81	0	1	7	3	4	0	0	46	4	4	5	162	6	0	15	5	4	1	2	0	25	11	53	0	52	0	13	0	0	0	0	0	0	0	0	0	0	0	0	1	0	0	0	0	0	0	0	0	0	1	14	1	1	0	0	0	0	7	0	0	41	0	0	0	5	0	0	151	0	0	0	0	0	0	0	125	11	0	1	0	0	2	1	0	1	12	0	7	0	0	0	1	0	0	39	200	0	90	119	3	0	0	0	0	0	0	1	0	0	0	0	0	0	0	0	1	0	0	0	0	5	0	0	0	0	169	0	0	0	0	5	0	1	0	1	0	248	1	2	13	25	0	0	0	0	0	2	1	0	1	1	1	2	0	0	0	0	0	0	0	0	1	0	0	0	0	211	0	0	0	0	0	0	0	3	1	4	0	0	0	1301	117	0	0	14	0	0	65	0	36	15	0	0	1	0	0	0	0	0	0	0	0	0	0	0	0	0	0	0	0	0	0	0	2	133	0	0	22	26	0	0	0	0	0	0	0	70	0	0	11	0	2	6	3	1	32	0	0	0	22	0	64	0	0	5	0	54	1	0	0	0	3	0	0	0	0	0	0	0	0	0	2	0	0	0	59	0	1	1	0	15	0	0	0	18	0	0	0	1	1	0	0	0	0	7	72	2	0	1	0	0	0	2	0	2	0	1	0	0	17	1	0	7	2	0	52	0	0	2	0	1	0	0	78	0	2	0	4	1	0	7	0	0	0	0	0	0	1	0	17	0	0	0	0	0	0	0	0	3	0	0	1	45	7	5	0	0	64	1	1	29	0	0	0	0	0	0	0	0	5	0	0	0	0	0	0	1	0	0	0	0	0	0	0	0	1	1	0	0	0	0	9	0	0	0	0	252	0	6	0	0	0	0	0	55	0	0	0	0	0	0	0	8	2	0	0	13	29	0	1	0	0	1	0	125	0	0	0	0	0	0	0	0	1	1	0	0	0	0	1	15	0	0	0	0	131	1	29	0	0	0	0	0	0	0	0	0	0	0	0	83	1	0	1	0	0	0	0	0	0	182	0	262	5	40	102	2	2	0	0	0	0	14	1	1	0	4	1	0	0	0	0	1	47	0	44	11	0	12	8	31	263	2	0	0	0	78	0	4	0	11	0	0	0	0	0	0	0	0	0	0	0	0	0	2	0	0	0	0	0	0	0	0	58	35	0	0	0	0	2	2	31	0	3	0	1	0	0	38	0	2	0	0	0	1	11	2	83	22	0	71	3	0	0	64	0	5	2	0	0	0	0	0	1	0	0	1	55	0	0	2	0	0	39	1	0	1	0	0	0	0	28	7	0	0	2	0	0	18	0	1	0	0	8	0	0	0	0	0	2	0	0	0	0	0	13	0	1	47	1	0	1	0	0	0	1	0	364	0	1	50	0	83	0	2	0	44	0	0	0	0	0	0	0	0	0	0	0	0	0	0	0	0	163	0	14	0	0	469	0	7	0	0	0	10	2	1	16	0	0	0	515	0	0	9	0	0	0	0	1	3	0	0	1	0	0	0	30	5	0	1	0	0	0	0	16	2	0	0	7	0	0	0	2	3	0	1	1	1	0	1	0	0	0	0	0	0	0	1	0	0	0	0	0	0	0	0	0	2	0	0	0	0	0	0	1	0	0	0	0	0	0	0	0	0	0	0	0	77	0	0	0	0	0	0	0	0	2	0	0	6	0	0	0	1	0	1	0	0	0	7	0	0	0	0	2	0	1	0	0	0	1	0	0	0	0	0	0	0	4	0	0	1	0	0	0	0	0	0	0	1	2	0	0	0	98	1	0	0	0	0	0	0	0	0	0	6	0	0	2	0	0	0	0	0	0	0	0	54	0	2	0	0	42	0	0	0	1	5	0	0	18	0	0	0	0	0	0	0	0	1	0	0	2	6	0	0	0	0	49	80	0	0	0	0	2	0	0	0	0	0	0	20	0	0	0	0	0	0	0	0	0	2	264	0	0	0	0	0	0	0	0	43	0	0	12	0	0	0	0	0	0	0	0	0	0	0	5	0	1	0	0	0	0	0	0	0	0	17	0	0	0	0	0	0	0	119	0	0	0	0	0	119	16	0	0	0	0	0	1	0	0	2	0	0	0	0	1	0	48	0	10	0	1	0	0	0	0	0	0	0	0	0	0	0	0	0	0	0	0	94	3	44	1	1	1	1	1	0	0	3	1	1	0	0	56	26	48	2	0	4	22	0	75	0	0	0	6	137	0	1	0	0	0	1	0	0	0	0	226	14	0	0	224	565	0	0	0	2	20	5	0	0	0	1	0	0	41	0	5	0	0	0	0	0	0	0	2	0	0	30	0	0	1	0	0	37	0	1	0	2	0	43	0	67	2	1	41	0	0	0	0	67	0	0	0	0	1	0	2	0	0	0	0	0	0	0	38	2	0	0	0	0	54	36	1	0	8	1	493	0	0	0	0	0	0	1	0	0	0	0	0	0	0	28	0	0	0	0	23	0	20	0	3	7	1	2	0	0	1	0	0	0	0	0	0	0	0	0	1	0	0	0	0	10	1	0	0	0	2	0	1	0	0	0	0	0	0	12	0	0	0	0	0	1	0	1	0	0	0	0	17	9	3	0	0	0	0	0	0	4	94	1	0	0	0	0	0	0	0	0	1	0	4	9	0	0	0	0	0	14	7	10	1	7	1	7	2	0	4	1	0	0	3	9	2	0	0	0	0	0	0	0	0	0	0	0	0	0	0	0	0	0	0	0	0	0	92	0	0	0	0	0	0	0	1	1	2	0	4	216	13	0	0	0	0	35	0	0	0	74	1	115	72	0	0	0	1	0	1	0	3	0	0	0	168	0	0	0	47	0	0	0	0	0	1	45	8	130	0	0	20	0	0	0	3	31	0	0	22	0	0	65	0	184	4	39	1	1	0	0	16	0	0	1	1	0	11	2	0	1	0	0	1	0	21	0	0	1	0	1	1	0	4	0	0	0	74	0	24	1	0	123	1	0	0	1	0	0	268	5	18	18	68	0	1	64	1	38	0	22	0	0	0	0	0	30	0	0	0	0	7	2	0	0	0	0	0	1	0	3	1	0	5	19	3	3	0	157	1	0	0	69	2	0	0	0	0	0	0	0	0	0	0	0	0	0	0	31	23	1	0	0	0	0	0	107	0	0	0	0	4	0	0	0	0	0	0	0	0	0	0	0	73	0	0	0	0	2	0	721	676	82	31	0	0	1	0	0	0	49	2	1	1	1	0	0	0	0	71	0	0	0	160	23	13	18	0	1	4	0	0	0	0	0	67	0	1	1	0	0	0	0	0	119	121	36	1	0	1	1	1	2	3	2	0	0	0	0	26	1	0	0	1	5	0	40	211	2	3	2	1	88	0	0	0	0	0	0	9	0	0	0	0	0	173	28	0	0	3	0	297	1	1	0	0	0	0	0	39	36	2	1	0	0	0	0	1137	0	104	44	245	34	133	69	0	0	588	34	0	97	1	0	0	14	41	1	0	0	0	0	0	0	0	0	1	31	0	0	0	1	0	1	2	2	258	138	1	2	1	99	0	144	122	107	0	0	176	0	0	0	0	0	0	0	0	1	0	0	0	0	0	0	0	0	0	4	0	0	16	0	0	0	21	0	20	0	0	184	0	6	0	12	1	140	51	7	1	0	0	0	0	925	120	2	1	0	0	1	0	142	0	1	3	0	0	0	53	0	1	0	0	1	0	0	37	79	0	0	0	0	0	0	0	0	8	0	0	0	0	0	3	0	9	0	49	1	0	0	0	0	1	1999	0	6163	0	47	0	13	42	4	5	0	0	0	0	0	0	0	0	63	1	14	0	0	0	0	0	0	1	0	0	0	0	832	0	0	21	0	0	3	0	0	0	0	168	0	0	0	0	0	0	0	0	1	26	0	2	0	0	1	0	1	0	0	0	0	0	0	0	0	13	0	0	68	1	0	0	0	0	0	0	0	113	0	0	0	1	0	0	0	0	224	0	0	0	1	0	0	0	0	0	1	0	1221	0	1	86	15	0	0	0	0	0	0	0	29	29	0	0	0	0	0	7	0	0	1	0	0	0	0	167	0	0	0	0	0	1	0	0	0	0	0	0	0	1112	4	20	0	1	219	0	1	303	3	127	102	1092	1502	451	0	670	299	417	0	0	620	3	0	10	2	3	91	1	4492	2	3	0	0	0	200	0	0	0	0	43	35	0	0	1	0	0	113	0	3	0	44	18	45	1	76	4	43	0	31	0	0	0	73	1	15	67	1	0	0	0	0	0	0	0	0	0	62	0	0	1	0	92	0	1	61	0	0	0	0	0	40	0	0	0	11	0	0	35	1	0	0	0	0	0	0	0	89	0	0	1	25	1	0	150	0	0	1	2	86	1720	1	41	0	0	5	0	4	7	0	4	0	176	0	0	1	0	0	43	0	11	277	1	0	18	0	96	3	0	0	32	1	0	0	59	0	29	0	5	0	123	0	0	0	0	1	0	28	16	0	0	8	0	0	1	1	0	0	0	0	0	0	0	0	89	1	0	2	7	0	1	136	40	0	0	1	1	0	0	0	0	70	0	0	0	20	114	0	37	62	0	0	12	0	0	0	0	1	1	0	0	1	0	0	68	152	60	59	0	0	0	0	0	1	0	2	0	2	0	4	1	0	0	0	0	0	0	80	3	0	2	0	0	0	0	0	0	18	0	1	0	0	0	0	0	0	6	0	0	0	0	0	0	0	0	0	0	22	0	0	0	0	0	0	48	16	0	1	0	19	18	0	0	0	0	0	0	0	27	0	0	9	0	0	0	0	4	0	0	0	14	17	0	0	0	0	0	0	0	0	0	0	2	131	0	0	0	0	0	0	17	1	117	0	0	0	0	0	2	0	41	8	46	24	0	0	4	0	0	376	2	0	0	0	1	305	163	11	67	2	0	222	0	145	0	278	0	0	3	130	463	104	18	71	19	67	130	32	0	77	0	0	70	26	32	4	1	122	0	69	196	0	64	0	115	5	1	108	1	54	27	3	51	0	0	0	0	268	0	1	71	62	48	136	0	0	4	404	591	2169	0	4	69	0	0	0	0	1	2	0	7	1	0	0	2	22	279	18	0	10	0	0	0	0	0	0	7	0	3	0	4	0	3	118	299	0	203	72	165	0	0	0	2	2	144	53	0	1	70	4	2	0	151	0	0	43	5	0	0	0	57	0	0	0	77	0	0	1	0	0	0	0	208	1	0	0	0	0	67	1	0	2	0	0	6	0	0	0	55	0	0	0	0	1	0	0	0	1	2	0	0	0	0	0	0	1	0	2	3	1	1	1	37	92	130	158	1	0	0	0	0	0	0	0	0	0	0	0	0	0	0	0	0	0	4	0	3	0	0	0	0	1	10	0	0	0	0	1	0	0	0	0	0	0	0	0	0	0	0	75	0	2	0	0	0	0	539	17	47	239	0	280	0	169	0	0	0	0	0	0	0	0	0	2	0	0	0	16	2	29	0	0	0	0	0	0	0	0	0	3	12	0	0	1	0	3	0	0	114	56	0	0	0	19	0	0	34	3	65	0	40	0	0	1	0	0	54	0	278	0	0	0	3	67	0	3	10	24	0	49	1	0	0	49	1	0	1	171	104	19	0	5	0	0	19	97	2	3	0	0	0	0	0	0	0	0	2	0	0	0	0	0	53	18	1	42	1	0	0	0	0	0	0	0	0	0	32	0	0	0	0	0	0	0	0	0	195	14	4	0	0	0	0	1	0	0	0	0	0	0	0	14	0	0	0	0	0	0	0	0	0	0	0	62	0	51	0	0	1	0	0	0	1	0	0	0	34	0	0	0	53	0	0	0	0	1	0	0	1	1	0	1	119	65	34	0	0	1	1	1	0	0	0	0	0	0	0	1	0	1	1	0	0	0	3	0	1	0	1	0	61	26	0	0	0	0	1	5	2	8	6	11	16	0	0	0	0	1	0	1	1	2	0	0	1	1	0	3	0	0	81	1	0	0	43	0	0	0	0	77	0	21	1	1	45	0	0	16	0	1	0	0	1	0	0	0	0	120	1	0	31	0	46	0	0	0	0	272	0	0	0	0	0	233	0	0	0	1	1	1	0	3	1	0	0	1	1	0	0	0	1	2	0	3	0	0	38	19	0	0	0	0	48	0	0	0	0	0	133	19	0	1	0	0	453	0	86813	0	0	0	0	0	88	0	0	0	0	0	0	0	0	0	0	77	0	0	0	0	0	5	34	1	0	1	48	1	0	0	0	0	0	0	18	0	25	89	0	4	0	0	0	0	0	1	3	0	1	0	0	1	0	3	34	30	51	67	2	2	85	0	15	0	0	0	0	0	236	94	161	883	0	0	0	1	2	4	0	7	226	6	0	153	0	0	0	0	3	0	0	2	1	63	2	0	23	2	0	0	184	197	1	0	127	0	0	0	6	0	0	0	0	1	0	0	0	57	112	2	133	105	1	26	115	1	1092	2	4	256	15	31	16	61	1	181	171	0	1	34	0	0	12	0	3	0	64	54	133	207	108	12	37	0	0	137	110	1	14	0	0	0	0	0	0	0	0	0	0	0	0	0	8	1	6	0	21	0	0	0	29	0	0	0	0	27	23	32	7	0	0	0	0	0	6	12	0	0	14	0	0	0	0	3	42	52	0	3	0	0	0	10	51	0	6	1	0	0	0	0	0	0	0	0	0	0	1	4	0	5	0	4	31	37	0	0	1	4	0	0	0	0	0	111	2	10	0	0	0	93	4	0	0	3	0	245	0	0	17	2	0	0	0	0	0	1	0	0	0	0	0	0	0	1	1	3	0	0	0	0	0	0	16	0	0	0	0	0	9	0	0	0	0	1	0	0	0	0	0	0	0	0	0	0	0	0	0	0	0	0	0	128	0	0	0	0	1	0	0	0	0	0	0	0	2	37	39	1	256	30	0	1	51	123	132	14	113	0	1	1	3	56	0	0	1	0	57	0	17	17	0	0	0	0	0	0	0	0	32	0	27	1	30	2	0	0	0	1	0	3925	40237	0	1	0	0	0	0	0	61	1	51	0	0	0	0	50	39	1	2005	1	2	0	45	152	0	56	0	697	0	0	3	1	864	0	0	1	0	0	1	0	0	99	0	0	109	62	88	0	0	0	153	6	3	0	0	0	0	0	1	0	0	0	0	0	1	35	1	0	0	0	1	0	0	5	2	4	1	2	1	11	2	0	0	1	1	0	56	148	25	100	231	44	78	84	0	0	19	28	87	54	0	0	4	2	3	0	2	0	0	0	0	2	84	0	0	0	0	0	0	0	0	22	0	57	0	0	0	3	96	14	0	0	14	0	0	0	1	1	0	0	1	78	0	105	0	0	0	0	0	0	0	1	0	1	0	2	0	1	0	0	1	0	0	12	181	0	0	1884	0	0	0	2	0	0	0	2	1	5	0	0	0	0	0	0	0	0	0	0	0	0	0	0	0	0	0	0	0	0	3	0	18	16	22	354	31	67	0	0	0	0	0	0	0	0	0	12	0	0	0	0	0	0	0	167	0	0	0	0	0	17	0	0	0	0	0	0	0	26	0	0	176	0	0	0	18	1	28	0	0	49	0	0	0	2	5	0	89	51	64	0	366	0	2	4	9	0	1	3	0	0	52	0	0	0	1	245	27	0	0	2	0	0	0	7	0	0	0	0	163	0	0	0	0	1	2	0	1	1	0	0	1	1	0	0	0	0	0	0	0	2	2	0	0	0	5	155	1	0	0	0	0	0	0	0	0	36	1	0	0	1	0	0	61	0	0	0	0	0	7	0	0	0	107	1	0	105	5	1	0	0	0	0	1	34	0	26	0	0	0	0	0	0	345	1	1	0	0	3	0	0	0	32	150	40	1	7681	0	38	176	19	0	88	0	499	65	237	34	0	0	0	4	2	0	0	4	0	25	1	0	1	0	0	0	4	557	7	0	1	0	0	936	0	4	0	0	0	153	59	0	0	0	0	23	0	0	49	0	1	4	20	28	0	0	0	0	57	0	11	0	0	0	0	0	0	0	4	0	0	2	0	0	4	0	0	0	0	2	1	0	0	21	54	24	103	1	1	35	61	65	37	29	78	0	0	0	0	0	0	0	0	0	785	0	0	0	459	241	36	19	0	499	0	7	50	3	0	0	1	0	0	0	0	0	0	0	0	6	989	66	2	0	0	0	0	1	0	0	0	0	0	0	1	1	0	0	0	0	0	0	0	0	1	0	0	0	0	0	0	0	0	0	1	0	0	0	0	0	0	0	0	14	0	1	0	0	0	0	0	0	0	0	0	0	2	0	0	0	17	0	9	0	0	1	5	0	0	2	0	0	1	0	1	0	0	23	474	24	249	11	0	2	1	0	1	0	20	17	0	0	0	0	29	1	7	0	0	39	0	9	15	0	1	28	0	0	3	12	38	206	2	0	1	0	0	0	0	0	0	108	1	30	0	21	0	173	3	0	189	0	1	35	19	0	0	0	22	275	44	1	0	49	110	29	1	51	0	42	1	0	0	0	0	2	0	0	0	0	0	0	24	0	11	40	0	0	3	10	6	13	33	0	18	1	0	15	0	84	0	23	42	0	4	229	1	69	0	0	0	0	0	0	0	0	0	179	0	11	25	0	0	32	0	0	0	0	0	0	0	0	0	0	3	1	0	1	36	13	1	27	26	82	136	3	0	20	0	0	0	0	0	2	2	1	0	0	0	72	0	0	0	4	3	13	0	0	0	0	0	0	37	21	1	31	85	0	0	0	1	0	0	39	4	21	0	3	5	0	0	0	86	0	0	0	0	0	0	0	0	0	2	0	0	5	2	0	0	0	0	0	0	0	0	0	3	0	0	0	0	0	0	2	2	0	0	0	0	1	0	0	0	56	0	39	31	0	34	55	14	23	35	19	12	0	60	0	1	0	0	0	0	0	0	0	0	0	0	0	62	0	0	0	1	1	0	0	0	24	1	0	57	0	0	1	0	50	0	0	0	0	0	0	1	0	1	16	2	0	0	0	0	0	0	0	0	0	0	1	2	0	1	0	0	2	0	0	133	0	0	0	0	0	0	0	0	0	0	39	0	3	0	29	0	30	645	0	0	0	0	0	0	0	0	0	1	0	0	0	0	0	0	0	0	0	0	0	0	0	0	0	0	0	5	0	0	0	0	0	12	0	0	448	0	0	0	0	0	1	1	0	0	0	0	0	0	71	13	0	0	0	1	0	0	0	0	0	0	0	0	0	1	0	0	2	0	0	51	0	0	1	0	0	5	75	0	0	9	0	0	0	0	0	0	0	0	0	0	0	0	0	0	0	2	0	0	1	0	0	0	0	1	1	0	0	0	0	0	0	0	0	0	0	0	0	0	0	4	0	0	0	0	0	0	0	0	0	0	0	0	0	40	0	0	0	0	0	0	0	0	0	0	1	0	0	0	0	17	0	0	0	3	0	0	0	0	0	0	0	0	0	1	0	0	0	0	0	0	0	91	0	0	0	0	0	0	0	0	0	0	0	0	0	0	0	0	0	0	0	0	23	0	1	0	1	0	51	0	0	1	0	0	0	0	0	0	0	0	0	0	3	0	0	2	0	0	0	1	3	0	0	0	11	0	0	0	1	0	26	2	2276	0	0	0	0	0	0	0	1	0	4	0	0	0	0	0	0	0	0	1	0	0	0	0	0	92	0	0	0	0	1	0	0	0	0	1	0	0	0	0	1	0	0	0	1	0	2	0	0	0	0	0	0	0	0	3	1	0	0	1	1	0	17	0	0	0	1	0	9	0	0	0	0	1	2	3	0	0	0	0	1	0	1	1	0	0	3	0	0	0	3	0	0	1	0	0	1	0	0	0	0	1	0	0	1	0	1	89	0	2	1	0	1	57	1	7	32	4	3	0	0	0	94	0	0	0	0	0	2	0	1	0	0	40	0	0	0	0	0	0	0	1	0	608	23	4	0	1	1	0	0	121	0	211	0	40	17	3	0	0	24	0	0	2	0	0	0	0	0	0	0	0	14	1	36	0	0	0	0	0	0	4	0	0	0	0	0	0	0	0	0	0	0	0	0	0	0	0	0	0	0	0	0	0	0	221	0	3	0	0	4	0	0	6	2	0	0	0	0	0	2	0	0	0	0	2	0	412	0	22	1	21	0	0	0	0	0	0	0	0	0	0	0	0	0	0	0	0	3	0	620	0	0	0	1	0	0	0	1	0	0	519	0	0	0	0	0	0	0	0	0	1	0	0	0	1	0	0	0	0	0	0	0	1	68	34	0	212	16	0	0	0	0	0	0	2	0	2417	0	1	0	7	0	0	0	7	5	9	2	0	0	1	0	0	0	0	0	0	34	11	1	20	0	40	3	48	0	0	0	1	0	0	0	0	0	0	0	0	0	0	0	0	0	0	2	0	1	39	0	0	27	0	0	0	0	0	0	18	2	82	47	126	235	0	46	137	1489	3	122	0	0	53	0	0	0	1	0	0	0	0	0	0	49	18	0	0	0	1	299	1	0	0	0	87	0	0	0	0	0	0	2	0	12	0	1	27	0	82	0	0	0	0	0	0	0	2	24	0	8	0	20	1	3	0	0	67	0	12	0	0	0	0	25	0	28	0	1	0	29	6	2	0	2	0	0	6	0	0	1	10	7	4	0	0	0	0	0	0	0	5	0	0	0	0	10	0	0	11	70	1	0	17	0	3	31	68	61	0	2	0	0	17	0	36	88	0	0	0	0	23	0	21	61	1	59	1	0	0	0	0	0	0	0	0	0	1	232	0	35	1	1	0	0	0	1	27	33	0	1	0	1	7	2	0	0	2	23	12	1	4	0	2	0	1	6	0	5	31	20	81	0	0	87	198	5	0	0	0	1	0	0	0	13	0	0	171	0	2	1	0	0	2	12	211	5	22	0	1	0	0	0	0	0	0	0	1	1	2	0	2	0	11	9	13	92	0	47	0	0	0	2	0	20	0	13	0	28	0	2	0	7	1	1	106	2	3	6	0	0	0	13	300	0	0	0	2	0	1	0	0	4	0	0	0	0	3	65	3	0	19	0	76	0	1	4	0	0	0	0	0	6	0	0	0	66	0	0	367	0	36	1	0	21	0	0	0	0	0	0	67	3	0	0	0	0	0	0	0	0	1	1	1	0	0	154	0	23	0	1	0	0	0	0	0	0	0	0	26	61	0	0	0	218	4	2	135	3	36	106	141	16	6	630	80	1	150	3312	16	142	8	0	8	0	0	1	2	1	0	0	1	8	0	1	0	49	0	0	0	0	0	0	0	0	0	0	0	0	27	2	0	0	1	11	0	0	0	0	1	0	0	0	0	0	1	0	0	0	0	0	0	0	0	1	0	0	0	0	0	0	11	9	0	0	0	0	0	0	0	0	0	0	0	0	0	0	0	0	0	0	0	0	0	0	0	0	95	44	0	626	2	0	0	5	0	0	0	107	42	188	2	1	2	318	1	0	1	0	1	0	0	0	0	0	0	0	0	12	2	2	0	121	182	0	0	0	22	6	56	0	18	0	0	1	0	0	0	0	0	0	1	0	0	0	1	0	8	1	16	0	25	0	7	10	35	0	39	0	44	0	0	0	0	0	0	15	75	0	0	0	0	0	0	0	2	3	2	0	0	41	13	4	105	0	0	0	0	0	0	8	0	0	1	128	1	0	1	0	0	171	0	0	0	2	58	0	1	0	0	0	0	0	0	11	0	0	26	53	0	10	105	0	6	0	129	0	1	0	5	0	0	9	4	0	30	0	0	0	0	1	57	3	0	0	63	22	10	65	0	34	0	49	0	0	22	0	0	1	0	1	0	0	54	0	0	0	1	18	0	18	0	0	0	0	0	0	0	1	2	0	0	0	1	1	0	0	0	0	0	0	0	0	2	0	0	0	0	0	0	0	0	0	0	2	0	2	0	0	0	55	5	0	13	36	0	0	0	10	1	226	62	139	75	0	17	209	401	0	2	112	1	49	0	0	1	0	0	0	63	0	79	55	1	0	0	1	0	0	2	45	8	0	0	27	16	415	0	0	0	0	0	0	0	1	0	1	0	0	0	1	0	1	0	0	0	1	366	1	55	48	13	0	19	0	11	0	0	0	0	0	0	0	0	0	0	0	56	0	6	2	1	0	74	2	824	1	0	0	0	1	1	0	39	43	18	3	5	9	0	6	7	2	0	0	0	0	10	2	20	906	49	23	0	3	1	0	0	0	24	0	0	0	12	1	15	0	167	0	0	0	0	270	3	0	0	0	4	41	59	37	5	1	1	0	0	1	1	102	0	4	4	0	0	0	0	1	1	0	0	0	1	0	0	0	0	0	0	0	0	0	0	150	0	0	0	0	472	1	1	0	0	0	9	0	1	0	0	0	7	18	0	58	2	1	13	0	0	0	27	6	0	0	0	0	0	1	0	1	50	55	1	4	6	12	0	33	8	7	3	0	0	0	0	0	0	0	0	25	0	0	0	76	0	0	0	0	0	0	0	47	1	0	0	57	0	27	0	0	56	0	29	0	0	20	0	4	0	0	9	0	2	22	83	132	21	61	0	116	0	0	0	0	0	0	0	0	0	0	3	4	0	0	0	0	0	0	9	1	0	0	20	0	0	1	0	4	0	0	1	0	187	0	243	0	0	193	0	0	0	0	0	0	0	0	1	149	0	0	0	0	0	0	2	1	0	0	3	0	9	0	0	1	0	1	5	113	0	3	2	0	13	0	0	0	52	2	2518	80	68	53	28	51	24	36	24	69	35	46	0	78	41	1	0	1	3	0	0	0	0	0	0	0	0	0	0	0	1	0	2	2	0	0	0	0	0	0	0	0	0	0	0	0	0	0	0	1	0	0	0	0	0	0	0	0	0	0	0	0	0	72	0	0	123	0	471	232	0	72	0	0	0	32	0	0	4	0	1	5	0	0	77	185	0	0	0	16	0	20	0	45	51	105	0	0	0	0	0	0	0	0	0	0	0	0	0	0	8	14	27	0	116	1	30	7	19	0	0	0	0	0	0	17	2	0	0	1	18	69	0	59	0	0	0	15	0	241	0	49	1	0	0	0	0	0	0	0	1	5	0	1	0	0	17	1	2	0	2	50	0	3	0	0	0	0	0	2	0	0	0	8	0	22	94	0	1	0	0	0	0	0	0	1	0	0	0	0	0
LakWasM128_HOW14_2_rpkm	0	3	0	0	0	27	55	0	0	1	0	40	4	2	0	0	1	1	13	0	0	0	9	153	1	1	0	0	1	30	0	0	0	37	5	33	9	0	1	0	0	0	0	4	103	132	97	31	0	72	4	74	3	0	0	6	1	10	156	97	972	1	0	4	0	0	0	0	41	134	8	5	117	0	276	0	1	0	0	0	1	45	2	0	0	0	0	0	2	0	0	2	18	6	104	1	0	0	0	4	0	2	4	0	0	0	0	0	0	1	0	2	331	13	142	7	0	0	0	0	0	0	0	7	0	0	3	1	0	0	51	1371	33	0	0	0	0	0	26	0	2	1	0	9	3	0	0	0	58	22	13	92	1	15	301	1	15	20	132	0	34	14	5	1	46	1	0	14	2	13	0	0	0	0	0	0	0	0	2	0	0	0	0	0	3	3	1	0	0	19	18	13	90	32	4	0	1	33	239	92	26	0	38	1	2	0	19	2	11	3	255	18	73	91	30	0	158	20	0	2	2	1	9	1	13	18	0	4	149	0	0	15	59	0	1	0	43	40	49	10	0	0	93	43	44	24	0	1	20	12	88	12	36	0	2469	767	0	1	0	0	5	27	1	123	8	1	5	7	7	345	32	0	8	2	0	0	0	3	122	53	3	169	43	133	67	0	1	0	73	6	1	0	0	0	5	0	0	3	10	0	0	36	86	4	17	0	70	125	34	0	30	0	396	114	0	0	0	1	1	0	1	0	3	3	11	69	6	2	15	0	0	0	0	0	0	2	59	0	0	0	0	3	31	10	65	1	14	2	1	1	10	2	1	0	2	0	6	0	1	43	95	0	8	1	1	96	26	123	30	17	1	274	0	0	24	4	0	88	2	11	0	0	15	0	8	0	317	1	0	0	1	5	478	2	6	18	59	1	0	63	1	17	0	21	42	0	3	0	0	0	1	12	13	739	6	29	108	2	2	0	0	0	0	1	0	0	0	1	3	1	4	3	0	0	0	3	0	0	10	0	84	33	0	0	2	20	0	0	0	1	1	476	41	1063	1	90	218	94	0	14	1	0	2	43	2	49	49	0	0	6	114	35	8	2	0	0	42	4	55	0	2	0	7	0	0	2	0	53	145	2	1	0	172	140	3	2	2	0	0	0	1	0	46	1	0	0	0	0	0	0	0	2	0	0	1	0	11	0	0	14	1	2	1	0	23	0	0	0	0	0	0	0	30	25	44	0	26	6	1	67	0	13	0	109	74	3	0	15	26	0	0	1	2	0	0	50	2	0	2	0	0	0	1	0	177	2	23	0	277	1	0	1	3	9	9	65	31	162	7	26	101	32	42	62	252	2	14	14	28	0	0	0	21	6	69	15	0	0	5	2	97	0	1	27	29	27	0	87	0	21	0	1782	468	444	1	0	699	1	1311	3	147	145	333	58	1	52	2	12	0	22	5	25	0	0	0	2	0	0	0	5	4	534	0	2	0	2	0	26	2	0	87	0	17	26	1	1	0	0	3	1	2	82	0	45	0	0	2	0	11	56	13	50	1	0	2	0	9	1	0	0	9	0	12	0	0	0	3	0	1	46	0	0	41	0	0	0	1	8	0	12	0	0	0	30	0	1	4	1	597	0	30	1	0	0	9	2	0	1	41	0	1	13	4	9	1	0	13	90	112	0	0	3	1	0	0	0	0	1	0	9	0	46	22	0	20	254	22	0	0	8	0	0	12	3	1	10	1	0	246	0	0	43	0	29	0	2	5	0	0	0	0	0	0	1	0	361	0	0	0	0	1	0	8	1	1	4	0	15	0	2	7	16	4	0	0	1	18	6	0	18	0	0	1	0	150	10	124	0	1	5	0	0	0	0	117	0	27	0	2	0	0	26	0	11	125	0	1	4	1	1	22	0	0	0	0	0	2	213	25	0	0	0	1	0	0	0	0	8	67	199	3	0	2	0	0	1	5	2	0	16	117	4	0	2	2	1	0	0	9	2	0	0	0	0	0	0	0	8	9	4	0	0	0	17	1	139	599	0	0	0	0	0	0	0	1	0	1	15	0	0	0	0	4	3	0	1	1	1	0	0	0	0	0	37	38	21	23	21	61	0	0	0	0	0	0	0	0	0	1	0	26	0	0	1	1	0	0	0	0	54	0	0	0	26	11	0	7	5	0	2	0	0	0	0	0	0	0	0	5	0	0	0	4	1	0	27	0	1	0	0	3	11	23	167	4	41	1	87	3	0	180	42	31	0	24	0	0	0	0	0	0	6	1	0	0	0	0	0	3	0	2	0	19	0	0	0	0	0	26	0	0	5	0	0	0	0	0	382	0	1	2	151	14	1	1	6	0	0	18	0	34	0	0	0	2	0	3	1	37	5	0	1	0	0	0	0	0	9	0	0	4	0	4	5	1	0	0	0	0	21	0	16	0	154	0	0	0	0	102	58	19	1	0	2	9	1	65	9	17	224	0	7	0	0	0	0	0	0	1	59	3	0	0	0	0	0	0	0	0	1	0	0	1	1	2	55	104	0	21	102	0	3	0	0	6	0	0	78	0	0	1	57	1	0	0	0	181	44	84	0	4	2	1	1	0	6	9	0	0	0	0	0	0	41	24	0	0	0	0	1	0	0	0	1	20	0	0	1	0	40	0	2	1	0	0	0	0	0	0	0	32	17	0	0	1	0	38	0	1	0	0	0	26	0	2	0	2	6	0	0	11	3	32	9	90	45	1	0	0	117	5	0	0	11	2	9	5	0	0	0	0	0	1	0	0	0	1	9	0	17	0	1	24	0	0	0	0	0	164	1	0	0	0	2	2	0	0	8	25	0	18	0	425	30	0	0	3	2	2	0	78	0	6	132	493	0	1	3	20	2	45	1	0	127	1	6	0	0	0	0	1	1	32	241	5	8	83	1114	0	97	0	4	13	7	0	251	2	0	46	0	0	26	2	0	1	30	1	0	68	4	3	0	6	0	1	3	2	5	0	22	2	0	0	6	0	0	0	0	0	0	0	0	228	0	0	0	1	1	2	1	0	0	0	7	5	0	107	100	136	13	1	0	95	1	0	1	0	1	2	32	0	7	8	0	0	0	67	33	0	2	0	0	2	27	36	0	19	6	9	32	0	1	10	165	10	3	21	12	8	1	0	0	12	1	145	0	139	207	23	71	78	9	123	0	0	45	16	36	0	0	1	10	8	64	18	0	19	0	0	6	3	17	43	49	8	0	107	0	0	0	0	0	4	21	7	0	0	0	8	2	3	214	3	1	40	0	13	14	4	10	5	8	2	9	7	8	0	24	4	0	0	2	8	5207	99	512	61	0	21	8	0	0	0	0	0	82	7	116	1	18	1	0	0	13	666	518	53	237	13	2	66	376	0	0	0	0	11	0	0	0	200	29	260	65	541	88	0	310	21	38	0	0	0	0	0	0	395	252	0	0	0	18	0	36	0	1	0	10	0	53	0	7	0	0	0	1	93	0	0	5	1	0	1	6	18	16	0	0	0	0	8	1	1	6	0	0	0	0	0	1	0	0	17	1	0	0	0	0	0	3	0	1	0	11	0	0	0	0	0	0	0	0	0	0	0	0	0	0	0	0	0	0	0	0	3	2	6	606	5	0	47	0	1	2	0	274	0	175	385	0	3	51	0	620	3	1	9	0	3	0	194	0	30	0	0	0	0	1	0	0	1	10	57	1	0	1	13	29	4	3	0	0	0	0	0	8	0	21	34	77	23	6	0	0	20	48	0	0	0	17	1	0	1	2	28	1	1	28	8	0	0	5	22	181	58	0	1	45	0	0	0	14	1	40	8	17	0	0	18	0	0	0	6	0	0	2	4	0	56	30	251	276	366	115	223	430	0	0	0	9	4	100	0	1	43	9	195	0	0	0	11	0	8	0	10	107	213	0	119	14	0	88	0	31	6	9	6	0	97	5	2	0	1	0	0	1	0	128	1	15	114	6	0	0	8	0	1	933	12	2	46	1	1	2	0	6	44	254	478	1160	0	23	4	172	1	7	0	2	2	0	3	1	109	1	3	1	0	26	0	29	34	37	25	19	0	1	0	30	0	0	1	9	0	0	0	2	3	8	4	0	1	0	189	0	118	20	0	8	45	190	0	4295	10	1	3	0	0	1	2	0	5	6	2	0	0	39	3	0	0	18	0	0	0	0	0	0	0	4	0	115	2	1	0	5	1	8	49	0	0	0	26	0	26	9	1	0	30	0	1	0	21	0	0	0	37	1	0	73	5	0	0	2	220	141	55	45	0	74	375	0	37	4	423	34	46	13	38	8	60	10	0	41	4	0	0	0	1	0	1	0	0	0	0	1	0	0	100	21	3	38	0	15	54	1	0	0	1	0	2	0	0	0	0	0	0	0	5	35	0	0	4	15	57	56	0	0	1	0	2	0	183	1	4	8	3	0	1	2	1	0	0	0	0	1	1	0	0	0	0	44	0	0	9	4	0	0	0	0	0	0	0	0	359	0	33	51	10	1	7	0	28	0	36	87	968	23	1	5	0	0	1	0	0	0	0	12	0	5	15	0	0	0	0	5	14	0	0	0	1	14	0	1	6	8	6	21	70	20	0	33	21	1	0	1	94	87	57	2	0	0	0	0	0	1	0	0	0	0	4	0	1	0	0	2	38	0	0	0	2	1	0	0	0	0	5	2	1	0	4	1	0	1	8	91	1	0	1	0	0	0	0	0	1	1	0	95	0	0	0	0	3	3	0	0	5	1	3	17	547	0	2	662	20	0	3	93	1	0	0	0	0	0	0	0	0	0	0	19	0	0	0	0	0	58	0	2	14	23	0	66	112	102	10	0	24	0	1	0	120	0	325	40	0	0	0	1	1	20	0	13	0	0	0	0	0	0	0	0	11	2	0	1	8	2	0	0	0	11	0	0	0	0	16	544	0	0	1	627	0	0	5	0	0	0	0	0	3	0	2	0	11	0	0	0	2	4	3	4	4	1	15	5	0	508	0	5	24	41	4	11	3	4	36	14	0	0	0	0	0	3	234	8	4	5	0	1	0	0	2	0	26	100	71	1	0	0	12	38	1	1	12	0	38	0	1	11	0	0	0	1	1	0	0	1	8	1	3	0	4	2	1	1	1	0	36	72	1	72	5	0	0	0	1	37	1	0	8	0	0	1	0	6	19	1	5	2	2	13	119	5	0	0	0	1	0	0	0	10	5	3	2	0	0	0	0	0	0	0	1	0	1	0	0	1	0	0	0	0	0	0	8	1	0	0	8	0	1	0	3	0	8	3	2	2	13	0	25	0	2	3	32	1	1	0	1	24	33	0	0	0	0	0	256	486	154	246	483	83	370	308	44	1104	76	323	138	61	105	59	45	225	290	11	213	8	328	254	246	392	1060	369	196	62	106	11	174	90	0	4	1	0	0	0	0	3	0	0	246	313	2	0	6	0	0	12	1	0	0	0	0	0	0	0	2	30	2	1	5	0	29	0	34	0	42	19	2	1	1	0	13	1	3	0	4	37	6	9	0	0	0	0	0	0	0	71	0	0	0	0	1	39	6	44	1	12	4	14	0	0	0	8	0	3	11	5	1	0	0	0	564	1	0	36	2	1	0	0	1	4	0	0	0	2	12	27	0	16	0	0	0	0	0	0	1	4	0	0	7	1	0	1	1	3	2	193	3	0	28	12	0	0	0	0	0	0	1	3	3	1	1	0	0	18	125	1	0	0	1	0	0	0	188	58	77	0	0	70	45	42	1	6	0	15	38	6	4	0	0	0	1	1	0	1	31	0	98	22	1	0	0	0	0	14	0	4	3	0	0	0	0	2	1	0	0	0	3	32	0	0	5	4	2	1	0	1	8	1	3	0	0	8	0	158	1	1487	0	0	0	28	0	0	1	0	0	0	5	0	0	4	0	0	7	0	2	3	2	0	1	0	134	0	0	140	23	0	25	28	0	158	0	17	0	1	0	0	0	0	2	22	0	10	2	0	32	0	0	0	1	0	4	0	3	0	5	0	1	1	1	0	0	0	8	0	1	0	5	1	6	0	0	1	51	0	0	0	0	47	3	25	256	275	6	0	56	0	0	1	0	1	0	0	0	0	0	1	0	0	0	0	63	14	31	53	2	1	0	44	0	0	2	2	13	116	2	1	3	2	74	0	0	3	0	0	0	0	0	0	0	0	0	0	109	40	0	1	0	1	1	0	0	1	0	136	36	25	17	7	2	2	1	4	44	4	0	5	0	0	0	0	0	0	2	0	0	6	1	0	52	84	2	0	1	1	4	10	2	0	2	3	2	4	7	3	4	1	10	4	5	0	0	2	0	0	2	1	0	22	0	1	0	0	0	0	1	11	20	0	188	3	5	26	0	6	1	2	6	0	8	0	9	43	3	79	21	0	6	0	1	0	0	1	0	38	0	1	0	0	0	0	508	0	3	31	109	52	0	40	28	34	0	13	0	33	1	41	2	25	3	18	0	15	40	7	3	17	0	17	0	24	1	0	2	42	0	7	2	30	72	25	107	167	82	140	136	0	82	120	157	0	17	4	0	0	9	18	1	26	3	1	5	6	154	13	0	0	0	15	0	0	40	4	4	0	0	4	29	0	0	0	6	171	0	0	0	0	0	0	0	0	5	1	0	23	0	5	12	0	22	0	0	119	0	0	1	0	3	1	0	202	0	2	27	53	59	0	27	2	25	0	1	0	100	0	0	1	0	1	3	0	23	0	1	8	0	0	1	0	2	152	0	0	152	17	0	53	0	45	0	9	0	116	60	0	1	1	9	9	1	3	6	0	5	0	7	5	0	0	25	1	0	3	168	55	1	0	0	0	0	0	4242	581	715	8	0	0	0	8	0	19	2	256	0	57	0	1	1	1	1064	696	91	0	0	0	132	0	2	0	134	5	84	0	2	2	2	0	0	3	0	0	4	0	0	0	0	0	0	0	2	1	83	1162	1	4	0	2	2	0	2	116	1	0	0	0	0	0	5	120	0	2	0	0	0	5	0	14922	16	393	0	0	3	16	0	10	3	3	0	58	0	14	0	1	0	2	1	1	9	3608	8	1	2	1	7	0	0	2	0	0	0	0	0	0	0	83	0	82	0	0	0	0	0	0	0	2	0	0	0	0	4	1	0	1	1	0	0	0	0	0	0	0	1	1	1	0	15	3	0	0	0	0	0	0	5	3	0	0	0	48	0	0	1	22	0	0	111	0	3	0	0	0	0	216	0	1	0	0	1	24	49	76	12	2	33	0	0	60	0	0	174	4	0	28	2	0	0	0	0	0	0	1	5	1	0	1	0	0	0	0	0	0	0	0	1	212	0	0	0	0	0	0	0	0	0	0	3	1	0	2	0	0	1	0	0	1	1	0	0	0	0	28	1	1	1	41	115	9	12	17	0	0	0	0	0	0	0	20	9	4	0	4	0	9	9	66	0	0	6	0	0	0	1	6	1	0	0	46	19	5	0	23	0	5	0	2	0	4	30	0	0	1	0	0	0	6	0	19	24	0	45	11	162	39	0	0	1	0	0	2	0	10	7	101	0	0	0	0	0	0	93	741	0	617	0	0	0	18	0	0	0	4	0	0	0	3	1	0	9	6	25	5	0	0	0	0	1	0	0	0	260	1	84	2	0	0	0	0	1	11	0	2	0	0	1	0	46	7	0	0	4	0	23	2	13806	1	0	134	0	1	1	3	248	0	0	0	84	1	2	0	0	0	0	0	23	0	0	34	1	1	2	0	1	0	0	1	5	0	1	0	0	1	0	542	4	0	2	0	1	0	0	846	0	1	0	24	0	2	0	0	0	1	0	0	30	0	1	0	0	0	0	2	1	13	0	0	2	0	3	0	1	0	0	0	0	0	0	0	8	7	7	1	3	0	0	235	0	15	2	0	0	0	0	0	0	0	0	0	0	0	0	0	0	2	0	0	2	0	0	0	1	0	1	0	0	14	0	0	4	0	0	0	0	1	0	19	42	0	0	0	53	1	2	56	43	0	0	1	1	0	0	0	0	0	1	1	0	0	0	3	0	1	3	0	1	0	0	2	0	10	0	0	1	0	20	0	0	0	20	1	0	1	0	0	6	3	0	35	0	0	0	0	5	2	0	0	0	88	5	0	1	7	8	0	0	0	0	0	0	0	0	0	1	0	12	0	0	908	0	0	0	1	1	2	0	0	5	0	0	0	0	72	0	3	0	0	0	1	0	3	13	0	9	0	1	0	3	0	8	0	8	10	0	0	0	1	0	12	2	1	1	0	0	0	0	1	0	11	0	1	0	0	0	2	0	0	0	1	0	0	0	0	0	0	0	0	3	0	1	3	29	0	0	0	0	1	0	0	1	0	0	18	0	0	3	1	0	18	2	0	0	6	1	0	0	0	0	1	1	0	0	3	0	2	0	0	0	0	0	0	0	0	1	0	1	1	1	0	0	1	9	0	0	0	0	0	0	0	0	20	0	0	0	0	1	10	0	0	1	0	249	0	2	21	38	5	4	0	0	340	0	1	65	0	0	200	0	0	6	2	6	2	2	0	0	7	0	106	50	17	2	6	1	327	0	0	0	1	0	190	5	86	0	1	0	2	0	0	2	22	0	0	0	2	0	0	0	0	0	18	0	0	0	1	0	0	0	0	0	0	0	0	0	0	0	0	2	0	0	1	0	0	0	173	0	123	1	3	1	1	0	0	0	0	0	1	910	0	0	0	0	0	0	1	0	1	0	0	1	0	1	5	6	0	2	0	0	2	1	2	0	65	0	0	0	0	2	116	0	1	0	0	0	0	0	1	0	0	15	0	2	0	0	2	0	0	0	0	0	0	1593	0	0	0	13	0	13	0	2	656	0	3	3	0	1	1	0	1	3	0	0	1	9	0	1	1	0	0	0	0	1	3	5	0	0	0	0	0	0	189	3	0	0	0	1	6	0	0	0	0	1	0	0	0	0	0	0	19	0	0	0	2	0	0	0	0	100	1	0	0	0	0	0	6	5	1	1	1	0	0	8	9	0	3	0	0	11	3	17	9	82	0	97	3	0	0	14	0	0	0	0	0	0	0	0	0	0	1	1	33	17	0	6	0	1	0	4	1	2	0	1	0	24	3	0	0	0	5	1	0	9	1	509	0	3	1	2	0	25	0	0	1	1	71	0	0	0	2	0	3	0	0	0	8	11	286	9	0	62	1	0	0	0	18	1	0	30	0	0	3	0	0	0	1	0	4	0	0	33	2	0	1	1	0	0	0	0	0	2	1	35	0	15	8	0	1	38	0	0	0	0	0	10	0	1	0	0	0	0	6	0	1	6	25	0	1	0	6	0	0	0	12	8	0	0	22	10	8	1	117	114	3	2359	3742	0	0	57	0	292	5	55	65	59	0	0	0	64	403	0	195	0	44	147	0	577	0	0	0	1	7	0	0	41	26	0	6	0	0	24	3	49	39	77	0	0	12	1	29	0	38	1	1	3	13	6	1	0	0	0	1	0	15	23	2	0	0	1	51	0	8	6	0	5	0	0	0	1	0	0	0	0	1	0	0	3	8	0	0	54	141	2	2	0	5	3	19	2	0	0	0	0	0	0	0	0	0	106	241	7	0	1	0	0	3	0	3	2	0	0	1	0	0	0	44	28	0	5	10	1	0	0	10	76	2	0	1	0	0	4	0	0	0	2	35	19	0	1	3	0	35	1	1	0	0	5	27	2	2	6	0	0	0	81	1	0	108	0	39	51	1	0	0	11	0	34	18	1	4	2	0	0	0	0	17	0	1	0	396	305	410	5	14	356	63	119	5	97	78	70	13	415	596	228	0	567	62	511	74	137	15	348	30	591	1	78	0	533	0	8	0	0	1	2	39	0	0	1	11	8	11	2	0	2	0	1	0	19	1	1	8	21	11	16	1	0	0	1	82	0	1	81	0	2	0	27	2	0	423	0	0	0	2	1	0	0	194	22	0	1	0	24	3	1	10	0	13	1	45	3	2	0	0	2	0	37	324	3	26	106	108	2	2	0	1	0	0	1	2	0	0	0	0	0	0	0	65	0	0	2	0	1	0	0	0	2	148	2	0	15	0	9	2	1	0	0	0	4	13	15	1	0	2	0	0	0	0	7	2	2	6	8	3	0	0	0	0	0	1	0	1	0	7	0	22	0	1	304	4	1	0	3	0	0	2	79	0	6	0	2	1	898	134	0	0	10	0	1	56	3	6	87	1	2	5	4	0	0	3	1	1	3	0	0	0	0	1	0	0	1	0	2	0	0	9	144	0	3	17	107	0	1	0	0	0	0	3	337	0	0	6	2	14	7	6	5	51	8	0	1	56	52	45	0	0	3	0	79	2	0	0	2	4	1	0	3	2	0	0	0	0	2	57	1	1	0	137	0	0	0	0	6	2	0	1	25	0	0	2	9	0	1	0	0	1	2	77	0	15	29	0	7	0	47	9	4	0	0	0	0	1	12	4	9	20	0	94	0	0	7	0	10	0	2	104	1	0	8	0	20	5	62	0	2	0	0	0	0	22	0	62	0	0	0	0	0	1	0	0	4	0	0	4	142	5	20	2	0	91	13	0	60	0	11	0	0	0	0	1	6	43	0	0	0	0	0	2	0	6	1	0	0	0	0	0	0	14	24	0	2	0	1	1	0	0	0	2	56	26	27	0	1	0	0	0	306	0	2	0	8	0	0	0	34	2	0	1	1	46	0	40	6	0	5	1	8	0	0	0	0	0	0	0	0	1	0	1	0	0	0	34	7	1	0	0	0	195	190	78	4	0	1	1	0	0	0	0	0	2	0	0	243	37	0	3	0	0	1	11	0	10	191	7	171	40	37	176	11	0	1	1	0	0	128	1	2	16	130	5	1	0	0	0	0	83	1	48	13	23	62	20	44	451	8	0	0	0	94	0	35	0	10	0	1	1	0	0	0	0	0	0	1	0	9	0	1	0	1	0	0	0	3	0	1	95	23	0	0	2	0	28	11	47	1	94	0	0	0	0	24	4	1	0	0	0	4	6	3	203	0	0	0	0	1	1	57	1	2	0	2	0	0	0	0	2	0	0	6	8	0	0	6	0	0	10	1	5	9	0	1	0	0	17	6	0	3	3	0	4	13	2	24	0	1	273	1	0	0	3	0	3	0	1	2	0	1	8	0	1	54	1	6	1	1	0	0	9	6	210	1	8	13	0	61	2	24	0	15	3	0	0	0	7	0	1	0	0	0	0	0	0	3	0	0	139	0	36	0	0	552	1	9	0	1	0	16	51	0	13	0	0	3	297	1	23	44	0	0	1	0	1	6	0	1	2	0	0	0	20	6	4	0	2	0	0	0	53	5	1	1	31	0	6	0	2	1	0	8	1	2	0	1	0	0	3	0	2	0	0	2	1	0	0	0	1	0	3	0	1	1	0	0	0	0	0	0	0	0	0	0	0	0	0	0	0	0	0	0	0	437	1	0	0	23	0	1	20	6	5	0	0	48	0	0	2	2	1	0	0	0	0	15	1	0	4	1	9	0	2	0	0	0	8	0	9	0	0	0	6	0	6	0	1	3	0	1	16	0	5	0	0	21	22	0	0	4	88	15	0	0	1	0	2	1	30	9	3	141	1	1	113	0	0	0	0	0	2	0	6	68	0	140	0	0	0	1	55	1	0	11	0	0	108	3	0	1	0	7	0	0	0	0	0	1	1	13	0	0	4	0	21	86	0	1	0	0	12	0	0	7	1	1	0	37	8	0	0	0	6	0	0	0	0	61	7	0	0	3	0	0	0	0	0	45	0	1	33	1	0	0	0	0	0	0	0	3	0	0	19	0	0	0	0	0	0	0	0	0	0	8	3	0	1	0	0	5	10	5	0	0	2	0	1	211	78	1	0	0	0	0	27	1	8	11	0	0	1	0	10	0	94	1	3	0	8	1	0	0	0	0	0	0	4	2	0	2	4	0	0	0	0	116	46	52	24	4	0	1	1	1	1	22	3	1	0	5	152	92	105	79	1	38	43	0	81	0	6	1	46	217	0	26	1	0	1	1	6	1	0	0	176	33	6	16	60	1061	0	0	0	21	6	17	0	0	2	5	0	2	51	1	20	0	0	1	0	3	0	0	145	0	1	28	11	0	3	0	0	120	2	14	11	6	16	111	9	132	58	0	54	0	6	0	3	49	7	0	0	0	9	0	3	4	9	0	0	0	6	1	32	32	75	0	0	4	64	60	12	2	6	9	265	9	0	0	2	5	3	5	2	0	0	0	0	0	1	45	0	1	1	0	12	0	15	7	336	15	0	2	0	0	17	0	0	1	0	1	0	4	0	0	4	1	0	0	1	0	0	1	0	4	4	1	1	1	1	0	0	1	0	6	1	1	5	3	2	15	0	0	0	0	10	0	18	9	116	8	0	1	6	0	12	3	163	51	6	3	2	2	1	1	0	0	0	0	12	215	0	0	102	3	0	39	9	9	6	60	12	8	4	0	14	6	1	1	17	27	1	1	0	0	0	2	8	2	0	0	0	0	0	0	0	15	10	2	1	65	0	0	60	18	0	1	0	0	0	0	51	2	27	1	26	346	11	0	0	0	0	51	0	0	0	28	17	134	77	2	20	0	0	0	29	0	208	4	1	0	3146	0	0	125	101	0	460	0	27	0	0	31	5	66	23	0	44	0	0	0	3	26	0	0	57	0	0	122	35	289	28	58	13	0	1	2	24	1	0	3	0	0	2	1	2	1	0	0	0	0	21	0	0	0	1	0	0	6	10	2	0	0	111	5	34	12	0	132	16	1	0	1	41	0	364	13	19	25	91	22	3	93	28	80	27	77	46	1	1	0	0	18	0	0	11	0	3	4	1	0	0	0	0	1	575	4	35	24	9	429	26	256	0	922	242	4	0	55	3	1	0	0	0	0	0	1	0	0	0	0	0	3	0	33	95	19	0	0	8	5	5	36	2	2	1	0	56	18	1	0	0	0	10	1	6	3	0	0	169	1	108	2	1	43	0	381	230	116	74	8	1	10	1	1	0	116	76	1	2	1	2	5	0	1	56	0	3	0	129	29	22	74	0	1	5	0	0	3	0	2	10	0	18	7	1	1	0	2	0	121	77	73	6	2	6	13	7	8	8	5	0	35	0	0	34	57	0	3	2	7	0	109	285	60	7	0	18	101	0	0	1	1	0	1	9	1	0	0	0	0	346	120	6	0	3	0	278	9	9	0	0	0	1	1	33	31	6	18	12	1	8	0	1116	0	151	90	175	38	163	105	3	7	1037	132	0	55	3	1	0	45	47	33	0	6	0	2	0	0	1	0	1	100	21	0	0	1	1	10	95	6	884	1458	8	271	12	67	0	442	271	110	1	0	217	0	0	0	2	0	0	0	0	1	1	0	0	0	1	1	0	5	1	6	3	0	117	2	0	0	38	2	35	0	20	366	29	29	4	29	27	150	38	7	5	0	0	1	0	923	171	35	0	1	3	29	40	96	0	5	3	0	0	8	41	3	1	0	0	1	1	0	50	122	0	1	0	1	0	3	2	0	10	3	0	0	0	0	313	1	57	42	758	11	17	0	0	0	0	29861	0	13220	1	28	0	13	14	130	11	0	0	0	0	0	0	0	13	259	6	41	1	0	0	0	2	1	9	169	3	0	0	213	0	0	14	0	0	1	0	0	0	1	176	0	0	0	0	1	0	1	0	1	28	7	0	0	1	2	1	0	0	1	0	0	0	0	0	2	18	23	0	131	18	0	26	0	2	2	0	6	174	1	0	0	0	0	1	0	2	117	0	0	14	1	0	7	0	0	4	6	1	1436	8	1	30	220	1	4	0	1	17	0	48	62	54	18	2	0	1	2	20	0	1	42	3	0	0	0	89	0	0	2	21	0	50	0	0	0	0	0	2	5	5938	15	56	1	18	13206	4	20	623	73	345	76	3183	2769	907	235	308	263	225	0	7	302	77	235	569	75	6	0	0	5501	1	7	70	4	3	122	12	1	0	224	126	48	0	1	12	3	19	183	1	1	0	39	30	45	19	37	30	68	13	19	0	13	1	79	13	18	37	2	1	0	0	2	0	0	0	0	1	43	11	0	5	9	129	1	4	355	0	1	2	6	6	60	3	10	0	17	0	2	56	33	0	2	0	0	0	66	0	91	0	11	0	49	18	0	222	12	1	0	19	393	1522	0	153	2	27	142	7	46	104	2	77	1	298	23	1	38	0	0	14	27	48	246	5	4	14	22	206	39	0	0	24	9	5	0	40	3	38	1	1	17	355	0	1	6	0	3	0	66	22	0	1	84	1	0	5	0	0	0	0	1	0	3	1	1	431	0	4	4	5	0	77	108	91	0	0	4	6	0	44	0	9	46	0	0	0	66	89	2	67	98	0	13	67	6	2	17	1	66	15	17	4	26	16	30	95	250	101	114	0	1	0	0	1	0	2	0	1	271	2	3	46	0	0	0	2	0	16	130	21	0	30	0	1	0	0	0	0	16	4	4	0	0	0	0	0	1	2	1	11	2	0	0	0	0	4	0	0	38	0	0	7	0	0	0	57	13	0	19	2	31	124	0	0	0	0	0	0	0	53	6	0	25	0	0	0	0	60	3	6	48	16	50	9	9	0	0	0	1	12	4	0	0	11	209	0	1	34	1	0	1	118	109	54	0	0	0	0	0	76	0	73	7	37	51	2	0	0	0	2	270	0	0	0	0	56	544	466	63	222	74	154	283	49	442	0	323	11	4	214	425	1374	768	715	554	67	148	193	123	3	175	52	50	176	170	50	13	94	528	6	274	500	34	146	27	502	236	21	176	70	168	295	115	153	0	0	2	0	781	261	0	100	188	352	199	49	45	1048	727	693	4552	2	235	104	0	4	4	0	6	52	6	9	0	20	0	333	916	266	4	0	115	1	0	0	3	0	57	255	21	159	107	215	55	240	162	283	0	16	160	99	26	1	0	0	2	209	132	4	38	166	64	29	13	83	28	11	71	53	0	0	0	130	0	3	1	138	2	0	7	0	0	2	0	117	18	1	1	0	2	43	24	7	11	0	0	0	0	2	6	251	0	1	0	0	0	1	0	0	11	28	0	6	14	0	0	1	4	2	1	4	8	6	8	26	90	30	97	90	2	0	1	4	0	0	22	0	0	0	0	0	0	0	1	0	0	0	1	47	0	1	1	0	0	77	0	0	0	1	1	0	1	0	0	0	0	7	2	11	0	0	167	0	0	0	0	16	1	518	0	62	174	0	279	2	507	0	1	0	0	0	0	0	0	0	1	0	6	0	70	12	31	15	0	2	1	0	0	1	2	0	2	24	5	2	51	1	39	0	0	161	124	0	0	0	34	0	1	29	28	267	30	53	0	0	8	0	0	180	5	107	2	0	0	13	62	18	68	17	41	14	51	37	0	1	72	109	0	14	491	90	19	25	3	0	0	14	62	7	19	0	1	3	0	0	0	18	2	5	0	0	0	0	0	29	11	4	31	1	0	0	0	1	0	2	4	3	0	208	7	1	0	4	0	0	0	0	0	244	19	21	0	1	30	0	14	5	0	5	25	25	0	0	14	0	1	4	5	2	15	0	0	0	0	0	75	12	79	6	4	0	6	0	0	9	0	2	0	42	56	0	4	73	3	7	0	0	2	13	1	35	13	3	2	49	330	38	0	0	24	0	0	7	1	1	1	3	0	0	1	5	8	15	8	6	0	1	6	0	0	3	8	86	17	0	0	0	0	33	0	3	29	3	18	13	0	1	0	0	0	2	5	1	7	1	1	2	10	0	1	2	0	104	50	0	0	137	38	9	0	3	129	0	42	12	11	1963	0	1	60	0	2	0	0	0	1	0	0	5	254	18	0	57	15	44	3	3	0	2	95	0	0	0	0	0	1704	0	0	1	0	1	0	2	5	2	0	0	0	2	0	0	0	0	4	0	8	0	5	63	23	0	0	0	0	184	33	7	0	2	3	93	71	0	17	0	0	239	2	105972	0	0	1	0	1	9	0	0	0	0	0	0	0	0	3	0	96	0	3	0	0	22	13	364	71	2	63	36	11	0	2	0	0	0	0	5	2	48	72	1	133	24	0	0	0	0	2	10	5	9	0	0	38	0	50	39	23	114	222	43	454	71	0	24	4	0	5	0	0	133	155	171	181	70	1	0	2	9	57	0	542	802	269	7	1129	0	0	0	0	65	0	448	8	2	149	20	2	42	6	0	0	120	207	3	0	79	42	0	9	4	0	0	0	0	4	0	2	0	103	190	47	558	698	0	53	664	1	608	230	63	616	201	243	321	133	92	294	495	1	150	491	43	237	149	3	0	0	321	194	378	1112	499	9	24	0	2	486	130	25	26	17	0	0	0	0	0	0	0	0	0	1	1	2	11	3	15	4	28	2	0	2	48	0	4	0	0	19	58	47	11	0	9	2	8	0	6	1	29	0	21	0	12	9	4	7	67	34	0	8	0	1	0	50	158	0	2	1	4	2	0	0	0	18	1	0	0	0	4	0	1	28	1	17	28	55	172	0	0	15	38	0	6	2	16	292	1	51	0	1	1	90	90	0	6	5	2	211	3	0	13	8	0	14	4	0	1	2	0	0	2	0	1	0	0	2	3	2	1	5	0	0	5	0	20	3	4	0	0	3	0	0	0	1	6	3	0	11	3	0	5	0	0	0	0	0	0	0	1	0	1	0	5	53	0	1	5	1	1	1	2	8	1	0	1	10	6	50	65	12	134	15	1	7	281	91	122	38	174	0	8	14	42	274	0	1	3	1	66	3	15	16	4	0	0	0	0	0	0	0	30	2	41	1	13	64	8	0	0	0	0	3610	70148	33	146	25	4	0	0	2	31	29	108	30	5	63	0	156	60	12	10	2	36	0	139	38	25	68	8	1113	0	0	160	37	496	4	0	1	0	0	0	0	0	102	1	43	129	93	197	0	0	0	89	34	96	3	1	3	1	1	7	0	0	2	1	0	13	43	13	0	10	0	5	5	4	0	8	6	8	12	48	5	0	1	0	0	1	0	75	200	47	147	328	128	31	364	0	11	15	24	60	25	0	9	39	1	17	0	13	1	2	0	0	9	122	7	11	20	13	2	0	25	0	12	27	62	0	14	0	6	31	3	3	2	46	0	0	0	0	1	0	2	5	449	0	206	0	0	0	9	11	3	1	1	0	0	0	2	0	0	0	0	6	1	0	9	127	0	0	0	0	2	8	26	1	0	1	3	11	40	1	0	0	0	2	1	0	0	1	1	0	3	0	2	0	0	2	1	0	1	109	0	35	81	284	265	56	122	0	0	0	0	0	0	0	0	0	0	0	1	0	0	0	0	0	300	2	0	0	2	9	44	1	0	0	0	0	0	0	13	0	0	156	0	1	2	31	9	61	14	0	112	13	12	8	18	6	4	6	36	40	0	483	7	7	164	323	50	28	75	0	0	126	2	1	28	14	31	41	1	1	1	1	1	2	1397	0	1	3	0	1395	0	24	0	0	3	53	2	13	1	0	0	5	7	0	0	0	2	0	0	0	4	12	0	0	1	7	286	32	0	0	0	3	0	0	0	1	115	0	0	0	1	0	1	34	36	0	7	0	0	9	3	2	0	68	13	2	156	33	4	0	3	0	0	9	42	17	59	9	17	1	1	0	0	772	2	87	2	0	9	8	2	0	92	273	68	22	3510	1	32	103	16	1	84	0	558	125	131	12	151	0	0	307	1	153	0	105	0	74	0	1	32	0	68	2	15	636	13	4	12	0	78	561	2	2	0	2	0	63	39	4	1	5	0	38	1	0	29	0	2	0	8	12	1	1	0	0	146	8	16	0	0	9	6	2	0	0	37	6	10	40	0	4	228	9	0	0	0	6	0	13	30	18	55	14	76	61	9	42	55	44	69	66	126	0	0	0	1	3	0	14	0	0	1515	2	0	1	199	46	71	17	12	519	1	5	34	14	0	7	48	8	1	1	1	2	7	0	0	113	466	215	4	0	2	0	0	1	0	0	2	2	1	1	1	2	0	0	0	1	0	0	0	0	0	0	5	0	1	0	0	0	1	0	1	0	0	0	0	1	0	2	2	7	0	0	0	0	0	1	0	0	2	0	0	1	11	0	0	0	37	9	28	7	0	6	2	1	2	1	2	13	9	0	5	0	1	44	8	23	112	12	10	128	26	1	14	1	40	37	1	0	0	0	38	6	28	0	0	22	0	1	45	0	19	58	0	10	7	84	3	508	56	0	26	3	2	10	0	0	0	147	18	38	8	55	14	143	52	2	458	18	0	59	6	0	11	0	68	169	222	333	0	168	51	52	5	73	1	10	0	3	0	0	0	0	3	14	0	0	0	0	33	0	95	41	0	0	0	31	1	37	59	9	68	55	0	24	8	71	23	29	51	26	14	240	54	256	4	1	1	1	0	5	0	20	6	289	22	387	16	0	0	36	0	1	2	0	0	0	0	0	0	0	25	9	0	49	46	44	0	109	54	141	2029	26	1	13	0	1	1	0	1	28	3	7	0	1	3	147	0	3	0	8	27	7	1	0	3	7	0	4	62	103	2	24	158	3	9	1	0	2	0	90	0	26	0	23	691	2	0	25	59	0	43	0	6	2	3	1	4	0	0	0	1	12	29	0	0	5	0	0	0	0	3	0	1	0	1	1	0	0	2	11	4	5	0	1	0	0	4	2	1	202	4	126	141	3	79	50	49	159	65	65	36	0	4	0	38	0	1	0	4	0	0	0	0	2	0	0	27	0	0	2	0	11	0	0	0	1	4	1	19	0	0	0	0	50	3	0	63	0	0	0	30	0	4	26	21	0	0	0	0	1	1	0	0	2	0	2	5	3	5	0	98	52	51	1	74	1	0	0	0	0	0	0	1	94	0	125	0	1	1	47	2	36	148	0	0	1	0	27	0	0	2	0	4	0	0	0	0	1	0	0	54	0	42	0	0	0	0	0	0	0	131	0	0	0	0	0	2	0	0	740	0	1	0	0	0	0	1	0	0	0	0	1	0	40	7	0	1	0	1	0	0	4	0	0	0	0	0	0	0	0	0	2	0	0	258	2	0	0	0	0	0	33	0	0	200	0	1	0	1	0	7	22	1	0	0	0	1	0	1	0	21	3	0	1	1	0	0	1	5	2	0	0	0	0	0	0	0	0	0	0	0	0	2	1	3	0	0	4	0	3	0	0	1	42	0	1	0	0	43	1	3	0	0	0	0	0	0	0	0	1	0	1	0	0	44	0	0	1	2	0	1	0	0	24	1	0	2	0	2	0	0	2	0	0	0	0	101	0	0	0	0	0	0	1	0	0	0	0	0	0	1	0	2	1	0	1	1	1	0	0	0	5	0	33	0	0	0	0	7	0	15	19	33	1	0	5	10	128	0	36	14	4	0	0	9	1	12	3	0	12	81	3	5	27	0	432	24	599	0	0	8	0	0	10	8	5	10	8	0	0	15	29	6	7	10	2	12	0	0	18	1	13	2	20	1	35	0	5	12	8	19	29	4	3	24	0	12	28	0	2	10	21	13	38	0	26	5	0	4	11	9	5	137	49	4	3	14	58	91	57	1	0	12	56	11	50	9	5	0	35	5	48	36	4	7	10	29	113	0	6	503	0	3	32	7	14	0	361	5	10	48	7	0	24	4	6	19	19	22	1	7	0	1	16	49	3	42	1	31	63	32	7	183	352	33	8	0	0	12	92	0	9	0	1	0	2	0	0	0	0	39	0	161	0	0	0	11	0	3	1	504	21	72	0	1	26	0	0	226	6	495	0	247	51	3	2	3	46	2	3	0	2	0	0	0	8	0	0	2	12	4	58	0	2	10	1	0	0	18	0	0	1	0	3	1	1	0	0	0	0	0	3	1	0	0	0	0	1	0	0	0	0	79	1	1	0	0	4	2	2	37	0	2	0	11	0	40	3	1	1	1	0	0	0	376	1	7	2	8	0	0	1	0	0	0	0	0	0	1	11	6	1	0	1	1	15	4	782	8	0	0	1	1	0	0	0	0	2	1273	0	14	5	2	0	0	0	5	0	0	0	2	0	3	0	0	1	0	0	0	0	10	115	118	1	224	206	0	1	0	0	0	2	26	0	30449	0	19	25	282	0	0	1	4	62	18	11	0	0	13	1	2	0	0	1	1	128	84	31	1497	2	14	66	85	0	2	2	4	0	0	3	12	1	0	0	2	3	1	1	0	4	23	0	0	32	146	3	9	35	0	0	0	1	0	0	24	29	45	91	118	103	1	94	200	3	0	243	1	11	151	3	5	14	29	0	4	0	2	0	1	114	20	0	0	0	1	131	48	2	0	0	17	0	0	1	0	0	3	3	0	22	5	40	69	0	102	0	0	1	0	1	0	3	4	7	6	24	4	53	12	9	89	0	12	0	18	0	0	0	3	75	0	77	0	3	0	10	27	2	3	19	11	1	3	9	43	43	550	122	2	1	0	1	3	0	0	0	0	2	0	1	0	21	0	0	27	532	28	0	56	2	7	141	76	31	0	11	1	5	19	19	65	244	3	0	1	0	23	7	69	77	29	55	7	5	1	0	4	0	0	1	7	9	1	500	77	83	0	30	1	0	20	10	46	48	0	0	0	15	47	95	15	4	60	16	22	1	400	0	30	11	15	25	4	33	47	52	176	6	7	27	189	52	1	3	0	1	0	0	1	55	1	0	290	0	50	0	0	3	5	22	305	35	12	0	0	0	0	4	0	0	2	4	4	0	5	2	1	0	128	25	17	311	3	163	0	1	0	6	0	30	1	20	0	20	0	6	0	18	0	4	82	41	16	76	0	2	0	76	250	0	0	1	2	0	17	0	1	2	0	0	0	0	25	71	23	2	75	0	110	5	4	3	0	1	0	3	0	87	0	1	0	160	0	0	867	1	51	7	0	24	14	0	0	0	4	1	120	24	1	0	7	0	7	9	0	0	7	45	3	0	0	216	147	38	6	1	0	1	3	7	6	0	0	0	15	70	29	20	2	252	20	5	275	106	297	109	382	28	152	391	300	20	388	1501	432	227	64	105	84	0	6	2	8	1	10	0	1	10	1	3	9	29	2	2	0	0	0	0	2	1	1	0	0	0	193	22	4	7	25	0	0	0	0	0	0	0	0	0	0	0	0	0	0	0	1	0	0	0	0	4	0	0	0	0	0	0	42	25	0	0	0	0	0	3	0	0	0	0	0	0	0	0	0	0	0	0	0	0	0	0	6	0	80	49	1	834	8	1	1	22	0	0	0	120	113	149	37	1	29	257	20	7	9	1	11	6	0	0	0	0	0	0	0	50	86	3	72	187	229	0	0	1	37	6	60	10	38	1	1	38	4	6	0	0	0	9	7	6	2	2	3	0	56	8	137	11	20	0	23	25	18	1	58	14	3	1	3	4	3	0	0	36	102	1	0	0	0	1	0	0	30	4	14	0	3	46	99	8	48	0	37	0	0	0	1	126	5	5	1	500	11	7	10	0	8	324	0	0	0	6	27	0	13	0	0	33	0	0	0	15	0	18	20	167	4	21	71	0	10	2	59	0	6	0	0	1	9	10	10	7	38	0	4	0	3	1	47	11	0	1	137	51	22	47	8	62	13	39	11	0	23	8	0	33	7	5	0	0	53	0	1	6	17	66	1	52	6	1	1	0	0	1	9	2	3	0	0	1	2	1	0	1	3	1	0	0	0	0	1	1	0	0	0	0	9	2	2	6	0	42	3	18	0	0	0	77	18	2	31	106	0	39	0	5	69	442	74	68	87	1	9	479	581	3	73	242	0	39	0	29	32	20	1	0	41	0	97	63	50	1	4	5	2	1	171	120	18	0	0	31	25	1263	8	0	0	0	0	0	0	98	0	3	2	2	337	0	0	0	0	0	2	6	646	24	170	32	67	0	70	73	22	0	0	1	0	0	15	0	0	0	14	0	130	1	26	16	13	0	239	9	2362	14	9	0	3	54	83	8	345	47	12	49	59	223	2	62	58	25	0	0	0	1	3	4	7	1014	199	2	2	27	1	7	0	0	113	0	0	8	39	3	0	0	280	151	0	0	0	199	58	27	24	7	35	260	154	187	0	3	29	0	0	15	24	22	0	5	0	1	0	0	1	12	8	0	6	1	11	0	0	0	0	0	1	0	0	0	0	524	1	3	1	0	607	45	88	0	0	1	7	6	5	0	0	0	77	72	42	2	63	0	71	27	1	0	44	92	0	17	2	1	0	39	5	7	90	48	22	21	49	11	3	939	19	89	157	0	0	0	2	2	0	0	0	21	0	1	1	65	0	0	0	0	0	0	0	36	1	14	6	40	4	16	1	3	57	2	53	0	0	14	3	9	0	0	0	7	22	17	174	293	19	149	0	494	1	0	1	0	0	3	0	0	0	0	1	57	0	0	0	0	0	0	20	4	1	0	31	0	1	10	3	9	1	6	3	0	342	0	755	0	0	497	0	0	3	0	0	0	0	0	22	157	0	0	0	3	5	2	33	30	4	2	96	15	43	0	25	0	264	1	76	124	3	2	6	2	17	0	62	0	110	44	459	205	149	132	51	202	46	81	127	99	82	21	2	28	156	0	4	5	28	0	7	0	1	0	2	760	2	0	43	0	0	1	2	28	0	0	0	0	0	1	0	0	0	1	0	0	1	2	0	9	0	1	0	1	0	0	0	0	2	0	9	7	0	75	12	0	198	0	605	355	20	150	0	1	2	13	0	1	19	0	0	64	1	0	157	26	0	0	0	54	0	22	0	75	103	188	0	0	1	0	5	0	1	1	3	0	4	0	2	1	14	8	38	0	135	2	13	17	8	2	1	0	4	0	2	36	20	2	0	4	11	160	0	47	4	0	9	18	0	20	0	96	20	0	0	0	0	0	0	0	0	16	2	2	0	77	20	7	7	5	5	29	1	5	1	0	1	0	0	0	0	2	4	1	3	20	38	0	0	1	0	0	3	0	0	7	0	6	1	0	13
LakWasM129_HOW14_2_rpkm	0	0	0	0	0	34	0	2	11	0	3	283	0	0	0	3	0	1	1	0	0	0	3	62	0	0	0	0	1	33	0	0	0	81	0	43	2	1	0	0	0	0	0	13	94	120	103	13	0	64	2	104	0	0	0	0	0	0	326	37	3	2	0	1	0	0	0	0	4	153	3	0	74	0	140	0	0	0	0	0	1	53	2	0	0	0	0	0	2	0	0	0	25	1	80	0	0	0	18	0	0	4	1	0	1	0	0	0	0	0	1	1	350	0	96	2	0	0	0	0	0	0	1	1	0	0	1	0	0	0	125	288	0	1	0	0	0	0	1	0	0	0	0	7	0	3	0	0	52	0	19	50	0	0	150	25	1	2	49	0	31	1	2	0	3	0	0	12	2	9	1	0	0	0	0	0	0	0	0	0	0	0	0	0	0	87	1	0	0	0	27	17	35	60	58	1	2	52	78	75	0	0	0	0	0	1	0	0	2	0	79	53	50	106	37	0	0	27	0	0	1	0	0	8	0	1	0	0	60	0	4	1	0	1	1	0	85	1	69	1	0	2	52	0	76	0	0	0	0	1	1	15	41	0	4107	1	0	0	0	0	5	0	1	194	0	0	8	4	5	359	0	0	35	0	0	6	0	2	1	1	3	119	2	148	105	0	0	0	31	12	1	0	0	2	8	1	0	9	44	0	0	54	97	6	0	2	4	323	11	4	2	0	157	104	0	0	2	0	95	1	1	0	0	0	78	36	0	0	0	0	0	1	0	0	0	0	28	0	0	0	1	3	30	1	56	0	35	8	0	1	0	6	0	3	10	0	0	0	0	58	0	0	1	0	0	80	0	108	1	11	0	176	0	0	24	0	1	108	0	5	1	0	24	1	9	0	140	0	0	0	0	0	567	0	1	19	24	0	0	60	0	46	0	24	59	0	0	0	1	1	0	6	7	1439	0	76	70	2	5	0	0	1	0	0	0	0	0	1	0	1	2	2	0	0	0	5	0	0	35	0	101	0	0	0	0	287	0	0	0	1	0	345	2	1423	0	0	183	1	1	0	1	1	0	51	4	62	75	1	0	0	62	2	11	5	0	0	49	0	12	0	1	0	15	5	0	1	0	3	4	0	0	1	190	235	1	0	0	1	0	0	0	1	46	1	0	0	0	1	0	3	0	1	0	0	1	0	3	0	1	30	3	0	0	1	4	0	0	0	0	0	1	0	200	91	48	0	39	0	0	84	0	0	1	56	54	0	0	0	1	0	0	0	5	2	0	1	0	9	0	0	0	2	0	0	59	0	0	1	209	0	0	1	5	26	1	0	0	534	3	4	12	24	8	0	254	0	2	2	53	0	0	0	1033	5	34	39	0	0	0	0	119	1	28	49	41	24	0	50	0	0	0	579	7	139	4	0	701	1	773	4	5	0	381	30	0	22	0	21	1	27	1	2	0	1	0	1	0	0	0	3	0	362	1	1	0	6	1	37	6	2	5	0	14	31	3	0	1	0	6	1	0	18	7	0	0	1	2	0	2	1	0	75	0	0	5	0	1	0	0	0	0	0	10	0	0	0	6	0	0	61	0	0	23	1	2	0	0	10	0	1	1	1	0	18	4	0	1	0	139	0	0	8	0	1	8	4	0	0	26	1	1	3	4	3	2	0	0	142	36	0	0	2	0	0	0	0	1	0	0	2	0	78	21	1	2	237	0	0	0	14	0	0	80	1	0	0	1	0	4	2	0	0	0	75	0	2	15	0	0	0	0	0	0	1	0	79	0	0	0	0	0	0	24	0	0	9	0	0	0	0	2	11	0	3	0	1	21	0	0	1	0	0	0	0	0	9	226	0	1	0	0	0	0	0	33	0	0	0	0	0	0	6	0	2	75	0	0	1	1	14	20	0	0	0	0	2	0	125	53	0	0	0	0	4	0	0	0	0	48	184	0	0	3	0	0	0	0	3	0	2	52	1	0	2	0	17	0	0	6	0	0	0	0	0	0	0	2	0	8	0	0	2	0	0	0	41	117	0	0	0	0	0	0	0	2	0	1	4	0	0	0	0	4	1	0	0	0	1	0	0	0	0	0	1	13	4	0	6	10	0	0	0	0	0	0	0	0	0	0	0	0	0	1	0	0	0	1	0	0	0	0	0	0	26	28	0	0	32	0	0	0	1	0	0	1	0	3	0	3	0	0	0	0	4	14	2	0	0	0	39	0	0	40	197	4	28	0	83	0	0	98	74	12	0	0	0	0	2	0	0	0	2	0	0	0	0	0	0	0	0	1	1	1	0	0	0	0	0	1	0	0	1	0	0	0	1	0	199	0	0	1	129	2	0	0	12	0	0	8	2	58	0	0	0	0	0	4	2	7	20	0	0	0	0	0	1	0	0	1	0	8	0	0	2	0	0	1	0	0	3	0	0	0	3605	0	0	0	0	0	0	21	0	1	22	0	2	3	1	0	166	0	1	1	0	0	1	0	0	1	91	0	0	0	0	0	0	0	0	0	2	0	0	0	0	0	0	4	0	0	0	0	1	0	0	15	0	0	118	0	1	4	8	0	0	0	0	0	0	20	0	0	3	0	0	0	1	0	0	0	0	1	0	0	10	0	0	0	0	0	0	0	0	0	1	0	0	0	4	0	5	0	0	0	0	0	0	0	0	0	0	57	1	0	0	0	0	36	3	12	0	1	0	20	0	1	0	0	9	0	0	0	6	30	99	156	92	1	2	0	103	12	0	0	0	0	25	1	0	0	0	0	0	2	0	0	0	1	3	5	0	0	0	9	0	1	0	1	0	1	0	0	0	0	1	1	0	0	0	2	0	3	0	193	4	2	2	2	0	4	0	28	0	4	146	438	0	0	0	5	0	0	0	0	65	0	2	0	0	0	1	0	3	3	83	0	162	141	1060	0	136	1	3	0	1	0	49	0	0	38	0	0	1	1	0	0	26	0	1	0	1	3	0	0	0	2	0	11	0	0	9	0	0	0	1	1	0	0	3	1	8	0	0	5	0	0	3	2	0	6	0	0	0	0	0	0	0	142	3	182	0	0	0	44	0	0	0	0	0	1	47	0	0	1	0	0	0	39	31	0	0	0	0	0	0	12	0	23	0	0	0	0	1	2	102	0	1	12	0	0	0	0	0	0	0	151	1	73	285	43	56	73	16	63	0	0	39	1	35	0	3	2	21	0	42	25	0	40	0	0	0	1	1	18	37	27	0	58	0	0	0	0	0	0	14	1	0	0	0	0	0	1	112	4	3	0	0	29	19	0	0	0	2	0	2	0	1	0	4	0	0	0	0	0	1912	71	358	121	3	22	3	0	0	0	0	0	98	4	8	5	25	1	1	1	2	515	1041	48	132	3	2	75	317	1	0	0	3	0	0	0	0	848	0	289	4	443	1	0	126	0	38	0	0	3	1	0	0	0	70	1	0	0	29	0	63	0	2	0	0	0	72	0	2	0	1	0	5	54	0	0	0	0	0	0	14	2	1	0	0	0	0	0	1	0	1	0	0	0	0	0	3	0	0	17	0	0	0	0	0	0	32	0	1	1	28	0	0	0	0	0	0	1	0	0	0	0	0	0	0	0	0	0	0	0	0	0	0	0	0	0	0	0	0	0	3	1	192	0	115	523	0	0	17	0	0	6	2	0	0	1	1	127	9	80	0	0	10	0	1	0	0	0	0	97	0	0	0	14	1	5	0	0	0	0	0	0	1	1	14	0	98	0	1	0	0	105	2	0	0	1	1	3	0	0	1	1	8	0	0	0	0	0	1	1	84	28	0	1	67	0	0	0	1	0	22	1	57	2	0	0	0	0	1	1	0	0	0	0	0	236	41	427	425	573	218	562	670	0	0	0	5	0	22	0	0	0	0	124	0	0	1	0	0	12	0	0	107	59	0	193	3	1	35	0	29	0	9	7	0	62	0	0	0	0	0	0	9	0	28	2	14	0	3	0	1	3	0	5	264	8	0	1	0	0	0	0	3	78	201	0	499	1	0	0	80	0	4	0	0	0	0	0	1	17	1	0	1	0	3	0	0	1	65	9	34	0	2	0	0	0	1	0	0	0	0	0	0	4	1	12	0	0	0	0	0	0	0	0	1	98	2	0	1	0	0	2	0	2	0	3	0	4	29	19	0	0	13	0	0	1	2	10	0	0	1	0	0	0	0	0	156	1	1	0	0	5	0	13	0	0	0	0	0	0	18	0	0	34	0	2	0	0	0	0	0	56	0	0	127	1	0	0	1	320	2	60	29	0	68	459	0	67	0	421	378	105	1	3	1	2	1	1	57	0	0	0	0	1	0	0	0	0	0	0	3	0	1	69	18	2	100	0	50	49	0	0	2	0	0	1	0	0	0	0	0	0	0	7	37	0	0	8	24	1	71	2	0	1	0	3	0	36	0	0	17	17	0	0	0	3	0	0	0	0	0	0	0	0	0	0	35	0	0	1	0	0	0	0	0	0	0	0	0	293	0	22	48	6	3	25	0	33	0	2	56	710	18	1	1	0	0	0	0	0	0	0	1	1	0	0	0	0	0	0	0	0	0	0	0	3	2	0	1	0	2	0	0	38	0	0	33	13	0	22	0	112	120	68	1	2	0	0	0	0	0	8	1	0	0	5	0	2	0	5	1	4	0	0	0	0	0	1	1	0	11	0	1	0	0	4	0	0	0	0	1	0	0	0	0	0	0	0	0	9	0	0	65	0	0	9	0	0	5	0	0	33	0	0	0	1361	0	0	462	12	0	1	143	1	0	1	0	0	0	0	0	0	0	1	4	0	0	0	0	5	55	0	0	0	24	1	47	92	43	0	0	0	0	0	0	4	0	72	0	0	1	0	0	3	0	0	0	0	0	0	0	0	0	0	1	17	1	0	0	0	2	0	0	0	2	0	0	0	0	1	316	0	0	0	286	0	0	3	0	0	0	0	0	0	0	0	0	0	0	0	0	0	1	4	3	0	5	3	0	0	2	0	13	0	5	29	1	0	27	35	0	0	0	0	0	0	0	99	7	4	7	0	1	0	3	1	15	58	50	57	0	0	0	6	1	0	1	1	0	0	0	0	1	0	0	0	9	2	0	0	5	15	0	26	0	7	3	0	10	5	0	39	0	0	30	1	0	0	0	0	0	2	0	1	0	3	0	0	0	17	2	7	2	1	10	30	3	1	0	0	0	1	2	0	4	12	13	5	0	0	0	0	1	0	0	0	0	1	1	1	0	0	0	0	0	1	0	2	0	0	0	0	0	0	0	0	0	16	0	5	0	4	0	26	0	0	2	30	1	0	0	0	45	71	0	0	0	0	0	27	892	68	532	213	5	483	5	1	1185	10	799	4	71	1	15	16	15	108	0	40	12	34	19	120	895	256	965	27	9	26	47	4	41	0	1	0	0	0	0	3	0	0	0	0	243	0	0	1	0	1	0	0	0	0	0	0	0	1	0	0	0	0	1	3	0	64	1	101	0	299	26	0	0	3	1	0	5	0	0	3	13	0	3	0	0	0	0	0	1	0	76	0	1	0	0	3	74	2	26	3	0	12	16	0	2	0	3	0	0	28	3	1	0	0	0	1	0	0	1	42	0	0	0	0	10	2	0	0	9	31	30	0	29	0	0	0	0	0	0	0	6	0	0	17	0	0	1	1	5	17	638	1	0	62	42	0	0	1	0	1	0	0	2	4	1	0	0	0	1	50	0	0	0	0	2	0	0	238	115	186	0	0	102	87	62	24	45	0	7	84	137	0	0	0	1	0	0	0	0	7	0	0	1	0	0	0	0	0	0	0	0	0	0	0	0	3	0	1	0	0	0	1	10	0	0	2	7	0	0	0	0	13	5	3	0	0	7	2	99	1	317	12	0	0	29	0	0	0	0	0	0	0	0	0	0	8	0	10	0	0	0	3	1	0	0	58	0	2	41	28	0	0	0	0	118	0	0	2	0	0	0	0	1	1	0	0	31	0	6	0	0	0	1	0	0	0	0	10	0	0	0	0	0	2	0	0	0	0	0	1	0	5	0	10	0	0	0	51	0	0	0	0	0	0	0	341	89	0	0	64	0	0	1	0	0	0	0	0	0	1	0	0	0	0	0	398	12	36	54	0	2	0	32	0	0	0	0	54	118	1	1	1	0	0	0	0	3	0	0	0	0	0	0	0	0	0	1	171	0	0	6	0	0	0	0	1	1	1	143	48	1	27	0	6	1	0	0	69	0	0	0	0	0	0	0	0	0	4	0	28	1	2	1	40	2	0	0	0	0	0	0	3	0	1	0	0	0	2	0	9	0	1	0	0	0	0	5	0	0	1	0	0	26	0	0	0	0	0	0	1	7	6	0	166	0	1	52	0	4	1	0	6	0	0	1	1	54	3	62	0	0	1	0	0	0	0	0	0	0	0	0	1	0	0	0	385	0	2	2	162	18	0	1	5	20	0	0	5	14	2	4	2	1	4	3	1	5	31	2	1	3	6	1	2	9	0	0	0	67	1	49	1	115	126	92	127	104	87	101	74	0	101	96	129	0	0	1	0	0	14	1	0	34	0	18	1	11	67	27	0	0	0	0	0	0	1	0	0	0	0	3	48	0	1	0	2	6	0	0	0	0	1	0	0	0	1	0	0	19	0	1	29	0	8	0	0	27	0	0	1	2	0	0	0	18	0	0	38	197	53	0	26	4	0	0	0	0	129	0	0	0	0	0	0	0	0	0	2	0	0	0	1	0	5	191	1	0	107	15	0	90	0	6	15	0	0	220	88	1	0	1	16	7	3	2	0	0	16	0	6	32	0	12	3	1	0	0	67	2	2	0	0	0	0	0	2470	5	0	5	0	0	0	0	0	0	0	121	0	22	0	2	0	0	3165	143	302	1	0	0	49	0	2	0	200	4	0	0	0	5	0	0	0	0	0	0	5	0	2	0	0	0	0	0	0	0	99	815	0	17	0	0	0	1	1	1	0	0	0	0	0	0	4	0	0	0	2	0	14	7	0	21708	77	82	0	0	1	0	0	0	15	1	0	114	0	0	0	0	0	1	0	2	0	929	0	2	6	0	7	0	1	0	0	0	0	3	0	0	0	0	0	39	0	0	0	0	0	0	0	0	0	0	0	0	2	0	0	0	1	0	0	0	0	0	0	0	0	0	0	0	16	0	0	0	2	0	0	0	1	5	0	1	0	78	0	0	0	0	0	0	90	0	3	0	1	0	2	278	3	0	10	0	1	0	3	196	16	0	0	0	0	51	5	1	106	0	0	2	3	0	0	0	0	0	0	0	3	0	0	1	0	0	0	0	0	0	0	0	0	1	1	1	0	0	0	0	1	0	2	0	0	1	2	1	1	0	3	0	0	7	0	1	0	0	0	21	0	0	7	2	72	29	0	20	0	0	0	0	0	1	1	10	16	0	0	3	0	53	1	61	0	0	0	0	0	0	0	15	3	0	0	6	10	0	1	0	0	19	0	0	5	8	2	0	0	0	1	0	0	7	0	0	0	0	0	1	152	0	0	0	1	0	0	2	0	12	11	110	0	0	0	0	0	0	111	246	0	0	0	0	0	0	0	0	0	0	0	0	0	2	0	0	21	1	0	0	0	0	0	0	0	0	0	0	84	1	48	7	0	3	0	0	0	7	1	2	0	0	0	1	23	3	0	0	0	0	17	1	14	0	0	145	0	0	0	9	136	0	0	0	54	1	6	0	0	0	1	1	6	0	0	20	6	0	1	0	0	0	0	0	2	0	3	0	0	1	0	294	4	0	0	0	0	0	0	164	0	0	0	21	0	1	0	0	0	0	0	0	12	0	0	1	1	1	0	2	0	15	0	0	3	0	1	0	0	0	0	0	3	0	0	1	8	13	4	0	1	0	0	159	0	0	0	0	0	1	0	0	0	0	0	0	0	0	5	7	0	0	0	0	7	0	0	0	1	0	0	1	0	1	1	0	0	0	0	0	0	0	0	44	17	0	0	0	108	3	1	121	49	0	0	1	0	1	0	0	0	1	0	0	0	0	1	4	19	0	130	0	1	0	0	0	0	7	0	3	0	0	3	0	6	0	20	0	0	1	0	0	0	0	0	12	0	0	0	0	2	2	1	0	0	101	3	1	0	2	1	1	0	0	0	0	0	0	0	0	0	0	2	0	0	0	0	0	0	0	0	0	0	5	16	0	0	0	0	176	0	2	0	0	0	0	0	8	0	0	4	0	0	0	5	0	1	9	20	7	0	0	0	3	0	39	0	2	0	0	0	1	1	0	0	88	0	0	0	0	0	3	0	0	1	0	1	0	0	1	0	0	0	0	0	0	6	3	43	0	0	0	0	0	0	0	0	0	0	14	0	0	0	3	0	16	0	0	0	18	0	0	0	0	0	0	1	0	5	8	0	0	0	0	0	0	0	0	0	0	0	0	1	0	0	0	0	64	0	0	0	0	0	0	0	0	0	25	0	2	0	0	0	0	0	0	0	0	219	0	1	53	16	7	5	0	1	113	1	0	38	4	2	310	0	0	4	0	1	0	3	1	0	5	0	32	119	17	3	5	38	91	0	192	7	0	1	66	0	2	0	0	1	0	0	0	1	1	0	0	1	0	0	0	1	1	1	40	0	0	1	0	0	0	0	1	0	0	0	0	0	0	0	0	10	2	0	0	0	2	0	106	0	84	25	0	0	0	0	0	0	0	0	0	33	2	0	0	0	0	0	0	0	1	0	0	0	0	0	1	4	0	0	0	0	5	0	4	1	59	0	0	0	0	0	247	0	0	2	0	0	0	0	0	1	0	17	1	0	2	0	2	0	0	1	0	2	0	425	0	0	0	8	17	24	0	0	241	0	11	2	0	1	0	0	0	0	0	0	0	35	2	5	5	0	0	0	0	0	0	0	2	0	0	0	0	0	99	4	0	0	0	0	0	0	0	0	0	5	0	0	0	2	0	0	0	1	0	0	1	0	0	1	0	95	0	0	0	2	0	0	30	1	2	0	0	0	0	0	0	0	0	0	0	3	0	0	0	0	0	0	0	0	0	53	0	0	0	0	0	0	0	0	0	0	0	1	6	49	0	15	0	6	0	0	0	0	1	9	0	25	2	0	0	0	0	0	0	22	0	208	0	1	0	0	1	1	0	0	3	0	54	2	0	0	0	0	17	0	0	0	9	8	40	7	0	11	0	0	0	0	2	5	0	97	0	0	19	1	1	0	3	0	6	0	1	25	0	2	2	0	0	2	0	0	0	0	0	34	0	0	0	0	4	30	1	1	0	0	0	8	0	0	0	0	0	2	1	0	0	10	0	1	3	0	14	1	1	2	12	0	1	0	22	1	0	0	230	127	15	717	1323	0	0	1	0	5	0	46	7	4	0	0	0	1	1	0	181	1	2	140	0	26	0	0	0	0	5	0	0	4	3	1	1	0	3	5	2	0	7	237	2	0	30	0	5	0	0	1	0	0	0	4	1	0	0	0	0	0	5	0	0	0	0	0	96	108	0	0	0	3	3	0	0	0	0	0	0	0	0	4	0	1	8	2	0	27	156	1	1	0	11	8	15	2	0	0	0	0	0	0	0	0	0	0	160	0	1	4	4	0	0	37	1	1	0	0	0	0	0	0	50	63	0	7	3	0	0	1	0	0	2	0	2	0	0	1	0	0	0	0	80	18	0	3	0	1	0	0	0	0	0	1	33	0	2	0	0	0	0	37	0	0	8	0	24	0	2	0	0	6	0	0	30	0	0	0	0	0	0	0	5	0	0	0	1044	1100	779	4	1	44	6	26	2	1	57	59	14	3	1162	19	0	1	56	12	91	4	13	456	0	1416	1	105	0	733	0	0	0	0	3	1	28	3	0	0	0	0	0	1	0	1	5	0	0	0	2	2	1	34	1	1	2	0	0	2	1	0	4	59	0	0	0	0	1	0	113	0	64	0	0	0	0	0	202	24	0	0	0	0	0	0	8	11	21	0	22	0	0	0	0	1	0	31	117	1	122	119	37	0	0	0	4	1	0	0	0	0	0	1	0	0	0	2	2	0	0	0	0	22	0	0	0	0	116	0	0	0	0	19	2	0	0	1	66	75	0	0	11	58	0	5	0	0	0	4	5	1	9	10	2	0	0	0	0	0	2	0	0	0	2	0	0	0	0	515	3	0	1	5	0	0	0	2	0	10	0	4	0	252	85	0	0	30	0	0	83	0	1	30	0	1	5	3	0	0	0	0	0	1	0	0	0	0	0	0	0	1	0	1	3	0	0	153	0	2	0	27	0	1	0	0	0	0	0	111	0	0	30	0	10	48	1	10	8	0	0	1	99	0	30	0	0	35	0	55	0	0	0	5	9	0	0	0	7	0	1	0	0	5	11	0	1	0	109	0	0	0	0	14	0	0	0	27	0	1	0	1	1	0	0	0	0	5	72	1	0	0	0	0	0	0	0	2	0	0	0	0	11	1	6	16	38	2	70	0	0	6	0	0	0	8	114	1	5	0	5	23	2	37	0	0	0	0	0	0	0	0	40	0	0	0	0	0	1	0	1	21	0	1	0	34	4	42	1	0	60	1	0	34	0	1	0	0	0	0	0	0	12	0	0	0	1	0	0	1	2	0	0	0	0	0	0	0	15	39	0	0	0	1	8	0	1	0	0	82	0	20	0	21	0	0	0	94	1	0	0	5	0	0	0	41	20	0	1	0	105	0	3	2	0	3	0	14	0	0	0	0	0	0	0	0	0	0	1	0	1	1	0	45	0	0	0	0	116	0	84	2	0	0	0	0	0	1	0	0	5	0	2	131	0	0	1	0	0	1	3	0	0	58	0	94	4	38	134	0	0	0	0	1	0	128	1	4	1	27	2	0	0	0	0	2	199	0	41	24	3	39	34	42	165	0	0	0	1	22	0	21	0	26	1	2	0	0	0	0	0	0	0	0	0	5	0	1	0	0	0	0	0	0	0	0	123	39	0	0	1	0	32	8	93	0	0	0	15	0	0	35	0	5	0	1	0	3	30	10	59	0	0	2	0	0	0	25	2	8	0	0	0	2	0	1	3	0	0	1	32	0	0	10	0	0	10	0	2	6	0	0	0	0	25	6	0	1	1	0	1	17	0	5	0	0	7	2	0	1	4	0	0	0	0	0	0	11	51	1	1	29	2	23	4	2	1	0	8	3	137	0	0	28	0	128	0	42	0	3	9	0	0	1	1	0	1	1	0	0	0	0	0	0	3	0	395	0	19	0	0	770	0	6	0	0	0	25	73	0	28	0	2	0	251	0	0	45	0	0	0	0	1	3	0	8	15	0	0	0	43	1	1	0	1	0	0	0	0	8	2	0	31	0	0	0	22	15	0	6	3	1	0	0	0	3	2	0	6	0	0	2	0	0	0	0	0	0	0	0	0	0	0	0	0	0	0	0	1	0	0	0	0	0	0	0	0	0	0	0	0	171	0	0	5	0	0	2	38	0	4	0	0	21	1	0	0	0	0	1	0	0	1	28	0	0	0	1	1	0	2	0	0	1	6	1	1	0	0	0	6	3	3	1	4	1	0	0	3	0	1	0	0	3	2	0	0	1	123	0	0	1	0	0	0	0	0	0	2	0	0	6	0	0	0	0	0	0	1	0	0	21	0	0	0	0	2	1	16	0	0	0	0	0	1	0	0	0	0	0	0	0	0	2	0	5	0	54	0	0	0	0	23	44	0	0	2	0	0	0	0	0	1	0	0	21	0	1	0	0	2	0	0	0	0	0	154	0	1	0	0	0	0	0	0	63	0	0	77	0	0	0	0	0	0	0	0	1	0	0	0	0	0	0	0	0	0	0	0	0	0	16	0	0	0	0	0	1	0	32	0	0	36	0	1	352	63	0	0	0	0	0	1	0	3	2	0	2	0	0	0	0	105	0	1	0	1	0	0	0	0	0	0	0	2	0	2	0	2	0	0	0	0	246	0	94	0	10	1	0	0	0	1	14	3	3	0	1	595	76	104	52	0	1	103	0	97	0	1	1	20	156	0	1	8	0	0	0	6	0	0	0	218	3	7	9	20	760	0	0	0	23	3	29	0	0	1	4	0	0	57	0	6	0	0	2	0	0	0	0	78	0	0	47	3	0	2	1	1	85	1	1435	0	14	0	42	1	172	0	0	34	0	6	0	0	71	2	0	1	1	1	0	2	1	0	0	1	0	33	0	33	0	0	0	0	4	98	117	0	6	17	8	325	8	1	0	1	0	0	0	2	0	0	0	1	1	0	25	0	1	0	0	26	0	37	0	2	9	0	2	0	0	3	0	1	5	0	2	0	4	0	0	4	0	0	1	0	0	0	2	2	0	0	0	0	0	1	1	0	2	2	17	0	0	0	0	0	6	0	2	0	0	13	0	20	22	0	0	3	0	13	0	0	1	155	0	0	0	3	6	0	0	3	0	1	1	22	15	0	0	111	0	0	100	5	13	3	15	4	22	1	0	14	1	0	2	5	2	0	0	0	1	4	0	0	0	1	0	0	0	0	0	0	0	5	0	0	2	1	0	31	1	0	0	0	0	0	0	2	3	0	1	5	350	8	0	0	1	0	69	0	0	0	50	1	59	54	9	7	0	0	0	7	1	0	1	1	0	1006	0	0	10	23	31	137	0	22	12	3	77	15	65	0	0	71	0	0	0	10	45	0	0	39	8	0	90	8	148	0	76	1	1	0	2	48	0	0	0	0	1	0	1	0	0	1	0	0	0	30	0	5	0	0	0	0	2	11	1	0	0	109	4	31	1	0	172	16	2	0	0	2	0	216	1	20	76	70	5	8	89	4	125	4	112	1	0	0	0	2	35	0	0	0	0	3	4	2	0	0	0	0	0	2	1	5	0	4	30	17	136	0	293	467	0	0	43	2	1	0	0	0	0	1	0	0	0	0	0	0	0	0	30	44	26	0	0	8	3	0	38	0	3	0	0	2	0	0	0	1	0	0	0	0	3	0	0	62	3	87	4	0	10	0	921	389	80	34	0	0	2	2	0	0	61	0	1	1	1	0	0	0	6	44	0	0	0	209	26	38	164	0	0	1	0	0	6	0	4	7	0	6	1	0	0	0	0	0	174	119	69	6	2	3	3	10	3	5	5	0	0	0	0	29	0	0	2	0	6	0	173	254	6	14	184	0	104	0	0	0	1	0	0	8	0	0	0	0	0	86	52	0	0	4	0	263	7	0	1	1	0	0	0	33	37	4	0	2	0	1	0	565	0	45	163	81	52	75	72	0	0	269	78	0	172	6	2	0	31	52	0	0	2	0	0	0	0	0	1	2	245	0	0	0	3	0	1	17	1	871	1051	2	0	2	153	0	582	389	214	0	0	253	1	0	0	0	0	0	0	0	18	0	0	0	0	0	0	0	1	0	6	0	0	0	0	0	0	11	0	97	0	0	124	0	18	0	73	2	137	101	0	2	0	0	0	0	324	125	3	0	21	1	0	0	108	2	0	10	0	0	1	34	0	0	0	0	0	2	0	45	103	0	0	0	1	0	1	3	1	21	0	1	0	1	0	5	0	1	0	346	0	1	0	0	0	0	14491	7	2962	0	60	0	21	26	3	15	0	0	0	0	0	0	0	2	93	0	38	0	0	0	0	0	0	28	305	1	0	1	549	0	0	21	0	0	5	0	0	0	0	1106	0	0	0	0	0	0	0	1	0	46	0	4	1	0	0	0	0	5	0	0	0	0	0	0	1	10	4	0	99	0	0	2	0	0	4	0	1	91	1	0	0	0	0	0	0	0	116	0	0	14	4	0	1	0	1	0	0	0	713	0	0	20	3	0	0	0	0	4	0	7	42	43	0	0	0	0	1	15	1	0	0	0	0	0	3	153	0	0	4	1	2	0	0	1	0	1	1	1	8	3766	0	57	10	0	8	0	0	86	0	216	58	382	365	284	25	339	125	203	0	0	21	1	0	1	0	4	294	15	2165	1	5	9	5	0	100	2	0	1	2	40	24	14	2	2	23	0	53	0	0	0	61	31	91	6	82	25	33	1	58	0	2	3	84	1	28	80	1	5	0	0	0	0	0	0	0	1	44	0	0	0	0	91	1	1	21	0	0	0	4	0	66	0	0	0	20	0	0	82	0	0	0	1	0	5	0	0	29	1	3	0	63	1	0	89	0	2	0	1	234	1361	0	94	0	2	252	0	7	3	0	3	0	51	0	1	0	0	0	41	0	52	184	3	0	27	0	80	0	0	0	24	2	1	0	30	0	46	0	1	3	152	0	0	0	0	0	0	31	13	0	1	3	0	0	1	0	0	0	0	1	0	1	0	1	92	0	0	12	4	0	16	112	59	0	0	0	0	0	0	0	0	39	0	0	5	4	113	1	103	134	0	0	38	0	1	0	0	0	0	0	0	0	31	0	83	632	232	242	5	0	0	0	0	1	0	0	0	0	1	0	0	0	0	0	1	0	32	160	4	0	9	0	4	0	0	0	0	33	2	2	1	0	0	3	0	0	7	1	0	0	0	0	0	0	2	0	1	66	0	0	1	0	0	0	50	12	0	1	1	52	127	0	0	0	1	0	0	0	46	0	0	81	0	0	0	0	0	0	0	1	21	16	0	0	0	0	0	0	1	0	0	0	11	171	0	2	0	0	0	2	68	2	171	0	0	0	1	3	2	0	44	0	29	44	1	0	1	0	3	250	1	0	0	0	0	806	961	146	357	0	152	347	0	359	0	179	0	0	1	493	817	199	227	364	59	140	118	114	1	262	0	0	109	125	67	1	0	670	0	452	472	1	208	1	327	2	0	292	4	156	186	0	287	0	0	0	10	397	0	2	327	265	290	159	0	0	0	880	1901	4717	0	4	156	1	0	0	1	0	30	0	50	1	0	0	7	1	303	9	0	7	0	0	0	0	2	6	4	0	0	0	3	1	0	96	131	0	13	157	78	1	0	0	1	3	61	97	1	0	120	1	11	0	86	0	1	74	2	0	0	0	49	0	0	1	174	1	0	3	0	0	0	0	100	0	1	2	1	0	35	0	5	4	0	0	31	0	0	6	73	0	0	0	0	0	0	0	0	0	0	1	0	0	0	0	1	5	0	0	0	4	4	1	66	170	115	103	0	1	0	0	5	0	0	0	0	0	0	1	0	1	0	0	0	0	0	0	0	0	3	3	0	0	36	0	0	0	1	0	0	0	0	1	0	0	2	2	7	0	7	70	0	0	0	0	2	0	137	1	45	283	0	150	1	211	3	0	0	0	2	6	0	0	0	1	0	0	0	89	0	40	2	1	1	9	0	0	1	0	0	1	27	0	3	4	3	0	1	0	209	139	0	0	0	52	1	2	56	1	100	22	26	1	0	0	0	1	159	0	465	0	0	0	0	52	0	0	27	51	0	46	128	0	0	98	0	0	3	215	72	30	0	4	0	0	14	165	14	9	0	0	2	0	0	0	0	3	7	0	0	0	1	1	40	54	5	76	0	0	0	0	0	0	3	11	4	0	196	7	0	1	4	0	0	0	0	0	173	30	1	0	6	0	2	0	3	0	0	0	0	0	0	0	0	0	0	0	4	0	0	1	0	1	0	89	2	56	0	1	2	3	0	11	1	0	2	0	35	0	1	0	53	0	12	0	0	1	0	2	1	9	0	0	126	81	62	0	0	2	0	6	1	0	1	0	0	0	0	4	6	2	0	0	0	0	4	0	4	0	0	0	146	57	1	7	0	0	0	1	3	55	1	18	22	1	0	0	0	2	4	5	0	3	6	1	0	2	0	0	6	0	38	0	0	0	128	4	0	0	1	151	0	55	0	1	0	0	0	33	0	0	0	0	0	0	1	1	3	104	0	1	67	1	50	0	3	0	1	160	0	0	0	1	0	306	0	0	0	0	0	2	2	8	0	2	0	3	2	0	2	0	0	0	0	0	4	16	66	31	0	0	0	0	32	0	4	0	0	0	153	76	0	2	2	0	720	3	83054	0	0	5	0	0	30	0	0	1	0	0	0	0	0	3	0	34	0	0	1	0	1	1	224	0	1	0	49	0	0	3	0	0	0	0	0	0	78	110	7	7	0	0	0	0	0	0	0	0	17	0	0	4	0	6	40	18	152	275	1	0	64	0	44	0	0	0	5	4	336	94	249	222	0	0	0	5	4	22	0	0	175	2	0	659	0	0	0	0	0	1	195	22	3	121	1	2	151	52	0	1	87	100	2	1	213	0	0	2	0	2	0	0	0	4	0	1	0	73	181	3	941	1579	7	50	965	2	2092	386	31	1710	47	769	422	294	281	825	892	0	138	967	53	363	449	1	3	3	675	801	805	2512	1412	20	50	1	1	196	107	2	15	0	0	0	0	0	0	0	0	0	0	0	0	0	44	2	22	1	46	0	0	0	51	0	5	3	0	48	88	40	26	4	0	0	0	0	7	4	0	0	13	0	0	0	0	1	29	46	0	7	0	0	0	21	129	0	6	0	2	0	0	0	0	4	0	0	0	0	0	3	0	52	0	5	14	39	7	0	2	14	1	0	49	0	2	151	0	33	1	0	1	93	5	0	12	12	0	170	4	0	32	9	1	5	1	3	1	0	0	0	2	0	1	9	0	1	0	2	2	0	1	0	4	3	14	0	3	0	1	1	2	1	0	2	1	3	0	5	0	0	0	0	1	0	0	0	0	0	1	0	1	1	9	106	0	0	8	0	0	0	0	0	0	0	3	9	33	93	100	39	344	33	1	26	12	164	147	39	132	0	11	0	0	129	1	1	24	0	36	3	26	11	0	0	1	0	0	0	0	0	109	8	226	3	18	5	6	0	0	0	0	5452	36564	1	0	4	0	0	0	0	114	0	170	0	4	5	0	74	46	1	1550	3	0	0	71	38	0	62	1	1453	0	0	3	0	709	0	0	0	0	0	2	0	0	102	0	4	288	75	92	1	0	0	97	0	0	3	1	2	0	0	9	1	0	1	2	0	0	32	1	0	3	0	0	0	4	0	6	8	4	1	2	4	0	1	0	0	0	2	146	344	98	65	69	91	76	148	0	0	17	20	69	42	1	0	3	2	28	0	3	0	6	0	0	14	87	0	0	3	12	1	0	1	0	14	0	16	4	0	0	0	54	29	0	6	26	0	0	1	0	0	1	0	1	154	0	130	0	9	0	0	3	5	0	85	2	0	1	1	1	4	0	1	0	0	0	10	526	0	0	1167	0	12	1	20	0	1	1	4	12	6	0	0	0	0	0	0	0	0	0	1	0	0	0	0	0	0	0	1	0	0	1	0	31	93	961	506	178	189	0	0	0	0	0	0	0	0	0	0	0	1	0	0	0	0	1	167	1	0	0	0	0	26	0	0	0	0	0	0	0	51	0	1	117	0	0	0	16	0	44	0	0	40	2	2	2	26	153	1	27	97	75	0	128	7	0	156	369	0	40	388	0	0	73	1	1	1	1	344	69	9	0	0	3	0	0	140	0	12	0	0	992	0	31	1	0	8	0	7	3	22	1	0	5	5	0	0	0	0	0	0	0	2	0	0	0	1	20	639	1	0	0	0	3	0	0	0	0	113	1	0	0	1	0	0	79	1	1	0	0	0	11	0	2	0	87	1	0	148	1	3	0	1	0	0	1	44	0	49	0	3	3	4	0	0	453	0	4	1	0	17	6	0	0	37	132	25	0	307	1	59	144	43	0	106	0	649	110	304	19	110	1	0	3	2	1	0	0	0	212	0	0	2	0	148	4	0	201	0	0	0	1	0	100	0	6	0	1	0	56	58	1	0	3	0	16	0	0	20	0	0	1	14	25	0	1	0	0	75	6	24	0	0	0	0	0	0	0	0	75	0	0	0	0	2	0	0	0	0	0	0	0	0	34	57	45	78	1	0	46	55	57	75	88	253	0	0	0	0	0	1	0	0	0	523	2	0	0	212	187	143	58	0	485	0	0	38	17	0	4	2	6	0	0	1	0	0	0	0	0	600	207	0	0	0	0	0	0	0	0	1	0	5	3	3	3	0	0	0	0	0	0	0	0	2	0	0	0	0	1	0	0	0	0	0	0	1	0	0	0	0	0	2	3	0	0	0	0	1	1	0	0	0	0	0	0	3	0	1	0	77	0	44	0	0	9	0	1	1	2	0	4	1	0	5	0	0	30	342	138	233	35	0	0	0	3	0	1	78	26	0	1	0	0	49	0	24	0	0	54	0	2	44	0	13	33	0	1	14	78	94	338	1	0	0	0	0	0	0	0	0	60	1	33	3	53	0	92	3	0	208	0	3	17	9	0	3	0	22	230	226	222	0	184	84	111	0	94	0	24	1	1	40	0	0	5	1	0	0	0	0	0	24	0	74	29	0	0	0	31	1	33	86	0	57	0	1	47	1	105	0	54	96	2	8	118	0	110	0	0	2	1	0	21	0	0	2	190	0	45	1	0	0	44	1	0	0	0	0	0	4	0	0	0	0	0	0	3	72	51	0	155	58	134	1075	4	2	18	0	0	0	0	0	18	2	11	0	0	4	101	0	0	1	18	2	21	0	1	0	0	0	61	20	63	1	26	280	0	0	1	0	1	0	246	0	23	0	42	369	0	2	0	50	4	0	0	0	0	0	2	0	0	0	0	0	21	6	0	0	0	0	0	1	2	2	1	1	0	1	0	0	0	4	0	1	2	0	0	0	2	2	1	1	69	8	214	180	0	121	149	72	329	119	33	59	0	3	1	0	0	0	0	0	0	0	0	0	1	0	0	20	0	2	0	0	10	0	0	0	2	12	0	47	0	0	1	0	35	28	0	0	0	0	0	1	0	0	45	3	0	0	0	0	0	0	0	0	22	0	6	4	3	14	0	1	34	0	2	107	2	0	0	0	0	0	0	2	71	0	228	0	2	4	24	0	63	731	0	0	0	0	0	21	0	0	0	4	1	0	0	0	0	0	0	9	0	16	0	0	0	0	0	1	0	25	0	0	0	0	0	5	1	0	234	0	0	0	1	0	4	0	0	0	0	0	0	0	78	7	0	0	0	15	0	1	2	0	0	1	0	0	0	1	0	0	2	1	1	162	0	1	0	0	0	0	85	0	0	63	0	0	0	0	0	4	0	0	0	0	0	0	1	0	1	8	0	1	3	0	1	0	0	9	2	0	0	0	0	0	0	0	0	0	0	1	0	0	0	0	0	0	2	0	0	0	0	0	0	0	0	0	0	45	3	0	2	0	0	0	0	10	0	0	0	0	0	0	0	52	0	0	0	0	0	0	0	1	0	0	0	0	1	2	0	0	0	0	0	0	0	55	0	0	0	0	0	0	0	0	0	0	0	0	0	0	0	0	0	0	1	0	6	0	0	0	0	0	2	0	0	0	0	0	0	0	0	0	0	0	0	0	0	0	0	0	0	0	0	0	0	0	0	0	0	0	0	0	0	0	17	0	7	0	0	0	0	0	0	0	0	0	0	0	0	0	0	0	0	0	0	0	0	0	1	0	0	64	0	0	0	0	0	0	0	0	0	0	0	7	0	0	0	1	1	0	0	0	0	0	0	0	0	0	0	1	0	0	0	2	0	0	0	0	0	0	0	0	0	0	4	0	0	1	26	0	0	0	0	0	0	2	0	0	0	2	0	0	0	0	0	0	1	0	0	0	0	0	0	1	0	2	2	0	0	0	0	0	0	59	0	1	0	8	0	13	0	0	571	1	1	0	0	0	297	0	1	0	20	0	1	0	0	0	2	51	0	193	0	0	0	38	0	1	0	368	14	0	0	1	1	0	0	192	0	169	0	606	29	1	1	0	51	0	7	0	0	0	0	0	0	0	0	6	16	3	48	0	4	5	2	0	1	3	0	0	1	0	2	1	0	1	0	0	0	0	0	1	0	0	0	0	0	0	0	0	1	102	1	2	0	0	1	0	2	23	1	0	0	0	0	0	1	0	0	0	2	0	0	289	0	3	4	134	0	4	0	0	0	0	0	0	2	0	0	0	0	0	0	1	3	0	327	0	0	0	0	0	0	2	0	0	0	386	0	16	1	1	0	0	1	0	0	0	0	0	0	0	0	0	0	1	0	0	0	1	86	51	2	140	130	0	2	0	0	3	90	35	0	4955	0	1	0	0	0	0	0	0	102	31	7	0	0	0	0	1	4	0	0	0	41	0	0	1	0	24	15	100	0	2	0	5	0	0	5	1	7	0	0	2	0	0	0	0	0	0	0	0	0	60	1	3	10	0	0	0	0	0	0	15	6	65	38	33	51	0	195	276	1023	1	156	3	2	111	2	0	9	0	1	2	0	0	0	3	41	24	0	0	1	0	165	1	0	0	0	212	0	0	0	0	2	110	1	0	18	0	0	257	0	170	0	0	0	0	0	0	1	1	23	1	26	0	22	0	17	0	0	53	0	13	0	0	0	2	41	1	57	0	1	0	193	178	18	0	4	1	3	0	0	21	0	16	164	0	1	0	0	0	0	2	0	0	0	0	0	2	21	2	0	22	234	0	0	31	0	1	167	70	28	0	0	0	0	117	0	61	106	0	0	0	1	39	7	42	91	2	184	53	0	0	2	0	0	0	0	0	9	3	243	1	181	13	0	0	0	0	0	101	37	0	0	0	0	34	4	0	2	0	57	12	1	1	0	0	0	4	20	0	33	71	157	124	2	0	33	142	61	1	0	0	16	0	0	3	0	2	0	202	0	9	1	3	2	5	33	171	43	38	0	0	1	0	26	0	0	0	1	1	1	1	0	0	0	27	43	43	133	0	50	0	1	0	2	0	23	0	40	0	25	2	0	0	19	1	9	69	3	41	0	0	1	0	46	169	0	0	1	0	0	16	0	0	10	0	0	0	0	23	71	2	0	25	1	66	0	5	5	0	0	0	3	0	98	0	1	0	91	0	7	300	1	146	2	0	40	0	0	1	0	1	0	70	2	1	0	2	1	0	4	1	0	1	50	13	0	1	154	1	30	0	0	0	0	0	3	0	0	0	0	15	33	0	16	0	611	34	2	1115	332	166	311	847	3	319	597	220	1	990	2130	834	697	18	327	30	0	0	3	17	0	0	0	1	8	3	0	1	28	8	1	0	3	1	0	1	1	0	0	2	0	71	0	1	9	9	7	0	0	0	0	0	0	0	0	0	0	0	1	0	0	0	0	0	0	0	0	0	0	0	0	0	0	20	24	0	0	0	0	0	0	0	0	0	0	0	0	0	0	0	0	0	0	0	0	0	0	10	0	93	64	2	328	14	1	1	32	0	0	0	57	16	52	0	3	4	46	0	0	0	3	0	6	1	0	0	0	0	0	0	47	0	12	3	109	177	0	6	0	40	0	50	0	28	0	1	0	0	0	1	0	0	2	52	0	12	0	0	0	57	2	107	0	33	0	33	59	53	0	61	1	7	0	0	81	1	0	0	167	142	0	1	0	0	1	0	0	25	8	56	0	0	25	347	9	51	2	3	0	0	1	0	0	3	2	0	392	1	0	0	0	1	103	0	0	0	0	66	0	10	0	0	0	0	0	1	26	0	2	28	676	4	20	20	0	16	0	51	0	7	0	4	1	0	16	41	0	38	0	0	1	0	1	31	33	0	0	63	47	22	73	1	64	0	25	41	0	30	4	21	3	0	14	0	0	104	1	1	2	5	49	3	37	0	1	1	0	0	0	0	0	8	0	0	0	0	2	0	1	5	0	2	0	0	2	2	0	0	0	0	0	0	0	1	5	0	1	0	0	0	0	0	39	4	1	34	75	0	1	0	8	2	684	98	129	54	0	29	689	233	0	2	193	0	41	1	41	1	17	0	0	69	0	106	107	1	3	7	2	0	1	28	236	20	0	0	76	31	417	0	0	0	0	0	0	0	0	0	0	1	0	59	0	0	0	0	0	6	0	411	0	376	154	28	0	119	0	24	1	0	0	0	0	1	0	0	0	88	0	193	0	4	2	3	0	63	28	898	0	2	0	0	1	7	0	32	53	25	16	2	17	0	14	26	0	0	0	1	0	3	6	3	988	123	228	1	1	0	0	0	0	61	1	0	0	0	1	19	0	524	1	0	0	0	441	23	4	2	0	11	520	243	256	1	3	1	0	0	3	0	28	2	10	6	2	0	2	2	0	1	0	1	0	1	0	0	1	0	0	1	0	0	1	0	509	0	0	1	0	304	8	123	0	0	0	16	3	20	0	0	1	85	90	0	8	5	0	62	0	0	0	10	0	0	2	1	0	0	1	3	2	157	73	17	22	131	0	0	55	21	11	7	1	0	0	0	2	0	0	4	25	0	0	7	67	0	0	0	0	0	0	0	89	0	1	2	44	7	34	2	7	34	1	36	0	1	26	1	14	0	0	12	9	33	21	108	133	43	276	1	325	0	1	0	1	1	6	0	0	0	2	5	7	0	2	0	0	0	2	38	1	0	0	47	0	0	1	3	10	1	3	4	0	286	0	856	0	0	492	0	0	0	0	0	0	0	0	21	179	0	0	0	3	0	0	9	2	7	0	50	1	25	0	0	0	2	0	4	72	0	0	0	0	3	0	0	0	57	2	6146	168	145	267	49	194	132	109	76	192	114	27	1	21	69	2	0	0	3	0	8	1	2	0	2	0	6	1	0	0	0	4	4	1	0	0	0	1	0	0	1	0	0	2	0	0	0	0	0	0	1	1	0	0	0	0	0	0	6	0	0	0	0	63	2	0	181	0	318	342	0	165	0	0	1	25	0	0	3	1	1	640	0	0	177	57	0	0	0	126	0	33	1	36	73	142	0	0	1	0	12	0	0	0	1	0	0	0	0	0	17	11	8	0	79	1	16	18	18	6	0	0	1	0	1	78	1	2	0	3	48	62	0	68	0	2	0	22	0	1	0	64	2	0	0	0	0	0	1	0	1	185	2	0	0	0	24	0	2	0	5	41	2	3	1	3	0	0	0	2	0	3	4	0	3	18	40	0	0	2	0	0	0	0	0	0	0	0	17	2	3
